
Hand #1: 

PokerStars Hand #246222355402:  Hold'em No Limit ($0.01/$0.02 CAD) - 2023/09/27 22:56:41 ET
Table 'Alya III' 6-max Seat #1 is the button
Seat 1: HortonRoundtree ($1.86 in chips) 
Seat 2: fourz4444 ($1.91 in chips) 
Seat 3: CashMatteo ($2 in chips) 
Seat 5: ljab26 ($2.96 in chips) 
Seat 6: vegasricky ($1.56 in chips) 
fourz4444: posts small blind $0.01
CashMatteo: posts big blind $0.02
bouchizzle: sits out 
*** HOLE CARDS ***
Dealt to CashMatteo [8c 3d]
ljab26: raises $0.02 to $0.04
vegasricky: folds 
HortonRoundtree: folds 
fourz4444: calls $0.03
CashMatteo: folds 
*** FLOP *** [4h Jd Kh]
fourz4444: checks 
ljab26: bets $0.04
fourz4444: raises $0.18 to $0.22
ljab26: folds 
Uncalled bet ($0.18) returned to fourz4444
fourz4444 collected $0.17 from pot
fourz4444: doesn't show hand 
*** SUMMARY ***
Total pot $0.18 | Rake $0.01 
Board [4h Jd Kh]
Seat 1: HortonRoundtree (button) folded before Flop (didn't bet)
Seat 2: fourz4444 (small blind) collected ($0.17)
Seat 3: CashMatteo (big blind) folded before Flop
Seat 5: ljab26 folded on the Flop
Seat 6: vegasricky folded before Flop (didn't bet)

Hand #2: 

PokerStars Hand #246222360465:  Hold'em No Limit ($0.01/$0.02 CAD) - 2023/09/27 22:57:21 ET
Table 'Alya III' 6-max Seat #2 is the button
Seat 1: HortonRoundtree ($1.86 in chips) 
Seat 2: fourz4444 ($2 in chips) 
Seat 3: CashMatteo ($1.98 in chips) 
Seat 4: bouchizzle ($2 in chips) 
Seat 5: ljab26 ($2.88 in chips) 
Seat 6: vegasricky ($1.56 in chips) 
CashMatteo: posts small blind $0.01
bouchizzle: posts big blind $0.02
*** HOLE CARDS ***
Dealt to CashMatteo [3d Js]
ljab26: folds 
vegasricky: calls $0.02
HortonRoundtree: folds 
fourz4444: calls $0.02
CashMatteo: folds 
bouchizzle: checks 
*** FLOP *** [Tc Kh 5c]
bouchizzle: checks 
vegasricky: bets $0.06
fourz4444: folds 
bouchizzle: folds 
Uncalled bet ($0.06) returned to vegasricky
vegasricky collected $0.07 from pot
*** SUMMARY ***
Total pot $0.07 | Rake $0 
Board [Tc Kh 5c]
Seat 1: HortonRoundtree folded before Flop (didn't bet)
Seat 2: fourz4444 (button) folded on the Flop
Seat 3: CashMatteo (small blind) folded before Flop
Seat 4: bouchizzle (big blind) folded on the Flop
Seat 5: ljab26 folded before Flop (didn't bet)
Seat 6: vegasricky collected ($0.07)

Hand #3: 

PokerStars Hand #246222366367:  Hold'em No Limit ($0.01/$0.02 CAD) - 2023/09/27 22:58:09 ET
Table 'Alya III' 6-max Seat #3 is the button
Seat 1: HortonRoundtree ($1.86 in chips) 
Seat 2: fourz4444 ($1.98 in chips) 
Seat 3: CashMatteo ($1.97 in chips) 
Seat 4: bouchizzle ($1.98 in chips) 
Seat 5: ljab26 ($2.88 in chips) 
Seat 6: vegasricky ($1.61 in chips) 
bouchizzle: posts small blind $0.01
ljab26: posts big blind $0.02
*** HOLE CARDS ***
Dealt to CashMatteo [2h 5s]
vegasricky: folds 
HortonRoundtree: raises $0.02 to $0.04
fourz4444: folds 
CashMatteo: calls $0.04
bouchizzle: raises $0.14 to $0.18
ljab26: folds 
HortonRoundtree: folds 
CashMatteo: folds 
Uncalled bet ($0.14) returned to bouchizzle
bouchizzle collected $0.14 from pot
bouchizzle: doesn't show hand 
*** SUMMARY ***
Total pot $0.14 | Rake $0 
Seat 1: HortonRoundtree folded before Flop
Seat 2: fourz4444 folded before Flop (didn't bet)
Seat 3: CashMatteo (button) folded before Flop
Seat 4: bouchizzle (small blind) collected ($0.14)
Seat 5: ljab26 (big blind) folded before Flop
Seat 6: vegasricky folded before Flop (didn't bet)

Hand #4: 

PokerStars Hand #246222370146:  Hold'em No Limit ($0.01/$0.02 CAD) - 2023/09/27 22:58:38 ET
Table 'Alya III' 6-max Seat #4 is the button
Seat 1: HortonRoundtree ($1.82 in chips) 
Seat 2: fourz4444 ($1.98 in chips) 
Seat 3: CashMatteo ($1.93 in chips) 
Seat 4: bouchizzle ($2.08 in chips) 
Seat 5: ljab26 ($2.86 in chips) 
Seat 6: vegasricky ($1.61 in chips) 
ljab26: posts small blind $0.01
vegasricky: posts big blind $0.02
*** HOLE CARDS ***
Dealt to CashMatteo [5h Td]
HortonRoundtree: folds 
fourz4444: calls $0.02
CashMatteo: folds 
bouchizzle: raises $0.06 to $0.08
ljab26: calls $0.07
vegasricky: folds 
fourz4444: calls $0.06
*** FLOP *** [8s 2h 5s]
ljab26: checks 
fourz4444: checks 
bouchizzle: bets $0.15
ljab26: folds 
fourz4444: calls $0.15
*** TURN *** [8s 2h 5s] [Jh]
fourz4444: bets $0.54
bouchizzle: folds 
Uncalled bet ($0.54) returned to fourz4444
fourz4444 collected $0.54 from pot
fourz4444: doesn't show hand 
*** SUMMARY ***
Total pot $0.56 | Rake $0.02 
Board [8s 2h 5s Jh]
Seat 1: HortonRoundtree folded before Flop (didn't bet)
Seat 2: fourz4444 collected ($0.54)
Seat 3: CashMatteo folded before Flop (didn't bet)
Seat 4: bouchizzle (button) folded on the Turn
Seat 5: ljab26 (small blind) folded on the Flop
Seat 6: vegasricky (big blind) folded before Flop

Hand #5: 

PokerStars Hand #246222376289:  Hold'em No Limit ($0.01/$0.02 CAD) - 2023/09/27 22:59:28 ET
Table 'Alya III' 6-max Seat #5 is the button
Seat 1: HortonRoundtree ($1.82 in chips) 
Seat 2: fourz4444 ($2.29 in chips) 
Seat 3: CashMatteo ($1.93 in chips) 
Seat 4: bouchizzle ($1.85 in chips) 
Seat 5: ljab26 ($2.78 in chips) 
Seat 6: vegasricky ($1.59 in chips) 
vegasricky: posts small blind $0.01
HortonRoundtree: posts big blind $0.02
*** HOLE CARDS ***
Dealt to CashMatteo [Ah 2c]
fourz4444: calls $0.02
CashMatteo: calls $0.02
bouchizzle: folds 
ljab26: calls $0.02
vegasricky: calls $0.01
HortonRoundtree: checks 
*** FLOP *** [6d Ts 8d]
vegasricky: bets $0.06
HortonRoundtree: folds 
fourz4444: calls $0.06
CashMatteo: folds 
ljab26: folds 
*** TURN *** [6d Ts 8d] [Qc]
vegasricky: bets $0.06
fourz4444: calls $0.06
*** RIVER *** [6d Ts 8d Qc] [3c]
vegasricky: bets $0.06
fourz4444: folds 
Uncalled bet ($0.06) returned to vegasricky
vegasricky collected $0.33 from pot
*** SUMMARY ***
Total pot $0.34 | Rake $0.01 
Board [6d Ts 8d Qc 3c]
Seat 1: HortonRoundtree (big blind) folded on the Flop
Seat 2: fourz4444 folded on the River
Seat 3: CashMatteo folded on the Flop
Seat 4: bouchizzle folded before Flop (didn't bet)
Seat 5: ljab26 (button) folded on the Flop
Seat 6: vegasricky (small blind) collected ($0.33)

Hand #6: 

PokerStars Hand #246222383878:  Hold'em No Limit ($0.01/$0.02 CAD) - 2023/09/27 23:00:26 ET
Table 'Alya III' 6-max Seat #6 is the button
Seat 1: HortonRoundtree ($1.80 in chips) 
Seat 2: fourz4444 ($2.15 in chips) 
Seat 3: CashMatteo ($1.91 in chips) 
Seat 4: bouchizzle ($2 in chips) 
Seat 5: ljab26 ($2.76 in chips) 
Seat 6: vegasricky ($1.78 in chips) 
HortonRoundtree: posts small blind $0.01
fourz4444: posts big blind $0.02
*** HOLE CARDS ***
Dealt to CashMatteo [Kh Ts]
CashMatteo: raises $0.04 to $0.06
bouchizzle: folds 
ljab26: folds 
vegasricky: folds 
HortonRoundtree: folds 
fourz4444: folds 
Uncalled bet ($0.04) returned to CashMatteo
CashMatteo collected $0.05 from pot
CashMatteo: doesn't show hand 
*** SUMMARY ***
Total pot $0.05 | Rake $0 
Seat 1: HortonRoundtree (small blind) folded before Flop
Seat 2: fourz4444 (big blind) folded before Flop
Seat 3: CashMatteo collected ($0.05)
Seat 4: bouchizzle folded before Flop (didn't bet)
Seat 5: ljab26 folded before Flop (didn't bet)
Seat 6: vegasricky (button) folded before Flop (didn't bet)

Hand #7: 

PokerStars Hand #246222387010:  Hold'em No Limit ($0.01/$0.02 CAD) - 2023/09/27 23:00:49 ET
Table 'Alya III' 6-max Seat #1 is the button
Seat 1: HortonRoundtree ($1.79 in chips) 
Seat 2: fourz4444 ($2.13 in chips) 
Seat 3: CashMatteo ($1.94 in chips) 
Seat 4: bouchizzle ($2 in chips) 
Seat 5: ljab26 ($2.76 in chips) 
Seat 6: vegasricky ($1.78 in chips) 
fourz4444: posts small blind $0.01
CashMatteo: posts big blind $0.02
*** HOLE CARDS ***
Dealt to CashMatteo [As Ad]
bouchizzle: folds 
ljab26: calls $0.02
vegasricky: folds 
HortonRoundtree: folds 
fourz4444: calls $0.01
CashMatteo: raises $0.04 to $0.06
ljab26: calls $0.04
fourz4444: calls $0.04
*** FLOP *** [6s 7s 3c]
fourz4444: checks 
CashMatteo: bets $0.07
ljab26: calls $0.07
fourz4444: calls $0.07
*** TURN *** [6s 7s 3c] [5d]
fourz4444: checks 
CashMatteo: checks 
ljab26: checks 
*** RIVER *** [6s 7s 3c 5d] [6d]
fourz4444: bets $0.19
CashMatteo: calls $0.19
ljab26: folds 
*** SHOW DOWN ***
fourz4444: shows [5h 8d] (two pair, Sixes and Fives)
CashMatteo: shows [As Ad] (two pair, Aces and Sixes)
CashMatteo collected $0.74 from pot
*** SUMMARY ***
Total pot $0.77 | Rake $0.03 
Board [6s 7s 3c 5d 6d]
Seat 1: HortonRoundtree (button) folded before Flop (didn't bet)
Seat 2: fourz4444 (small blind) showed [5h 8d] and lost with two pair, Sixes and Fives
Seat 3: CashMatteo (big blind) showed [As Ad] and won ($0.74) with two pair, Aces and Sixes
Seat 4: bouchizzle folded before Flop (didn't bet)
Seat 5: ljab26 folded on the River
Seat 6: vegasricky folded before Flop (didn't bet)

Hand #8: 

PokerStars Hand #246222400269:  Hold'em No Limit ($0.01/$0.02 CAD) - 2023/09/27 23:02:22 ET
Table 'Alya III' 6-max Seat #2 is the button
Seat 1: HortonRoundtree ($1.79 in chips) 
Seat 2: fourz4444 ($1.81 in chips) 
Seat 3: CashMatteo ($2.36 in chips) 
Seat 4: bouchizzle ($2 in chips) 
Seat 5: ljab26 ($2.63 in chips) 
Seat 6: vegasricky ($1.78 in chips) 
CashMatteo: posts small blind $0.01
bouchizzle: posts big blind $0.02
*** HOLE CARDS ***
Dealt to CashMatteo [Jh 6c]
ljab26: folds 
vegasricky: folds 
HortonRoundtree: folds 
fourz4444: calls $0.02
CashMatteo: calls $0.01
bouchizzle: checks 
*** FLOP *** [Th 2h 3d]
CashMatteo: checks 
bouchizzle: checks 
fourz4444: checks 
*** TURN *** [Th 2h 3d] [2s]
CashMatteo: checks 
bouchizzle: bets $0.06
fourz4444: calls $0.06
CashMatteo: folds 
*** RIVER *** [Th 2h 3d 2s] [Kd]
bouchizzle: bets $0.23
fourz4444: calls $0.23
*** SHOW DOWN ***
bouchizzle: shows [2d Js] (three of a kind, Deuces)
fourz4444: mucks hand 
bouchizzle collected $0.62 from pot
*** SUMMARY ***
Total pot $0.64 | Rake $0.02 
Board [Th 2h 3d 2s Kd]
Seat 1: HortonRoundtree folded before Flop (didn't bet)
Seat 2: fourz4444 (button) mucked [Ks 7c]
Seat 3: CashMatteo (small blind) folded on the Turn
Seat 4: bouchizzle (big blind) showed [2d Js] and won ($0.62) with three of a kind, Deuces
Seat 5: ljab26 folded before Flop (didn't bet)
Seat 6: vegasricky folded before Flop (didn't bet)

Hand #9: 

PokerStars Hand #246222408874:  Hold'em No Limit ($0.01/$0.02 CAD) - 2023/09/27 23:03:22 ET
Table 'Alya III' 6-max Seat #3 is the button
Seat 1: HortonRoundtree ($1.79 in chips) 
Seat 2: fourz4444 ($1.50 in chips) 
Seat 3: CashMatteo ($2.34 in chips) 
Seat 4: bouchizzle ($2.31 in chips) 
Seat 5: ljab26 ($2.63 in chips) 
Seat 6: vegasricky ($1.78 in chips) 
bouchizzle: posts small blind $0.01
ljab26: posts big blind $0.02
*** HOLE CARDS ***
Dealt to CashMatteo [2s 4h]
vegasricky: raises $0.02 to $0.04
HortonRoundtree: folds 
fourz4444: calls $0.04
CashMatteo: folds 
bouchizzle: folds 
ljab26: folds 
*** FLOP *** [Jc Js 5h]
vegasricky: checks 
fourz4444: bets $0.20
vegasricky: folds 
Uncalled bet ($0.20) returned to fourz4444
fourz4444 collected $0.11 from pot
fourz4444: doesn't show hand 
*** SUMMARY ***
Total pot $0.11 | Rake $0 
Board [Jc Js 5h]
Seat 1: HortonRoundtree folded before Flop (didn't bet)
Seat 2: fourz4444 collected ($0.11)
Seat 3: CashMatteo (button) folded before Flop (didn't bet)
Seat 4: bouchizzle (small blind) folded before Flop
Seat 5: ljab26 (big blind) folded before Flop
Seat 6: vegasricky folded on the Flop

Hand #10: 

PokerStars Hand #246222415143:  Hold'em No Limit ($0.01/$0.02 CAD) - 2023/09/27 23:04:06 ET
Table 'Alya III' 6-max Seat #4 is the button
Seat 1: HortonRoundtree ($1.79 in chips) 
Seat 2: fourz4444 ($1.57 in chips) 
Seat 3: CashMatteo ($2.34 in chips) 
Seat 4: bouchizzle ($2.30 in chips) 
Seat 5: ljab26 ($2.61 in chips) 
Seat 6: vegasricky ($1.74 in chips) 
ljab26: posts small blind $0.01
vegasricky: posts big blind $0.02
*** HOLE CARDS ***
Dealt to CashMatteo [2d 4h]
HortonRoundtree: calls $0.02
fourz4444: raises $0.20 to $0.22
CashMatteo: folds 
bouchizzle: folds 
ljab26: folds 
vegasricky: folds 
HortonRoundtree: folds 
Uncalled bet ($0.20) returned to fourz4444
fourz4444 collected $0.07 from pot
fourz4444: doesn't show hand 
*** SUMMARY ***
Total pot $0.07 | Rake $0 
Seat 1: HortonRoundtree folded before Flop
Seat 2: fourz4444 collected ($0.07)
Seat 3: CashMatteo folded before Flop (didn't bet)
Seat 4: bouchizzle (button) folded before Flop (didn't bet)
Seat 5: ljab26 (small blind) folded before Flop
Seat 6: vegasricky (big blind) folded before Flop

Hand #11: 

PokerStars Hand #246222418846:  Hold'em No Limit ($0.01/$0.02 CAD) - 2023/09/27 23:04:33 ET
Table 'Alya III' 6-max Seat #5 is the button
Seat 1: HortonRoundtree ($1.77 in chips) 
Seat 2: fourz4444 ($1.62 in chips) 
Seat 3: CashMatteo ($2.34 in chips) 
Seat 4: bouchizzle ($2.30 in chips) 
Seat 5: ljab26 ($2.60 in chips) 
Seat 6: vegasricky ($1.72 in chips) 
vegasricky: posts small blind $0.01
HortonRoundtree: posts big blind $0.02
*** HOLE CARDS ***
Dealt to CashMatteo [Qc Qd]
fourz4444: folds 
CashMatteo: raises $0.04 to $0.06
bouchizzle: folds 
ljab26: folds 
vegasricky: folds 
HortonRoundtree: calls $0.04
*** FLOP *** [4c 9h Kc]
HortonRoundtree: checks 
CashMatteo: bets $0.07
HortonRoundtree: folds 
Uncalled bet ($0.07) returned to CashMatteo
CashMatteo collected $0.13 from pot
CashMatteo: doesn't show hand 
*** SUMMARY ***
Total pot $0.13 | Rake $0 
Board [4c 9h Kc]
Seat 1: HortonRoundtree (big blind) folded on the Flop
Seat 2: fourz4444 folded before Flop (didn't bet)
Seat 3: CashMatteo collected ($0.13)
Seat 4: bouchizzle folded before Flop (didn't bet)
Seat 5: ljab26 (button) folded before Flop (didn't bet)
Seat 6: vegasricky (small blind) folded before Flop

Hand #12: 

PokerStars Hand #246222423272:  Hold'em No Limit ($0.01/$0.02 CAD) - 2023/09/27 23:05:04 ET
Table 'Alya III' 6-max Seat #6 is the button
Seat 1: HortonRoundtree ($1.71 in chips) 
Seat 2: fourz4444 ($1.62 in chips) 
Seat 3: CashMatteo ($2.41 in chips) 
Seat 4: bouchizzle ($2.30 in chips) 
Seat 5: ljab26 ($2.60 in chips) 
Seat 6: vegasricky ($1.71 in chips) 
HortonRoundtree: posts small blind $0.01
fourz4444: posts big blind $0.02
*** HOLE CARDS ***
Dealt to CashMatteo [Ks 4c]
CashMatteo: calls $0.02
bouchizzle: folds 
ljab26: folds 
vegasricky: folds 
HortonRoundtree: folds 
fourz4444: checks 
*** FLOP *** [7h 2h Kc]
fourz4444: checks 
CashMatteo: bets $0.03
fourz4444: folds 
Uncalled bet ($0.03) returned to CashMatteo
CashMatteo collected $0.05 from pot
CashMatteo: doesn't show hand 
*** SUMMARY ***
Total pot $0.05 | Rake $0 
Board [7h 2h Kc]
Seat 1: HortonRoundtree (small blind) folded before Flop
Seat 2: fourz4444 (big blind) folded on the Flop
Seat 3: CashMatteo collected ($0.05)
Seat 4: bouchizzle folded before Flop (didn't bet)
Seat 5: ljab26 folded before Flop (didn't bet)
Seat 6: vegasricky (button) folded before Flop (didn't bet)

Hand #13: 

PokerStars Hand #246222429875:  Hold'em No Limit ($0.01/$0.02 CAD) - 2023/09/27 23:05:51 ET
Table 'Alya III' 6-max Seat #1 is the button
Seat 1: HortonRoundtree ($1.70 in chips) 
Seat 2: fourz4444 ($1.60 in chips) 
Seat 3: CashMatteo ($2.44 in chips) 
Seat 4: bouchizzle ($2.30 in chips) 
Seat 5: ljab26 ($2.60 in chips) 
Seat 6: vegasricky ($1.71 in chips) 
fourz4444: posts small blind $0.01
CashMatteo: posts big blind $0.02
*** HOLE CARDS ***
Dealt to CashMatteo [3s Jc]
bouchizzle: folds 
ljab26: folds 
vegasricky: folds 
HortonRoundtree: folds 
fourz4444: calls $0.01
CashMatteo: raises $0.04 to $0.06
vegasricky leaves the table
fourz4444: calls $0.04
*** FLOP *** [5d 3c 8s]
fourz4444: bets $1.54 and is all-in
CashMatteo: folds 
Uncalled bet ($1.54) returned to fourz4444
fourz4444 collected $0.12 from pot
fourz4444: doesn't show hand 
*** SUMMARY ***
Total pot $0.12 | Rake $0 
Board [5d 3c 8s]
Seat 1: HortonRoundtree (button) folded before Flop (didn't bet)
Seat 2: fourz4444 (small blind) collected ($0.12)
Seat 3: CashMatteo (big blind) folded on the Flop
Seat 4: bouchizzle folded before Flop (didn't bet)
Seat 5: ljab26 folded before Flop (didn't bet)
Seat 6: vegasricky folded before Flop (didn't bet)

Hand #14: 

PokerStars Hand #246222436059:  Hold'em No Limit ($0.01/$0.02 CAD) - 2023/09/27 23:06:35 ET
Table 'Alya III' 6-max Seat #2 is the button
Seat 1: HortonRoundtree ($1.70 in chips) 
Seat 2: fourz4444 ($1.66 in chips) 
Seat 3: CashMatteo ($2.38 in chips) 
Seat 4: bouchizzle ($2.30 in chips) 
Seat 5: ljab26 ($2.60 in chips) 
CashMatteo: posts small blind $0.01
bouchizzle: posts big blind $0.02
*** HOLE CARDS ***
Dealt to CashMatteo [2d 5c]
ljab26: folds 
HortonRoundtree: folds 
fourz4444: calls $0.02
CashMatteo: folds 
bouchizzle: raises $0.06 to $0.08
fourz4444: calls $0.06
*** FLOP *** [Qc 4s 8c]
bouchizzle: bets $0.10
fourz4444: folds 
Uncalled bet ($0.10) returned to bouchizzle
bouchizzle collected $0.16 from pot
bouchizzle: doesn't show hand 
*** SUMMARY ***
Total pot $0.17 | Rake $0.01 
Board [Qc 4s 8c]
Seat 1: HortonRoundtree folded before Flop (didn't bet)
Seat 2: fourz4444 (button) folded on the Flop
Seat 3: CashMatteo (small blind) folded before Flop
Seat 4: bouchizzle (big blind) collected ($0.16)
Seat 5: ljab26 folded before Flop (didn't bet)

Hand #15: 

PokerStars Hand #246222439147:  Hold'em No Limit ($0.01/$0.02 CAD) - 2023/09/27 23:06:57 ET
Table 'Alya III' 6-max Seat #3 is the button
Seat 1: HortonRoundtree ($1.70 in chips) 
Seat 2: fourz4444 ($1.58 in chips) 
Seat 3: CashMatteo ($2.37 in chips) 
Seat 4: bouchizzle ($2.38 in chips) 
Seat 5: ljab26 ($2.60 in chips) 
bouchizzle: posts small blind $0.01
ljab26: posts big blind $0.02
*** HOLE CARDS ***
Dealt to CashMatteo [Ah 4h]
HortonRoundtree: folds 
fourz4444: calls $0.02
CashMatteo: raises $0.04 to $0.06
bouchizzle: folds 
ljab26: folds 
fourz4444: calls $0.04
*** FLOP *** [9s 8s 2s]
fourz4444: bets $1.52 and is all-in
CashMatteo: folds 
Uncalled bet ($1.52) returned to fourz4444
fourz4444 collected $0.14 from pot
fourz4444: doesn't show hand 
*** SUMMARY ***
Total pot $0.15 | Rake $0.01 
Board [9s 8s 2s]
Seat 1: HortonRoundtree folded before Flop (didn't bet)
Seat 2: fourz4444 collected ($0.14)
Seat 3: CashMatteo (button) folded on the Flop
Seat 4: bouchizzle (small blind) folded before Flop
Seat 5: ljab26 (big blind) folded before Flop

Hand #16: 

PokerStars Hand #246222443886:  Hold'em No Limit ($0.01/$0.02 CAD) - 2023/09/27 23:07:30 ET
Table 'Alya III' 6-max Seat #4 is the button
Seat 1: HortonRoundtree ($1.70 in chips) 
Seat 2: fourz4444 ($1.66 in chips) 
Seat 3: CashMatteo ($2.31 in chips) 
Seat 4: bouchizzle ($2.37 in chips) 
Seat 5: ljab26 ($2.58 in chips) 
ljab26: posts small blind $0.01
HortonRoundtree: posts big blind $0.02
*** HOLE CARDS ***
Dealt to CashMatteo [Ks As]
fourz4444: folds 
CashMatteo: raises $0.04 to $0.06
bouchizzle: folds 
ljab26: calls $0.05
HortonRoundtree: folds 
*** FLOP *** [Ah 6s 5s]
ljab26: checks 
CashMatteo: checks 
*** TURN *** [Ah 6s 5s] [Kd]
ljab26: bets $0.04
CashMatteo: calls $0.04
*** RIVER *** [Ah 6s 5s Kd] [Qd]
ljab26: bets $0.06
CashMatteo: raises $0.17 to $0.23
ljab26: calls $0.17
*** SHOW DOWN ***
CashMatteo: shows [Ks As] (two pair, Aces and Kings)
ljab26: mucks hand 
CashMatteo collected $0.66 from pot
*** SUMMARY ***
Total pot $0.68 | Rake $0.02 
Board [Ah 6s 5s Kd Qd]
Seat 1: HortonRoundtree (big blind) folded before Flop
Seat 2: fourz4444 folded before Flop (didn't bet)
Seat 3: CashMatteo showed [Ks As] and won ($0.66) with two pair, Aces and Kings
Seat 4: bouchizzle (button) folded before Flop (didn't bet)
Seat 5: ljab26 (small blind) mucked [Jc Ac]

Hand #17: 

PokerStars Hand #246222448512:  Hold'em No Limit ($0.01/$0.02 CAD) - 2023/09/27 23:08:03 ET
Table 'Alya III' 6-max Seat #5 is the button
Seat 1: HortonRoundtree ($1.68 in chips) 
Seat 2: fourz4444 ($1.66 in chips) 
Seat 3: CashMatteo ($2.64 in chips) 
Seat 4: bouchizzle ($2.37 in chips) 
Seat 5: ljab26 ($2.25 in chips) 
HortonRoundtree: posts small blind $0.01
fourz4444: posts big blind $0.02
*** HOLE CARDS ***
Dealt to CashMatteo [9d 2s]
CashMatteo has timed out
CashMatteo: folds 
bouchizzle: raises $0.04 to $0.06
ljab26: folds 
HortonRoundtree: folds 
fourz4444: folds 
Uncalled bet ($0.04) returned to bouchizzle
bouchizzle collected $0.05 from pot
bouchizzle: doesn't show hand 
*** SUMMARY ***
Total pot $0.05 | Rake $0 
Seat 1: HortonRoundtree (small blind) folded before Flop
Seat 2: fourz4444 (big blind) folded before Flop
Seat 3: CashMatteo folded before Flop (didn't bet)
Seat 4: bouchizzle collected ($0.05)
Seat 5: ljab26 (button) folded before Flop (didn't bet)

Hand #18: 

PokerStars Hand #246222451906:  Hold'em No Limit ($0.01/$0.02 CAD) - 2023/09/27 23:08:27 ET
Table 'Alya III' 6-max Seat #1 is the button
Seat 1: HortonRoundtree ($1.67 in chips) 
Seat 2: fourz4444 ($1.64 in chips) 
Seat 3: CashMatteo ($2.64 in chips) 
Seat 4: bouchizzle ($2.40 in chips) 
Seat 5: ljab26 ($2.25 in chips) 
fourz4444: posts small blind $0.01
CashMatteo: posts big blind $0.02
*** HOLE CARDS ***
Dealt to CashMatteo [Kc 6s]
bouchizzle: folds 
ljab26: folds 
HortonRoundtree: folds 
fourz4444: folds 
Uncalled bet ($0.01) returned to CashMatteo
CashMatteo collected $0.02 from pot
CashMatteo: doesn't show hand 
*** SUMMARY ***
Total pot $0.02 | Rake $0 
Seat 1: HortonRoundtree (button) folded before Flop (didn't bet)
Seat 2: fourz4444 (small blind) folded before Flop
Seat 3: CashMatteo (big blind) collected ($0.02)
Seat 4: bouchizzle folded before Flop (didn't bet)
Seat 5: ljab26 folded before Flop (didn't bet)

Hand #19: 

PokerStars Hand #246222453602:  Hold'em No Limit ($0.01/$0.02 CAD) - 2023/09/27 23:08:39 ET
Table 'Alya III' 6-max Seat #2 is the button
Seat 1: HortonRoundtree ($1.67 in chips) 
Seat 2: fourz4444 ($1.63 in chips) 
Seat 3: CashMatteo ($2.65 in chips) 
Seat 4: bouchizzle ($2.40 in chips) 
Seat 5: ljab26 ($2.25 in chips) 
CashMatteo: posts small blind $0.01
bouchizzle: posts big blind $0.02
*** HOLE CARDS ***
Dealt to CashMatteo [Jd 5c]
ljab26: folds 
HortonRoundtree: folds 
fourz4444: folds 
CashMatteo: calls $0.01
bouchizzle: checks 
*** FLOP *** [7s 3d 2h]
CashMatteo: checks 
bouchizzle: checks 
*** TURN *** [7s 3d 2h] [Ts]
CashMatteo: checks 
bouchizzle: checks 
*** RIVER *** [7s 3d 2h Ts] [Jc]
CashMatteo: bets $0.02
bouchizzle: folds 
Uncalled bet ($0.02) returned to CashMatteo
CashMatteo collected $0.04 from pot
CashMatteo: doesn't show hand 
*** SUMMARY ***
Total pot $0.04 | Rake $0 
Board [7s 3d 2h Ts Jc]
Seat 1: HortonRoundtree folded before Flop (didn't bet)
Seat 2: fourz4444 (button) folded before Flop (didn't bet)
Seat 3: CashMatteo (small blind) collected ($0.04)
Seat 4: bouchizzle (big blind) folded on the River
Seat 5: ljab26 folded before Flop (didn't bet)

Hand #20: 

PokerStars Hand #246222462554:  Hold'em No Limit ($0.01/$0.02 CAD) - 2023/09/27 23:09:44 ET
Table 'Alya III' 6-max Seat #3 is the button
Seat 1: HortonRoundtree ($1.67 in chips) 
Seat 2: fourz4444 ($1.63 in chips) 
Seat 3: CashMatteo ($2.67 in chips) 
Seat 4: bouchizzle ($2.38 in chips) 
Seat 5: ljab26 ($2.25 in chips) 
bouchizzle: posts small blind $0.01
ljab26: posts big blind $0.02
*** HOLE CARDS ***
Dealt to CashMatteo [Qs As]
HortonRoundtree: folds 
fourz4444: folds 
CashMatteo: raises $0.04 to $0.06
bouchizzle: folds 
ljab26: folds 
Uncalled bet ($0.04) returned to CashMatteo
CashMatteo collected $0.05 from pot
CashMatteo: doesn't show hand 
*** SUMMARY ***
Total pot $0.05 | Rake $0 
Seat 1: HortonRoundtree folded before Flop (didn't bet)
Seat 2: fourz4444 folded before Flop (didn't bet)
Seat 3: CashMatteo (button) collected ($0.05)
Seat 4: bouchizzle (small blind) folded before Flop
Seat 5: ljab26 (big blind) folded before Flop

Hand #21: 

PokerStars Hand #246222465686:  Hold'em No Limit ($0.01/$0.02 CAD) - 2023/09/27 23:10:06 ET
Table 'Alya III' 6-max Seat #4 is the button
Seat 1: HortonRoundtree ($1.67 in chips) 
Seat 2: fourz4444 ($1.63 in chips) 
Seat 3: CashMatteo ($2.70 in chips) 
Seat 4: bouchizzle ($2.37 in chips) 
Seat 5: ljab26 ($2.23 in chips) 
ljab26: posts small blind $0.01
HortonRoundtree: posts big blind $0.02
*** HOLE CARDS ***
Dealt to CashMatteo [9c As]
fourz4444: folds 
CashMatteo: raises $0.04 to $0.06
bouchizzle: folds 
ljab26: folds 
HortonRoundtree: folds 
Uncalled bet ($0.04) returned to CashMatteo
CashMatteo collected $0.05 from pot
CashMatteo: doesn't show hand 
*** SUMMARY ***
Total pot $0.05 | Rake $0 
Seat 1: HortonRoundtree (big blind) folded before Flop
Seat 2: fourz4444 folded before Flop (didn't bet)
Seat 3: CashMatteo collected ($0.05)
Seat 4: bouchizzle (button) folded before Flop (didn't bet)
Seat 5: ljab26 (small blind) folded before Flop

Hand #22: 

PokerStars Hand #246222467968:  Hold'em No Limit ($0.01/$0.02 CAD) - 2023/09/27 23:10:22 ET
Table 'Alya III' 6-max Seat #5 is the button
Seat 1: HortonRoundtree ($1.65 in chips) 
Seat 2: fourz4444 ($1.63 in chips) 
Seat 3: CashMatteo ($2.73 in chips) 
Seat 4: bouchizzle ($2.37 in chips) 
Seat 5: ljab26 ($2.22 in chips) 
HortonRoundtree: posts small blind $0.01
fourz4444: posts big blind $0.02
*** HOLE CARDS ***
Dealt to CashMatteo [3c 8d]
CashMatteo: folds 
bouchizzle: folds 
ljab26: folds 
HortonRoundtree: folds 
Uncalled bet ($0.01) returned to fourz4444
fourz4444 collected $0.02 from pot
fourz4444: doesn't show hand 
*** SUMMARY ***
Total pot $0.02 | Rake $0 
Seat 1: HortonRoundtree (small blind) folded before Flop
Seat 2: fourz4444 (big blind) collected ($0.02)
Seat 3: CashMatteo folded before Flop (didn't bet)
Seat 4: bouchizzle folded before Flop (didn't bet)
Seat 5: ljab26 (button) folded before Flop (didn't bet)

Hand #23: 

PokerStars Hand #246222469578:  Hold'em No Limit ($0.01/$0.02 CAD) - 2023/09/27 23:10:33 ET
Table 'Alya III' 6-max Seat #1 is the button
Seat 1: HortonRoundtree ($1.64 in chips) 
Seat 2: fourz4444 ($1.64 in chips) 
Seat 3: CashMatteo ($2.73 in chips) 
Seat 4: bouchizzle ($2.37 in chips) 
Seat 5: ljab26 ($2.22 in chips) 
fourz4444: posts small blind $0.01
CashMatteo: posts big blind $0.02
*** HOLE CARDS ***
Dealt to CashMatteo [2h Td]
bouchizzle: folds 
ljab26: folds 
HortonRoundtree: calls $0.02
fourz4444: folds 
CashMatteo: checks 
*** FLOP *** [Jc 3c 3d]
CashMatteo: checks 
HortonRoundtree: checks 
*** TURN *** [Jc 3c 3d] [Ah]
CashMatteo: bets $0.03
HortonRoundtree: folds 
Uncalled bet ($0.03) returned to CashMatteo
CashMatteo collected $0.05 from pot
CashMatteo: doesn't show hand 
*** SUMMARY ***
Total pot $0.05 | Rake $0 
Board [Jc 3c 3d Ah]
Seat 1: HortonRoundtree (button) folded on the Turn
Seat 2: fourz4444 (small blind) folded before Flop
Seat 3: CashMatteo (big blind) collected ($0.05)
Seat 4: bouchizzle folded before Flop (didn't bet)
Seat 5: ljab26 folded before Flop (didn't bet)

Hand #24: 

PokerStars Hand #246222473805:  Hold'em No Limit ($0.01/$0.02 CAD) - 2023/09/27 23:11:03 ET
Table 'Alya III' 6-max Seat #2 is the button
Seat 1: HortonRoundtree ($1.62 in chips) 
Seat 2: fourz4444 ($1.63 in chips) 
Seat 3: CashMatteo ($2.76 in chips) 
Seat 4: bouchizzle ($2.37 in chips) 
Seat 5: ljab26 ($2.22 in chips) 
CashMatteo: posts small blind $0.01
bouchizzle: posts big blind $0.02
*** HOLE CARDS ***
Dealt to CashMatteo [6s 7s]
ljab26: folds 
HortonRoundtree: calls $0.02
fourz4444: calls $0.02
CashMatteo: calls $0.01
bouchizzle: checks 
*** FLOP *** [5d As Kd]
CashMatteo: checks 
bouchizzle: checks 
HortonRoundtree: checks 
fourz4444: bets $0.12
Canguru19 joins the table at seat #6 
CashMatteo: folds 
bouchizzle: folds 
HortonRoundtree: folds 
Uncalled bet ($0.12) returned to fourz4444
fourz4444 collected $0.08 from pot
fourz4444: doesn't show hand 
*** SUMMARY ***
Total pot $0.08 | Rake $0 
Board [5d As Kd]
Seat 1: HortonRoundtree folded on the Flop
Seat 2: fourz4444 (button) collected ($0.08)
Seat 3: CashMatteo (small blind) folded on the Flop
Seat 4: bouchizzle (big blind) folded on the Flop
Seat 5: ljab26 folded before Flop (didn't bet)

Hand #25: 

PokerStars Hand #246222478991:  Hold'em No Limit ($0.01/$0.02 CAD) - 2023/09/27 23:11:40 ET
Table 'Alya III' 6-max Seat #3 is the button
Seat 1: HortonRoundtree ($1.60 in chips) 
Seat 2: fourz4444 ($1.69 in chips) 
Seat 3: CashMatteo ($2.74 in chips) 
Seat 4: bouchizzle ($2.35 in chips) 
Seat 5: ljab26 ($2.22 in chips) 
bouchizzle: posts small blind $0.01
ljab26: posts big blind $0.02
Canguru19: sits out 
*** HOLE CARDS ***
Dealt to CashMatteo [Ts 6h]
HortonRoundtree: folds 
fourz4444: folds 
CashMatteo: calls $0.02
bouchizzle: folds 
ljab26: checks 
*** FLOP *** [Jd 7s 3d]
ljab26: checks 
CashMatteo: checks 
*** TURN *** [Jd 7s 3d] [Ac]
ljab26: bets $0.02
CashMatteo: folds 
Uncalled bet ($0.02) returned to ljab26
ljab26 collected $0.05 from pot
ljab26: doesn't show hand 
*** SUMMARY ***
Total pot $0.05 | Rake $0 
Board [Jd 7s 3d Ac]
Seat 1: HortonRoundtree folded before Flop (didn't bet)
Seat 2: fourz4444 folded before Flop (didn't bet)
Seat 3: CashMatteo (button) folded on the Turn
Seat 4: bouchizzle (small blind) folded before Flop
Seat 5: ljab26 (big blind) collected ($0.05)

Hand #26: 

PokerStars Hand #246222483593:  Hold'em No Limit ($0.01/$0.02 CAD) - 2023/09/27 23:12:13 ET
Table 'Alya III' 6-max Seat #4 is the button
Seat 1: HortonRoundtree ($1.60 in chips) 
Seat 2: fourz4444 ($1.69 in chips) 
Seat 3: CashMatteo ($2.72 in chips) 
Seat 4: bouchizzle ($2.34 in chips) 
Seat 5: ljab26 ($2.25 in chips) 
Seat 6: Canguru19 ($1.60 in chips) 
ljab26: posts small blind $0.01
Canguru19: posts big blind $0.02
*** HOLE CARDS ***
Dealt to CashMatteo [Jc 9s]
HortonRoundtree: folds 
fourz4444: folds 
CashMatteo: calls $0.02
bouchizzle: raises $0.06 to $0.08
ljab26: folds 
Canguru19: calls $0.06
CashMatteo: calls $0.06
*** FLOP *** [6c Qh 7s]
Canguru19: checks 
CashMatteo: checks 
bouchizzle: bets $0.14
Canguru19: calls $0.14
CashMatteo: folds 
*** TURN *** [6c Qh 7s] [9d]
Canguru19: checks 
bouchizzle: checks 
*** RIVER *** [6c Qh 7s 9d] [5h]
Canguru19: checks 
bouchizzle: bets $0.31
Canguru19: folds 
Uncalled bet ($0.31) returned to bouchizzle
bouchizzle collected $0.51 from pot
bouchizzle: doesn't show hand 
*** SUMMARY ***
Total pot $0.53 | Rake $0.02 
Board [6c Qh 7s 9d 5h]
Seat 1: HortonRoundtree folded before Flop (didn't bet)
Seat 2: fourz4444 folded before Flop (didn't bet)
Seat 3: CashMatteo folded on the Flop
Seat 4: bouchizzle (button) collected ($0.51)
Seat 5: ljab26 (small blind) folded before Flop
Seat 6: Canguru19 (big blind) folded on the River

Hand #27: 

PokerStars Hand #246222492800:  Hold'em No Limit ($0.01/$0.02 CAD) - 2023/09/27 23:13:19 ET
Table 'Alya III' 6-max Seat #5 is the button
Seat 1: HortonRoundtree ($1.60 in chips) 
Seat 3: CashMatteo ($2.64 in chips) 
Seat 4: bouchizzle ($2.63 in chips) 
Seat 5: ljab26 ($2.24 in chips) 
Seat 6: Canguru19 ($1.38 in chips) 
Canguru19: posts small blind $0.01
HortonRoundtree: posts big blind $0.02
*** HOLE CARDS ***
Dealt to CashMatteo [Qc 5c]
CashMatteo: calls $0.02
bouchizzle: folds 
ljab26: calls $0.02
Canguru19: folds 
HortonRoundtree: checks 
*** FLOP *** [6h 4c 6c]
HortonRoundtree: checks 
CashMatteo: bets $0.07
ljab26: folds 
HortonRoundtree: folds 
Uncalled bet ($0.07) returned to CashMatteo
CashMatteo collected $0.07 from pot
CashMatteo: doesn't show hand 
*** SUMMARY ***
Total pot $0.07 | Rake $0 
Board [6h 4c 6c]
Seat 1: HortonRoundtree (big blind) folded on the Flop
Seat 3: CashMatteo collected ($0.07)
Seat 4: bouchizzle folded before Flop (didn't bet)
Seat 5: ljab26 (button) folded on the Flop
Seat 6: Canguru19 (small blind) folded before Flop

Hand #28: 

PokerStars Hand #246222497092:  Hold'em No Limit ($0.01/$0.02 CAD) - 2023/09/27 23:13:49 ET
Table 'Alya III' 6-max Seat #6 is the button
Seat 1: HortonRoundtree ($1.58 in chips) 
Seat 3: CashMatteo ($2.69 in chips) 
Seat 4: bouchizzle ($2.63 in chips) 
Seat 5: ljab26 ($2.22 in chips) 
Seat 6: Canguru19 ($1.37 in chips) 
HortonRoundtree: posts small blind $0.01
CashMatteo: posts big blind $0.02
*** HOLE CARDS ***
Dealt to CashMatteo [Kh 6s]
bouchizzle: folds 
ljab26: folds 
Canguru19: calls $0.02
HortonRoundtree: folds 
CashMatteo: checks 
*** FLOP *** [Ts Qh Td]
CashMatteo: checks 
Canguru19: bets $0.05
CashMatteo: folds 
Uncalled bet ($0.05) returned to Canguru19
Canguru19 collected $0.05 from pot
Canguru19: doesn't show hand 
*** SUMMARY ***
Total pot $0.05 | Rake $0 
Board [Ts Qh Td]
Seat 1: HortonRoundtree (small blind) folded before Flop
Seat 3: CashMatteo (big blind) folded on the Flop
Seat 4: bouchizzle folded before Flop (didn't bet)
Seat 5: ljab26 folded before Flop (didn't bet)
Seat 6: Canguru19 (button) collected ($0.05)

Hand #29: 

PokerStars Hand #246222501352:  Hold'em No Limit ($0.01/$0.02 CAD) - 2023/09/27 23:14:19 ET
Table 'Alya III' 6-max Seat #1 is the button
Seat 1: HortonRoundtree ($1.57 in chips) 
Seat 3: CashMatteo ($2.67 in chips) 
Seat 4: bouchizzle ($2.63 in chips) 
Seat 5: ljab26 ($2.22 in chips) 
Seat 6: Canguru19 ($1.40 in chips) 
CashMatteo: posts small blind $0.01
bouchizzle: posts big blind $0.02
*** HOLE CARDS ***
Dealt to CashMatteo [3s 6c]
ljab26: calls $0.02
Canguru19: folds 
HortonRoundtree: calls $0.02
CashMatteo: folds 
bouchizzle: checks 
*** FLOP *** [Kh 8s 6s]
bouchizzle: checks 
ljab26: checks 
HortonRoundtree: checks 
*** TURN *** [Kh 8s 6s] [Jc]
bouchizzle: checks 
ljab26: checks 
HortonRoundtree: checks 
*** RIVER *** [Kh 8s 6s Jc] [As]
bouchizzle: bets $0.04
ljab26: calls $0.04
HortonRoundtree: folds 
*** SHOW DOWN ***
bouchizzle: shows [3c Ah] (a pair of Aces)
ljab26: shows [2c Ac] (a pair of Aces)
bouchizzle collected $0.07 from pot
ljab26 collected $0.07 from pot
*** SUMMARY ***
Total pot $0.15 | Rake $0.01 
Board [Kh 8s 6s Jc As]
Seat 1: HortonRoundtree (button) folded on the River
Seat 3: CashMatteo (small blind) folded before Flop
Seat 4: bouchizzle (big blind) showed [3c Ah] and won ($0.07) with a pair of Aces
Seat 5: ljab26 showed [2c Ac] and won ($0.07) with a pair of Aces
Seat 6: Canguru19 folded before Flop (didn't bet)

Hand #30: 

PokerStars Hand #246222507223:  Hold'em No Limit ($0.01/$0.02 CAD) - 2023/09/27 23:15:02 ET
Table 'Alya III' 6-max Seat #3 is the button
Seat 1: HortonRoundtree ($1.55 in chips) 
Seat 3: CashMatteo ($2.66 in chips) 
Seat 4: bouchizzle ($2.64 in chips) 
Seat 5: ljab26 ($2.23 in chips) 
Seat 6: Canguru19 ($1.40 in chips) 
bouchizzle: posts small blind $0.01
ljab26: posts big blind $0.02
*** HOLE CARDS ***
Dealt to CashMatteo [3d 9d]
Canguru19: calls $0.02
HortonRoundtree: folds 
CashMatteo: raises $0.04 to $0.06
bouchizzle: folds 
ljab26: folds 
Canguru19: folds 
Uncalled bet ($0.04) returned to CashMatteo
CashMatteo collected $0.07 from pot
CashMatteo: doesn't show hand 
*** SUMMARY ***
Total pot $0.07 | Rake $0 
Seat 1: HortonRoundtree folded before Flop (didn't bet)
Seat 3: CashMatteo (button) collected ($0.07)
Seat 4: bouchizzle (small blind) folded before Flop
Seat 5: ljab26 (big blind) folded before Flop
Seat 6: Canguru19 folded before Flop

Hand #31: 

PokerStars Hand #246222510955:  Hold'em No Limit ($0.01/$0.02 CAD) - 2023/09/27 23:15:29 ET
Table 'Alya III' 6-max Seat #4 is the button
Seat 1: HortonRoundtree ($1.55 in chips) 
Seat 3: CashMatteo ($2.71 in chips) 
Seat 4: bouchizzle ($2.63 in chips) 
Seat 5: ljab26 ($2.21 in chips) 
Seat 6: Canguru19 ($1.38 in chips) 
ljab26: posts small blind $0.01
Canguru19: posts big blind $0.02
*** HOLE CARDS ***
Dealt to CashMatteo [5c Tc]
HortonRoundtree: folds 
CashMatteo: calls $0.02
bouchizzle: raises $0.06 to $0.08
ljab26: folds 
Canguru19: folds 
CashMatteo: calls $0.06
*** FLOP *** [Ad Qh Ts]
CashMatteo: checks 
bouchizzle: bets $0.11
CashMatteo: folds 
Uncalled bet ($0.11) returned to bouchizzle
bouchizzle collected $0.18 from pot
bouchizzle: doesn't show hand 
*** SUMMARY ***
Total pot $0.19 | Rake $0.01 
Board [Ad Qh Ts]
Seat 1: HortonRoundtree folded before Flop (didn't bet)
Seat 3: CashMatteo folded on the Flop
Seat 4: bouchizzle (button) collected ($0.18)
Seat 5: ljab26 (small blind) folded before Flop
Seat 6: Canguru19 (big blind) folded before Flop

Hand #32: 

PokerStars Hand #246222516008:  Hold'em No Limit ($0.01/$0.02 CAD) - 2023/09/27 23:16:06 ET
Table 'Alya III' 6-max Seat #5 is the button
Seat 1: HortonRoundtree ($1.55 in chips) 
Seat 2: fourz4444 ($1.69 in chips) 
Seat 3: CashMatteo ($2.63 in chips) 
Seat 4: bouchizzle ($2.73 in chips) 
Seat 5: ljab26 ($2.20 in chips) 
Seat 6: Canguru19 ($1.36 in chips) 
Canguru19: posts small blind $0.01
HortonRoundtree: posts big blind $0.02
fourz4444: posts small & big blinds $0.03
*** HOLE CARDS ***
Dealt to CashMatteo [2h As]
fourz4444: checks 
CashMatteo: calls $0.02
bouchizzle: raises $0.08 to $0.10
ljab26: calls $0.10
Canguru19: folds 
HortonRoundtree: folds 
fourz4444: folds 
CashMatteo: calls $0.08
*** FLOP *** [5h 5c 3c]
CashMatteo: checks 
bouchizzle: bets $0.21
ljab26: folds 
CashMatteo: folds 
Uncalled bet ($0.21) returned to bouchizzle
bouchizzle collected $0.35 from pot
bouchizzle: doesn't show hand 
*** SUMMARY ***
Total pot $0.36 | Rake $0.01 
Board [5h 5c 3c]
Seat 1: HortonRoundtree (big blind) folded before Flop
Seat 2: fourz4444 folded before Flop (didn't bet)
Seat 3: CashMatteo folded on the Flop
Seat 4: bouchizzle collected ($0.35)
Seat 5: ljab26 (button) folded on the Flop
Seat 6: Canguru19 (small blind) folded before Flop

Hand #33: 

PokerStars Hand #246222524472:  Hold'em No Limit ($0.01/$0.02 CAD) - 2023/09/27 23:17:07 ET
Table 'Alya III' 6-max Seat #6 is the button
Seat 1: HortonRoundtree ($1.53 in chips) 
Seat 2: fourz4444 ($1.66 in chips) 
Seat 3: CashMatteo ($2.53 in chips) 
Seat 4: bouchizzle ($2.98 in chips) 
Seat 5: ljab26 ($2.10 in chips) 
Seat 6: Canguru19 ($1.35 in chips) 
HortonRoundtree: posts small blind $0.01
fourz4444: posts big blind $0.02
*** HOLE CARDS ***
Dealt to CashMatteo [7c 9s]
CashMatteo: folds 
bouchizzle: folds 
ljab26: calls $0.02
Canguru19: calls $0.02
HortonRoundtree: folds 
fourz4444: checks 
*** FLOP *** [2h Td 7s]
fourz4444: bets $0.02
ljab26: folds 
Canguru19: folds 
Uncalled bet ($0.02) returned to fourz4444
fourz4444 collected $0.07 from pot
fourz4444: doesn't show hand 
*** SUMMARY ***
Total pot $0.07 | Rake $0 
Board [2h Td 7s]
Seat 1: HortonRoundtree (small blind) folded before Flop
Seat 2: fourz4444 (big blind) collected ($0.07)
Seat 3: CashMatteo folded before Flop (didn't bet)
Seat 4: bouchizzle folded before Flop (didn't bet)
Seat 5: ljab26 folded on the Flop
Seat 6: Canguru19 (button) folded on the Flop

Hand #34: 

PokerStars Hand #246222528500:  Hold'em No Limit ($0.01/$0.02 CAD) - 2023/09/27 23:17:36 ET
Table 'Alya III' 6-max Seat #1 is the button
Seat 1: HortonRoundtree ($1.52 in chips) 
Seat 2: fourz4444 ($1.71 in chips) 
Seat 3: CashMatteo ($2.53 in chips) 
Seat 4: bouchizzle ($2.98 in chips) 
Seat 5: ljab26 ($2.08 in chips) 
Seat 6: Canguru19 ($1.33 in chips) 
fourz4444: posts small blind $0.01
CashMatteo: posts big blind $0.02
*** HOLE CARDS ***
Dealt to CashMatteo [Kd Td]
bouchizzle: folds 
ljab26: folds 
Canguru19: calls $0.02
HortonRoundtree: folds 
fourz4444: calls $0.01
CashMatteo: raises $0.04 to $0.06
Canguru19: calls $0.04
fourz4444: calls $0.04
*** FLOP *** [Js 4h 6c]
fourz4444: checks 
CashMatteo: bets $0.09
Canguru19: folds 
fourz4444: folds 
Uncalled bet ($0.09) returned to CashMatteo
CashMatteo collected $0.17 from pot
CashMatteo: doesn't show hand 
*** SUMMARY ***
Total pot $0.18 | Rake $0.01 
Board [Js 4h 6c]
Seat 1: HortonRoundtree (button) folded before Flop (didn't bet)
Seat 2: fourz4444 (small blind) folded on the Flop
Seat 3: CashMatteo (big blind) collected ($0.17)
Seat 4: bouchizzle folded before Flop (didn't bet)
Seat 5: ljab26 folded before Flop (didn't bet)
Seat 6: Canguru19 folded on the Flop

Hand #35: 

PokerStars Hand #246222533063:  Hold'em No Limit ($0.01/$0.02 CAD) - 2023/09/27 23:18:09 ET
Table 'Alya III' 6-max Seat #2 is the button
Seat 1: HortonRoundtree ($1.52 in chips) 
Seat 2: fourz4444 ($1.65 in chips) 
Seat 3: CashMatteo ($2.64 in chips) 
Seat 4: bouchizzle ($2.98 in chips) 
Seat 5: ljab26 ($2.08 in chips) 
Seat 6: Canguru19 ($1.27 in chips) 
CashMatteo: posts small blind $0.01
bouchizzle: posts big blind $0.02
*** HOLE CARDS ***
Dealt to CashMatteo [7c Ad]
ljab26: calls $0.02
Canguru19: folds 
HortonRoundtree: folds 
fourz4444: calls $0.02
CashMatteo: calls $0.01
bouchizzle: checks 
*** FLOP *** [3s 7d 3h]
CashMatteo: bets $0.04
bouchizzle: folds 
ljab26: folds 
fourz4444: raises $0.16 to $0.20
CashMatteo: calls $0.16
*** TURN *** [3s 7d 3h] [8s]
CashMatteo: bets $0.23
fourz4444: raises $0.23 to $0.46
CashMatteo: calls $0.23
*** RIVER *** [3s 7d 3h 8s] [Jh]
CashMatteo: bets $0.68
fourz4444: raises $0.29 to $0.97 and is all-in
CashMatteo: calls $0.29
*** SHOW DOWN ***
fourz4444: shows [7s Kh] (two pair, Sevens and Threes)
CashMatteo: shows [7c Ad] (two pair, Sevens and Threes - Ace kicker)
CashMatteo collected $3.22 from pot
*** SUMMARY ***
Total pot $3.34 | Rake $0.12 
Board [3s 7d 3h 8s Jh]
Seat 1: HortonRoundtree folded before Flop (didn't bet)
Seat 2: fourz4444 (button) showed [7s Kh] and lost with two pair, Sevens and Threes
Seat 3: CashMatteo (small blind) showed [7c Ad] and won ($3.22) with two pair, Sevens and Threes
Seat 4: bouchizzle (big blind) folded on the Flop
Seat 5: ljab26 folded on the Flop
Seat 6: Canguru19 folded before Flop (didn't bet)

Hand #36: 

PokerStars Hand #246222541923:  Hold'em No Limit ($0.01/$0.02 CAD) - 2023/09/27 23:19:13 ET
Table 'Alya III' 6-max Seat #3 is the button
Seat 1: HortonRoundtree ($1.52 in chips) 
Seat 3: CashMatteo ($4.21 in chips) 
Seat 4: bouchizzle ($2.96 in chips) 
Seat 5: ljab26 ($2.06 in chips) 
Seat 6: Canguru19 ($1.27 in chips) 
bouchizzle: posts small blind $0.01
ljab26: posts big blind $0.02
*** HOLE CARDS ***
Dealt to CashMatteo [Jh As]
Canguru19: folds 
HortonRoundtree: folds 
CashMatteo: raises $0.04 to $0.06
bouchizzle: folds 
ljab26: folds 
Uncalled bet ($0.04) returned to CashMatteo
CashMatteo collected $0.05 from pot
CashMatteo: doesn't show hand 
*** SUMMARY ***
Total pot $0.05 | Rake $0 
Seat 1: HortonRoundtree folded before Flop (didn't bet)
Seat 3: CashMatteo (button) collected ($0.05)
Seat 4: bouchizzle (small blind) folded before Flop
Seat 5: ljab26 (big blind) folded before Flop
Seat 6: Canguru19 folded before Flop (didn't bet)

Hand #37: 

PokerStars Hand #246222543919:  Hold'em No Limit ($0.01/$0.02 CAD) - 2023/09/27 23:19:27 ET
Table 'Alya III' 6-max Seat #4 is the button
Seat 1: HortonRoundtree ($1.52 in chips) 
Seat 3: CashMatteo ($4.24 in chips) 
Seat 4: bouchizzle ($2.95 in chips) 
Seat 5: ljab26 ($2.04 in chips) 
Seat 6: Canguru19 ($1.27 in chips) 
ljab26: posts small blind $0.01
Canguru19: posts big blind $0.02
*** HOLE CARDS ***
Dealt to CashMatteo [Td Ks]
HortonRoundtree: folds 
CashMatteo: raises $0.04 to $0.06
bouchizzle: folds 
ljab26: folds 
Canguru19: folds 
Uncalled bet ($0.04) returned to CashMatteo
CashMatteo collected $0.05 from pot
CashMatteo: doesn't show hand 
*** SUMMARY ***
Total pot $0.05 | Rake $0 
Seat 1: HortonRoundtree folded before Flop (didn't bet)
Seat 3: CashMatteo collected ($0.05)
Seat 4: bouchizzle (button) folded before Flop (didn't bet)
Seat 5: ljab26 (small blind) folded before Flop
Seat 6: Canguru19 (big blind) folded before Flop

Hand #38: 

PokerStars Hand #246222547421:  Hold'em No Limit ($0.01/$0.02 CAD) - 2023/09/27 23:19:52 ET
Table 'Alya III' 6-max Seat #5 is the button
Seat 1: HortonRoundtree ($1.52 in chips) 
Seat 2: fourz4444 ($2 in chips) 
Seat 3: CashMatteo ($4.27 in chips) 
Seat 4: bouchizzle ($2.95 in chips) 
Seat 5: ljab26 ($2.03 in chips) 
Seat 6: Canguru19 ($1.25 in chips) 
Canguru19: posts small blind $0.01
HortonRoundtree: posts big blind $0.02
*** HOLE CARDS ***
Dealt to CashMatteo [2s 4h]
fourz4444: calls $0.02
CashMatteo: folds 
bouchizzle: folds 
ljab26: folds 
Canguru19: folds 
HortonRoundtree: checks 
*** FLOP *** [2h Kd 9d]
HortonRoundtree: checks 
fourz4444: checks 
*** TURN *** [2h Kd 9d] [3s]
HortonRoundtree: bets $0.02
fourz4444: folds 
Uncalled bet ($0.02) returned to HortonRoundtree
HortonRoundtree collected $0.05 from pot
HortonRoundtree: doesn't show hand 
*** SUMMARY ***
Total pot $0.05 | Rake $0 
Board [2h Kd 9d 3s]
Seat 1: HortonRoundtree (big blind) collected ($0.05)
Seat 2: fourz4444 folded on the Turn
Seat 3: CashMatteo folded before Flop (didn't bet)
Seat 4: bouchizzle folded before Flop (didn't bet)
Seat 5: ljab26 (button) folded before Flop (didn't bet)
Seat 6: Canguru19 (small blind) folded before Flop

Hand #39: 

PokerStars Hand #246222551256:  Hold'em No Limit ($0.01/$0.02 CAD) - 2023/09/27 23:20:20 ET
Table 'Alya III' 6-max Seat #6 is the button
Seat 1: HortonRoundtree ($1.55 in chips) 
Seat 2: fourz4444 ($1.98 in chips) 
Seat 3: CashMatteo ($4.27 in chips) 
Seat 4: bouchizzle ($2.95 in chips) 
Seat 5: ljab26 ($2.03 in chips) 
Seat 6: Canguru19 ($1.24 in chips) 
HortonRoundtree: posts small blind $0.01
fourz4444: posts big blind $0.02
*** HOLE CARDS ***
Dealt to CashMatteo [9h 3h]
CashMatteo: calls $0.02
bouchizzle: folds 
ljab26: raises $0.02 to $0.04
Canguru19: folds 
HortonRoundtree: folds 
fourz4444: calls $0.02
CashMatteo: calls $0.02
*** FLOP *** [Td 6h Qs]
fourz4444: checks 
CashMatteo: checks 
ljab26: bets $0.06
fourz4444: raises $0.06 to $0.12
CashMatteo: folds 
ljab26: calls $0.06
*** TURN *** [Td 6h Qs] [Ah]
fourz4444: bets $0.50
ljab26: raises $0.50 to $1
fourz4444: raises $0.50 to $1.50
ljab26: raises $0.37 to $1.87 and is all-in
fourz4444: calls $0.32 and is all-in
Uncalled bet ($0.05) returned to ljab26
*** RIVER *** [Td 6h Qs Ah] [7s]
*** SHOW DOWN ***
fourz4444: shows [Tc As] (two pair, Aces and Tens)
ljab26: shows [Ks Jc] (a straight, Ten to Ace)
ljab26 collected $3.87 from pot
*** SUMMARY ***
Total pot $4.01 | Rake $0.14 
Board [Td 6h Qs Ah 7s]
Seat 1: HortonRoundtree (small blind) folded before Flop
Seat 2: fourz4444 (big blind) showed [Tc As] and lost with two pair, Aces and Tens
Seat 3: CashMatteo folded on the Flop
Seat 4: bouchizzle folded before Flop (didn't bet)
Seat 5: ljab26 showed [Ks Jc] and won ($3.87) with a straight, Ten to Ace
Seat 6: Canguru19 (button) folded before Flop (didn't bet)

Hand #40: 

PokerStars Hand #246222560790:  Hold'em No Limit ($0.01/$0.02 CAD) - 2023/09/27 23:21:29 ET
Table 'Alya III' 6-max Seat #1 is the button
Seat 1: HortonRoundtree ($1.54 in chips) 
Seat 3: CashMatteo ($4.23 in chips) 
Seat 4: bouchizzle ($2.95 in chips) 
Seat 5: ljab26 ($3.92 in chips) 
Seat 6: Canguru19 ($1.24 in chips) 
CashMatteo: posts small blind $0.01
bouchizzle: posts big blind $0.02
*** HOLE CARDS ***
Dealt to CashMatteo [8c Kc]
ljab26: folds 
Canguru19: calls $0.02
HortonRoundtree: folds 
CashMatteo: calls $0.01
bouchizzle: checks 
*** FLOP *** [4s Ts 5s]
CashMatteo: checks 
bouchizzle: checks 
Canguru19: bets $0.06
CashMatteo: calls $0.06
bouchizzle: folds 
*** TURN *** [4s Ts 5s] [Qc]
CashMatteo: checks 
Canguru19: bets $0.17
CashMatteo: folds 
Uncalled bet ($0.17) returned to Canguru19
Canguru19 collected $0.17 from pot
Canguru19: doesn't show hand 
*** SUMMARY ***
Total pot $0.18 | Rake $0.01 
Board [4s Ts 5s Qc]
Seat 1: HortonRoundtree (button) folded before Flop (didn't bet)
Seat 3: CashMatteo (small blind) folded on the Turn
Seat 4: bouchizzle (big blind) folded on the Flop
Seat 5: ljab26 folded before Flop (didn't bet)
Seat 6: Canguru19 collected ($0.17)

Hand #41: 

PokerStars Hand #246222565242:  Hold'em No Limit ($0.01/$0.02 CAD) - 2023/09/27 23:22:02 ET
Table 'Alya III' 6-max Seat #3 is the button
Seat 1: HortonRoundtree ($1.54 in chips) 
Seat 2: fourz4444 ($2 in chips) 
Seat 3: CashMatteo ($4.15 in chips) 
Seat 4: bouchizzle ($2.93 in chips) 
Seat 5: ljab26 ($3.92 in chips) 
Seat 6: Canguru19 ($1.33 in chips) 
bouchizzle: posts small blind $0.01
ljab26: posts big blind $0.02
fourz4444: posts small blind $0.01
*** HOLE CARDS ***
Dealt to CashMatteo [Ad 8d]
Canguru19: calls $0.02
HortonRoundtree: calls $0.02
fourz4444: folds 
CashMatteo: raises $0.04 to $0.06
bouchizzle: folds 
ljab26: folds 
Canguru19: calls $0.04
HortonRoundtree: calls $0.04
*** FLOP *** [2d Js 2s]
Canguru19: checks 
HortonRoundtree: checks 
CashMatteo: checks 
*** TURN *** [2d Js 2s] [Kh]
Canguru19: checks 
HortonRoundtree: checks 
CashMatteo: checks 
*** RIVER *** [2d Js 2s Kh] [6s]
Canguru19: bets $0.04
HortonRoundtree: folds 
CashMatteo: calls $0.04
*** SHOW DOWN ***
Canguru19: shows [4c Kc] (two pair, Kings and Deuces)
CashMatteo: mucks hand 
Canguru19 collected $0.29 from pot
*** SUMMARY ***
Total pot $0.30 | Rake $0.01 
Board [2d Js 2s Kh 6s]
Seat 1: HortonRoundtree folded on the River
Seat 2: fourz4444 folded before Flop (didn't bet)
Seat 3: CashMatteo (button) mucked [Ad 8d]
Seat 4: bouchizzle (small blind) folded before Flop
Seat 5: ljab26 (big blind) folded before Flop
Seat 6: Canguru19 showed [4c Kc] and won ($0.29) with two pair, Kings and Deuces

Hand #42: 

PokerStars Hand #246222571439:  Hold'em No Limit ($0.01/$0.02 CAD) - 2023/09/27 23:22:47 ET
Table 'Alya III' 6-max Seat #4 is the button
Seat 1: HortonRoundtree ($1.48 in chips) 
Seat 2: fourz4444 ($1.99 in chips) 
Seat 3: CashMatteo ($4.05 in chips) 
Seat 4: bouchizzle ($2.92 in chips) 
Seat 5: ljab26 ($3.90 in chips) 
Seat 6: Canguru19 ($1.52 in chips) 
ljab26: posts small blind $0.01
Canguru19: posts big blind $0.02
*** HOLE CARDS ***
Dealt to CashMatteo [8s Js]
HortonRoundtree: folds 
fourz4444: folds 
CashMatteo: calls $0.02
bouchizzle: raises $0.06 to $0.08
ljab26: folds 
Canguru19: calls $0.06
CashMatteo: calls $0.06
*** FLOP *** [Ah Jd 6c]
Canguru19: checks 
CashMatteo: bets $0.12
bouchizzle: folds 
Canguru19: calls $0.12
*** TURN *** [Ah Jd 6c] [6d]
Canguru19: checks 
CashMatteo: bets $0.47
Canguru19: calls $0.47
*** RIVER *** [Ah Jd 6c 6d] [9s]
Canguru19: checks 
CashMatteo: checks 
*** SHOW DOWN ***
Canguru19: shows [Kc Ad] (two pair, Aces and Sixes)
CashMatteo: mucks hand 
Canguru19 collected $1.38 from pot
*** SUMMARY ***
Total pot $1.43 | Rake $0.05 
Board [Ah Jd 6c 6d 9s]
Seat 1: HortonRoundtree folded before Flop (didn't bet)
Seat 2: fourz4444 folded before Flop (didn't bet)
Seat 3: CashMatteo mucked [8s Js]
Seat 4: bouchizzle (button) folded on the Flop
Seat 5: ljab26 (small blind) folded before Flop
Seat 6: Canguru19 (big blind) showed [Kc Ad] and won ($1.38) with two pair, Aces and Sixes

Hand #43: 

PokerStars Hand #246222576786:  Hold'em No Limit ($0.01/$0.02 CAD) - 2023/09/27 23:23:26 ET
Table 'Alya III' 6-max Seat #5 is the button
Seat 1: HortonRoundtree ($1.48 in chips) 
Seat 2: fourz4444 ($1.99 in chips) 
Seat 3: CashMatteo ($3.38 in chips) 
Seat 4: bouchizzle ($2.84 in chips) 
Seat 5: ljab26 ($3.89 in chips) 
Seat 6: Canguru19 ($2.23 in chips) 
Canguru19: posts small blind $0.01
HortonRoundtree: posts big blind $0.02
*** HOLE CARDS ***
Dealt to CashMatteo [Td 3d]
fourz4444: folds 
CashMatteo: calls $0.02
bouchizzle: folds 
ljab26: calls $0.02
Canguru19: calls $0.01
HortonRoundtree: checks 
*** FLOP *** [Ac Ts 5h]
Canguru19: checks 
HortonRoundtree: checks 
CashMatteo: checks 
ljab26: checks 
*** TURN *** [Ac Ts 5h] [4s]
Canguru19: bets $0.08
HortonRoundtree: folds 
CashMatteo: folds 
ljab26: folds 
Uncalled bet ($0.08) returned to Canguru19
Canguru19 collected $0.08 from pot
Canguru19: doesn't show hand 
*** SUMMARY ***
Total pot $0.08 | Rake $0 
Board [Ac Ts 5h 4s]
Seat 1: HortonRoundtree (big blind) folded on the Turn
Seat 2: fourz4444 folded before Flop (didn't bet)
Seat 3: CashMatteo folded on the Turn
Seat 4: bouchizzle folded before Flop (didn't bet)
Seat 5: ljab26 (button) folded on the Turn
Seat 6: Canguru19 (small blind) collected ($0.08)

Hand #44: 

PokerStars Hand #246222582906:  Hold'em No Limit ($0.01/$0.02 CAD) - 2023/09/27 23:24:10 ET
Table 'Alya III' 6-max Seat #6 is the button
Seat 1: HortonRoundtree ($1.46 in chips) 
Seat 2: fourz4444 ($1.99 in chips) 
Seat 3: CashMatteo ($3.36 in chips) 
Seat 4: bouchizzle ($2.84 in chips) 
Seat 5: ljab26 ($3.87 in chips) 
Seat 6: Canguru19 ($2.29 in chips) 
HortonRoundtree: posts small blind $0.01
fourz4444: posts big blind $0.02
*** HOLE CARDS ***
Dealt to CashMatteo [Qh 9s]
CashMatteo: calls $0.02
bouchizzle: folds 
ljab26: calls $0.02
Canguru19: calls $0.02
HortonRoundtree: calls $0.01
fourz4444: checks 
*** FLOP *** [Jh 8c Kd]
HortonRoundtree: checks 
fourz4444: checks 
CashMatteo: checks 
ljab26: checks 
Canguru19: bets $0.10
HortonRoundtree: folds 
fourz4444: folds 
CashMatteo: folds 
ljab26: folds 
Uncalled bet ($0.10) returned to Canguru19
Canguru19 collected $0.10 from pot
Canguru19: doesn't show hand 
*** SUMMARY ***
Total pot $0.10 | Rake $0 
Board [Jh 8c Kd]
Seat 1: HortonRoundtree (small blind) folded on the Flop
Seat 2: fourz4444 (big blind) folded on the Flop
Seat 3: CashMatteo folded on the Flop
Seat 4: bouchizzle folded before Flop (didn't bet)
Seat 5: ljab26 folded on the Flop
Seat 6: Canguru19 (button) collected ($0.10)

Hand #45: 

PokerStars Hand #246222587528:  Hold'em No Limit ($0.01/$0.02 CAD) - 2023/09/27 23:24:45 ET
Table 'Alya III' 6-max Seat #1 is the button
Seat 1: HortonRoundtree ($1.44 in chips) 
Seat 2: fourz4444 ($1.97 in chips) 
Seat 3: CashMatteo ($3.34 in chips) 
Seat 4: bouchizzle ($2.84 in chips) 
Seat 5: ljab26 ($3.85 in chips) 
Seat 6: Canguru19 ($2.37 in chips) 
fourz4444: posts small blind $0.01
CashMatteo: posts big blind $0.02
*** HOLE CARDS ***
Dealt to CashMatteo [Qd Tc]
bouchizzle: folds 
ljab26: folds 
Canguru19: folds 
HortonRoundtree: calls $0.02
fourz4444: folds 
CashMatteo: raises $0.04 to $0.06
HortonRoundtree: calls $0.04
*** FLOP *** [9h Jd 2c]
CashMatteo: bets $0.07
HortonRoundtree: folds 
Uncalled bet ($0.07) returned to CashMatteo
CashMatteo collected $0.13 from pot
CashMatteo: doesn't show hand 
*** SUMMARY ***
Total pot $0.13 | Rake $0 
Board [9h Jd 2c]
Seat 1: HortonRoundtree (button) folded on the Flop
Seat 2: fourz4444 (small blind) folded before Flop
Seat 3: CashMatteo (big blind) collected ($0.13)
Seat 4: bouchizzle folded before Flop (didn't bet)
Seat 5: ljab26 folded before Flop (didn't bet)
Seat 6: Canguru19 folded before Flop (didn't bet)

Hand #46: 

PokerStars Hand #246222590984:  Hold'em No Limit ($0.01/$0.02 CAD) - 2023/09/27 23:25:11 ET
Table 'Alya III' 6-max Seat #2 is the button
Seat 1: HortonRoundtree ($1.38 in chips) 
Seat 2: fourz4444 ($1.96 in chips) 
Seat 3: CashMatteo ($3.41 in chips) 
Seat 4: bouchizzle ($2.84 in chips) 
Seat 5: ljab26 ($3.85 in chips) 
Seat 6: Canguru19 ($2.37 in chips) 
CashMatteo: posts small blind $0.01
bouchizzle: posts big blind $0.02
*** HOLE CARDS ***
Dealt to CashMatteo [8d 3c]
ljab26: folds 
Canguru19: folds 
HortonRoundtree: folds 
fourz4444: folds 
CashMatteo: calls $0.01
bouchizzle: raises $0.06 to $0.08
CashMatteo: folds 
Uncalled bet ($0.06) returned to bouchizzle
bouchizzle collected $0.04 from pot
bouchizzle: doesn't show hand 
*** SUMMARY ***
Total pot $0.04 | Rake $0 
Seat 1: HortonRoundtree folded before Flop (didn't bet)
Seat 2: fourz4444 (button) folded before Flop (didn't bet)
Seat 3: CashMatteo (small blind) folded before Flop
Seat 4: bouchizzle (big blind) collected ($0.04)
Seat 5: ljab26 folded before Flop (didn't bet)
Seat 6: Canguru19 folded before Flop (didn't bet)

Hand #47: 

PokerStars Hand #246222593440:  Hold'em No Limit ($0.01/$0.02 CAD) - 2023/09/27 23:25:28 ET
Table 'Alya III' 6-max Seat #3 is the button
Seat 1: HortonRoundtree ($1.38 in chips) 
Seat 2: fourz4444 ($1.96 in chips) 
Seat 3: CashMatteo ($3.39 in chips) 
Seat 4: bouchizzle ($2.86 in chips) 
Seat 5: ljab26 ($3.85 in chips) 
Seat 6: Canguru19 ($2.37 in chips) 
bouchizzle: posts small blind $0.01
ljab26: posts big blind $0.02
*** HOLE CARDS ***
Dealt to CashMatteo [5s Qs]
Canguru19: folds 
HortonRoundtree: folds 
fourz4444: calls $0.02
CashMatteo: raises $0.02 to $0.04
bouchizzle: folds 
ljab26: calls $0.02
fourz4444: raises $0.02 to $0.06
CashMatteo: calls $0.02
ljab26: calls $0.02
*** FLOP *** [Ks Kh 3s]
ljab26: checks 
fourz4444: bets $0.18
CashMatteo: calls $0.18
ljab26: folds 
*** TURN *** [Ks Kh 3s] [8h]
fourz4444: bets $0.02
CashMatteo: calls $0.02
*** RIVER *** [Ks Kh 3s 8h] [2s]
fourz4444: bets $0.02
CashMatteo: raises $0.61 to $0.63
fourz4444: folds 
Uncalled bet ($0.61) returned to CashMatteo
CashMatteo collected $0.61 from pot
CashMatteo: doesn't show hand 
*** SUMMARY ***
Total pot $0.63 | Rake $0.02 
Board [Ks Kh 3s 8h 2s]
Seat 1: HortonRoundtree folded before Flop (didn't bet)
Seat 2: fourz4444 folded on the River
Seat 3: CashMatteo (button) collected ($0.61)
Seat 4: bouchizzle (small blind) folded before Flop
Seat 5: ljab26 (big blind) folded on the Flop
Seat 6: Canguru19 folded before Flop (didn't bet)

Hand #48: 

PokerStars Hand #246222602593:  Hold'em No Limit ($0.01/$0.02 CAD) - 2023/09/27 23:26:36 ET
Table 'Alya III' 6-max Seat #4 is the button
Seat 1: HortonRoundtree ($1.38 in chips) 
Seat 2: fourz4444 ($1.68 in chips) 
Seat 3: CashMatteo ($3.72 in chips) 
Seat 4: bouchizzle ($2.85 in chips) 
Seat 5: ljab26 ($3.79 in chips) 
Seat 6: Canguru19 ($2.37 in chips) 
ljab26: posts small blind $0.01
Canguru19: posts big blind $0.02
*** HOLE CARDS ***
Dealt to CashMatteo [5c 3s]
HortonRoundtree: calls $0.02
fourz4444: folds 
CashMatteo: calls $0.02
bouchizzle: folds 
ljab26: calls $0.01
Canguru19: checks 
*** FLOP *** [Js 4c 2h]
ljab26: checks 
Canguru19: bets $0.08
HortonRoundtree: folds 
CashMatteo: calls $0.08
ljab26: folds 
*** TURN *** [Js 4c 2h] [Qh]
Canguru19: checks 
CashMatteo: checks 
*** RIVER *** [Js 4c 2h Qh] [5d]
Canguru19: bets $0.12
CashMatteo: calls $0.12
*** SHOW DOWN ***
Canguru19: shows [7d Jd] (a pair of Jacks)
CashMatteo: mucks hand 
Canguru19 collected $0.46 from pot
*** SUMMARY ***
Total pot $0.48 | Rake $0.02 
Board [Js 4c 2h Qh 5d]
Seat 1: HortonRoundtree folded on the Flop
Seat 2: fourz4444 folded before Flop (didn't bet)
Seat 3: CashMatteo mucked [5c 3s]
Seat 4: bouchizzle (button) folded before Flop (didn't bet)
Seat 5: ljab26 (small blind) folded on the Flop
Seat 6: Canguru19 (big blind) showed [7d Jd] and won ($0.46) with a pair of Jacks

Hand #49: 

PokerStars Hand #246222609436:  Hold'em No Limit ($0.01/$0.02 CAD) - 2023/09/27 23:27:26 ET
Table 'Alya III' 6-max Seat #5 is the button
Seat 1: HortonRoundtree ($1.36 in chips) 
Seat 2: fourz4444 ($1.68 in chips) 
Seat 3: CashMatteo ($3.50 in chips) 
Seat 4: bouchizzle ($2.85 in chips) 
Seat 5: ljab26 ($3.77 in chips) 
Seat 6: Canguru19 ($2.61 in chips) 
Canguru19: posts small blind $0.01
HortonRoundtree: posts big blind $0.02
*** HOLE CARDS ***
Dealt to CashMatteo [2s 9s]
fourz4444: calls $0.02
CashMatteo: calls $0.02
bouchizzle: folds 
ljab26: folds 
Canguru19: calls $0.01
HortonRoundtree: checks 
*** FLOP *** [Ks 2d 8d]
Canguru19: checks 
HortonRoundtree: checks 
fourz4444: checks 
CashMatteo: checks 
*** TURN *** [Ks 2d 8d] [4h]
Canguru19: checks 
HortonRoundtree: bets $0.04
fourz4444: calls $0.04
CashMatteo: calls $0.04
Canguru19: calls $0.04
*** RIVER *** [Ks 2d 8d 4h] [7h]
Canguru19: checks 
HortonRoundtree: bets $0.12
fourz4444: raises $0.47 to $0.59
CashMatteo: folds 
Canguru19: folds 
HortonRoundtree: folds 
Uncalled bet ($0.47) returned to fourz4444
fourz4444 collected $0.46 from pot
fourz4444: doesn't show hand 
*** SUMMARY ***
Total pot $0.48 | Rake $0.02 
Board [Ks 2d 8d 4h 7h]
Seat 1: HortonRoundtree (big blind) folded on the River
Seat 2: fourz4444 collected ($0.46)
Seat 3: CashMatteo folded on the River
Seat 4: bouchizzle folded before Flop (didn't bet)
Seat 5: ljab26 (button) folded before Flop (didn't bet)
Seat 6: Canguru19 (small blind) folded on the River

Hand #50: 

PokerStars Hand #246222618015:  Hold'em No Limit ($0.01/$0.02 CAD) - 2023/09/27 23:28:28 ET
Table 'Alya III' 6-max Seat #6 is the button
Seat 1: HortonRoundtree ($1.18 in chips) 
Seat 2: fourz4444 ($1.96 in chips) 
Seat 3: CashMatteo ($3.44 in chips) 
Seat 4: bouchizzle ($2.85 in chips) 
Seat 5: ljab26 ($3.77 in chips) 
Seat 6: Canguru19 ($2.55 in chips) 
HortonRoundtree: posts small blind $0.01
fourz4444: posts big blind $0.02
*** HOLE CARDS ***
Dealt to CashMatteo [Ah Qd]
CashMatteo: raises $0.04 to $0.06
bouchizzle: calls $0.06
ljab26: folds 
Canguru19: folds 
HortonRoundtree: folds 
fourz4444: folds 
*** FLOP *** [Kc Js Td]
CashMatteo: bets $0.07
bouchizzle: folds 
Uncalled bet ($0.07) returned to CashMatteo
CashMatteo collected $0.14 from pot
CashMatteo: doesn't show hand 
*** SUMMARY ***
Total pot $0.15 | Rake $0.01 
Board [Kc Js Td]
Seat 1: HortonRoundtree (small blind) folded before Flop
Seat 2: fourz4444 (big blind) folded before Flop
Seat 3: CashMatteo collected ($0.14)
Seat 4: bouchizzle folded on the Flop
Seat 5: ljab26 folded before Flop (didn't bet)
Seat 6: Canguru19 (button) folded before Flop (didn't bet)

Hand #51: 

PokerStars Hand #246222623507:  Hold'em No Limit ($0.01/$0.02 CAD) - 2023/09/27 23:29:09 ET
Table 'Alya III' 6-max Seat #1 is the button
Seat 1: HortonRoundtree ($1.17 in chips) 
Seat 2: fourz4444 ($1.94 in chips) 
Seat 3: CashMatteo ($3.52 in chips) 
Seat 4: bouchizzle ($2.79 in chips) 
Seat 5: ljab26 ($3.77 in chips) 
Seat 6: Canguru19 ($2.55 in chips) 
fourz4444: posts small blind $0.01
CashMatteo: posts big blind $0.02
*** HOLE CARDS ***
Dealt to CashMatteo [Ad 9d]
bouchizzle: folds 
ljab26: folds 
Canguru19: folds 
HortonRoundtree: folds 
fourz4444: calls $0.01
CashMatteo: raises $0.04 to $0.06
fourz4444: calls $0.04
*** FLOP *** [Qc 2h 6c]
fourz4444: checks 
CashMatteo: bets $0.06
fourz4444: calls $0.06
*** TURN *** [Qc 2h 6c] [4s]
fourz4444: checks 
CashMatteo: checks 
*** RIVER *** [Qc 2h 6c 4s] [Ac]
fourz4444: bets $1.82 and is all-in
CashMatteo: calls $1.82
*** SHOW DOWN ***
fourz4444: shows [5c 7c] (a flush, Ace high)
CashMatteo: shows [Ad 9d] (a pair of Aces)
fourz4444 collected $3.74 from pot
*** SUMMARY ***
Total pot $3.88 | Rake $0.14 
Board [Qc 2h 6c 4s Ac]
Seat 1: HortonRoundtree (button) folded before Flop (didn't bet)
Seat 2: fourz4444 (small blind) showed [5c 7c] and won ($3.74) with a flush, Ace high
Seat 3: CashMatteo (big blind) showed [Ad 9d] and lost with a pair of Aces
Seat 4: bouchizzle folded before Flop (didn't bet)
Seat 5: ljab26 folded before Flop (didn't bet)
Seat 6: Canguru19 folded before Flop (didn't bet)

Hand #52: 

PokerStars Hand #246222630964:  Hold'em No Limit ($0.01/$0.02 CAD) - 2023/09/27 23:30:05 ET
Table 'Alya III' 6-max Seat #2 is the button
Seat 1: HortonRoundtree ($1.17 in chips) 
Seat 2: fourz4444 ($3.74 in chips) 
Seat 3: CashMatteo ($1.58 in chips) 
Seat 4: bouchizzle ($2.79 in chips) 
Seat 5: ljab26 ($3.77 in chips) 
Seat 6: Canguru19 ($2.55 in chips) 
CashMatteo: posts small blind $0.01
bouchizzle: posts big blind $0.02
*** HOLE CARDS ***
Dealt to CashMatteo [9h 4s]
ljab26: folds 
Canguru19: calls $0.02
HortonRoundtree: folds 
fourz4444: calls $0.02
CashMatteo: calls $0.01
bouchizzle: checks 
*** FLOP *** [6h Qs 6d]
fourz4444 said, "ty"
CashMatteo: checks 
bouchizzle: checks 
Canguru19: checks 
fourz4444: checks 
*** TURN *** [6h Qs 6d] [2d]
CashMatteo: checks 
bouchizzle: checks 
Canguru19: checks 
fourz4444: checks 
*** RIVER *** [6h Qs 6d 2d] [Ad]
CashMatteo: checks 
bouchizzle: checks 
Canguru19: checks 
fourz4444: bets $0.08
CashMatteo: folds 
bouchizzle: folds 
Canguru19: folds 
Uncalled bet ($0.08) returned to fourz4444
fourz4444 collected $0.08 from pot
fourz4444: doesn't show hand 
*** SUMMARY ***
Total pot $0.08 | Rake $0 
Board [6h Qs 6d 2d Ad]
Seat 1: HortonRoundtree folded before Flop (didn't bet)
Seat 2: fourz4444 (button) collected ($0.08)
Seat 3: CashMatteo (small blind) folded on the River
Seat 4: bouchizzle (big blind) folded on the River
Seat 5: ljab26 folded before Flop (didn't bet)
Seat 6: Canguru19 folded on the River

Hand #53: 

PokerStars Hand #246222640687:  Hold'em No Limit ($0.01/$0.02 CAD) - 2023/09/27 23:31:17 ET
Table 'Alya III' 6-max Seat #3 is the button
Seat 1: HortonRoundtree ($1.17 in chips) 
Seat 2: fourz4444 ($3.80 in chips) 
Seat 3: CashMatteo ($1.56 in chips) 
Seat 4: bouchizzle ($2.77 in chips) 
Seat 5: ljab26 ($3.77 in chips) 
Seat 6: Canguru19 ($2.53 in chips) 
bouchizzle: posts small blind $0.01
ljab26: posts big blind $0.02
*** HOLE CARDS ***
Dealt to CashMatteo [4s Jh]
Canguru19: calls $0.02
HortonRoundtree: folds 
fourz4444: folds 
CashMatteo: calls $0.02
bouchizzle: folds 
ljab26: checks 
*** FLOP *** [Ad Qs 6s]
ljab26: checks 
Canguru19: checks 
CashMatteo: checks 
*** TURN *** [Ad Qs 6s] [Qc]
ljab26: bets $0.04
Canguru19: folds 
CashMatteo: folds 
Uncalled bet ($0.04) returned to ljab26
ljab26 collected $0.07 from pot
ljab26: doesn't show hand 
*** SUMMARY ***
Total pot $0.07 | Rake $0 
Board [Ad Qs 6s Qc]
Seat 1: HortonRoundtree folded before Flop (didn't bet)
Seat 2: fourz4444 folded before Flop (didn't bet)
Seat 3: CashMatteo (button) folded on the Turn
Seat 4: bouchizzle (small blind) folded before Flop
Seat 5: ljab26 (big blind) collected ($0.07)
Seat 6: Canguru19 folded on the Turn

Hand #54: 

PokerStars Hand #246222644483:  Hold'em No Limit ($0.01/$0.02 CAD) - 2023/09/27 23:31:45 ET
Table 'Alya III' 6-max Seat #4 is the button
Seat 1: HortonRoundtree ($1.17 in chips) 
Seat 2: fourz4444 ($3.80 in chips) 
Seat 3: CashMatteo ($1.54 in chips) 
Seat 4: bouchizzle ($2.76 in chips) 
Seat 5: ljab26 ($3.82 in chips) 
Seat 6: Canguru19 ($2.51 in chips) 
ljab26: posts small blind $0.01
Canguru19: posts big blind $0.02
*** HOLE CARDS ***
Dealt to CashMatteo [3c 7h]
HortonRoundtree: calls $0.02
fourz4444: calls $0.02
CashMatteo: folds 
bouchizzle: folds 
ljab26: folds 
Canguru19: checks 
*** FLOP *** [7c Qs Kh]
Canguru19: checks 
HortonRoundtree: checks 
fourz4444: checks 
*** TURN *** [7c Qs Kh] [4h]
Canguru19: checks 
HortonRoundtree: checks 
fourz4444: bets $0.07
Canguru19: folds 
HortonRoundtree: folds 
Uncalled bet ($0.07) returned to fourz4444
fourz4444 collected $0.07 from pot
fourz4444: doesn't show hand 
*** SUMMARY ***
Total pot $0.07 | Rake $0 
Board [7c Qs Kh 4h]
Seat 1: HortonRoundtree folded on the Turn
Seat 2: fourz4444 collected ($0.07)
Seat 3: CashMatteo folded before Flop (didn't bet)
Seat 4: bouchizzle (button) folded before Flop (didn't bet)
Seat 5: ljab26 (small blind) folded before Flop
Seat 6: Canguru19 (big blind) folded on the Turn

Hand #55: 

PokerStars Hand #246222649558:  Hold'em No Limit ($0.01/$0.02 CAD) - 2023/09/27 23:32:23 ET
Table 'Alya III' 6-max Seat #5 is the button
Seat 1: HortonRoundtree ($1.15 in chips) 
Seat 2: fourz4444 ($3.85 in chips) 
Seat 3: CashMatteo ($1.54 in chips) 
Seat 4: bouchizzle ($2.76 in chips) 
Seat 5: ljab26 ($3.81 in chips) 
Seat 6: Canguru19 ($2.49 in chips) 
Canguru19: posts small blind $0.01
HortonRoundtree: posts big blind $0.02
*** HOLE CARDS ***
Dealt to CashMatteo [5c Ks]
fourz4444: calls $0.02
CashMatteo: calls $0.02
bouchizzle: folds 
ljab26: folds 
Canguru19: calls $0.01
HortonRoundtree: checks 
*** FLOP *** [5s 5h 6s]
Canguru19: checks 
HortonRoundtree: checks 
fourz4444: bets $0.18
CashMatteo: calls $0.18
Canguru19: folds 
HortonRoundtree: folds 
*** TURN *** [5s 5h 6s] [7h]
fourz4444: checks 
CashMatteo: checks 
*** RIVER *** [5s 5h 6s 7h] [8s]
fourz4444: bets $3.65 and is all-in
CashMatteo: calls $1.34 and is all-in
Uncalled bet ($2.31) returned to fourz4444
*** SHOW DOWN ***
fourz4444: shows [7c 7d] (a full house, Sevens full of Fives)
CashMatteo: shows [5c Ks] (three of a kind, Fives)
fourz4444 collected $3.01 from pot
*** SUMMARY ***
Total pot $3.12 | Rake $0.11 
Board [5s 5h 6s 7h 8s]
Seat 1: HortonRoundtree (big blind) folded on the Flop
Seat 2: fourz4444 showed [7c 7d] and won ($3.01) with a full house, Sevens full of Fives
Seat 3: CashMatteo showed [5c Ks] and lost with three of a kind, Fives
Seat 4: bouchizzle folded before Flop (didn't bet)
Seat 5: ljab26 (button) folded before Flop (didn't bet)
Seat 6: Canguru19 (small blind) folded on the Flop

Hand #56: 

PokerStars Hand #246222666261:  Hold'em No Limit ($0.01/$0.02 CAD) - 2023/09/27 23:34:29 ET
Table 'Alya III' 6-max Seat #1 is the button
Seat 1: HortonRoundtree ($1.11 in chips) 
Seat 2: fourz4444 ($5.30 in chips) 
Seat 3: CashMatteo ($2 in chips) 
Seat 4: bouchizzle ($2.76 in chips) 
Seat 5: ljab26 ($3.81 in chips) 
Seat 6: Canguru19 ($2.51 in chips) 
fourz4444: posts small blind $0.01
CashMatteo: posts big blind $0.02
*** HOLE CARDS ***
Dealt to CashMatteo [Qs 8s]
bouchizzle: folds 
ljab26: calls $0.02
Canguru19: folds 
HortonRoundtree: folds 
fourz4444: folds 
CashMatteo: raises $0.04 to $0.06
ljab26: calls $0.04
*** FLOP *** [Jh 7c Qh]
CashMatteo: checks 
ljab26: checks 
*** TURN *** [Jh 7c Qh] [4c]
CashMatteo: checks 
ljab26: checks 
*** RIVER *** [Jh 7c Qh 4c] [4s]
CashMatteo: checks 
ljab26: checks 
*** SHOW DOWN ***
CashMatteo: shows [Qs 8s] (two pair, Queens and Fours)
ljab26: mucks hand 
CashMatteo collected $0.13 from pot
*** SUMMARY ***
Total pot $0.13 | Rake $0 
Board [Jh 7c Qh 4c 4s]
Seat 1: HortonRoundtree (button) folded before Flop (didn't bet)
Seat 2: fourz4444 (small blind) folded before Flop
Seat 3: CashMatteo (big blind) showed [Qs 8s] and won ($0.13) with two pair, Queens and Fours
Seat 4: bouchizzle folded before Flop (didn't bet)
Seat 5: ljab26 mucked [3h 3c]
Seat 6: Canguru19 folded before Flop (didn't bet)

Hand #57: 

PokerStars Hand #246222671711:  Hold'em No Limit ($0.01/$0.02 CAD) - 2023/09/27 23:35:11 ET
Table 'Alya III' 6-max Seat #2 is the button
Seat 1: HortonRoundtree ($1.11 in chips) 
Seat 2: fourz4444 ($5.29 in chips) 
Seat 3: CashMatteo ($2.07 in chips) 
Seat 4: bouchizzle ($2.76 in chips) 
Seat 5: ljab26 ($3.75 in chips) 
Seat 6: Canguru19 ($2.51 in chips) 
CashMatteo: posts small blind $0.01
bouchizzle: posts big blind $0.02
*** HOLE CARDS ***
Dealt to CashMatteo [Ad Js]
ljab26: calls $0.02
Canguru19: calls $0.02
HortonRoundtree: folds 
fourz4444: folds 
CashMatteo: raises $0.04 to $0.06
bouchizzle: folds 
ljab26: folds 
Canguru19: calls $0.04
*** FLOP *** [8s 9c 2s]
CashMatteo: checks 
Canguru19: checks 
*** TURN *** [8s 9c 2s] [9h]
CashMatteo: checks 
Canguru19: bets $0.08
CashMatteo: calls $0.08
*** RIVER *** [8s 9c 2s 9h] [Jh]
fourz4444 said, "hey matteo have a good night"
CashMatteo said, "ok sure"
CashMatteo: bets $0.16
Canguru19: folds 
Uncalled bet ($0.16) returned to CashMatteo
CashMatteo collected $0.31 from pot
CashMatteo: doesn't show hand 
*** SUMMARY ***
Total pot $0.32 | Rake $0.01 
Board [8s 9c 2s 9h Jh]
Seat 1: HortonRoundtree folded before Flop (didn't bet)
Seat 2: fourz4444 (button) folded before Flop (didn't bet)
Seat 3: CashMatteo (small blind) collected ($0.31)
Seat 4: bouchizzle (big blind) folded before Flop
Seat 5: ljab26 folded before Flop
Seat 6: Canguru19 folded on the River

Hand #58: 

PokerStars Hand #246222678972:  Hold'em No Limit ($0.01/$0.02 CAD) - 2023/09/27 23:36:06 ET
Table 'Alya III' 6-max Seat #3 is the button
Seat 1: HortonRoundtree ($1.11 in chips) 
Seat 2: fourz4444 ($5.29 in chips) 
Seat 3: CashMatteo ($2.24 in chips) 
Seat 4: bouchizzle ($2.74 in chips) 
Seat 5: ljab26 ($3.73 in chips) 
Seat 6: Canguru19 ($2.37 in chips) 
bouchizzle: posts small blind $0.01
ljab26: posts big blind $0.02
*** HOLE CARDS ***
Dealt to CashMatteo [5h 3c]
Canguru19: folds 
HortonRoundtree: folds 
fourz4444: folds 
CashMatteo: calls $0.02
bouchizzle: folds 
fourz4444 leaves the table
ljab26: checks 
*** FLOP *** [Jc 4s 8s]
ljab26: checks 
CashMatteo: checks 
*** TURN *** [Jc 4s 8s] [Ac]
ljab26: checks 
CashMatteo: checks 
*** RIVER *** [Jc 4s 8s Ac] [6h]
ljab26: checks 
CashMatteo: checks 
*** SHOW DOWN ***
ljab26: shows [5c Qs] (high card Ace)
CashMatteo: mucks hand 
ljab26 collected $0.05 from pot
*** SUMMARY ***
Total pot $0.05 | Rake $0 
Board [Jc 4s 8s Ac 6h]
Seat 1: HortonRoundtree folded before Flop (didn't bet)
Seat 2: fourz4444 folded before Flop (didn't bet)
Seat 3: CashMatteo (button) mucked [5h 3c]
Seat 4: bouchizzle (small blind) folded before Flop
Seat 5: ljab26 (big blind) showed [5c Qs] and won ($0.05) with high card Ace
Seat 6: Canguru19 folded before Flop (didn't bet)

Hand #59: 

PokerStars Hand #246222683272:  Hold'em No Limit ($0.01/$0.02 CAD) - 2023/09/27 23:36:39 ET
Table 'Alya III' 6-max Seat #4 is the button
Seat 1: HortonRoundtree ($1.11 in chips) 
Seat 3: CashMatteo ($2.22 in chips) 
Seat 4: bouchizzle ($2.73 in chips) 
Seat 5: ljab26 ($3.76 in chips) 
Seat 6: Canguru19 ($2.37 in chips) 
ljab26: posts small blind $0.01
Canguru19: posts big blind $0.02
*** HOLE CARDS ***
Dealt to CashMatteo [Ts 9h]
HortonRoundtree: folds 
CashMatteo: calls $0.02
bouchizzle: raises $0.06 to $0.08
ljab26: folds 
Canguru19: folds 
CashMatteo: folds 
Uncalled bet ($0.06) returned to bouchizzle
bouchizzle collected $0.07 from pot
bouchizzle: doesn't show hand 
*** SUMMARY ***
Total pot $0.07 | Rake $0 
Seat 1: HortonRoundtree folded before Flop (didn't bet)
Seat 3: CashMatteo folded before Flop
Seat 4: bouchizzle (button) collected ($0.07)
Seat 5: ljab26 (small blind) folded before Flop
Seat 6: Canguru19 (big blind) folded before Flop

Hand #60: 

PokerStars Hand #246222685685:  Hold'em No Limit ($0.01/$0.02 CAD) - 2023/09/27 23:36:57 ET
Table 'Alya III' 6-max Seat #5 is the button
Seat 1: HortonRoundtree ($1.11 in chips) 
Seat 3: CashMatteo ($2.20 in chips) 
Seat 4: bouchizzle ($2.78 in chips) 
Seat 5: ljab26 ($3.75 in chips) 
Seat 6: Canguru19 ($2.35 in chips) 
Canguru19: posts small blind $0.01
HortonRoundtree: posts big blind $0.02
*** HOLE CARDS ***
Dealt to CashMatteo [Ks Kh]
CashMatteo: raises $0.04 to $0.06
bouchizzle: folds 
ljab26: folds 
Canguru19: folds 
HortonRoundtree: folds 
Uncalled bet ($0.04) returned to CashMatteo
CashMatteo collected $0.05 from pot
CashMatteo: doesn't show hand 
*** SUMMARY ***
Total pot $0.05 | Rake $0 
Seat 1: HortonRoundtree (big blind) folded before Flop
Seat 3: CashMatteo collected ($0.05)
Seat 4: bouchizzle folded before Flop (didn't bet)
Seat 5: ljab26 (button) folded before Flop (didn't bet)
Seat 6: Canguru19 (small blind) folded before Flop

Hand #61: 

PokerStars Hand #246222687646:  Hold'em No Limit ($0.01/$0.02 CAD) - 2023/09/27 23:37:13 ET
Table 'Alya III' 6-max Seat #6 is the button
Seat 1: HortonRoundtree ($1.09 in chips) 
Seat 3: CashMatteo ($2.23 in chips) 
Seat 4: bouchizzle ($2.78 in chips) 
Seat 5: ljab26 ($3.75 in chips) 
Seat 6: Canguru19 ($2.34 in chips) 
HortonRoundtree: posts small blind $0.01
CashMatteo: posts big blind $0.02
*** HOLE CARDS ***
Dealt to CashMatteo [Kd 4d]
pborg1 joins the table at seat #2 
bouchizzle: folds 
ljab26: folds 
Canguru19: calls $0.02
HortonRoundtree: folds 
CashMatteo: raises $0.04 to $0.06
Canguru19: calls $0.04
*** FLOP *** [9d Kc 2c]
CashMatteo: bets $0.07
Canguru19: calls $0.07
*** TURN *** [9d Kc 2c] [Ah]
CashMatteo: bets $0.13
Canguru19: calls $0.13
*** RIVER *** [9d Kc 2c Ah] [2h]
CashMatteo: checks 
Canguru19: checks 
*** SHOW DOWN ***
CashMatteo: shows [Kd 4d] (two pair, Kings and Deuces)
Canguru19: mucks hand 
CashMatteo collected $0.51 from pot
*** SUMMARY ***
Total pot $0.53 | Rake $0.02 
Board [9d Kc 2c Ah 2h]
Seat 1: HortonRoundtree (small blind) folded before Flop
Seat 3: CashMatteo (big blind) showed [Kd 4d] and won ($0.51) with two pair, Kings and Deuces
Seat 4: bouchizzle folded before Flop (didn't bet)
Seat 5: ljab26 folded before Flop (didn't bet)
Seat 6: Canguru19 (button) mucked [Jc Qc]

Hand #62: 

PokerStars Hand #246222692083:  Hold'em No Limit ($0.01/$0.02 CAD) - 2023/09/27 23:37:46 ET
Table 'Alya III' 6-max Seat #1 is the button
Seat 1: HortonRoundtree ($1.08 in chips) 
Seat 3: CashMatteo ($2.48 in chips) 
Seat 4: bouchizzle ($2.78 in chips) 
Seat 5: ljab26 ($3.75 in chips) 
Seat 6: Canguru19 ($2.08 in chips) 
pborg1 will be allowed to play after the button
CashMatteo: posts small blind $0.01
bouchizzle: posts big blind $0.02
*** HOLE CARDS ***
Dealt to CashMatteo [5s 3c]
ljab26: calls $0.02
Canguru19: calls $0.02
HortonRoundtree: calls $0.02
CashMatteo: calls $0.01
bouchizzle: raises $0.18 to $0.20
ljab26: folds 
Canguru19: folds 
HortonRoundtree: folds 
CashMatteo: folds 
Uncalled bet ($0.18) returned to bouchizzle
bouchizzle collected $0.10 from pot
bouchizzle: doesn't show hand 
*** SUMMARY ***
Total pot $0.10 | Rake $0 
Seat 1: HortonRoundtree (button) folded before Flop
Seat 3: CashMatteo (small blind) folded before Flop
Seat 4: bouchizzle (big blind) collected ($0.10)
Seat 5: ljab26 folded before Flop
Seat 6: Canguru19 folded before Flop

Hand #63: 

PokerStars Hand #246222695903:  Hold'em No Limit ($0.01/$0.02 CAD) - 2023/09/27 23:38:15 ET
Table 'Alya III' 6-max Seat #3 is the button
Seat 1: HortonRoundtree ($1.06 in chips) 
Seat 2: pborg1 ($2 in chips) 
Seat 3: CashMatteo ($2.46 in chips) 
Seat 4: bouchizzle ($2.86 in chips) 
Seat 5: ljab26 ($3.73 in chips) 
Seat 6: Canguru19 ($2.06 in chips) 
bouchizzle: posts small blind $0.01
ljab26: posts big blind $0.02
pborg1: posts big blind $0.02
*** HOLE CARDS ***
Dealt to CashMatteo [Js 8d]
Canguru19: calls $0.02
HortonRoundtree: folds 
pborg1: checks 
CashMatteo: calls $0.02
bouchizzle: folds 
ljab26: checks 
*** FLOP *** [Qh Qc 4d]
ljab26: checks 
Canguru19: checks 
pborg1: checks 
CashMatteo: checks 
*** TURN *** [Qh Qc 4d] [Qd]
ljab26: checks 
Canguru19: checks 
pborg1: checks 
CashMatteo: checks 
*** RIVER *** [Qh Qc 4d Qd] [8c]
ljab26: checks 
Canguru19: checks 
pborg1: checks 
CashMatteo: bets $0.02
ljab26: calls $0.02
Canguru19: folds 
pborg1: folds 
*** SHOW DOWN ***
CashMatteo: shows [Js 8d] (a full house, Queens full of Eights)
ljab26: shows [8s Jd] (a full house, Queens full of Eights)
ljab26 collected $0.07 from pot
CashMatteo collected $0.06 from pot
*** SUMMARY ***
Total pot $0.13 | Rake $0 
Board [Qh Qc 4d Qd 8c]
Seat 1: HortonRoundtree folded before Flop (didn't bet)
Seat 2: pborg1 folded on the River (didn't bet)
Seat 3: CashMatteo (button) showed [Js 8d] and won ($0.06) with a full house, Queens full of Eights
Seat 4: bouchizzle (small blind) folded before Flop
Seat 5: ljab26 (big blind) showed [8s Jd] and won ($0.07) with a full house, Queens full of Eights
Seat 6: Canguru19 folded on the River

Hand #64: 

PokerStars Hand #246222702305:  Hold'em No Limit ($0.01/$0.02 CAD) - 2023/09/27 23:39:03 ET
Table 'Alya III' 6-max Seat #4 is the button
Seat 1: HortonRoundtree ($1.06 in chips) 
Seat 2: pborg1 ($1.98 in chips) 
Seat 3: CashMatteo ($2.48 in chips) 
Seat 4: bouchizzle ($2.85 in chips) 
Seat 5: ljab26 ($3.76 in chips) 
Seat 6: Canguru19 ($2.04 in chips) 
ljab26: posts small blind $0.01
Canguru19: posts big blind $0.02
*** HOLE CARDS ***
Dealt to CashMatteo [6s 4s]
HortonRoundtree: folds 
pborg1: folds 
CashMatteo: calls $0.02
bouchizzle: folds 
ljab26: calls $0.01
Canguru19: checks 
*** FLOP *** [Js 5c Ad]
ljab26: checks 
Canguru19: checks 
CashMatteo: checks 
*** TURN *** [Js 5c Ad] [6h]
ljab26: bets $0.04
Canguru19: folds 
CashMatteo: calls $0.04
*** RIVER *** [Js 5c Ad 6h] [7d]
ljab26: bets $0.04
CashMatteo: calls $0.04
*** SHOW DOWN ***
ljab26: shows [Ah Kd] (a pair of Aces)
CashMatteo: mucks hand 
ljab26 collected $0.21 from pot
*** SUMMARY ***
Total pot $0.22 | Rake $0.01 
Board [Js 5c Ad 6h 7d]
Seat 1: HortonRoundtree folded before Flop (didn't bet)
Seat 2: pborg1 folded before Flop (didn't bet)
Seat 3: CashMatteo mucked [6s 4s]
Seat 4: bouchizzle (button) folded before Flop (didn't bet)
Seat 5: ljab26 (small blind) showed [Ah Kd] and won ($0.21) with a pair of Aces
Seat 6: Canguru19 (big blind) folded on the Turn

Hand #65: 

PokerStars Hand #246222705650:  Hold'em No Limit ($0.01/$0.02 CAD) - 2023/09/27 23:39:29 ET
Table 'Alya III' 6-max Seat #5 is the button
Seat 1: HortonRoundtree ($1.06 in chips) 
Seat 2: pborg1 ($1.98 in chips) 
Seat 3: CashMatteo ($2.38 in chips) 
Seat 4: bouchizzle ($2.85 in chips) 
Seat 5: ljab26 ($3.87 in chips) 
Seat 6: Canguru19 ($2.02 in chips) 
Canguru19: posts small blind $0.01
HortonRoundtree: posts big blind $0.02
*** HOLE CARDS ***
Dealt to CashMatteo [5s 2c]
pborg1: folds 
CashMatteo: folds 
bouchizzle: raises $0.04 to $0.06
ljab26: folds 
Canguru19: calls $0.05
HortonRoundtree: folds 
*** FLOP *** [Tc 6s 7h]
Canguru19: checks 
bouchizzle: bets $0.08
Canguru19: calls $0.08
*** TURN *** [Tc 6s 7h] [9c]
Canguru19: checks 
bouchizzle: checks 
*** RIVER *** [Tc 6s 7h 9c] [Th]
Canguru19: checks 
bouchizzle: checks 
*** SHOW DOWN ***
Canguru19: shows [Jh Kh] (a pair of Tens)
bouchizzle: shows [6d 3d] (two pair, Tens and Sixes)
bouchizzle collected $0.29 from pot
*** SUMMARY ***
Total pot $0.30 | Rake $0.01 
Board [Tc 6s 7h 9c Th]
Seat 1: HortonRoundtree (big blind) folded before Flop
Seat 2: pborg1 folded before Flop (didn't bet)
Seat 3: CashMatteo folded before Flop (didn't bet)
Seat 4: bouchizzle showed [6d 3d] and won ($0.29) with two pair, Tens and Sixes
Seat 5: ljab26 (button) folded before Flop (didn't bet)
Seat 6: Canguru19 (small blind) showed [Jh Kh] and lost with a pair of Tens

Hand #66: 

PokerStars Hand #246222710611:  Hold'em No Limit ($0.01/$0.02 CAD) - 2023/09/27 23:40:06 ET
Table 'Alya III' 6-max Seat #6 is the button
Seat 1: HortonRoundtree ($1.04 in chips) 
Seat 2: pborg1 ($1.98 in chips) 
Seat 3: CashMatteo ($2.38 in chips) 
Seat 4: bouchizzle ($3 in chips) 
Seat 5: ljab26 ($3.87 in chips) 
Seat 6: Canguru19 ($1.88 in chips) 
HortonRoundtree: posts small blind $0.01
pborg1: posts big blind $0.02
*** HOLE CARDS ***
Dealt to CashMatteo [4c 2s]
CashMatteo: folds 
bouchizzle: folds 
ljab26: folds 
Canguru19: calls $0.02
HortonRoundtree: folds 
pborg1: checks 
*** FLOP *** [5d Kd 2c]
pborg1: checks 
Canguru19: bets $0.05
pborg1: calls $0.05
*** TURN *** [5d Kd 2c] [8c]
pborg1: checks 
Canguru19: bets $0.14
pborg1: folds 
Uncalled bet ($0.14) returned to Canguru19
Canguru19 collected $0.14 from pot
Canguru19: doesn't show hand 
*** SUMMARY ***
Total pot $0.15 | Rake $0.01 
Board [5d Kd 2c 8c]
Seat 1: HortonRoundtree (small blind) folded before Flop
Seat 2: pborg1 (big blind) folded on the Turn
Seat 3: CashMatteo folded before Flop (didn't bet)
Seat 4: bouchizzle folded before Flop (didn't bet)
Seat 5: ljab26 folded before Flop (didn't bet)
Seat 6: Canguru19 (button) collected ($0.14)

Hand #67: 

PokerStars Hand #246222715054:  Hold'em No Limit ($0.01/$0.02 CAD) - 2023/09/27 23:40:40 ET
Table 'Alya III' 6-max Seat #1 is the button
Seat 1: HortonRoundtree ($1.03 in chips) 
Seat 2: pborg1 ($1.91 in chips) 
Seat 3: CashMatteo ($2.38 in chips) 
Seat 4: bouchizzle ($3 in chips) 
Seat 5: ljab26 ($3.87 in chips) 
Seat 6: Canguru19 ($1.95 in chips) 
pborg1: posts small blind $0.01
CashMatteo: posts big blind $0.02
*** HOLE CARDS ***
Dealt to CashMatteo [7d 4s]
bouchizzle: folds 
ljab26: calls $0.02
Canguru19: calls $0.02
HortonRoundtree: calls $0.02
pborg1: calls $0.01
CashMatteo: checks 
*** FLOP *** [8s 9h Ac]
pborg1: checks 
CashMatteo: checks 
ljab26: checks 
Canguru19: checks 
HortonRoundtree: checks 
*** TURN *** [8s 9h Ac] [2s]
pborg1: checks 
CashMatteo: checks 
ljab26: bets $0.04
Canguru19: folds 
HortonRoundtree: folds 
pborg1: calls $0.04
CashMatteo: folds 
*** RIVER *** [8s 9h Ac 2s] [Qh]
pborg1: checks 
ljab26: bets $0.06
pborg1: folds 
Uncalled bet ($0.06) returned to ljab26
ljab26 collected $0.17 from pot
ljab26: doesn't show hand 
*** SUMMARY ***
Total pot $0.18 | Rake $0.01 
Board [8s 9h Ac 2s Qh]
Seat 1: HortonRoundtree (button) folded on the Turn
Seat 2: pborg1 (small blind) folded on the River
Seat 3: CashMatteo (big blind) folded on the Turn
Seat 4: bouchizzle folded before Flop (didn't bet)
Seat 5: ljab26 collected ($0.17)
Seat 6: Canguru19 folded on the Turn

Hand #68: 

PokerStars Hand #246222724119:  Hold'em No Limit ($0.01/$0.02 CAD) - 2023/09/27 23:41:48 ET
Table 'Alya III' 6-max Seat #2 is the button
Seat 1: HortonRoundtree ($1.01 in chips) 
Seat 2: pborg1 ($1.85 in chips) 
Seat 3: CashMatteo ($2.36 in chips) 
Seat 4: bouchizzle ($3 in chips) 
Seat 5: ljab26 ($3.98 in chips) 
Seat 6: Canguru19 ($1.93 in chips) 
CashMatteo: posts small blind $0.01
bouchizzle: posts big blind $0.02
*** HOLE CARDS ***
Dealt to CashMatteo [7d Ad]
ljab26: folds 
Canguru19: calls $0.02
HortonRoundtree: folds 
pborg1: calls $0.02
CashMatteo: raises $0.04 to $0.06
bouchizzle: folds 
Canguru19: folds 
pborg1: calls $0.04
*** FLOP *** [6s 7s 9s]
CashMatteo: checks 
pborg1: checks 
*** TURN *** [6s 7s 9s] [5c]
CashMatteo: checks 
pborg1: bets $0.02
CashMatteo: calls $0.02
*** RIVER *** [6s 7s 9s 5c] [Jh]
CashMatteo: checks 
pborg1: bets $0.08
CashMatteo: folds 
Uncalled bet ($0.08) returned to pborg1
pborg1 collected $0.19 from pot
*** SUMMARY ***
Total pot $0.20 | Rake $0.01 
Board [6s 7s 9s 5c Jh]
Seat 1: HortonRoundtree folded before Flop (didn't bet)
Seat 2: pborg1 (button) collected ($0.19)
Seat 3: CashMatteo (small blind) folded on the River
Seat 4: bouchizzle (big blind) folded before Flop
Seat 5: ljab26 folded before Flop (didn't bet)
Seat 6: Canguru19 folded before Flop

Hand #69: 

PokerStars Hand #246222730805:  Hold'em No Limit ($0.01/$0.02 CAD) - 2023/09/27 23:42:38 ET
Table 'Alya III' 6-max Seat #3 is the button
Seat 1: HortonRoundtree ($1.01 in chips) 
Seat 2: pborg1 ($1.96 in chips) 
Seat 3: CashMatteo ($2.28 in chips) 
Seat 4: bouchizzle ($2.98 in chips) 
Seat 5: ljab26 ($3.98 in chips) 
Seat 6: Canguru19 ($1.91 in chips) 
bouchizzle: posts small blind $0.01
ljab26: posts big blind $0.02
*** HOLE CARDS ***
Dealt to CashMatteo [Jc 6h]
Canguru19: folds 
HortonRoundtree: folds 
pborg1: raises $0.06 to $0.08
CashMatteo: calls $0.08
bouchizzle: folds 
ljab26: folds 
*** FLOP *** [7h 5h 3s]
pborg1: bets $0.02
CashMatteo: calls $0.02
*** TURN *** [7h 5h 3s] [Kh]
pborg1: bets $0.02
CashMatteo: calls $0.02
*** RIVER *** [7h 5h 3s Kh] [Td]
pborg1: bets $0.02
CashMatteo: calls $0.02
*** SHOW DOWN ***
pborg1: shows [As Ks] (a pair of Kings)
CashMatteo: mucks hand 
pborg1 collected $0.30 from pot
*** SUMMARY ***
Total pot $0.31 | Rake $0.01 
Board [7h 5h 3s Kh Td]
Seat 1: HortonRoundtree folded before Flop (didn't bet)
Seat 2: pborg1 showed [As Ks] and won ($0.30) with a pair of Kings
Seat 3: CashMatteo (button) mucked [Jc 6h]
Seat 4: bouchizzle (small blind) folded before Flop
Seat 5: ljab26 (big blind) folded before Flop
Seat 6: Canguru19 folded before Flop (didn't bet)

Hand #70: 

PokerStars Hand #246222736480:  Hold'em No Limit ($0.01/$0.02 CAD) - 2023/09/27 23:43:21 ET
Table 'Alya III' 6-max Seat #4 is the button
Seat 1: HortonRoundtree ($1.01 in chips) 
Seat 2: pborg1 ($2.12 in chips) 
Seat 3: CashMatteo ($2.14 in chips) 
Seat 4: bouchizzle ($2.97 in chips) 
Seat 5: ljab26 ($3.96 in chips) 
Seat 6: Canguru19 ($1.91 in chips) 
ljab26: posts small blind $0.01
Canguru19: posts big blind $0.02
*** HOLE CARDS ***
Dealt to CashMatteo [5d 8s]
HortonRoundtree: folds 
pborg1: folds 
CashMatteo: folds 
bouchizzle: raises $0.04 to $0.06
ljab26: calls $0.05
Canguru19: calls $0.04
*** FLOP *** [Kh 2d 5s]
ljab26: checks 
Canguru19: checks 
bouchizzle: bets $0.10
ljab26: folds 
Canguru19: calls $0.10
*** TURN *** [Kh 2d 5s] [Ts]
Canguru19: checks 
bouchizzle: checks 
*** RIVER *** [Kh 2d 5s Ts] [8d]
Canguru19: bets $0.10
bouchizzle: folds 
Uncalled bet ($0.10) returned to Canguru19
Canguru19 collected $0.37 from pot
Canguru19: doesn't show hand 
*** SUMMARY ***
Total pot $0.38 | Rake $0.01 
Board [Kh 2d 5s Ts 8d]
Seat 1: HortonRoundtree folded before Flop (didn't bet)
Seat 2: pborg1 folded before Flop (didn't bet)
Seat 3: CashMatteo folded before Flop (didn't bet)
Seat 4: bouchizzle (button) folded on the River
Seat 5: ljab26 (small blind) folded on the Flop
Seat 6: Canguru19 (big blind) collected ($0.37)

Hand #71: 

PokerStars Hand #246222744467:  Hold'em No Limit ($0.01/$0.02 CAD) - 2023/09/27 23:44:22 ET
Table 'Alya III' 6-max Seat #5 is the button
Seat 1: HortonRoundtree ($1.01 in chips) 
Seat 2: pborg1 ($2.12 in chips) 
Seat 3: CashMatteo ($2.14 in chips) 
Seat 4: bouchizzle ($2.81 in chips) 
Seat 5: ljab26 ($3.90 in chips) 
Seat 6: Canguru19 ($2.12 in chips) 
Canguru19: posts small blind $0.01
HortonRoundtree: posts big blind $0.02
*** HOLE CARDS ***
Dealt to CashMatteo [Ts Jc]
pborg1: calls $0.02
CashMatteo has timed out
CashMatteo: folds 
bouchizzle: folds 
ljab26: calls $0.02
Canguru19: calls $0.01
HortonRoundtree: checks 
*** FLOP *** [8c 5d Jd]
Canguru19: checks 
HortonRoundtree: checks 
pborg1: checks 
ljab26: checks 
*** TURN *** [8c 5d Jd] [Ks]
Canguru19: checks 
HortonRoundtree: checks 
pborg1: checks 
ljab26: checks 
*** RIVER *** [8c 5d Jd Ks] [Qs]
Canguru19: checks 
HortonRoundtree: bets $0.08
pborg1: folds 
ljab26: folds 
Canguru19: folds 
Uncalled bet ($0.08) returned to HortonRoundtree
HortonRoundtree collected $0.08 from pot
HortonRoundtree: doesn't show hand 
*** SUMMARY ***
Total pot $0.08 | Rake $0 
Board [8c 5d Jd Ks Qs]
Seat 1: HortonRoundtree (big blind) collected ($0.08)
Seat 2: pborg1 folded on the River
Seat 3: CashMatteo folded before Flop (didn't bet)
Seat 4: bouchizzle folded before Flop (didn't bet)
Seat 5: ljab26 (button) folded on the River
Seat 6: Canguru19 (small blind) folded on the River

Hand #72: 

PokerStars Hand #246222751939:  Hold'em No Limit ($0.01/$0.02 CAD) - 2023/09/27 23:45:21 ET
Table 'Alya III' 6-max Seat #6 is the button
Seat 1: HortonRoundtree ($1.07 in chips) 
Seat 2: pborg1 ($2.10 in chips) 
Seat 3: CashMatteo ($2.14 in chips) 
Seat 4: bouchizzle ($2.81 in chips) 
Seat 5: ljab26 ($3.88 in chips) 
Seat 6: Canguru19 ($2.10 in chips) 
HortonRoundtree: posts small blind $0.01
pborg1: posts big blind $0.02
*** HOLE CARDS ***
Dealt to CashMatteo [Jd Kd]
CashMatteo: raises $0.04 to $0.06
bouchizzle: folds 
ljab26: folds 
Canguru19: folds 
HortonRoundtree: calls $0.05
pborg1: calls $0.04
*** FLOP *** [5d Qs Ah]
HortonRoundtree: checks 
pborg1: checks 
CashMatteo: bets $0.09
HortonRoundtree: calls $0.09
pborg1: folds 
*** TURN *** [5d Qs Ah] [3d]
HortonRoundtree: checks 
CashMatteo: bets $0.18
HortonRoundtree: calls $0.18
*** RIVER *** [5d Qs Ah 3d] [Ks]
HortonRoundtree: checks 
CashMatteo: checks 
*** SHOW DOWN ***
HortonRoundtree: shows [Qd Ac] (two pair, Aces and Queens)
CashMatteo: mucks hand 
HortonRoundtree collected $0.69 from pot
*** SUMMARY ***
Total pot $0.72 | Rake $0.03 
Board [5d Qs Ah 3d Ks]
Seat 1: HortonRoundtree (small blind) showed [Qd Ac] and won ($0.69) with two pair, Aces and Queens
Seat 2: pborg1 (big blind) folded on the Flop
Seat 3: CashMatteo mucked [Jd Kd]
Seat 4: bouchizzle folded before Flop (didn't bet)
Seat 5: ljab26 folded before Flop (didn't bet)
Seat 6: Canguru19 (button) folded before Flop (didn't bet)

Hand #73: 

PokerStars Hand #246222758002:  Hold'em No Limit ($0.01/$0.02 CAD) - 2023/09/27 23:46:08 ET
Table 'Alya III' 6-max Seat #1 is the button
Seat 1: HortonRoundtree ($1.43 in chips) 
Seat 2: pborg1 ($2.04 in chips) 
Seat 3: CashMatteo ($1.81 in chips) 
Seat 4: bouchizzle ($2.81 in chips) 
Seat 5: ljab26 ($3.88 in chips) 
Seat 6: Canguru19 ($2.10 in chips) 
pborg1: posts small blind $0.01
CashMatteo: posts big blind $0.02
*** HOLE CARDS ***
Dealt to CashMatteo [5d 5c]
bouchizzle: folds 
ljab26: folds 
Canguru19: calls $0.02
HortonRoundtree: folds 
pborg1: calls $0.01
CashMatteo: checks 
*** FLOP *** [3d As Ts]
pborg1: checks 
CashMatteo: checks 
Canguru19: bets $0.06
pborg1: folds 
CashMatteo: folds 
Uncalled bet ($0.06) returned to Canguru19
Canguru19 collected $0.06 from pot
Canguru19: doesn't show hand 
*** SUMMARY ***
Total pot $0.06 | Rake $0 
Board [3d As Ts]
Seat 1: HortonRoundtree (button) folded before Flop (didn't bet)
Seat 2: pborg1 (small blind) folded on the Flop
Seat 3: CashMatteo (big blind) folded on the Flop
Seat 4: bouchizzle folded before Flop (didn't bet)
Seat 5: ljab26 folded before Flop (didn't bet)
Seat 6: Canguru19 collected ($0.06)

Hand #74: 

PokerStars Hand #246222761686:  Hold'em No Limit ($0.01/$0.02 CAD) - 2023/09/27 23:46:36 ET
Table 'Alya III' 6-max Seat #2 is the button
Seat 1: HortonRoundtree ($1.43 in chips) 
Seat 2: pborg1 ($2.02 in chips) 
Seat 3: CashMatteo ($1.79 in chips) 
Seat 4: bouchizzle ($2.81 in chips) 
Seat 5: ljab26 ($3.88 in chips) 
Seat 6: Canguru19 ($2.14 in chips) 
CashMatteo: posts small blind $0.01
bouchizzle: posts big blind $0.02
*** HOLE CARDS ***
Dealt to CashMatteo [7s 7c]
ljab26: folds 
Canguru19: calls $0.02
HortonRoundtree: folds 
pborg1: calls $0.02
CashMatteo: calls $0.01
bouchizzle: checks 
*** FLOP *** [Qc 7d 9h]
CashMatteo: checks 
bouchizzle: checks 
Canguru19: checks 
pborg1: bets $0.02
CashMatteo: raises $0.12 to $0.14
bouchizzle: folds 
Canguru19: folds 
pborg1: calls $0.12
*** TURN *** [Qc 7d 9h] [8c]
CashMatteo: checks 
pborg1: checks 
*** RIVER *** [Qc 7d 9h 8c] [Ah]
CashMatteo: bets $0.18
pborg1: calls $0.18
*** SHOW DOWN ***
CashMatteo: shows [7s 7c] (three of a kind, Sevens)
pborg1: mucks hand 
CashMatteo collected $0.69 from pot
*** SUMMARY ***
Total pot $0.72 | Rake $0.03 
Board [Qc 7d 9h 8c Ah]
Seat 1: HortonRoundtree folded before Flop (didn't bet)
Seat 2: pborg1 (button) mucked [6d Qd]
Seat 3: CashMatteo (small blind) showed [7s 7c] and won ($0.69) with three of a kind, Sevens
Seat 4: bouchizzle (big blind) folded on the Flop
Seat 5: ljab26 folded before Flop (didn't bet)
Seat 6: Canguru19 folded on the Flop

Hand #75: 

PokerStars Hand #246222768714:  Hold'em No Limit ($0.01/$0.02 CAD) - 2023/09/27 23:47:31 ET
Table 'Alya III' 6-max Seat #3 is the button
Seat 1: HortonRoundtree ($1.43 in chips) 
Seat 2: pborg1 ($1.68 in chips) 
Seat 3: CashMatteo ($2.14 in chips) 
Seat 4: bouchizzle ($2.79 in chips) 
Seat 5: ljab26 ($3.88 in chips) 
Seat 6: Canguru19 ($2.12 in chips) 
bouchizzle: posts small blind $0.01
ljab26: posts big blind $0.02
*** HOLE CARDS ***
Dealt to CashMatteo [4d 3s]
Canguru19: calls $0.02
HortonRoundtree: folds 
pborg1: calls $0.02
CashMatteo: calls $0.02
bouchizzle: raises $0.16 to $0.18
ljab26: folds 
Canguru19: folds 
pborg1: folds 
CashMatteo: calls $0.16
*** FLOP *** [6c Js As]
bouchizzle: bets $0.25
CashMatteo: folds 
Uncalled bet ($0.25) returned to bouchizzle
bouchizzle collected $0.41 from pot
bouchizzle: doesn't show hand 
*** SUMMARY ***
Total pot $0.42 | Rake $0.01 
Board [6c Js As]
Seat 1: HortonRoundtree folded before Flop (didn't bet)
Seat 2: pborg1 folded before Flop
Seat 3: CashMatteo (button) folded on the Flop
Seat 4: bouchizzle (small blind) collected ($0.41)
Seat 5: ljab26 (big blind) folded before Flop
Seat 6: Canguru19 folded before Flop

Hand #76: 

PokerStars Hand #246222772348:  Hold'em No Limit ($0.01/$0.02 CAD) - 2023/09/27 23:47:59 ET
Table 'Alya III' 6-max Seat #4 is the button
Seat 1: HortonRoundtree ($1.43 in chips) 
Seat 2: pborg1 ($1.66 in chips) 
Seat 3: CashMatteo ($1.96 in chips) 
Seat 4: bouchizzle ($3.02 in chips) 
Seat 5: ljab26 ($3.86 in chips) 
Seat 6: Canguru19 ($2.10 in chips) 
ljab26: posts small blind $0.01
Canguru19: posts big blind $0.02
*** HOLE CARDS ***
Dealt to CashMatteo [9c Jd]
HortonRoundtree: calls $0.02
pborg1: folds 
CashMatteo: calls $0.02
bouchizzle: folds 
ljab26: calls $0.01
Canguru19: checks 
*** FLOP *** [2s 8c 9s]
ljab26: checks 
Canguru19: checks 
HortonRoundtree: checks 
CashMatteo: bets $0.04
ljab26: calls $0.04
Canguru19: folds 
HortonRoundtree: folds 
*** TURN *** [2s 8c 9s] [2h]
ljab26: checks 
CashMatteo: checks 
*** RIVER *** [2s 8c 9s 2h] [Ad]
ljab26: checks 
CashMatteo: bets $0.08
ljab26: folds 
Uncalled bet ($0.08) returned to CashMatteo
CashMatteo collected $0.15 from pot
CashMatteo: doesn't show hand 
*** SUMMARY ***
Total pot $0.16 | Rake $0.01 
Board [2s 8c 9s 2h Ad]
Seat 1: HortonRoundtree folded on the Flop
Seat 2: pborg1 folded before Flop (didn't bet)
Seat 3: CashMatteo collected ($0.15)
Seat 4: bouchizzle (button) folded before Flop (didn't bet)
Seat 5: ljab26 (small blind) folded on the River
Seat 6: Canguru19 (big blind) folded on the Flop

Hand #77: 

PokerStars Hand #246222779735:  Hold'em No Limit ($0.01/$0.02 CAD) - 2023/09/27 23:48:57 ET
Table 'Alya III' 6-max Seat #5 is the button
Seat 1: HortonRoundtree ($1.41 in chips) 
Seat 2: pborg1 ($1.66 in chips) 
Seat 3: CashMatteo ($2.05 in chips) 
Seat 4: bouchizzle ($3.02 in chips) 
Seat 5: ljab26 ($3.80 in chips) 
Seat 6: Canguru19 ($2.08 in chips) 
Canguru19: posts small blind $0.01
HortonRoundtree: posts big blind $0.02
*** HOLE CARDS ***
Dealt to CashMatteo [5h 6c]
pborg1: calls $0.02
CashMatteo: calls $0.02
bouchizzle: folds 
ljab26: folds 
Canguru19: folds 
HortonRoundtree: checks 
*** FLOP *** [3c 3d Ac]
HortonRoundtree: checks 
pborg1: checks 
CashMatteo: checks 
*** TURN *** [3c 3d Ac] [Th]
HortonRoundtree: checks 
pborg1: checks 
CashMatteo: checks 
*** RIVER *** [3c 3d Ac Th] [4c]
HortonRoundtree: checks 
pborg1: checks 
CashMatteo: checks 
*** SHOW DOWN ***
HortonRoundtree: shows [5c Qd] (a pair of Threes)
pborg1: mucks hand 
CashMatteo: mucks hand 
HortonRoundtree collected $0.07 from pot
*** SUMMARY ***
Total pot $0.07 | Rake $0 
Board [3c 3d Ac Th 4c]
Seat 1: HortonRoundtree (big blind) showed [5c Qd] and won ($0.07) with a pair of Threes
Seat 2: pborg1 mucked [9d 6s]
Seat 3: CashMatteo mucked [5h 6c]
Seat 4: bouchizzle folded before Flop (didn't bet)
Seat 5: ljab26 (button) folded before Flop (didn't bet)
Seat 6: Canguru19 (small blind) folded before Flop

Hand #78: 

PokerStars Hand #246222784488:  Hold'em No Limit ($0.01/$0.02 CAD) - 2023/09/27 23:49:35 ET
Table 'Alya III' 6-max Seat #6 is the button
Seat 1: HortonRoundtree ($1.46 in chips) 
Seat 2: pborg1 ($1.64 in chips) 
Seat 3: CashMatteo ($2.03 in chips) 
Seat 4: bouchizzle ($3.02 in chips) 
Seat 5: ljab26 ($3.80 in chips) 
Seat 6: Canguru19 ($2.07 in chips) 
HortonRoundtree: posts small blind $0.01
pborg1: posts big blind $0.02
*** HOLE CARDS ***
Dealt to CashMatteo [Qc 6c]
CashMatteo has timed out
CashMatteo: folds 
bouchizzle: folds 
ljab26: calls $0.02
Canguru19: calls $0.02
HortonRoundtree: folds 
pborg1: checks 
*** FLOP *** [9h 6s 4s]
pborg1: checks 
ljab26: checks 
Canguru19: checks 
*** TURN *** [9h 6s 4s] [As]
pborg1: checks 
ljab26: checks 
Canguru19: checks 
*** RIVER *** [9h 6s 4s As] [8d]
pborg1: checks 
ljab26: checks 
Canguru19: checks 
*** SHOW DOWN ***
pborg1: shows [Jh 5h] (high card Ace)
ljab26: shows [5c 8c] (a pair of Eights)
Canguru19: mucks hand 
ljab26 collected $0.07 from pot
*** SUMMARY ***
Total pot $0.07 | Rake $0 
Board [9h 6s 4s As 8d]
Seat 1: HortonRoundtree (small blind) folded before Flop
Seat 2: pborg1 (big blind) showed [Jh 5h] and lost with high card Ace
Seat 3: CashMatteo folded before Flop (didn't bet)
Seat 4: bouchizzle folded before Flop (didn't bet)
Seat 5: ljab26 showed [5c 8c] and won ($0.07) with a pair of Eights
Seat 6: Canguru19 (button) mucked [3d Jd]

Hand #79: 

PokerStars Hand #246222790268:  Hold'em No Limit ($0.01/$0.02 CAD) - 2023/09/27 23:50:21 ET
Table 'Alya III' 6-max Seat #1 is the button
Seat 1: HortonRoundtree ($1.45 in chips) 
Seat 2: pborg1 ($1.62 in chips) 
Seat 3: CashMatteo ($2.03 in chips) 
Seat 4: bouchizzle ($3.02 in chips) 
Seat 5: ljab26 ($3.85 in chips) 
Seat 6: Canguru19 ($2.05 in chips) 
pborg1: posts small blind $0.01
CashMatteo: posts big blind $0.02
*** HOLE CARDS ***
Dealt to CashMatteo [Jd 2s]
bouchizzle: folds 
ljab26: folds 
Canguru19: folds 
HortonRoundtree: folds 
pborg1: calls $0.01
CashMatteo: checks 
*** FLOP *** [7h Th Qd]
pborg1: bets $0.02
CashMatteo: calls $0.02
*** TURN *** [7h Th Qd] [4d]
pborg1: bets $0.02
CashMatteo: folds 
Uncalled bet ($0.02) returned to pborg1
pborg1 collected $0.08 from pot
*** SUMMARY ***
Total pot $0.08 | Rake $0 
Board [7h Th Qd 4d]
Seat 1: HortonRoundtree (button) folded before Flop (didn't bet)
Seat 2: pborg1 (small blind) collected ($0.08)
Seat 3: CashMatteo (big blind) folded on the Turn
Seat 4: bouchizzle folded before Flop (didn't bet)
Seat 5: ljab26 folded before Flop (didn't bet)
Seat 6: Canguru19 folded before Flop (didn't bet)

Hand #80: 

PokerStars Hand #246222793231:  Hold'em No Limit ($0.01/$0.02 CAD) - 2023/09/27 23:50:44 ET
Table 'Alya III' 6-max Seat #2 is the button
Seat 1: HortonRoundtree ($1.45 in chips) 
Seat 2: pborg1 ($1.66 in chips) 
Seat 3: CashMatteo ($1.99 in chips) 
Seat 4: bouchizzle ($3.02 in chips) 
Seat 5: ljab26 ($3.85 in chips) 
Seat 6: Canguru19 ($2.05 in chips) 
CashMatteo: posts small blind $0.01
bouchizzle: posts big blind $0.02
*** HOLE CARDS ***
Dealt to CashMatteo [2s 9s]
ljab26: calls $0.02
Canguru19: folds 
HortonRoundtree: folds 
pborg1: calls $0.02
CashMatteo: calls $0.01
bouchizzle: checks 
*** FLOP *** [Ac 5d 3s]
CashMatteo: checks 
bouchizzle: checks 
ljab26: checks 
pborg1: checks 
*** TURN *** [Ac 5d 3s] [9h]
CashMatteo: checks 
bouchizzle: checks 
ljab26: checks 
pborg1: checks 
*** RIVER *** [Ac 5d 3s 9h] [7s]
CashMatteo: checks 
bouchizzle: checks 
ljab26: checks 
pborg1: checks 
*** SHOW DOWN ***
CashMatteo: shows [2s 9s] (a pair of Nines)
bouchizzle: mucks hand 
ljab26: mucks hand 
pborg1: shows [Js 9c] (a pair of Nines - Ace+Jack kicker)
pborg1 collected $0.08 from pot
*** SUMMARY ***
Total pot $0.08 | Rake $0 
Board [Ac 5d 3s 9h 7s]
Seat 1: HortonRoundtree folded before Flop (didn't bet)
Seat 2: pborg1 (button) showed [Js 9c] and won ($0.08) with a pair of Nines
Seat 3: CashMatteo (small blind) showed [2s 9s] and lost with a pair of Nines
Seat 4: bouchizzle (big blind) mucked [8c 2d]
Seat 5: ljab26 mucked [Td Ks]
Seat 6: Canguru19 folded before Flop (didn't bet)

Hand #81: 

PokerStars Hand #246222799911:  Hold'em No Limit ($0.01/$0.02 CAD) - 2023/09/27 23:51:38 ET
Table 'Alya III' 6-max Seat #3 is the button
Seat 1: HortonRoundtree ($1.45 in chips) 
Seat 2: pborg1 ($1.72 in chips) 
Seat 3: CashMatteo ($1.97 in chips) 
Seat 4: bouchizzle ($3 in chips) 
Seat 5: ljab26 ($3.83 in chips) 
Seat 6: Canguru19 ($2.05 in chips) 
bouchizzle: posts small blind $0.01
ljab26: posts big blind $0.02
*** HOLE CARDS ***
Dealt to CashMatteo [Js 9c]
Canguru19: folds 
HortonRoundtree: folds 
pborg1: folds 
CashMatteo: raises $0.04 to $0.06
bouchizzle: folds 
ljab26: calls $0.04
*** FLOP *** [Qs 5d 4c]
ljab26: checks 
CashMatteo: checks 
*** TURN *** [Qs 5d 4c] [7h]
ljab26: checks 
CashMatteo: checks 
*** RIVER *** [Qs 5d 4c 7h] [9d]
ljab26: checks 
CashMatteo: checks 
*** SHOW DOWN ***
ljab26: shows [8c Kc] (high card King)
CashMatteo: shows [Js 9c] (a pair of Nines)
CashMatteo collected $0.13 from pot
*** SUMMARY ***
Total pot $0.13 | Rake $0 
Board [Qs 5d 4c 7h 9d]
Seat 1: HortonRoundtree folded before Flop (didn't bet)
Seat 2: pborg1 folded before Flop (didn't bet)
Seat 3: CashMatteo (button) showed [Js 9c] and won ($0.13) with a pair of Nines
Seat 4: bouchizzle (small blind) folded before Flop
Seat 5: ljab26 (big blind) showed [8c Kc] and lost with high card King
Seat 6: Canguru19 folded before Flop (didn't bet)

Hand #82: 

PokerStars Hand #246222804593:  Hold'em No Limit ($0.01/$0.02 CAD) - 2023/09/27 23:52:15 ET
Table 'Alya III' 6-max Seat #4 is the button
Seat 1: HortonRoundtree ($1.45 in chips) 
Seat 2: pborg1 ($1.72 in chips) 
Seat 3: CashMatteo ($2.04 in chips) 
Seat 4: bouchizzle ($2.99 in chips) 
Seat 5: ljab26 ($3.77 in chips) 
Seat 6: Canguru19 ($2.05 in chips) 
ljab26: posts small blind $0.01
Canguru19: posts big blind $0.02
*** HOLE CARDS ***
Dealt to CashMatteo [Ks Qh]
HortonRoundtree: folds 
pborg1: calls $0.02
CashMatteo: raises $0.04 to $0.06
bouchizzle: calls $0.06
ljab26: folds 
Canguru19: calls $0.04
pborg1: calls $0.04
*** FLOP *** [3h 7c Jh]
Canguru19: checks 
pborg1: checks 
CashMatteo: checks 
bouchizzle: bets $0.14
Canguru19: calls $0.14
pborg1: folds 
CashMatteo: calls $0.14
*** TURN *** [3h 7c Jh] [7h]
Canguru19: checks 
CashMatteo: checks 
bouchizzle: checks 
*** RIVER *** [3h 7c Jh 7h] [4c]
Canguru19: checks 
CashMatteo: checks 
bouchizzle: checks 
*** SHOW DOWN ***
Canguru19: shows [3c Ac] (two pair, Sevens and Threes)
CashMatteo: mucks hand 
bouchizzle: shows [5h 5d] (two pair, Sevens and Fives)
bouchizzle collected $0.65 from pot
*** SUMMARY ***
Total pot $0.67 | Rake $0.02 
Board [3h 7c Jh 7h 4c]
Seat 1: HortonRoundtree folded before Flop (didn't bet)
Seat 2: pborg1 folded on the Flop
Seat 3: CashMatteo mucked [Ks Qh]
Seat 4: bouchizzle (button) showed [5h 5d] and won ($0.65) with two pair, Sevens and Fives
Seat 5: ljab26 (small blind) folded before Flop
Seat 6: Canguru19 (big blind) showed [3c Ac] and lost with two pair, Sevens and Threes

Hand #83: 

PokerStars Hand #246222810326:  Hold'em No Limit ($0.01/$0.02 CAD) - 2023/09/27 23:53:01 ET
Table 'Alya III' 6-max Seat #5 is the button
Seat 1: HortonRoundtree ($1.45 in chips) 
Seat 2: pborg1 ($1.66 in chips) 
Seat 3: CashMatteo ($1.84 in chips) 
Seat 4: bouchizzle ($3.44 in chips) 
Seat 5: ljab26 ($3.76 in chips) 
Seat 6: Canguru19 ($1.85 in chips) 
Canguru19: posts small blind $0.01
HortonRoundtree: posts big blind $0.02
*** HOLE CARDS ***
Dealt to CashMatteo [Ad Ks]
pborg1: calls $0.02
CashMatteo: raises $0.04 to $0.06
bouchizzle: folds 
ljab26: calls $0.06
Canguru19: calls $0.05
HortonRoundtree: folds 
pborg1: calls $0.04
*** FLOP *** [3h Kd 2s]
Canguru19: checks 
pborg1: checks 
CashMatteo: bets $0.25
ljab26: folds 
Canguru19: folds 
pborg1: calls $0.25
*** TURN *** [3h Kd 2s] [Th]
pborg1: checks 
CashMatteo: checks 
*** RIVER *** [3h Kd 2s Th] [Jd]
pborg1: bets $0.14
CashMatteo: calls $0.14
*** SHOW DOWN ***
pborg1: shows [2c 2h] (three of a kind, Deuces)
CashMatteo: mucks hand 
pborg1 collected $1 from pot
*** SUMMARY ***
Total pot $1.04 | Rake $0.04 
Board [3h Kd 2s Th Jd]
Seat 1: HortonRoundtree (big blind) folded before Flop
Seat 2: pborg1 showed [2c 2h] and won ($1) with three of a kind, Deuces
Seat 3: CashMatteo mucked [Ad Ks]
Seat 4: bouchizzle folded before Flop (didn't bet)
Seat 5: ljab26 (button) folded on the Flop
Seat 6: Canguru19 (small blind) folded on the Flop

Hand #84: 

PokerStars Hand #246222816339:  Hold'em No Limit ($0.01/$0.02 CAD) - 2023/09/27 23:53:50 ET
Table 'Alya III' 6-max Seat #6 is the button
Seat 1: HortonRoundtree ($1.43 in chips) 
Seat 2: pborg1 ($2.21 in chips) 
Seat 3: CashMatteo ($1.39 in chips) 
Seat 4: bouchizzle ($3.44 in chips) 
Seat 5: ljab26 ($3.70 in chips) 
Seat 6: Canguru19 ($1.79 in chips) 
HortonRoundtree: posts small blind $0.01
pborg1: posts big blind $0.02
*** HOLE CARDS ***
Dealt to CashMatteo [2c 5c]
CashMatteo: calls $0.02
bouchizzle: folds 
ljab26: folds 
Canguru19: calls $0.02
HortonRoundtree: folds 
pborg1: checks 
*** FLOP *** [8c 5s 7h]
pborg1: checks 
CashMatteo: checks 
Canguru19: bets $0.04
pborg1: folds 
CashMatteo: calls $0.04
*** TURN *** [8c 5s 7h] [Qh]
CashMatteo: checks 
Canguru19: bets $0.14
CashMatteo: folds 
Uncalled bet ($0.14) returned to Canguru19
Canguru19 collected $0.14 from pot
Canguru19: doesn't show hand 
*** SUMMARY ***
Total pot $0.15 | Rake $0.01 
Board [8c 5s 7h Qh]
Seat 1: HortonRoundtree (small blind) folded before Flop
Seat 2: pborg1 (big blind) folded on the Flop
Seat 3: CashMatteo folded on the Turn
Seat 4: bouchizzle folded before Flop (didn't bet)
Seat 5: ljab26 folded before Flop (didn't bet)
Seat 6: Canguru19 (button) collected ($0.14)

Hand #85: 

PokerStars Hand #246222820914:  Hold'em No Limit ($0.01/$0.02 CAD) - 2023/09/27 23:54:27 ET
Table 'Alya III' 6-max Seat #1 is the button
Seat 1: HortonRoundtree ($1.42 in chips) 
Seat 2: pborg1 ($2.19 in chips) 
Seat 3: CashMatteo ($1.33 in chips) 
Seat 4: bouchizzle ($3.44 in chips) 
Seat 5: ljab26 ($3.70 in chips) 
Seat 6: Canguru19 ($1.87 in chips) 
pborg1: posts small blind $0.01
CashMatteo: posts big blind $0.02
*** HOLE CARDS ***
Dealt to CashMatteo [4h 8s]
bouchizzle: folds 
ljab26: folds 
Canguru19: calls $0.02
HortonRoundtree: calls $0.02
pborg1: calls $0.01
CashMatteo: checks 
*** FLOP *** [5d 4s 3s]
pborg1: checks 
CashMatteo: checks 
Canguru19: checks 
HortonRoundtree: checks 
*** TURN *** [5d 4s 3s] [8d]
pborg1: bets $0.02
CashMatteo: raises $0.12 to $0.14
Canguru19: folds 
HortonRoundtree: calls $0.14
pborg1: calls $0.12
*** RIVER *** [5d 4s 3s 8d] [Jc]
pborg1: checks 
CashMatteo: bets $0.48
HortonRoundtree: calls $0.48
pborg1: folds 
*** SHOW DOWN ***
CashMatteo: shows [4h 8s] (two pair, Eights and Fours)
HortonRoundtree: mucks hand 
CashMatteo collected $1.41 from pot
*** SUMMARY ***
Total pot $1.46 | Rake $0.05 
Board [5d 4s 3s 8d Jc]
Seat 1: HortonRoundtree (button) mucked [Ts Js]
Seat 2: pborg1 (small blind) folded on the River
Seat 3: CashMatteo (big blind) showed [4h 8s] and won ($1.41) with two pair, Eights and Fours
Seat 4: bouchizzle folded before Flop (didn't bet)
Seat 5: ljab26 folded before Flop (didn't bet)
Seat 6: Canguru19 folded on the Turn

Hand #86: 

PokerStars Hand #246222827009:  Hold'em No Limit ($0.01/$0.02 CAD) - 2023/09/27 23:55:19 ET
Table 'Alya III' 6-max Seat #2 is the button
Seat 1: HortonRoundtree ($0.78 in chips) 
Seat 2: pborg1 ($2.03 in chips) 
Seat 3: CashMatteo ($2.10 in chips) 
Seat 4: bouchizzle ($3.44 in chips) 
Seat 5: ljab26 ($3.70 in chips) 
Seat 6: Canguru19 ($1.85 in chips) 
CashMatteo: posts small blind $0.01
bouchizzle: posts big blind $0.02
*** HOLE CARDS ***
Dealt to CashMatteo [3h Qh]
ljab26: folds 
Canguru19: calls $0.02
HortonRoundtree: calls $0.02
pborg1: calls $0.02
CashMatteo: calls $0.01
bouchizzle: checks 
*** FLOP *** [Ks Ah 7c]
CashMatteo: checks 
bouchizzle: checks 
Canguru19: checks 
HortonRoundtree: checks 
pborg1: checks 
*** TURN *** [Ks Ah 7c] [Kc]
CashMatteo: checks 
bouchizzle: checks 
Canguru19: checks 
HortonRoundtree: checks 
pborg1: checks 
*** RIVER *** [Ks Ah 7c Kc] [4s]
CashMatteo: checks 
bouchizzle: checks 
Canguru19: checks 
HortonRoundtree: bets $0.10
pborg1: folds 
CashMatteo: folds 
bouchizzle: folds 
Canguru19: folds 
Uncalled bet ($0.10) returned to HortonRoundtree
HortonRoundtree collected $0.10 from pot
HortonRoundtree: doesn't show hand 
*** SUMMARY ***
Total pot $0.10 | Rake $0 
Board [Ks Ah 7c Kc 4s]
Seat 1: HortonRoundtree collected ($0.10)
Seat 2: pborg1 (button) folded on the River
Seat 3: CashMatteo (small blind) folded on the River
Seat 4: bouchizzle (big blind) folded on the River
Seat 5: ljab26 folded before Flop (didn't bet)
Seat 6: Canguru19 folded on the River

Hand #87: 

PokerStars Hand #246222832232:  Hold'em No Limit ($0.01/$0.02 CAD) - 2023/09/27 23:56:10 ET
Table 'Alya III' 6-max Seat #3 is the button
Seat 1: HortonRoundtree ($0.86 in chips) 
Seat 2: pborg1 ($2.01 in chips) 
Seat 3: CashMatteo ($2.08 in chips) 
Seat 4: bouchizzle ($3.42 in chips) 
Seat 5: ljab26 ($3.70 in chips) 
Seat 6: Canguru19 ($1.83 in chips) 
bouchizzle: posts small blind $0.01
ljab26: posts big blind $0.02
*** HOLE CARDS ***
Dealt to CashMatteo [2c Jc]
Canguru19: calls $0.02
HortonRoundtree: folds 
pborg1: calls $0.02
CashMatteo: calls $0.02
bouchizzle: folds 
ljab26: checks 
*** FLOP *** [3c Kc Qd]
ljab26: checks 
Canguru19: checks 
pborg1: checks 
CashMatteo: bets $0.05
ljab26: folds 
Canguru19: calls $0.05
pborg1: folds 
*** TURN *** [3c Kc Qd] [2h]
Canguru19: checks 
CashMatteo: bets $0.09
Canguru19: calls $0.09
*** RIVER *** [3c Kc Qd 2h] [7h]
Canguru19: checks 
CashMatteo: checks 
*** SHOW DOWN ***
Canguru19: shows [8c 9c] (high card King)
CashMatteo: shows [2c Jc] (a pair of Deuces)
CashMatteo collected $0.36 from pot
*** SUMMARY ***
Total pot $0.37 | Rake $0.01 
Board [3c Kc Qd 2h 7h]
Seat 1: HortonRoundtree folded before Flop (didn't bet)
Seat 2: pborg1 folded on the Flop
Seat 3: CashMatteo (button) showed [2c Jc] and won ($0.36) with a pair of Deuces
Seat 4: bouchizzle (small blind) folded before Flop
Seat 5: ljab26 (big blind) folded on the Flop
Seat 6: Canguru19 showed [8c 9c] and lost with high card King

Hand #88: 

PokerStars Hand #246222836540:  Hold'em No Limit ($0.01/$0.02 CAD) - 2023/09/27 23:56:52 ET
Table 'Alya III' 6-max Seat #4 is the button
Seat 1: HortonRoundtree ($0.86 in chips) 
Seat 2: pborg1 ($1.99 in chips) 
Seat 3: CashMatteo ($2.28 in chips) 
Seat 4: bouchizzle ($3.41 in chips) 
Seat 5: ljab26 ($3.68 in chips) 
Seat 6: Canguru19 ($1.67 in chips) 
ljab26: posts small blind $0.01
Canguru19: posts big blind $0.02
*** HOLE CARDS ***
Dealt to CashMatteo [Qs 8s]
HortonRoundtree: folds 
pborg1: folds 
CashMatteo: raises $0.04 to $0.06
bouchizzle: folds 
ljab26: folds 
Canguru19: calls $0.04
*** FLOP *** [Kh 7s 8d]
Canguru19: checks 
CashMatteo: bets $0.07
Canguru19: calls $0.07
*** TURN *** [Kh 7s 8d] [6s]
Canguru19: checks 
CashMatteo: bets $0.13
Canguru19: calls $0.13
*** RIVER *** [Kh 7s 8d 6s] [5c]
Canguru19: checks 
CashMatteo: checks 
*** SHOW DOWN ***
Canguru19: shows [Jh Js] (a pair of Jacks)
CashMatteo: mucks hand 
Canguru19 collected $0.51 from pot
*** SUMMARY ***
Total pot $0.53 | Rake $0.02 
Board [Kh 7s 8d 6s 5c]
Seat 1: HortonRoundtree folded before Flop (didn't bet)
Seat 2: pborg1 folded before Flop (didn't bet)
Seat 3: CashMatteo mucked [Qs 8s]
Seat 4: bouchizzle (button) folded before Flop (didn't bet)
Seat 5: ljab26 (small blind) folded before Flop
Seat 6: Canguru19 (big blind) showed [Jh Js] and won ($0.51) with a pair of Jacks

Hand #89: 

PokerStars Hand #246222839712:  Hold'em No Limit ($0.01/$0.02 CAD) - 2023/09/27 23:57:23 ET
Table 'Alya III' 6-max Seat #5 is the button
Seat 1: HortonRoundtree ($0.86 in chips) 
Seat 2: pborg1 ($1.99 in chips) 
Seat 3: CashMatteo ($2.02 in chips) 
Seat 4: bouchizzle ($3.41 in chips) 
Seat 5: ljab26 ($3.67 in chips) 
Seat 6: Canguru19 ($1.92 in chips) 
Canguru19: posts small blind $0.01
HortonRoundtree: posts big blind $0.02
*** HOLE CARDS ***
Dealt to CashMatteo [4s 8h]
pborg1: calls $0.02
CashMatteo: folds 
bouchizzle: folds 
ljab26: calls $0.02
Canguru19: calls $0.01
HortonRoundtree: checks 
*** FLOP *** [9s 9c Jd]
Canguru19: checks 
HortonRoundtree: checks 
pborg1: checks 
ljab26: checks 
*** TURN *** [9s 9c Jd] [3c]
Canguru19: checks 
HortonRoundtree: checks 
pborg1: checks 
ljab26: bets $0.04
Canguru19: folds 
HortonRoundtree: calls $0.04
pborg1: folds 
*** RIVER *** [9s 9c Jd 3c] [Tc]
HortonRoundtree: checks 
ljab26: bets $0.08
pborg1 leaves the table
HortonRoundtree: folds 
Uncalled bet ($0.08) returned to ljab26
ljab26 collected $0.15 from pot
ljab26: doesn't show hand 
*** SUMMARY ***
Total pot $0.16 | Rake $0.01 
Board [9s 9c Jd 3c Tc]
Seat 1: HortonRoundtree (big blind) folded on the River
Seat 2: pborg1 folded on the Turn
Seat 3: CashMatteo folded before Flop (didn't bet)
Seat 4: bouchizzle folded before Flop (didn't bet)
Seat 5: ljab26 (button) collected ($0.15)
Seat 6: Canguru19 (small blind) folded on the Turn

Hand #90: 

PokerStars Hand #246222844406:  Hold'em No Limit ($0.01/$0.02 CAD) - 2023/09/27 23:58:09 ET
Table 'Alya III' 6-max Seat #6 is the button
Seat 1: HortonRoundtree ($0.80 in chips) 
Seat 3: CashMatteo ($2.02 in chips) 
Seat 4: bouchizzle ($3.41 in chips) 
Seat 5: ljab26 ($3.76 in chips) 
Seat 6: Canguru19 ($1.90 in chips) 
HortonRoundtree: posts small blind $0.01
CashMatteo: posts big blind $0.02
*** HOLE CARDS ***
Dealt to CashMatteo [Jd 6s]
bouchizzle: folds 
ljab26: calls $0.02
Canguru19: calls $0.02
HortonRoundtree: folds 
CashMatteo: checks 
*** FLOP *** [4h Kh 8d]
CashMatteo: checks 
ljab26: bets $0.04
Canguru19: calls $0.04
CashMatteo: folds 
*** TURN *** [4h Kh 8d] [8c]
ljab26: checks 
Canguru19: bets $0.07
ljab26: calls $0.07
*** RIVER *** [4h Kh 8d 8c] [7d]
ljab26: checks 
Canguru19: bets $0.28
ljab26: folds 
Uncalled bet ($0.28) returned to Canguru19
Canguru19 collected $0.28 from pot
Canguru19: doesn't show hand 
*** SUMMARY ***
Total pot $0.29 | Rake $0.01 
Board [4h Kh 8d 8c 7d]
Seat 1: HortonRoundtree (small blind) folded before Flop
Seat 3: CashMatteo (big blind) folded on the Flop
Seat 4: bouchizzle folded before Flop (didn't bet)
Seat 5: ljab26 folded on the River
Seat 6: Canguru19 (button) collected ($0.28)

Hand #91: 

PokerStars Hand #246222848761:  Hold'em No Limit ($0.01/$0.02 CAD) - 2023/09/27 23:58:53 ET
Table 'Alya III' 6-max Seat #1 is the button
Seat 1: HortonRoundtree ($0.79 in chips) 
Seat 3: CashMatteo ($2 in chips) 
Seat 4: bouchizzle ($3.41 in chips) 
Seat 5: ljab26 ($3.63 in chips) 
Seat 6: Canguru19 ($2.05 in chips) 
CashMatteo: posts small blind $0.01
bouchizzle: posts big blind $0.02
*** HOLE CARDS ***
Dealt to CashMatteo [Kd 6c]
ljab26: calls $0.02
Canguru19: folds 
HortonRoundtree: folds 
CashMatteo: calls $0.01
bouchizzle: checks 
*** FLOP *** [6s As 8s]
CashMatteo: checks 
bouchizzle: checks 
ljab26: checks 
*** TURN *** [6s As 8s] [6d]
CashMatteo: bets $0.03
bouchizzle: folds 
ljab26: calls $0.03
*** RIVER *** [6s As 8s 6d] [Qc]
CashMatteo: checks 
ljab26: bets $0.06
CashMatteo: folds 
Uncalled bet ($0.06) returned to ljab26
ljab26 collected $0.12 from pot
ljab26: doesn't show hand 
*** SUMMARY ***
Total pot $0.12 | Rake $0 
Board [6s As 8s 6d Qc]
Seat 1: HortonRoundtree (button) folded before Flop (didn't bet)
Seat 3: CashMatteo (small blind) folded on the River
Seat 4: bouchizzle (big blind) folded on the Turn
Seat 5: ljab26 collected ($0.12)
Seat 6: Canguru19 folded before Flop (didn't bet)

Hand #92: 

PokerStars Hand #246222852505:  Hold'em No Limit ($0.01/$0.02 CAD) - 2023/09/27 23:59:30 ET
Table 'Alya III' 6-max Seat #3 is the button
Seat 1: HortonRoundtree ($0.79 in chips) 
Seat 3: CashMatteo ($1.95 in chips) 
Seat 4: bouchizzle ($3.39 in chips) 
Seat 5: ljab26 ($3.70 in chips) 
Seat 6: Canguru19 ($2.05 in chips) 
bouchizzle: posts small blind $0.01
ljab26: posts big blind $0.02
*** HOLE CARDS ***
Dealt to CashMatteo [Td 7s]
Canguru19: calls $0.02
HortonRoundtree: folds 
CashMatteo: calls $0.02
bouchizzle: folds 
ljab26: checks 
*** FLOP *** [7c 9c Th]
ljab26: checks 
Canguru19: checks 
CashMatteo: bets $0.04
ljab26: folds 
Canguru19: calls $0.04
*** TURN *** [7c 9c Th] [3c]
Canguru19: checks 
CashMatteo: bets $0.07
Canguru19: folds 
Uncalled bet ($0.07) returned to CashMatteo
CashMatteo collected $0.14 from pot
CashMatteo: doesn't show hand 
*** SUMMARY ***
Total pot $0.15 | Rake $0.01 
Board [7c 9c Th 3c]
Seat 1: HortonRoundtree folded before Flop (didn't bet)
Seat 3: CashMatteo (button) collected ($0.14)
Seat 4: bouchizzle (small blind) folded before Flop
Seat 5: ljab26 (big blind) folded on the Flop
Seat 6: Canguru19 folded on the Turn

Hand #93: 

PokerStars Hand #246222855401:  Hold'em No Limit ($0.01/$0.02 CAD) - 2023/09/27 23:59:58 ET
Table 'Alya III' 6-max Seat #4 is the button
Seat 1: HortonRoundtree ($0.79 in chips) 
Seat 3: CashMatteo ($2.03 in chips) 
Seat 4: bouchizzle ($3.38 in chips) 
Seat 5: ljab26 ($3.68 in chips) 
Seat 6: Canguru19 ($1.99 in chips) 
ljab26: posts small blind $0.01
Canguru19: posts big blind $0.02
*** HOLE CARDS ***
Dealt to CashMatteo [Jc 9d]
HortonRoundtree: calls $0.02
CashMatteo: raises $0.02 to $0.04
bouchizzle: calls $0.04
ljab26: calls $0.03
Canguru19: calls $0.02
HortonRoundtree: calls $0.02
*** FLOP *** [5c Qd 3d]
ljab26: checks 
Canguru19: checks 
HortonRoundtree: checks 
CashMatteo: checks 
bouchizzle: bets $0.14
ljab26: folds 
Canguru19: folds 
HortonRoundtree: folds 
CashMatteo: folds 
Uncalled bet ($0.14) returned to bouchizzle
bouchizzle collected $0.19 from pot
bouchizzle: doesn't show hand 
*** SUMMARY ***
Total pot $0.20 | Rake $0.01 
Board [5c Qd 3d]
Seat 1: HortonRoundtree folded on the Flop
Seat 3: CashMatteo folded on the Flop
Seat 4: bouchizzle (button) collected ($0.19)
Seat 5: ljab26 (small blind) folded on the Flop
Seat 6: Canguru19 (big blind) folded on the Flop

Hand #94: 

PokerStars Hand #246222859342:  Hold'em No Limit ($0.01/$0.02 CAD) - 2023/09/28 0:00:35 ET
Table 'Alya III' 6-max Seat #5 is the button
Seat 1: HortonRoundtree ($0.75 in chips) 
Seat 3: CashMatteo ($1.99 in chips) 
Seat 4: bouchizzle ($3.53 in chips) 
Seat 5: ljab26 ($3.64 in chips) 
Seat 6: Canguru19 ($1.95 in chips) 
Canguru19: posts small blind $0.01
HortonRoundtree: posts big blind $0.02
*** HOLE CARDS ***
Dealt to CashMatteo [Td 4d]
CashMatteo: calls $0.02
bouchizzle: folds 
ljab26: folds 
Canguru19: calls $0.01
HortonRoundtree: checks 
*** FLOP *** [2d 6d 9s]
Canguru19: checks 
HortonRoundtree: checks 
CashMatteo: bets $0.03
Canguru19: folds 
HortonRoundtree: calls $0.03
*** TURN *** [2d 6d 9s] [Js]
HortonRoundtree: checks 
CashMatteo: checks 
*** RIVER *** [2d 6d 9s Js] [7c]
HortonRoundtree: checks 
CashMatteo: checks 
*** SHOW DOWN ***
HortonRoundtree: shows [3d 5c] (high card Jack)
CashMatteo: shows [Td 4d] (high card Jack - Ten kicker)
CashMatteo collected $0.12 from pot
*** SUMMARY ***
Total pot $0.12 | Rake $0 
Board [2d 6d 9s Js 7c]
Seat 1: HortonRoundtree (big blind) showed [3d 5c] and lost with high card Jack
Seat 3: CashMatteo showed [Td 4d] and won ($0.12) with high card Jack
Seat 4: bouchizzle folded before Flop (didn't bet)
Seat 5: ljab26 (button) folded before Flop (didn't bet)
Seat 6: Canguru19 (small blind) folded on the Flop

Hand #95: 

PokerStars Hand #246222863234:  Hold'em No Limit ($0.01/$0.02 CAD) - 2023/09/28 0:01:09 ET
Table 'Alya III' 6-max Seat #6 is the button
Seat 1: HortonRoundtree ($0.70 in chips) 
Seat 3: CashMatteo ($2.06 in chips) 
Seat 4: bouchizzle ($3.53 in chips) 
Seat 5: ljab26 ($3.64 in chips) 
Seat 6: Canguru19 ($1.93 in chips) 
HortonRoundtree: posts small blind $0.01
CashMatteo: posts big blind $0.02
*** HOLE CARDS ***
Dealt to CashMatteo [5d Ac]
bouchizzle: folds 
ljab26: folds 
Canguru19: calls $0.02
HortonRoundtree: folds 
CashMatteo: checks 
*** FLOP *** [9s 4c 3d]
CashMatteo: checks 
Canguru19: checks 
*** TURN *** [9s 4c 3d] [Js]
CashMatteo: checks 
Canguru19: checks 
*** RIVER *** [9s 4c 3d Js] [Qd]
CashMatteo: checks 
Canguru19: checks 
*** SHOW DOWN ***
CashMatteo: shows [5d Ac] (high card Ace)
Canguru19: mucks hand 
CashMatteo collected $0.05 from pot
*** SUMMARY ***
Total pot $0.05 | Rake $0 
Board [9s 4c 3d Js Qd]
Seat 1: HortonRoundtree (small blind) folded before Flop
Seat 3: CashMatteo (big blind) showed [5d Ac] and won ($0.05) with high card Ace
Seat 4: bouchizzle folded before Flop (didn't bet)
Seat 5: ljab26 folded before Flop (didn't bet)
Seat 6: Canguru19 (button) mucked [5h 7c]

Hand #96: 

PokerStars Hand #246222866644:  Hold'em No Limit ($0.01/$0.02 CAD) - 2023/09/28 0:01:39 ET
Table 'Alya III' 6-max Seat #1 is the button
Seat 1: HortonRoundtree ($0.69 in chips) 
Seat 3: CashMatteo ($2.09 in chips) 
Seat 4: bouchizzle ($3.53 in chips) 
Seat 5: ljab26 ($3.64 in chips) 
Seat 6: Canguru19 ($1.91 in chips) 
CashMatteo: posts small blind $0.01
bouchizzle: posts big blind $0.02
*** HOLE CARDS ***
Dealt to CashMatteo [6h 7c]
ljab26: folds 
Canguru19: calls $0.02
HortonRoundtree: folds 
CashMatteo: calls $0.01
bouchizzle: checks 
*** FLOP *** [6d Tc 7d]
CashMatteo: bets $0.03
bouchizzle: folds 
Canguru19: folds 
Uncalled bet ($0.03) returned to CashMatteo
CashMatteo collected $0.06 from pot
CashMatteo: doesn't show hand 
*** SUMMARY ***
Total pot $0.06 | Rake $0 
Board [6d Tc 7d]
Seat 1: HortonRoundtree (button) folded before Flop (didn't bet)
Seat 3: CashMatteo (small blind) collected ($0.06)
Seat 4: bouchizzle (big blind) folded on the Flop
Seat 5: ljab26 folded before Flop (didn't bet)
Seat 6: Canguru19 folded on the Flop

Hand #97: 

PokerStars Hand #246222868932:  Hold'em No Limit ($0.01/$0.02 CAD) - 2023/09/28 0:01:58 ET
Table 'Alya III' 6-max Seat #3 is the button
Seat 1: HortonRoundtree ($0.69 in chips) 
Seat 3: CashMatteo ($2.13 in chips) 
Seat 4: bouchizzle ($3.51 in chips) 
Seat 5: ljab26 ($3.64 in chips) 
Seat 6: Canguru19 ($1.89 in chips) 
bouchizzle: posts small blind $0.01
ljab26: posts big blind $0.02
*** HOLE CARDS ***
Dealt to CashMatteo [Ac Qc]
Canguru19: folds 
HortonRoundtree: folds 
CashMatteo: raises $0.04 to $0.06
bouchizzle: folds 
ljab26: folds 
Uncalled bet ($0.04) returned to CashMatteo
CashMatteo collected $0.05 from pot
CashMatteo: doesn't show hand 
*** SUMMARY ***
Total pot $0.05 | Rake $0 
Seat 1: HortonRoundtree folded before Flop (didn't bet)
Seat 3: CashMatteo (button) collected ($0.05)
Seat 4: bouchizzle (small blind) folded before Flop
Seat 5: ljab26 (big blind) folded before Flop
Seat 6: Canguru19 folded before Flop (didn't bet)

Hand #98: 

PokerStars Hand #246222870530:  Hold'em No Limit ($0.01/$0.02 CAD) - 2023/09/28 0:02:12 ET
Table 'Alya III' 6-max Seat #4 is the button
Seat 1: HortonRoundtree ($0.69 in chips) 
Seat 3: CashMatteo ($2.16 in chips) 
Seat 4: bouchizzle ($3.50 in chips) 
Seat 5: ljab26 ($3.62 in chips) 
Seat 6: Canguru19 ($1.89 in chips) 
ljab26: posts small blind $0.01
Canguru19: posts big blind $0.02
*** HOLE CARDS ***
Dealt to CashMatteo [6s 9d]
Colbe777 joins the table at seat #2 
HortonRoundtree: calls $0.02
CashMatteo: raises $0.04 to $0.06
bouchizzle: folds 
ljab26: folds 
Canguru19: folds 
HortonRoundtree: calls $0.04
*** FLOP *** [Td Jh 8d]
HortonRoundtree: checks 
CashMatteo: bets $0.07
ljab26 leaves the table
HortonRoundtree: calls $0.07
*** TURN *** [Td Jh 8d] [Qd]
HortonRoundtree: checks 
CashMatteo: bets $0.14
HortonRoundtree: calls $0.14
*** RIVER *** [Td Jh 8d Qd] [8s]
HortonRoundtree: bets $0.42 and is all-in
CashMatteo: calls $0.42
*** SHOW DOWN ***
HortonRoundtree: shows [Qh As] (two pair, Queens and Eights)
CashMatteo: shows [6s 9d] (a straight, Eight to Queen)
CashMatteo collected $1.36 from pot
*** SUMMARY ***
Total pot $1.41 | Rake $0.05 
Board [Td Jh 8d Qd 8s]
Seat 1: HortonRoundtree showed [Qh As] and lost with two pair, Queens and Eights
Seat 3: CashMatteo showed [6s 9d] and won ($1.36) with a straight, Eight to Queen
Seat 4: bouchizzle (button) folded before Flop (didn't bet)
Seat 5: ljab26 (small blind) folded before Flop
Seat 6: Canguru19 (big blind) folded before Flop

Hand #99: 

PokerStars Hand #246222876748:  Hold'em No Limit ($0.01/$0.02 CAD) - 2023/09/28 0:03:05 ET
Table 'Alya III' 6-max Seat #6 is the button
Seat 3: CashMatteo ($2.83 in chips) 
Seat 4: bouchizzle ($3.50 in chips) 
Seat 6: Canguru19 ($1.87 in chips) 
CashMatteo: posts small blind $0.01
bouchizzle: posts big blind $0.02
*** HOLE CARDS ***
Dealt to CashMatteo [Ac Ah]
Canguru19: folds 
CashMatteo: raises $0.04 to $0.06
bouchizzle: calls $0.04
*** FLOP *** [5d 5s 9s]
CashMatteo: checks 
bouchizzle: bets $0.07
CashMatteo: calls $0.07
*** TURN *** [5d 5s 9s] [7d]
CashMatteo: checks 
HortonRoundtree leaves the table
bouchizzle: checks 
*** RIVER *** [5d 5s 9s 7d] [2c]
CashMatteo: bets $0.13
bouchizzle: folds 
Uncalled bet ($0.13) returned to CashMatteo
CashMatteo collected $0.25 from pot
CashMatteo: doesn't show hand 
*** SUMMARY ***
Total pot $0.26 | Rake $0.01 
Board [5d 5s 9s 7d 2c]
Seat 3: CashMatteo (small blind) collected ($0.25)
Seat 4: bouchizzle (big blind) folded on the River
Seat 6: Canguru19 (button) folded before Flop (didn't bet)

Hand #100: 

PokerStars Hand #246222880903:  Hold'em No Limit ($0.01/$0.02 CAD) - 2023/09/28 0:03:40 ET
Table 'Alya III' 6-max Seat #3 is the button
Seat 3: CashMatteo ($2.95 in chips) 
Seat 4: bouchizzle ($3.37 in chips) 
Seat 6: Canguru19 ($1.87 in chips) 
bouchizzle: posts small blind $0.01
Canguru19: posts big blind $0.02
Colbe777: sits out 
*** HOLE CARDS ***
Dealt to CashMatteo [Jc 7c]
CashMatteo: raises $0.04 to $0.06
bouchizzle: raises $0.16 to $0.22
Canguru19: folds 
CashMatteo: folds 
Uncalled bet ($0.16) returned to bouchizzle
bouchizzle collected $0.14 from pot
bouchizzle: doesn't show hand 
*** SUMMARY ***
Total pot $0.14 | Rake $0 
Seat 3: CashMatteo (button) folded before Flop
Seat 4: bouchizzle (small blind) collected ($0.14)
Seat 6: Canguru19 (big blind) folded before Flop

Hand #101: 

PokerStars Hand #246222882963:  Hold'em No Limit ($0.01/$0.02 CAD) - 2023/09/28 0:03:58 ET
Table 'Alya III' 6-max Seat #4 is the button
Seat 2: Colbe777 ($0.80 in chips) 
Seat 3: CashMatteo ($2.89 in chips) 
Seat 4: bouchizzle ($3.45 in chips) 
Seat 6: Canguru19 ($1.85 in chips) 
Canguru19: posts small blind $0.01
Colbe777: posts big blind $0.02
*** HOLE CARDS ***
Dealt to CashMatteo [4s Jc]
CashMatteo: folds 
bouchizzle: folds 
Canguru19: calls $0.01
Colbe777: checks 
*** FLOP *** [Ah Qc 7c]
Canguru19: bets $0.04
Colbe777: calls $0.04
*** TURN *** [Ah Qc 7c] [2h]
Canguru19: bets $0.12
Colbe777: folds 
Uncalled bet ($0.12) returned to Canguru19
Canguru19 collected $0.12 from pot
Canguru19: doesn't show hand 
*** SUMMARY ***
Total pot $0.12 | Rake $0 
Board [Ah Qc 7c 2h]
Seat 2: Colbe777 (big blind) folded on the Turn
Seat 3: CashMatteo folded before Flop (didn't bet)
Seat 4: bouchizzle (button) folded before Flop (didn't bet)
Seat 6: Canguru19 (small blind) collected ($0.12)

Hand #102: 

PokerStars Hand #246222886460:  Hold'em No Limit ($0.01/$0.02 CAD) - 2023/09/28 0:04:27 ET
Table 'Alya III' 6-max Seat #6 is the button
Seat 2: Colbe777 ($0.74 in chips) 
Seat 3: CashMatteo ($2.89 in chips) 
Seat 4: bouchizzle ($3.45 in chips) 
Seat 6: Canguru19 ($1.91 in chips) 
Colbe777: posts small blind $0.01
CashMatteo: posts big blind $0.02
*** HOLE CARDS ***
Dealt to CashMatteo [9s 4h]
bouchizzle: folds 
Canguru19: folds 
Colbe777: folds 
Uncalled bet ($0.01) returned to CashMatteo
CashMatteo collected $0.02 from pot
CashMatteo: doesn't show hand 
*** SUMMARY ***
Total pot $0.02 | Rake $0 
Seat 2: Colbe777 (small blind) folded before Flop
Seat 3: CashMatteo (big blind) collected ($0.02)
Seat 4: bouchizzle folded before Flop (didn't bet)
Seat 6: Canguru19 (button) folded before Flop (didn't bet)

Hand #103: 

PokerStars Hand #246222887509:  Hold'em No Limit ($0.01/$0.02 CAD) - 2023/09/28 0:04:36 ET
Table 'Alya III' 6-max Seat #2 is the button
Seat 2: Colbe777 ($0.73 in chips) 
Seat 3: CashMatteo ($2.90 in chips) 
Seat 6: Canguru19 ($1.91 in chips) 
CashMatteo: posts small blind $0.01
bouchizzle: is sitting out 
Canguru19: posts big blind $0.02
*** HOLE CARDS ***
Dealt to CashMatteo [5d 2d]
Colbe777: calls $0.02
CashMatteo: folds 
Canguru19: checks 
*** FLOP *** [9s 2s Kh]
Canguru19: checks 
Colbe777: checks 
*** TURN *** [9s 2s Kh] [3h]
bouchizzle leaves the table
Canguru19: bets $0.02
deacrdeacr joins the table at seat #4 
Colbe777: folds 
Uncalled bet ($0.02) returned to Canguru19
Canguru19 collected $0.05 from pot
Canguru19: doesn't show hand 
*** SUMMARY ***
Total pot $0.05 | Rake $0 
Board [9s 2s Kh 3h]
Seat 2: Colbe777 (button) folded on the Turn
Seat 3: CashMatteo (small blind) folded before Flop
Seat 6: Canguru19 (big blind) collected ($0.05)

Hand #104: 

PokerStars Hand #246222890663:  Hold'em No Limit ($0.01/$0.02 CAD) - 2023/09/28 0:05:02 ET
Table 'Alya III' 6-max Seat #3 is the button
Seat 2: Colbe777 ($0.71 in chips) 
Seat 3: CashMatteo ($2.89 in chips) 
Seat 6: Canguru19 ($1.94 in chips) 
deacrdeacr will be allowed to play after the button
Canguru19: posts small blind $0.01
Colbe777: posts big blind $0.02
*** HOLE CARDS ***
Dealt to CashMatteo [5h Ac]
CashMatteo: raises $0.04 to $0.06
Canguru19: folds 
Colbe777: calls $0.04
*** FLOP *** [Qs Qc 6d]
Colbe777: bets $0.02
CashMatteo: calls $0.02
*** TURN *** [Qs Qc 6d] [As]
Colbe777: checks 
CashMatteo: checks 
*** RIVER *** [Qs Qc 6d As] [8c]
Colbe777: bets $0.04
CashMatteo: calls $0.04
*** SHOW DOWN ***
Colbe777: shows [8s 8d] (a full house, Eights full of Queens)
CashMatteo: mucks hand 
Colbe777 collected $0.24 from pot
*** SUMMARY ***
Total pot $0.25 | Rake $0.01 
Board [Qs Qc 6d As 8c]
Seat 2: Colbe777 (big blind) showed [8s 8d] and won ($0.24) with a full house, Eights full of Queens
Seat 3: CashMatteo (button) mucked [5h Ac]
Seat 6: Canguru19 (small blind) folded before Flop

Hand #105: 

PokerStars Hand #246222895863:  Hold'em No Limit ($0.01/$0.02 CAD) - 2023/09/28 0:05:46 ET
Table 'Alya III' 6-max Seat #6 is the button
Seat 2: Colbe777 ($0.83 in chips) 
Seat 3: CashMatteo ($2.77 in chips) 
Seat 4: deacrdeacr ($1.60 in chips) 
Seat 6: Canguru19 ($1.93 in chips) 
Colbe777: posts small blind $0.01
CashMatteo: posts big blind $0.02
deacrdeacr: posts big blind $0.02
*** HOLE CARDS ***
Dealt to CashMatteo [3s 5h]
deacrdeacr: checks 
Canguru19: folds 
Colbe777: folds 
CashMatteo: checks 
*** FLOP *** [9h 6c As]
CashMatteo: checks 
deacrdeacr: checks 
*** TURN *** [9h 6c As] [8c]
CashMatteo: checks 
deacrdeacr: checks 
*** RIVER *** [9h 6c As 8c] [4d]
dbetts55 joins the table at seat #5 
CashMatteo: checks 
deacrdeacr: checks 
*** SHOW DOWN ***
CashMatteo: shows [3s 5h] (high card Ace)
deacrdeacr: shows [8d 2d] (a pair of Eights)
deacrdeacr collected $0.05 from pot
*** SUMMARY ***
Total pot $0.05 | Rake $0 
Board [9h 6c As 8c 4d]
Seat 2: Colbe777 (small blind) folded before Flop
Seat 3: CashMatteo (big blind) showed [3s 5h] and lost with high card Ace
Seat 4: deacrdeacr showed [8d 2d] and won ($0.05) with a pair of Eights
Seat 6: Canguru19 (button) folded before Flop (didn't bet)

Hand #106: 

PokerStars Hand #246222898774:  Hold'em No Limit ($0.01/$0.02 CAD) - 2023/09/28 0:06:11 ET
Table 'Alya III' 6-max Seat #2 is the button
Seat 2: Colbe777 ($0.82 in chips) 
Seat 3: CashMatteo ($2.75 in chips) 
Seat 4: deacrdeacr ($1.63 in chips) 
Seat 6: Canguru19 ($1.93 in chips) 
CashMatteo: posts small blind $0.01
deacrdeacr: posts big blind $0.02
dbetts55: sits out 
*** HOLE CARDS ***
Dealt to CashMatteo [4h 5h]
Canguru19: folds 
Colbe777: folds 
CashMatteo: calls $0.01
deacrdeacr: checks 
*** FLOP *** [Qs 5c 8c]
CashMatteo: bets $0.02
deacrdeacr: folds 
Uncalled bet ($0.02) returned to CashMatteo
CashMatteo collected $0.04 from pot
CashMatteo: doesn't show hand 
*** SUMMARY ***
Total pot $0.04 | Rake $0 
Board [Qs 5c 8c]
Seat 2: Colbe777 (button) folded before Flop (didn't bet)
Seat 3: CashMatteo (small blind) collected ($0.04)
Seat 4: deacrdeacr (big blind) folded on the Flop
Seat 6: Canguru19 folded before Flop (didn't bet)

Hand #107: 

PokerStars Hand #246222901145:  Hold'em No Limit ($0.01/$0.02 CAD) - 2023/09/28 0:06:30 ET
Table 'Alya III' 6-max Seat #3 is the button
Seat 2: Colbe777 ($0.82 in chips) 
Seat 3: CashMatteo ($2.77 in chips) 
Seat 4: deacrdeacr ($1.61 in chips) 
Seat 5: dbetts55 ($0.84 in chips) 
Seat 6: Canguru19 ($1.93 in chips) 
deacrdeacr: posts small blind $0.01
dbetts55: posts big blind $0.02
*** HOLE CARDS ***
Dealt to CashMatteo [Jh Th]
Canguru19: folds 
Colbe777: raises $0.02 to $0.04
CashMatteo: calls $0.04
deacrdeacr: folds 
dbetts55: folds 
*** FLOP *** [Kd 7c Tc]
Colbe777: checks 
CashMatteo: checks 
*** TURN *** [Kd 7c Tc] [6c]
Colbe777: checks 
CashMatteo: bets $0.06
Colbe777: calls $0.06
*** RIVER *** [Kd 7c Tc 6c] [9h]
Colbe777: checks 
CashMatteo: checks 
*** SHOW DOWN ***
Colbe777: shows [Jd Jc] (a pair of Jacks)
CashMatteo: mucks hand 
Colbe777 collected $0.22 from pot
deacrdeacr leaves the table
*** SUMMARY ***
Total pot $0.23 | Rake $0.01 
Board [Kd 7c Tc 6c 9h]
Seat 2: Colbe777 showed [Jd Jc] and won ($0.22) with a pair of Jacks
Seat 3: CashMatteo (button) mucked [Jh Th]
Seat 4: deacrdeacr (small blind) folded before Flop
Seat 5: dbetts55 (big blind) folded before Flop
Seat 6: Canguru19 folded before Flop (didn't bet)

Hand #108: 

PokerStars Hand #246222906574:  Hold'em No Limit ($0.01/$0.02 CAD) - 2023/09/28 0:07:16 ET
Table 'Alya III' 6-max Seat #5 is the button
Seat 2: Colbe777 ($0.94 in chips) 
Seat 3: CashMatteo ($2.67 in chips) 
Seat 5: dbetts55 ($0.82 in chips) 
Seat 6: Canguru19 ($1.93 in chips) 
Canguru19: posts small blind $0.01
Colbe777: posts big blind $0.02
*** HOLE CARDS ***
Dealt to CashMatteo [8d Jd]
CashMatteo: calls $0.02
dbetts55: calls $0.02
Canguru19: calls $0.01
Colbe777: checks 
*** FLOP *** [5h Ks 5c]
Canguru19: checks 
Colbe777: checks 
CashMatteo: checks 
dbetts55: checks 
*** TURN *** [5h Ks 5c] [7s]
Canguru19: checks 
Colbe777: checks 
CashMatteo: checks 
dbetts55: checks 
*** RIVER *** [5h Ks 5c 7s] [Js]
Canguru19: checks 
Colbe777: checks 
CashMatteo: checks 
dbetts55: checks 
*** SHOW DOWN ***
Canguru19: shows [As Td] (a pair of Fives)
Colbe777: shows [7h Qc] (two pair, Sevens and Fives)
CashMatteo: shows [8d Jd] (two pair, Jacks and Fives)
dbetts55: mucks hand 
CashMatteo collected $0.08 from pot
*** SUMMARY ***
Total pot $0.08 | Rake $0 
Board [5h Ks 5c 7s Js]
Seat 2: Colbe777 (big blind) showed [7h Qc] and lost with two pair, Sevens and Fives
Seat 3: CashMatteo showed [8d Jd] and won ($0.08) with two pair, Jacks and Fives
Seat 5: dbetts55 (button) mucked [Ts Qd]
Seat 6: Canguru19 (small blind) showed [As Td] and lost with a pair of Fives

Hand #109: 

PokerStars Hand #246222912574:  Hold'em No Limit ($0.01/$0.02 CAD) - 2023/09/28 0:08:06 ET
Table 'Alya III' 6-max Seat #6 is the button
Seat 2: Colbe777 ($0.92 in chips) 
Seat 3: CashMatteo ($2.73 in chips) 
Seat 5: dbetts55 ($0.80 in chips) 
Seat 6: Canguru19 ($1.91 in chips) 
Colbe777: posts small blind $0.01
CashMatteo: posts big blind $0.02
*** HOLE CARDS ***
Dealt to CashMatteo [9h 2h]
dbetts55: calls $0.02
Canguru19: folds 
Colbe777: calls $0.01
CashMatteo: checks 
*** FLOP *** [8s Qc 5d]
Colbe777: bets $0.02
CashMatteo: folds 
dbetts55: folds 
Uncalled bet ($0.02) returned to Colbe777
Colbe777 collected $0.06 from pot
*** SUMMARY ***
Total pot $0.06 | Rake $0 
Board [8s Qc 5d]
Seat 2: Colbe777 (small blind) collected ($0.06)
Seat 3: CashMatteo (big blind) folded on the Flop
Seat 5: dbetts55 folded on the Flop
Seat 6: Canguru19 (button) folded before Flop (didn't bet)

Hand #110: 

PokerStars Hand #246222916053:  Hold'em No Limit ($0.01/$0.02 CAD) - 2023/09/28 0:08:35 ET
Table 'Alya III' 6-max Seat #2 is the button
Seat 2: Colbe777 ($0.96 in chips) 
Seat 3: CashMatteo ($2.71 in chips) 
Seat 5: dbetts55 ($0.78 in chips) 
Seat 6: Canguru19 ($1.91 in chips) 
CashMatteo: posts small blind $0.01
dbetts55: posts big blind $0.02
*** HOLE CARDS ***
Dealt to CashMatteo [3c 5d]
Canguru19: folds 
Colbe777: folds 
CashMatteo: folds 
Uncalled bet ($0.01) returned to dbetts55
dbetts55 collected $0.02 from pot
*** SUMMARY ***
Total pot $0.02 | Rake $0 
Seat 2: Colbe777 (button) folded before Flop (didn't bet)
Seat 3: CashMatteo (small blind) folded before Flop
Seat 5: dbetts55 (big blind) collected ($0.02)
Seat 6: Canguru19 folded before Flop (didn't bet)

Hand #111: 

PokerStars Hand #246222918876:  Hold'em No Limit ($0.01/$0.02 CAD) - 2023/09/28 0:08:59 ET
Table 'Alya III' 6-max Seat #3 is the button
Seat 2: Colbe777 ($0.96 in chips) 
Seat 3: CashMatteo ($2.70 in chips) 
Seat 5: dbetts55 ($0.79 in chips) 
Seat 6: Canguru19 ($1.91 in chips) 
dbetts55: posts small blind $0.01
Canguru19: posts big blind $0.02
*** HOLE CARDS ***
Dealt to CashMatteo [Th Ac]
Colbe777: folds 
CashMatteo: raises $0.04 to $0.06
dbetts55: calls $0.05
Canguru19: folds 
*** FLOP *** [9c 5h 2d]
dbetts55: checks 
CashMatteo: checks 
*** TURN *** [9c 5h 2d] [7s]
dbetts55: checks 
CashMatteo: checks 
*** RIVER *** [9c 5h 2d 7s] [Kh]
dbetts55: checks 
CashMatteo: checks 
*** SHOW DOWN ***
dbetts55: shows [2s Jd] (a pair of Deuces)
CashMatteo: mucks hand 
dbetts55 collected $0.14 from pot
*** SUMMARY ***
Total pot $0.14 | Rake $0 
Board [9c 5h 2d 7s Kh]
Seat 2: Colbe777 folded before Flop (didn't bet)
Seat 3: CashMatteo (button) mucked [Th Ac]
Seat 5: dbetts55 (small blind) showed [2s Jd] and won ($0.14) with a pair of Deuces
Seat 6: Canguru19 (big blind) folded before Flop

Hand #112: 

PokerStars Hand #246222924898:  Hold'em No Limit ($0.01/$0.02 CAD) - 2023/09/28 0:09:50 ET
Table 'Alya III' 6-max Seat #5 is the button
Seat 2: Colbe777 ($0.96 in chips) 
Seat 3: CashMatteo ($2.64 in chips) 
Seat 5: dbetts55 ($0.87 in chips) 
Seat 6: Canguru19 ($1.89 in chips) 
Canguru19: posts small blind $0.01
Colbe777: posts big blind $0.02
*** HOLE CARDS ***
Dealt to CashMatteo [5c 4h]
rich1717 joins the table at seat #1 
CashMatteo: folds 
dbetts55: calls $0.02
Canguru19: folds 
rich1717 leaves the table
Colbe777: checks 
*** FLOP *** [7c 5d 6s]
Colbe777: bets $0.02
dbetts55: folds 
Uncalled bet ($0.02) returned to Colbe777
Colbe777 collected $0.05 from pot
rich1717 joins the table at seat #4 
*** SUMMARY ***
Total pot $0.05 | Rake $0 
Board [7c 5d 6s]
Seat 2: Colbe777 (big blind) collected ($0.05)
Seat 3: CashMatteo folded before Flop (didn't bet)
Seat 5: dbetts55 (button) folded on the Flop
Seat 6: Canguru19 (small blind) folded before Flop

Hand #113: 

PokerStars Hand #246222928954:  Hold'em No Limit ($0.01/$0.02 CAD) - 2023/09/28 0:10:24 ET
Table 'Alya III' 6-max Seat #6 is the button
Seat 2: Colbe777 ($0.99 in chips) 
Seat 3: CashMatteo ($2.64 in chips) 
Seat 5: dbetts55 ($0.85 in chips) 
Seat 6: Canguru19 ($1.88 in chips) 
Colbe777: posts small blind $0.01
CashMatteo: posts big blind $0.02
rich1717: sits out 
*** HOLE CARDS ***
Dealt to CashMatteo [As Ac]
dbetts55: calls $0.02
Canguru19: calls $0.02
Colbe777: calls $0.01
CashMatteo: raises $0.04 to $0.06
dbetts55: calls $0.04
Canguru19: calls $0.04
Colbe777: calls $0.04
*** FLOP *** [Td Jh 4h]
Colbe777: checks 
CashMatteo: bets $0.12
dbetts55: folds 
Canguru19: folds 
Colbe777: folds 
Uncalled bet ($0.12) returned to CashMatteo
CashMatteo collected $0.23 from pot
CashMatteo: doesn't show hand 
*** SUMMARY ***
Total pot $0.24 | Rake $0.01 
Board [Td Jh 4h]
Seat 2: Colbe777 (small blind) folded on the Flop
Seat 3: CashMatteo (big blind) collected ($0.23)
Seat 5: dbetts55 folded on the Flop
Seat 6: Canguru19 (button) folded on the Flop

Hand #114: 

PokerStars Hand #246222933758:  Hold'em No Limit ($0.01/$0.02 CAD) - 2023/09/28 0:11:05 ET
Table 'Alya III' 6-max Seat #2 is the button
Seat 2: Colbe777 ($0.93 in chips) 
Seat 3: CashMatteo ($2.81 in chips) 
Seat 4: rich1717 ($1.60 in chips) 
Seat 5: dbetts55 ($0.79 in chips) 
Seat 6: Canguru19 ($1.82 in chips) 
CashMatteo: posts small blind $0.01
rich1717: posts big blind $0.02
*** HOLE CARDS ***
Dealt to CashMatteo [Ac 8h]
dbetts55: calls $0.02
Canguru19: folds 
Colbe777: calls $0.02
CashMatteo: calls $0.01
rich1717: checks 
*** FLOP *** [6c 7d Qc]
CashMatteo: checks 
rich1717: checks 
dbetts55: checks 
Colbe777: checks 
*** TURN *** [6c 7d Qc] [Ts]
CashMatteo: checks 
rich1717: checks 
dbetts55: checks 
Colbe777: checks 
*** RIVER *** [6c 7d Qc Ts] [Kh]
CashMatteo: checks 
rich1717: checks 
dbetts55: checks 
Colbe777: checks 
*** SHOW DOWN ***
CashMatteo: shows [Ac 8h] (high card Ace)
rich1717: shows [Kd 2s] (a pair of Kings)
dbetts55: mucks hand 
Colbe777: shows [Td 6d] (two pair, Tens and Sixes)
Colbe777 collected $0.08 from pot
*** SUMMARY ***
Total pot $0.08 | Rake $0 
Board [6c 7d Qc Ts Kh]
Seat 2: Colbe777 (button) showed [Td 6d] and won ($0.08) with two pair, Tens and Sixes
Seat 3: CashMatteo (small blind) showed [Ac 8h] and lost with high card Ace
Seat 4: rich1717 (big blind) showed [Kd 2s] and lost with a pair of Kings
Seat 5: dbetts55 mucked [As 2c]
Seat 6: Canguru19 folded before Flop (didn't bet)

Hand #115: 

PokerStars Hand #246222940874:  Hold'em No Limit ($0.01/$0.02 CAD) - 2023/09/28 0:12:07 ET
Table 'Alya III' 6-max Seat #3 is the button
Seat 2: Colbe777 ($0.99 in chips) 
Seat 3: CashMatteo ($2.79 in chips) 
Seat 4: rich1717 ($1.58 in chips) 
Seat 5: dbetts55 ($0.77 in chips) 
Seat 6: Canguru19 ($1.82 in chips) 
rich1717: posts small blind $0.01
dbetts55: posts big blind $0.02
*** HOLE CARDS ***
Dealt to CashMatteo [2c Ks]
Canguru19: calls $0.02
Colbe777: calls $0.02
CashMatteo: calls $0.02
rich1717: raises $0.04 to $0.06
dbetts55: calls $0.04
Canguru19: folds 
Colbe777: calls $0.04
CashMatteo: folds 
*** FLOP *** [7c 3h 7h]
Canguru19 leaves the table
rich1717: bets $0.06
dbetts55: calls $0.06
Colbe777: calls $0.06
*** TURN *** [7c 3h 7h] [3c]
rich1717: checks 
dbetts55: checks 
Colbe777: checks 
*** RIVER *** [7c 3h 7h 3c] [4h]
rich1717: checks 
dbetts55: checks 
Colbe777: checks 
*** SHOW DOWN ***
rich1717: shows [Ah Ac] (two pair, Aces and Sevens)
dbetts55: shows [Qd 7s] (a full house, Sevens full of Threes)
Colbe777: mucks hand 
dbetts55 collected $0.39 from pot
*** SUMMARY ***
Total pot $0.40 | Rake $0.01 
Board [7c 3h 7h 3c 4h]
Seat 2: Colbe777 mucked [8s 8d]
Seat 3: CashMatteo (button) folded before Flop
Seat 4: rich1717 (small blind) showed [Ah Ac] and lost with two pair, Aces and Sevens
Seat 5: dbetts55 (big blind) showed [Qd 7s] and won ($0.39) with a full house, Sevens full of Threes
Seat 6: Canguru19 folded before Flop

Hand #116: 

PokerStars Hand #246222951358:  Hold'em No Limit ($0.01/$0.02 CAD) - 2023/09/28 0:13:38 ET
Table 'Alya III' 6-max Seat #4 is the button
Seat 2: Colbe777 ($0.87 in chips) 
Seat 3: CashMatteo ($2.77 in chips) 
Seat 4: rich1717 ($1.46 in chips) 
Seat 5: dbetts55 ($1.04 in chips) 
dbetts55: posts small blind $0.01
Colbe777: posts big blind $0.02
*** HOLE CARDS ***
Dealt to CashMatteo [Kc 3d]
CashMatteo: calls $0.02
rich1717: folds 
dbetts55: calls $0.01
Colbe777: checks 
*** FLOP *** [Tc Ac 7d]
dbetts55: checks 
Colbe777: checks 
CashMatteo: checks 
*** TURN *** [Tc Ac 7d] [7h]
dbetts55: checks 
Colbe777: checks 
CashMatteo: checks 
*** RIVER *** [Tc Ac 7d 7h] [5h]
dbetts55: checks 
Colbe777: checks 
CashMatteo: checks 
*** SHOW DOWN ***
dbetts55: shows [Jh Th] (two pair, Tens and Sevens)
Colbe777: shows [9d Ts] (two pair, Tens and Sevens)
CashMatteo: mucks hand 
dbetts55 collected $0.03 from pot
Colbe777 collected $0.03 from pot
*** SUMMARY ***
Total pot $0.06 | Rake $0 
Board [Tc Ac 7d 7h 5h]
Seat 2: Colbe777 (big blind) showed [9d Ts] and won ($0.03) with two pair, Tens and Sevens
Seat 3: CashMatteo mucked [Kc 3d]
Seat 4: rich1717 (button) folded before Flop (didn't bet)
Seat 5: dbetts55 (small blind) showed [Jh Th] and won ($0.03) with two pair, Tens and Sevens

Hand #117: 

PokerStars Hand #246222955614:  Hold'em No Limit ($0.01/$0.02 CAD) - 2023/09/28 0:14:14 ET
Table 'Alya III' 6-max Seat #5 is the button
Seat 2: Colbe777 ($0.88 in chips) 
Seat 3: CashMatteo ($2.75 in chips) 
Seat 4: rich1717 ($1.46 in chips) 
Seat 5: dbetts55 ($1.05 in chips) 
Colbe777: posts small blind $0.01
CashMatteo: posts big blind $0.02
*** HOLE CARDS ***
Dealt to CashMatteo [7c 2c]
rich1717: folds 
dbetts55: calls $0.02
Colbe777: calls $0.01
CashMatteo: checks 
*** FLOP *** [9s Td Qh]
Colbe777: checks 
CashMatteo: checks 
dbetts55: bets $0.14
Colbe777: calls $0.14
CashMatteo: folds 
*** TURN *** [9s Td Qh] [Kc]
Colbe777: checks 
dbetts55: bets $0.10
Colbe777: calls $0.10
*** RIVER *** [9s Td Qh Kc] [Js]
Colbe777: checks 
dbetts55: bets $0.12
Colbe777: folds 
Uncalled bet ($0.12) returned to dbetts55
dbetts55 collected $0.52 from pot
*** SUMMARY ***
Total pot $0.54 | Rake $0.02 
Board [9s Td Qh Kc Js]
Seat 2: Colbe777 (small blind) folded on the River
Seat 3: CashMatteo (big blind) folded on the Flop
Seat 4: rich1717 folded before Flop (didn't bet)
Seat 5: dbetts55 (button) collected ($0.52)

Hand #118: 

PokerStars Hand #246222962341:  Hold'em No Limit ($0.01/$0.02 CAD) - 2023/09/28 0:15:13 ET
Table 'Alya III' 6-max Seat #2 is the button
Seat 2: Colbe777 ($0.62 in chips) 
Seat 3: CashMatteo ($2.73 in chips) 
Seat 4: rich1717 ($1.46 in chips) 
Seat 5: dbetts55 ($1.31 in chips) 
CashMatteo: posts small blind $0.01
rich1717: posts big blind $0.02
*** HOLE CARDS ***
Dealt to CashMatteo [2h Jc]
dbetts55: calls $0.02
Colbe777: calls $0.02
CashMatteo: calls $0.01
bibuman joins the table at seat #1 
rich1717: checks 
*** FLOP *** [4c Ah Ad]
CashMatteo: checks 
rich1717: checks 
dbetts55: checks 
Colbe777: checks 
*** TURN *** [4c Ah Ad] [5s]
CashMatteo: checks 
rich1717: checks 
dbetts55: checks 
Colbe777: bets $0.02
CashMatteo: folds 
rich1717: folds 
dbetts55: folds 
Uncalled bet ($0.02) returned to Colbe777
Colbe777 collected $0.08 from pot
*** SUMMARY ***
Total pot $0.08 | Rake $0 
Board [4c Ah Ad 5s]
Seat 2: Colbe777 (button) collected ($0.08)
Seat 3: CashMatteo (small blind) folded on the Turn
Seat 4: rich1717 (big blind) folded on the Turn
Seat 5: dbetts55 folded on the Turn

Hand #119: 

PokerStars Hand #246222969494:  Hold'em No Limit ($0.01/$0.02 CAD) - 2023/09/28 0:16:15 ET
Table 'Alya III' 6-max Seat #3 is the button
Seat 2: Colbe777 ($0.68 in chips) 
Seat 3: CashMatteo ($2.71 in chips) 
Seat 4: rich1717 ($1.44 in chips) 
Seat 5: dbetts55 ($1.29 in chips) 
rich1717: posts small blind $0.01
dbetts55: posts big blind $0.02
bibuman: sits out 
*** HOLE CARDS ***
Dealt to CashMatteo [Ac 9c]
Colbe777: folds 
CashMatteo: raises $0.04 to $0.06
rich1717: folds 
dbetts55: folds 
Uncalled bet ($0.04) returned to CashMatteo
CashMatteo collected $0.05 from pot
CashMatteo: doesn't show hand 
*** SUMMARY ***
Total pot $0.05 | Rake $0 
Seat 2: Colbe777 folded before Flop (didn't bet)
Seat 3: CashMatteo (button) collected ($0.05)
Seat 4: rich1717 (small blind) folded before Flop
Seat 5: dbetts55 (big blind) folded before Flop

Hand #120: 

PokerStars Hand #246222973112:  Hold'em No Limit ($0.01/$0.02 CAD) - 2023/09/28 0:16:47 ET
Table 'Alya III' 6-max Seat #4 is the button
Seat 1: bibuman ($0.80 in chips) 
Seat 2: Colbe777 ($0.68 in chips) 
Seat 3: CashMatteo ($2.74 in chips) 
Seat 4: rich1717 ($1.43 in chips) 
Seat 5: dbetts55 ($1.27 in chips) 
dbetts55: posts small blind $0.01
bibuman: posts big blind $0.02
*** HOLE CARDS ***
Dealt to CashMatteo [5h 3c]
Colbe777: calls $0.02
CashMatteo: folds 
rich1717: folds 
dbetts55: calls $0.01
jbarber74 joins the table at seat #6 
bibuman: checks 
*** FLOP *** [6d 4c Ks]
dbetts55: checks 
bibuman: checks 
Colbe777: checks 
*** TURN *** [6d 4c Ks] [As]
dbetts55: bets $0.02
bibuman: calls $0.02
Colbe777: folds 
*** RIVER *** [6d 4c Ks As] [Kh]
dbetts55: checks 
bibuman: checks 
*** SHOW DOWN ***
dbetts55: shows [Kc Qd] (three of a kind, Kings)
bibuman: mucks hand 
dbetts55 collected $0.10 from pot
*** SUMMARY ***
Total pot $0.10 | Rake $0 
Board [6d 4c Ks As Kh]
Seat 1: bibuman (big blind) mucked [Td Js]
Seat 2: Colbe777 folded on the Turn
Seat 3: CashMatteo folded before Flop (didn't bet)
Seat 4: rich1717 (button) folded before Flop (didn't bet)
Seat 5: dbetts55 (small blind) showed [Kc Qd] and won ($0.10) with three of a kind, Kings

Hand #121: 

PokerStars Hand #246222981218:  Hold'em No Limit ($0.01/$0.02 CAD) - 2023/09/28 0:17:56 ET
Table 'Alya III' 6-max Seat #5 is the button
Seat 1: bibuman ($0.76 in chips) 
Seat 2: Colbe777 ($0.66 in chips) 
Seat 3: CashMatteo ($2.74 in chips) 
Seat 4: rich1717 ($1.43 in chips) 
Seat 5: dbetts55 ($1.33 in chips) 
jbarber74 will be allowed to play after the button
bibuman: posts small blind $0.01
Colbe777: posts big blind $0.02
*** HOLE CARDS ***
Dealt to CashMatteo [5c 4h]
CashMatteo: folds 
rich1717: folds 
dbetts55: folds 
CashMatteo leaves the table
bibuman: calls $0.01
Colbe777: checks 
*** FLOP *** [Ts 4d 2d]
bibuman: checks 
Colbe777: checks 
*** TURN *** [Ts 4d 2d] [8d]
bibuman: bets $0.02
Colbe777: calls $0.02
*** RIVER *** [Ts 4d 2d 8d] [Ac]
bibuman: checks 
Colbe777: checks 
*** SHOW DOWN ***
bibuman: shows [Js 9s] (high card Ace)
Colbe777: shows [Kh 8s] (a pair of Eights)
Colbe777 collected $0.08 from pot
*** SUMMARY ***
Total pot $0.08 | Rake $0 
Board [Ts 4d 2d 8d Ac]
Seat 1: bibuman (small blind) showed [Js 9s] and lost with high card Ace
Seat 2: Colbe777 (big blind) showed [Kh 8s] and won ($0.08) with a pair of Eights
Seat 3: CashMatteo folded before Flop (didn't bet)
Seat 4: rich1717 folded before Flop (didn't bet)
Seat 5: dbetts55 (button) folded before Flop (didn't bet)

Hand #122: 

PokerStars Hand #246223025315: Tournament #3651032131, $0.23+$0.02 CAD Hold'em No Limit - Level I (10/20) - 2023/09/28 0:24:21 ET
Table '3651032131 1' 3-max Seat #1 is the button
Seat 1: smiley sandy (500 in chips) 
Seat 2: CashMatteo (500 in chips) 
Seat 3: raybinz (500 in chips) 
CashMatteo: posts small blind 10
raybinz: posts big blind 20
*** HOLE CARDS ***
Dealt to CashMatteo [Ts Qc]
smiley sandy: calls 20
CashMatteo: raises 40 to 60
raybinz: calls 40
smiley sandy: calls 40
*** FLOP *** [9s 3h 3s]
CashMatteo: checks 
raybinz: checks 
smiley sandy: checks 
*** TURN *** [9s 3h 3s] [Jd]
CashMatteo: checks 
raybinz: bets 90
smiley sandy: folds 
CashMatteo: folds 
Uncalled bet (90) returned to raybinz
raybinz collected 180 from pot
*** SUMMARY ***
Total pot 180 | Rake 0 
Board [9s 3h 3s Jd]
Seat 1: smiley sandy (button) folded on the Turn
Seat 2: CashMatteo (small blind) folded on the Turn
Seat 3: raybinz (big blind) collected (180)

Hand #123: 

PokerStars Hand #246223028708: Tournament #3651032131, $0.23+$0.02 CAD Hold'em No Limit - Level I (10/20) - 2023/09/28 0:24:52 ET
Table '3651032131 1' 3-max Seat #2 is the button
Seat 1: smiley sandy (440 in chips) 
Seat 2: CashMatteo (440 in chips) 
Seat 3: raybinz (620 in chips) 
raybinz: posts small blind 10
smiley sandy: posts big blind 20
*** HOLE CARDS ***
Dealt to CashMatteo [3s 7s]
CashMatteo: folds 
raybinz: calls 10
smiley sandy: raises 20 to 40
raybinz: calls 20
*** FLOP *** [2h 9c Jh]
raybinz: checks 
smiley sandy: bets 40
raybinz: calls 40
*** TURN *** [2h 9c Jh] [9h]
raybinz: checks 
smiley sandy: bets 20
raybinz: calls 20
*** RIVER *** [2h 9c Jh 9h] [Kd]
raybinz: checks 
smiley sandy: bets 20
raybinz: calls 20
*** SHOW DOWN ***
smiley sandy: shows [Kh Qs] (two pair, Kings and Nines)
raybinz: mucks hand 
smiley sandy collected 240 from pot
*** SUMMARY ***
Total pot 240 | Rake 0 
Board [2h 9c Jh 9h Kd]
Seat 1: smiley sandy (big blind) showed [Kh Qs] and won (240) with two pair, Kings and Nines
Seat 2: CashMatteo (button) folded before Flop (didn't bet)
Seat 3: raybinz (small blind) mucked [8d Jc]

Hand #124: 

PokerStars Hand #246223032054: Tournament #3651032131, $0.23+$0.02 CAD Hold'em No Limit - Level I (10/20) - 2023/09/28 0:25:21 ET
Table '3651032131 1' 3-max Seat #3 is the button
Seat 1: smiley sandy (560 in chips) 
Seat 2: CashMatteo (440 in chips) 
Seat 3: raybinz (500 in chips) 
smiley sandy: posts small blind 10
CashMatteo: posts big blind 20
*** HOLE CARDS ***
Dealt to CashMatteo [As 7c]
raybinz: folds 
smiley sandy: calls 10
CashMatteo: checks 
*** FLOP *** [7s Ks 2d]
smiley sandy: bets 20
CashMatteo: calls 20
*** TURN *** [7s Ks 2d] [8d]
smiley sandy: bets 20
CashMatteo: calls 20
*** RIVER *** [7s Ks 2d 8d] [Ad]
smiley sandy: bets 20
CashMatteo: raises 80 to 100
smiley sandy: folds 
Uncalled bet (80) returned to CashMatteo
CashMatteo collected 160 from pot
CashMatteo: doesn't show hand 
*** SUMMARY ***
Total pot 160 | Rake 0 
Board [7s Ks 2d 8d Ad]
Seat 1: smiley sandy (small blind) folded on the River
Seat 2: CashMatteo (big blind) collected (160)
Seat 3: raybinz (button) folded before Flop (didn't bet)

Hand #125: 

PokerStars Hand #246223034156: Tournament #3651032131, $0.23+$0.02 CAD Hold'em No Limit - Level I (10/20) - 2023/09/28 0:25:39 ET
Table '3651032131 1' 3-max Seat #1 is the button
Seat 1: smiley sandy (480 in chips) 
Seat 2: CashMatteo (520 in chips) 
Seat 3: raybinz (500 in chips) 
CashMatteo: posts small blind 10
raybinz: posts big blind 20
*** HOLE CARDS ***
Dealt to CashMatteo [5d Jc]
smiley sandy: calls 20
CashMatteo: calls 10
raybinz: checks 
*** FLOP *** [9c 5s Jd]
CashMatteo: bets 30
raybinz: folds 
smiley sandy: calls 30
*** TURN *** [9c 5s Jd] [6s]
CashMatteo: checks 
smiley sandy: checks 
*** RIVER *** [9c 5s Jd 6s] [8s]
CashMatteo: bets 60
smiley sandy: folds 
Uncalled bet (60) returned to CashMatteo
CashMatteo collected 120 from pot
CashMatteo: doesn't show hand 
*** SUMMARY ***
Total pot 120 | Rake 0 
Board [9c 5s Jd 6s 8s]
Seat 1: smiley sandy (button) folded on the River
Seat 2: CashMatteo (small blind) collected (120)
Seat 3: raybinz (big blind) folded on the Flop

Hand #126: 

PokerStars Hand #246223036754: Tournament #3651032131, $0.23+$0.02 CAD Hold'em No Limit - Level I (10/20) - 2023/09/28 0:26:02 ET
Table '3651032131 1' 3-max Seat #2 is the button
Seat 1: smiley sandy (430 in chips) 
Seat 2: CashMatteo (590 in chips) 
Seat 3: raybinz (480 in chips) 
raybinz: posts small blind 10
smiley sandy: posts big blind 20
*** HOLE CARDS ***
Dealt to CashMatteo [8c 6d]
CashMatteo: folds 
raybinz: raises 20 to 40
smiley sandy: calls 20
*** FLOP *** [Ac 2h Ts]
raybinz: checks 
smiley sandy: checks 
*** TURN *** [Ac 2h Ts] [9s]
raybinz: bets 80
smiley sandy: calls 80
*** RIVER *** [Ac 2h Ts 9s] [7d]
raybinz: bets 140
smiley sandy: calls 140
*** SHOW DOWN ***
raybinz: shows [Qd As] (a pair of Aces)
smiley sandy: mucks hand 
raybinz collected 520 from pot
*** SUMMARY ***
Total pot 520 | Rake 0 
Board [Ac 2h Ts 9s 7d]
Seat 1: smiley sandy (big blind) mucked [8s Tc]
Seat 2: CashMatteo (button) folded before Flop (didn't bet)
Seat 3: raybinz (small blind) showed [Qd As] and won (520) with a pair of Aces

Hand #127: 

PokerStars Hand #246223039883: Tournament #3651032131, $0.23+$0.02 CAD Hold'em No Limit - Level II (15/30) - 2023/09/28 0:26:30 ET
Table '3651032131 1' 3-max Seat #3 is the button
Seat 1: smiley sandy (170 in chips) 
Seat 2: CashMatteo (590 in chips) 
Seat 3: raybinz (740 in chips) 
smiley sandy: posts small blind 15
CashMatteo: posts big blind 30
*** HOLE CARDS ***
Dealt to CashMatteo [4s 8h]
raybinz: calls 30
smiley sandy: raises 30 to 60
CashMatteo: folds 
raybinz: calls 30
*** FLOP *** [6s 4d 5h]
smiley sandy: bets 30
raybinz: raises 30 to 60
smiley sandy: folds 
Uncalled bet (30) returned to raybinz
raybinz collected 210 from pot
*** SUMMARY ***
Total pot 210 | Rake 0 
Board [6s 4d 5h]
Seat 1: smiley sandy (small blind) folded on the Flop
Seat 2: CashMatteo (big blind) folded before Flop
Seat 3: raybinz (button) collected (210)

Hand #128: 

PokerStars Hand #246223041529: Tournament #3651032131, $0.23+$0.02 CAD Hold'em No Limit - Level II (15/30) - 2023/09/28 0:26:45 ET
Table '3651032131 1' 3-max Seat #1 is the button
Seat 1: smiley sandy (80 in chips) 
Seat 2: CashMatteo (560 in chips) 
Seat 3: raybinz (860 in chips) 
CashMatteo: posts small blind 15
raybinz: posts big blind 30
*** HOLE CARDS ***
Dealt to CashMatteo [5h 3h]
smiley sandy: raises 30 to 60
CashMatteo: folds 
raybinz: calls 30
*** FLOP *** [3d 7d Jc]
raybinz: checks 
smiley sandy: bets 20 and is all-in
raybinz: calls 20
*** TURN *** [3d 7d Jc] [7s]
*** RIVER *** [3d 7d Jc 7s] [Qh]
*** SHOW DOWN ***
raybinz: shows [3s 4s] (two pair, Sevens and Threes)
smiley sandy: shows [6s 6d] (two pair, Sevens and Sixes)
smiley sandy collected 175 from pot
*** SUMMARY ***
Total pot 175 | Rake 0 
Board [3d 7d Jc 7s Qh]
Seat 1: smiley sandy (button) showed [6s 6d] and won (175) with two pair, Sevens and Sixes
Seat 2: CashMatteo (small blind) folded before Flop
Seat 3: raybinz (big blind) showed [3s 4s] and lost with two pair, Sevens and Threes

Hand #129: 

PokerStars Hand #246223043695: Tournament #3651032131, $0.23+$0.02 CAD Hold'em No Limit - Level II (15/30) - 2023/09/28 0:27:05 ET
Table '3651032131 1' 3-max Seat #2 is the button
Seat 1: smiley sandy (175 in chips) 
Seat 2: CashMatteo (545 in chips) 
Seat 3: raybinz (780 in chips) 
raybinz: posts small blind 15
smiley sandy: posts big blind 30
*** HOLE CARDS ***
Dealt to CashMatteo [3s 5c]
CashMatteo: folds 
raybinz: folds 
Uncalled bet (15) returned to smiley sandy
smiley sandy collected 30 from pot
*** SUMMARY ***
Total pot 30 | Rake 0 
Seat 1: smiley sandy (big blind) collected (30)
Seat 2: CashMatteo (button) folded before Flop (didn't bet)
Seat 3: raybinz (small blind) folded before Flop

Hand #130: 

PokerStars Hand #246223044621: Tournament #3651032131, $0.23+$0.02 CAD Hold'em No Limit - Level II (15/30) - 2023/09/28 0:27:13 ET
Table '3651032131 1' 3-max Seat #3 is the button
Seat 1: smiley sandy (190 in chips) 
Seat 2: CashMatteo (545 in chips) 
Seat 3: raybinz (765 in chips) 
smiley sandy: posts small blind 15
CashMatteo: posts big blind 30
*** HOLE CARDS ***
Dealt to CashMatteo [Ad 6s]
raybinz: folds 
smiley sandy: calls 15
CashMatteo: checks 
*** FLOP *** [Qh 7h 9h]
smiley sandy: checks 
CashMatteo: checks 
*** TURN *** [Qh 7h 9h] [2s]
smiley sandy: checks 
CashMatteo: checks 
*** RIVER *** [Qh 7h 9h 2s] [5s]
smiley sandy: checks 
CashMatteo: checks 
*** SHOW DOWN ***
smiley sandy: shows [7s 8h] (a pair of Sevens)
CashMatteo: mucks hand 
smiley sandy collected 60 from pot
*** SUMMARY ***
Total pot 60 | Rake 0 
Board [Qh 7h 9h 2s 5s]
Seat 1: smiley sandy (small blind) showed [7s 8h] and won (60) with a pair of Sevens
Seat 2: CashMatteo (big blind) mucked [Ad 6s]
Seat 3: raybinz (button) folded before Flop (didn't bet)

Hand #131: 

PokerStars Hand #246223046333: Tournament #3651032131, $0.23+$0.02 CAD Hold'em No Limit - Level II (15/30) - 2023/09/28 0:27:27 ET
Table '3651032131 1' 3-max Seat #1 is the button
Seat 1: smiley sandy (220 in chips) 
Seat 2: CashMatteo (515 in chips) 
Seat 3: raybinz (765 in chips) 
CashMatteo: posts small blind 15
raybinz: posts big blind 30
*** HOLE CARDS ***
Dealt to CashMatteo [Ks 6s]
smiley sandy: folds 
CashMatteo: calls 15
raybinz: checks 
*** FLOP *** [Qs 9h 6h]
CashMatteo: bets 30
raybinz: calls 30
*** TURN *** [Qs 9h 6h] [4h]
CashMatteo: checks 
raybinz: checks 
*** RIVER *** [Qs 9h 6h 4h] [Kd]
CashMatteo: bets 60
raybinz: folds 
Uncalled bet (60) returned to CashMatteo
CashMatteo collected 120 from pot
CashMatteo: doesn't show hand 
*** SUMMARY ***
Total pot 120 | Rake 0 
Board [Qs 9h 6h 4h Kd]
Seat 1: smiley sandy (button) folded before Flop (didn't bet)
Seat 2: CashMatteo (small blind) collected (120)
Seat 3: raybinz (big blind) folded on the River

Hand #132: 

PokerStars Hand #246223048795: Tournament #3651032131, $0.23+$0.02 CAD Hold'em No Limit - Level II (15/30) - 2023/09/28 0:27:49 ET
Table '3651032131 1' 3-max Seat #2 is the button
Seat 1: smiley sandy (220 in chips) 
Seat 2: CashMatteo (575 in chips) 
Seat 3: raybinz (705 in chips) 
raybinz: posts small blind 15
smiley sandy: posts big blind 30
*** HOLE CARDS ***
Dealt to CashMatteo [5c Ts]
CashMatteo: folds 
raybinz: raises 30 to 60
smiley sandy: folds 
Uncalled bet (30) returned to raybinz
raybinz collected 60 from pot
*** SUMMARY ***
Total pot 60 | Rake 0 
Seat 1: smiley sandy (big blind) folded before Flop
Seat 2: CashMatteo (button) folded before Flop (didn't bet)
Seat 3: raybinz (small blind) collected (60)

Hand #133: 

PokerStars Hand #246223049676: Tournament #3651032131, $0.23+$0.02 CAD Hold'em No Limit - Level II (15/30) - 2023/09/28 0:27:57 ET
Table '3651032131 1' 3-max Seat #3 is the button
Seat 1: smiley sandy (190 in chips) 
Seat 2: CashMatteo (575 in chips) 
Seat 3: raybinz (735 in chips) 
smiley sandy: posts small blind 15
CashMatteo: posts big blind 30
*** HOLE CARDS ***
Dealt to CashMatteo [Kh 2s]
raybinz: folds 
smiley sandy: calls 15
CashMatteo: checks 
*** FLOP *** [5c 6s 9s]
smiley sandy: bets 30
CashMatteo: folds 
Uncalled bet (30) returned to smiley sandy
smiley sandy collected 60 from pot
*** SUMMARY ***
Total pot 60 | Rake 0 
Board [5c 6s 9s]
Seat 1: smiley sandy (small blind) collected (60)
Seat 2: CashMatteo (big blind) folded on the Flop
Seat 3: raybinz (button) folded before Flop (didn't bet)

Hand #134: 

PokerStars Hand #246223051011: Tournament #3651032131, $0.23+$0.02 CAD Hold'em No Limit - Level II (15/30) - 2023/09/28 0:28:09 ET
Table '3651032131 1' 3-max Seat #1 is the button
Seat 1: smiley sandy (220 in chips) 
Seat 2: CashMatteo (545 in chips) 
Seat 3: raybinz (735 in chips) 
CashMatteo: posts small blind 15
raybinz: posts big blind 30
*** HOLE CARDS ***
Dealt to CashMatteo [9c 9d]
smiley sandy: calls 30
CashMatteo: raises 60 to 90
raybinz: calls 60
smiley sandy: folds 
*** FLOP *** [2c 5c Th]
CashMatteo: bets 105
raybinz: calls 105
*** TURN *** [2c 5c Th] [Qd]
CashMatteo: checks 
raybinz: checks 
*** RIVER *** [2c 5c Th Qd] [Jc]
CashMatteo: checks 
raybinz: bets 300
CashMatteo: folds 
Uncalled bet (300) returned to raybinz
raybinz collected 420 from pot
*** SUMMARY ***
Total pot 420 | Rake 0 
Board [2c 5c Th Qd Jc]
Seat 1: smiley sandy (button) folded before Flop
Seat 2: CashMatteo (small blind) folded on the River
Seat 3: raybinz (big blind) collected (420)

Hand #135: 

PokerStars Hand #246223055343: Tournament #3651032131, $0.23+$0.02 CAD Hold'em No Limit - Level III (20/40) - 2023/09/28 0:28:47 ET
Table '3651032131 1' 3-max Seat #2 is the button
Seat 1: smiley sandy (190 in chips) 
Seat 2: CashMatteo (350 in chips) 
Seat 3: raybinz (960 in chips) 
raybinz: posts small blind 20
smiley sandy: posts big blind 40
*** HOLE CARDS ***
Dealt to CashMatteo [6s 6d]
CashMatteo: raises 80 to 120
raybinz: folds 
smiley sandy: folds 
Uncalled bet (80) returned to CashMatteo
CashMatteo collected 100 from pot
CashMatteo: doesn't show hand 
*** SUMMARY ***
Total pot 100 | Rake 0 
Seat 1: smiley sandy (big blind) folded before Flop
Seat 2: CashMatteo (button) collected (100)
Seat 3: raybinz (small blind) folded before Flop

Hand #136: 

PokerStars Hand #246223056236: Tournament #3651032131, $0.23+$0.02 CAD Hold'em No Limit - Level III (20/40) - 2023/09/28 0:28:55 ET
Table '3651032131 1' 3-max Seat #3 is the button
Seat 1: smiley sandy (150 in chips) 
Seat 2: CashMatteo (410 in chips) 
Seat 3: raybinz (940 in chips) 
smiley sandy: posts small blind 20
CashMatteo: posts big blind 40
*** HOLE CARDS ***
Dealt to CashMatteo [Ks 7d]
raybinz: folds 
smiley sandy: folds 
Uncalled bet (20) returned to CashMatteo
CashMatteo collected 40 from pot
CashMatteo: doesn't show hand 
*** SUMMARY ***
Total pot 40 | Rake 0 
Seat 1: smiley sandy (small blind) folded before Flop
Seat 2: CashMatteo (big blind) collected (40)
Seat 3: raybinz (button) folded before Flop (didn't bet)

Hand #137: 

PokerStars Hand #246223057234: Tournament #3651032131, $0.23+$0.02 CAD Hold'em No Limit - Level III (20/40) - 2023/09/28 0:29:04 ET
Table '3651032131 1' 3-max Seat #1 is the button
Seat 1: smiley sandy (130 in chips) 
Seat 2: CashMatteo (430 in chips) 
Seat 3: raybinz (940 in chips) 
CashMatteo: posts small blind 20
raybinz: posts big blind 40
*** HOLE CARDS ***
Dealt to CashMatteo [Jh 7h]
smiley sandy: folds 
CashMatteo: calls 20
raybinz: raises 40 to 80
CashMatteo: folds 
Uncalled bet (40) returned to raybinz
raybinz collected 80 from pot
*** SUMMARY ***
Total pot 80 | Rake 0 
Seat 1: smiley sandy (button) folded before Flop (didn't bet)
Seat 2: CashMatteo (small blind) folded before Flop
Seat 3: raybinz (big blind) collected (80)

Hand #138: 

PokerStars Hand #246223058381: Tournament #3651032131, $0.23+$0.02 CAD Hold'em No Limit - Level III (20/40) - 2023/09/28 0:29:15 ET
Table '3651032131 1' 3-max Seat #2 is the button
Seat 1: smiley sandy (130 in chips) 
Seat 2: CashMatteo (390 in chips) 
Seat 3: raybinz (980 in chips) 
raybinz: posts small blind 20
smiley sandy: posts big blind 40
*** HOLE CARDS ***
Dealt to CashMatteo [4h Jc]
CashMatteo: folds 
raybinz: folds 
Uncalled bet (20) returned to smiley sandy
smiley sandy collected 40 from pot
*** SUMMARY ***
Total pot 40 | Rake 0 
Seat 1: smiley sandy (big blind) collected (40)
Seat 2: CashMatteo (button) folded before Flop (didn't bet)
Seat 3: raybinz (small blind) folded before Flop

Hand #139: 

PokerStars Hand #246223059127: Tournament #3651032131, $0.23+$0.02 CAD Hold'em No Limit - Level III (20/40) - 2023/09/28 0:29:21 ET
Table '3651032131 1' 3-max Seat #3 is the button
Seat 1: smiley sandy (150 in chips) 
Seat 2: CashMatteo (390 in chips) 
Seat 3: raybinz (960 in chips) 
smiley sandy: posts small blind 20
CashMatteo: posts big blind 40
*** HOLE CARDS ***
Dealt to CashMatteo [2d 3s]
raybinz: folds 
smiley sandy: calls 20
CashMatteo: checks 
*** FLOP *** [7s 9h 5c]
smiley sandy: checks 
CashMatteo: checks 
*** TURN *** [7s 9h 5c] [3h]
smiley sandy: checks 
CashMatteo: checks 
*** RIVER *** [7s 9h 5c 3h] [2c]
smiley sandy: checks 
CashMatteo: bets 80
smiley sandy: folds 
Uncalled bet (80) returned to CashMatteo
CashMatteo collected 80 from pot
CashMatteo: doesn't show hand 
*** SUMMARY ***
Total pot 80 | Rake 0 
Board [7s 9h 5c 3h 2c]
Seat 1: smiley sandy (small blind) folded on the River
Seat 2: CashMatteo (big blind) collected (80)
Seat 3: raybinz (button) folded before Flop (didn't bet)

Hand #140: 

PokerStars Hand #246223061015: Tournament #3651032131, $0.23+$0.02 CAD Hold'em No Limit - Level III (20/40) - 2023/09/28 0:29:39 ET
Table '3651032131 1' 3-max Seat #1 is the button
Seat 1: smiley sandy (110 in chips) 
Seat 2: CashMatteo (430 in chips) 
Seat 3: raybinz (960 in chips) 
CashMatteo: posts small blind 20
raybinz: posts big blind 40
*** HOLE CARDS ***
Dealt to CashMatteo [3s 8h]
smiley sandy: raises 40 to 80
CashMatteo: folds 
raybinz: calls 40
*** FLOP *** [Td Tc 5c]
raybinz: checks 
smiley sandy: bets 30 and is all-in
raybinz: calls 30
*** TURN *** [Td Tc 5c] [Th]
*** RIVER *** [Td Tc 5c Th] [3h]
*** SHOW DOWN ***
raybinz: shows [7c 3d] (a full house, Tens full of Threes)
smiley sandy: shows [Qd 9d] (three of a kind, Tens)
raybinz collected 240 from pot
smiley sandy finished the tournament in 3rd place
*** SUMMARY ***
Total pot 240 | Rake 0 
Board [Td Tc 5c Th 3h]
Seat 1: smiley sandy (button) showed [Qd 9d] and lost with three of a kind, Tens
Seat 2: CashMatteo (small blind) folded before Flop
Seat 3: raybinz (big blind) showed [7c 3d] and won (240) with a full house, Tens full of Threes

Hand #141: 

PokerStars Hand #246223064449: Tournament #3651032131, $0.23+$0.02 CAD Hold'em No Limit - Level III (20/40) - 2023/09/28 0:30:09 ET
Table '3651032131 1' 3-max Seat #3 is the button
Seat 2: CashMatteo (410 in chips) 
Seat 3: raybinz (1090 in chips) 
raybinz: posts small blind 20
CashMatteo: posts big blind 40
*** HOLE CARDS ***
Dealt to CashMatteo [2c 4h]
raybinz: calls 20
CashMatteo: checks 
*** FLOP *** [5c Ts Ad]
CashMatteo: checks 
raybinz: checks 
*** TURN *** [5c Ts Ad] [9c]
CashMatteo: bets 40
raybinz: folds 
Uncalled bet (40) returned to CashMatteo
CashMatteo collected 80 from pot
CashMatteo: doesn't show hand 
*** SUMMARY ***
Total pot 80 | Rake 0 
Board [5c Ts Ad 9c]
Seat 2: CashMatteo (big blind) collected (80)
Seat 3: raybinz (button) (small blind) folded on the Turn

Hand #142: 

PokerStars Hand #246223066592: Tournament #3651032131, $0.23+$0.02 CAD Hold'em No Limit - Level IV (30/60) - 2023/09/28 0:30:28 ET
Table '3651032131 1' 3-max Seat #2 is the button
Seat 2: CashMatteo (450 in chips) 
Seat 3: raybinz (1050 in chips) 
CashMatteo: posts small blind 30
raybinz: posts big blind 60
*** HOLE CARDS ***
Dealt to CashMatteo [6c Th]
CashMatteo: folds 
Uncalled bet (30) returned to raybinz
raybinz collected 60 from pot
*** SUMMARY ***
Total pot 60 | Rake 0 
Seat 2: CashMatteo (button) (small blind) folded before Flop
Seat 3: raybinz (big blind) collected (60)

Hand #143: 

PokerStars Hand #246223067288: Tournament #3651032131, $0.23+$0.02 CAD Hold'em No Limit - Level IV (30/60) - 2023/09/28 0:30:34 ET
Table '3651032131 1' 3-max Seat #3 is the button
Seat 2: CashMatteo (420 in chips) 
Seat 3: raybinz (1080 in chips) 
raybinz: posts small blind 30
CashMatteo: posts big blind 60
*** HOLE CARDS ***
Dealt to CashMatteo [4d 3d]
raybinz: calls 30
CashMatteo: checks 
*** FLOP *** [8d 5d Kd]
CashMatteo: checks 
raybinz: checks 
*** TURN *** [8d 5d Kd] [2d]
CashMatteo: checks 
raybinz: checks 
*** RIVER *** [8d 5d Kd 2d] [Ah]
CashMatteo: bets 120
raybinz: folds 
Uncalled bet (120) returned to CashMatteo
CashMatteo collected 120 from pot
CashMatteo: doesn't show hand 
*** SUMMARY ***
Total pot 120 | Rake 0 
Board [8d 5d Kd 2d Ah]
Seat 2: CashMatteo (big blind) collected (120)
Seat 3: raybinz (button) (small blind) folded on the River

Hand #144: 

PokerStars Hand #246223069580: Tournament #3651032131, $0.23+$0.02 CAD Hold'em No Limit - Level IV (30/60) - 2023/09/28 0:30:55 ET
Table '3651032131 1' 3-max Seat #2 is the button
Seat 2: CashMatteo (480 in chips) 
Seat 3: raybinz (1020 in chips) 
CashMatteo: posts small blind 30
raybinz: posts big blind 60
*** HOLE CARDS ***
Dealt to CashMatteo [7s 3c]
CashMatteo: folds 
Uncalled bet (30) returned to raybinz
raybinz collected 60 from pot
*** SUMMARY ***
Total pot 60 | Rake 0 
Seat 2: CashMatteo (button) (small blind) folded before Flop
Seat 3: raybinz (big blind) collected (60)

Hand #145: 

PokerStars Hand #246223070295: Tournament #3651032131, $0.23+$0.02 CAD Hold'em No Limit - Level IV (30/60) - 2023/09/28 0:31:02 ET
Table '3651032131 1' 3-max Seat #3 is the button
Seat 2: CashMatteo (450 in chips) 
Seat 3: raybinz (1050 in chips) 
raybinz: posts small blind 30
CashMatteo: posts big blind 60
*** HOLE CARDS ***
Dealt to CashMatteo [4d 8d]
raybinz: calls 30
CashMatteo: checks 
*** FLOP *** [7c 8c Kh]
CashMatteo: checks 
raybinz: checks 
*** TURN *** [7c 8c Kh] [9c]
CashMatteo: bets 60
raybinz: calls 60
*** RIVER *** [7c 8c Kh 9c] [Qd]
CashMatteo: checks 
raybinz: checks 
*** SHOW DOWN ***
CashMatteo: shows [4d 8d] (a pair of Eights)
raybinz: shows [Ts 9d] (a pair of Nines)
raybinz collected 240 from pot
*** SUMMARY ***
Total pot 240 | Rake 0 
Board [7c 8c Kh 9c Qd]
Seat 2: CashMatteo (big blind) showed [4d 8d] and lost with a pair of Eights
Seat 3: raybinz (button) (small blind) showed [Ts 9d] and won (240) with a pair of Nines

Hand #146: 

PokerStars Hand #246223072047: Tournament #3651032131, $0.23+$0.02 CAD Hold'em No Limit - Level IV (30/60) - 2023/09/28 0:31:18 ET
Table '3651032131 1' 3-max Seat #2 is the button
Seat 2: CashMatteo (330 in chips) 
Seat 3: raybinz (1170 in chips) 
CashMatteo: posts small blind 30
raybinz: posts big blind 60
*** HOLE CARDS ***
Dealt to CashMatteo [Ac Ks]
CashMatteo: raises 120 to 180
raybinz: raises 990 to 1170 and is all-in
CashMatteo: calls 150 and is all-in
Uncalled bet (840) returned to raybinz
*** FLOP *** [Kc Tc 3h]
*** TURN *** [Kc Tc 3h] [4h]
*** RIVER *** [Kc Tc 3h 4h] [3d]
*** SHOW DOWN ***
raybinz: shows [9s 9h] (two pair, Nines and Threes)
CashMatteo: shows [Ac Ks] (two pair, Kings and Threes)
CashMatteo collected 660 from pot
*** SUMMARY ***
Total pot 660 | Rake 0 
Board [Kc Tc 3h 4h 3d]
Seat 2: CashMatteo (button) (small blind) showed [Ac Ks] and won (660) with two pair, Kings and Threes
Seat 3: raybinz (big blind) showed [9s 9h] and lost with two pair, Nines and Threes

Hand #147: 

PokerStars Hand #246223073828: Tournament #3651032131, $0.23+$0.02 CAD Hold'em No Limit - Level IV (30/60) - 2023/09/28 0:31:34 ET
Table '3651032131 1' 3-max Seat #3 is the button
Seat 2: CashMatteo (660 in chips) 
Seat 3: raybinz (840 in chips) 
raybinz: posts small blind 30
CashMatteo: posts big blind 60
*** HOLE CARDS ***
Dealt to CashMatteo [5c Qs]
raybinz: folds 
Uncalled bet (30) returned to CashMatteo
CashMatteo collected 60 from pot
CashMatteo: doesn't show hand 
*** SUMMARY ***
Total pot 60 | Rake 0 
Seat 2: CashMatteo (big blind) collected (60)
Seat 3: raybinz (button) (small blind) folded before Flop

Hand #148: 

PokerStars Hand #246223074425: Tournament #3651032131, $0.23+$0.02 CAD Hold'em No Limit - Level IV (30/60) - 2023/09/28 0:31:39 ET
Table '3651032131 1' 3-max Seat #2 is the button
Seat 2: CashMatteo (690 in chips) 
Seat 3: raybinz (810 in chips) 
CashMatteo: posts small blind 30
raybinz: posts big blind 60
*** HOLE CARDS ***
Dealt to CashMatteo [9d 4s]
CashMatteo: folds 
Uncalled bet (30) returned to raybinz
raybinz collected 60 from pot
*** SUMMARY ***
Total pot 60 | Rake 0 
Seat 2: CashMatteo (button) (small blind) folded before Flop
Seat 3: raybinz (big blind) collected (60)

Hand #149: 

PokerStars Hand #246223075506: Tournament #3651032131, $0.23+$0.02 CAD Hold'em No Limit - Level IV (30/60) - 2023/09/28 0:31:50 ET
Table '3651032131 1' 3-max Seat #3 is the button
Seat 2: CashMatteo (660 in chips) 
Seat 3: raybinz (840 in chips) 
raybinz: posts small blind 30
CashMatteo: posts big blind 60
*** HOLE CARDS ***
Dealt to CashMatteo [5h 3h]
raybinz: calls 30
CashMatteo: checks 
*** FLOP *** [Qh 3s 9c]
CashMatteo: checks 
raybinz: checks 
*** TURN *** [Qh 3s 9c] [Td]
CashMatteo: checks 
raybinz: checks 
*** RIVER *** [Qh 3s 9c Td] [Ah]
CashMatteo: checks 
raybinz: bets 60
CashMatteo: folds 
Uncalled bet (60) returned to raybinz
raybinz collected 120 from pot
*** SUMMARY ***
Total pot 120 | Rake 0 
Board [Qh 3s 9c Td Ah]
Seat 2: CashMatteo (big blind) folded on the River
Seat 3: raybinz (button) (small blind) collected (120)

Hand #150: 

PokerStars Hand #246223078181: Tournament #3651032131, $0.23+$0.02 CAD Hold'em No Limit - Level IV (30/60) - 2023/09/28 0:32:14 ET
Table '3651032131 1' 3-max Seat #2 is the button
Seat 2: CashMatteo (600 in chips) 
Seat 3: raybinz (900 in chips) 
CashMatteo: posts small blind 30
raybinz: posts big blind 60
*** HOLE CARDS ***
Dealt to CashMatteo [Ah 6d]
CashMatteo: calls 30
raybinz: checks 
*** FLOP *** [9h 4d Qd]
raybinz: checks 
CashMatteo: checks 
*** TURN *** [9h 4d Qd] [4s]
raybinz: checks 
CashMatteo: checks 
*** RIVER *** [9h 4d Qd 4s] [7h]
raybinz: checks 
CashMatteo: checks 
*** SHOW DOWN ***
raybinz: shows [Jd 5h] (a pair of Fours)
CashMatteo: shows [Ah 6d] (a pair of Fours - Ace kicker)
CashMatteo collected 120 from pot
*** SUMMARY ***
Total pot 120 | Rake 0 
Board [9h 4d Qd 4s 7h]
Seat 2: CashMatteo (button) (small blind) showed [Ah 6d] and won (120) with a pair of Fours
Seat 3: raybinz (big blind) showed [Jd 5h] and lost with a pair of Fours

Hand #151: 

PokerStars Hand #246223080228: Tournament #3651032131, $0.23+$0.02 CAD Hold'em No Limit - Level V (40/80) - 2023/09/28 0:32:32 ET
Table '3651032131 1' 3-max Seat #3 is the button
Seat 2: CashMatteo (660 in chips) 
Seat 3: raybinz (840 in chips) 
raybinz: posts small blind 40
CashMatteo: posts big blind 80
*** HOLE CARDS ***
Dealt to CashMatteo [8h Jh]
raybinz: raises 80 to 160
CashMatteo: calls 80
*** FLOP *** [5s Td 3d]
CashMatteo: checks 
raybinz: bets 160
CashMatteo: folds 
Uncalled bet (160) returned to raybinz
raybinz collected 320 from pot
*** SUMMARY ***
Total pot 320 | Rake 0 
Board [5s Td 3d]
Seat 2: CashMatteo (big blind) folded on the Flop
Seat 3: raybinz (button) (small blind) collected (320)

Hand #152: 

PokerStars Hand #246223081679: Tournament #3651032131, $0.23+$0.02 CAD Hold'em No Limit - Level V (40/80) - 2023/09/28 0:32:46 ET
Table '3651032131 1' 3-max Seat #2 is the button
Seat 2: CashMatteo (500 in chips) 
Seat 3: raybinz (1000 in chips) 
CashMatteo: posts small blind 40
raybinz: posts big blind 80
*** HOLE CARDS ***
Dealt to CashMatteo [3s Ks]
CashMatteo: calls 40
raybinz: checks 
*** FLOP *** [Jc Jh Kh]
raybinz: checks 
CashMatteo: checks 
*** TURN *** [Jc Jh Kh] [6c]
raybinz: checks 
CashMatteo: bets 80
raybinz: folds 
Uncalled bet (80) returned to CashMatteo
CashMatteo collected 160 from pot
CashMatteo: doesn't show hand 
*** SUMMARY ***
Total pot 160 | Rake 0 
Board [Jc Jh Kh 6c]
Seat 2: CashMatteo (button) (small blind) collected (160)
Seat 3: raybinz (big blind) folded on the Turn

Hand #153: 

PokerStars Hand #246223083317: Tournament #3651032131, $0.23+$0.02 CAD Hold'em No Limit - Level V (40/80) - 2023/09/28 0:33:01 ET
Table '3651032131 1' 3-max Seat #3 is the button
Seat 2: CashMatteo (580 in chips) 
Seat 3: raybinz (920 in chips) 
raybinz: posts small blind 40
CashMatteo: posts big blind 80
*** HOLE CARDS ***
Dealt to CashMatteo [8s 7d]
raybinz: calls 40
CashMatteo: checks 
*** FLOP *** [9s 2h Ts]
CashMatteo: bets 80
raybinz: calls 80
*** TURN *** [9s 2h Ts] [Js]
CashMatteo: checks 
raybinz: checks 
*** RIVER *** [9s 2h Ts Js] [Jc]
CashMatteo: bets 320
raybinz: raises 320 to 640
CashMatteo: calls 100 and is all-in
Uncalled bet (220) returned to raybinz
*** SHOW DOWN ***
raybinz: shows [2c 2d] (a full house, Deuces full of Jacks)
CashMatteo: shows [8s 7d] (a straight, Seven to Jack)
raybinz collected 1160 from pot
CashMatteo finished the tournament in 2nd place
raybinz wins the tournament and receives $0.50 - congratulations!
*** SUMMARY ***
Total pot 1160 | Rake 0 
Board [9s 2h Ts Js Jc]
Seat 2: CashMatteo (big blind) showed [8s 7d] and lost with a straight, Seven to Jack
Seat 3: raybinz (button) (small blind) showed [2c 2d] and won (1160) with a full house, Deuces full of Jacks

Hand #154: 

PokerStars Hand #246223089171: Tournament #3651034066, $0.23+$0.02 CAD Hold'em No Limit - Level I (10/20) - 2023/09/28 0:33:54 ET
Table '3651034066 1' 3-max Seat #1 is the button
Seat 1: CashMatteo (500 in chips) 
Seat 2: realme090 (500 in chips) 
Seat 3: raybinz (500 in chips) 
realme090: posts small blind 10
raybinz: posts big blind 20
*** HOLE CARDS ***
Dealt to CashMatteo [Js 8c]
CashMatteo: calls 20
realme090: calls 10
raybinz: checks 
*** FLOP *** [Ks 8h 2d]
realme090: checks 
raybinz: checks 
CashMatteo: checks 
*** TURN *** [Ks 8h 2d] [8d]
realme090: checks 
raybinz: checks 
CashMatteo: bets 20
realme090: calls 20
raybinz: folds 
*** RIVER *** [Ks 8h 2d 8d] [7c]
realme090: checks 
CashMatteo: bets 50
realme090: calls 50
*** SHOW DOWN ***
CashMatteo: shows [Js 8c] (three of a kind, Eights)
realme090: mucks hand 
CashMatteo collected 200 from pot
*** SUMMARY ***
Total pot 200 | Rake 0 
Board [Ks 8h 2d 8d 7c]
Seat 1: CashMatteo (button) showed [Js 8c] and won (200) with three of a kind, Eights
Seat 2: realme090 (small blind) mucked [Qs 6c]
Seat 3: raybinz (big blind) folded on the Turn

Hand #155: 

PokerStars Hand #246223093386: Tournament #3651034066, $0.23+$0.02 CAD Hold'em No Limit - Level I (10/20) - 2023/09/28 0:34:33 ET
Table '3651034066 1' 3-max Seat #2 is the button
Seat 1: CashMatteo (610 in chips) 
Seat 2: realme090 (410 in chips) 
Seat 3: raybinz (480 in chips) 
raybinz: posts small blind 10
CashMatteo: posts big blind 20
*** HOLE CARDS ***
Dealt to CashMatteo [2s 3c]
realme090: raises 40 to 60
raybinz: folds 
CashMatteo: folds 
Uncalled bet (40) returned to realme090
realme090 collected 50 from pot
*** SUMMARY ***
Total pot 50 | Rake 0 
Seat 1: CashMatteo (big blind) folded before Flop
Seat 2: realme090 (button) collected (50)
Seat 3: raybinz (small blind) folded before Flop

Hand #156: 

PokerStars Hand #246223094589: Tournament #3651034066, $0.23+$0.02 CAD Hold'em No Limit - Level I (10/20) - 2023/09/28 0:34:44 ET
Table '3651034066 1' 3-max Seat #3 is the button
Seat 1: CashMatteo (590 in chips) 
Seat 2: realme090 (440 in chips) 
Seat 3: raybinz (470 in chips) 
CashMatteo: posts small blind 10
realme090: posts big blind 20
*** HOLE CARDS ***
Dealt to CashMatteo [6h 9d]
raybinz: calls 20
CashMatteo: raises 40 to 60
realme090: calls 40
raybinz: calls 40
*** FLOP *** [7s 6s 5s]
CashMatteo: checks 
realme090: bets 90
raybinz: calls 90
CashMatteo: folds 
*** TURN *** [7s 6s 5s] [6c]
realme090: checks 
raybinz: checks 
*** RIVER *** [7s 6s 5s 6c] [Ah]
realme090: bets 290 and is all-in
raybinz: folds 
Uncalled bet (290) returned to realme090
realme090 collected 360 from pot
*** SUMMARY ***
Total pot 360 | Rake 0 
Board [7s 6s 5s 6c Ah]
Seat 1: CashMatteo (small blind) folded on the Flop
Seat 2: realme090 (big blind) collected (360)
Seat 3: raybinz (button) folded on the River

Hand #157: 

PokerStars Hand #246223100719: Tournament #3651034066, $0.23+$0.02 CAD Hold'em No Limit - Level I (10/20) - 2023/09/28 0:35:39 ET
Table '3651034066 1' 3-max Seat #1 is the button
Seat 1: CashMatteo (530 in chips) 
Seat 2: realme090 (650 in chips) 
Seat 3: raybinz (320 in chips) 
realme090: posts small blind 10
raybinz: posts big blind 20
*** HOLE CARDS ***
Dealt to CashMatteo [Kc 3s]
CashMatteo: calls 20
realme090: folds 
raybinz: checks 
*** FLOP *** [Qd 6h 5d]
raybinz: checks 
CashMatteo: checks 
*** TURN *** [Qd 6h 5d] [Ac]
raybinz: checks 
CashMatteo: checks 
*** RIVER *** [Qd 6h 5d Ac] [6d]
raybinz: checks 
CashMatteo: checks 
*** SHOW DOWN ***
raybinz: shows [Jc Kh] (a pair of Sixes)
CashMatteo: shows [Kc 3s] (a pair of Sixes)
raybinz collected 25 from pot
CashMatteo collected 25 from pot
*** SUMMARY ***
Total pot 50 | Rake 0 
Board [Qd 6h 5d Ac 6d]
Seat 1: CashMatteo (button) showed [Kc 3s] and won (25) with a pair of Sixes
Seat 2: realme090 (small blind) folded before Flop
Seat 3: raybinz (big blind) showed [Jc Kh] and won (25) with a pair of Sixes

Hand #158: 

PokerStars Hand #246223103127: Tournament #3651034066, $0.23+$0.02 CAD Hold'em No Limit - Level I (10/20) - 2023/09/28 0:36:01 ET
Table '3651034066 1' 3-max Seat #2 is the button
Seat 1: CashMatteo (535 in chips) 
Seat 2: realme090 (640 in chips) 
Seat 3: raybinz (325 in chips) 
raybinz: posts small blind 10
CashMatteo: posts big blind 20
*** HOLE CARDS ***
Dealt to CashMatteo [3d Qh]
realme090: raises 20 to 40
raybinz: calls 30
CashMatteo: calls 20
*** FLOP *** [5h 5s Ad]
raybinz: checks 
CashMatteo: checks 
realme090: checks 
*** TURN *** [5h 5s Ad] [Qs]
raybinz: checks 
CashMatteo: checks 
realme090: checks 
*** RIVER *** [5h 5s Ad Qs] [2d]
raybinz: checks 
CashMatteo: bets 20
realme090: raises 20 to 40
raybinz: folds 
CashMatteo: calls 20
*** SHOW DOWN ***
realme090: shows [2h Ks] (two pair, Fives and Deuces)
CashMatteo: shows [3d Qh] (two pair, Queens and Fives)
CashMatteo collected 200 from pot
*** SUMMARY ***
Total pot 200 | Rake 0 
Board [5h 5s Ad Qs 2d]
Seat 1: CashMatteo (big blind) showed [3d Qh] and won (200) with two pair, Queens and Fives
Seat 2: realme090 (button) showed [2h Ks] and lost with two pair, Fives and Deuces
Seat 3: raybinz (small blind) folded on the River

Hand #159: 

PokerStars Hand #246223107024: Tournament #3651034066, $0.23+$0.02 CAD Hold'em No Limit - Level I (10/20) - 2023/09/28 0:36:37 ET
Table '3651034066 1' 3-max Seat #3 is the button
Seat 1: CashMatteo (655 in chips) 
Seat 2: realme090 (560 in chips) 
Seat 3: raybinz (285 in chips) 
CashMatteo: posts small blind 10
realme090: posts big blind 20
*** HOLE CARDS ***
Dealt to CashMatteo [Ts Jd]
raybinz: folds 
CashMatteo: calls 10
realme090: raises 20 to 40
CashMatteo: calls 20
*** FLOP *** [6h 7d Qc]
CashMatteo: checks 
realme090: bets 40
CashMatteo: folds 
Uncalled bet (40) returned to realme090
realme090 collected 80 from pot
realme090: doesn't show hand 
*** SUMMARY ***
Total pot 80 | Rake 0 
Board [6h 7d Qc]
Seat 1: CashMatteo (small blind) folded on the Flop
Seat 2: realme090 (big blind) collected (80)
Seat 3: raybinz (button) folded before Flop (didn't bet)

Hand #160: 

PokerStars Hand #246223110101: Tournament #3651034066, $0.23+$0.02 CAD Hold'em No Limit - Level II (15/30) - 2023/09/28 0:37:05 ET
Table '3651034066 1' 3-max Seat #1 is the button
Seat 1: CashMatteo (615 in chips) 
Seat 2: realme090 (600 in chips) 
Seat 3: raybinz (285 in chips) 
realme090: posts small blind 15
raybinz: posts big blind 30
*** HOLE CARDS ***
Dealt to CashMatteo [Ks 9h]
CashMatteo: calls 30
realme090: calls 15
raybinz: checks 
*** FLOP *** [2s Qd 2d]
realme090: checks 
raybinz: checks 
CashMatteo: checks 
*** TURN *** [2s Qd 2d] [7h]
realme090: checks 
raybinz: checks 
CashMatteo: checks 
*** RIVER *** [2s Qd 2d 7h] [Jh]
realme090: bets 45
raybinz: folds 
CashMatteo: folds 
Uncalled bet (45) returned to realme090
realme090 collected 90 from pot
*** SUMMARY ***
Total pot 90 | Rake 0 
Board [2s Qd 2d 7h Jh]
Seat 1: CashMatteo (button) folded on the River
Seat 2: realme090 (small blind) collected (90)
Seat 3: raybinz (big blind) folded on the River

Hand #161: 

PokerStars Hand #246223114083: Tournament #3651034066, $0.23+$0.02 CAD Hold'em No Limit - Level II (15/30) - 2023/09/28 0:37:41 ET
Table '3651034066 1' 3-max Seat #2 is the button
Seat 1: CashMatteo (585 in chips) 
Seat 2: realme090 (660 in chips) 
Seat 3: raybinz (255 in chips) 
raybinz: posts small blind 15
CashMatteo: posts big blind 30
*** HOLE CARDS ***
Dealt to CashMatteo [8h 6h]
realme090: folds 
raybinz: raises 30 to 60
CashMatteo: folds 
Uncalled bet (30) returned to raybinz
raybinz collected 60 from pot
*** SUMMARY ***
Total pot 60 | Rake 0 
Seat 1: CashMatteo (big blind) folded before Flop
Seat 2: realme090 (button) folded before Flop (didn't bet)
Seat 3: raybinz (small blind) collected (60)

Hand #162: 

PokerStars Hand #246223114977: Tournament #3651034066, $0.23+$0.02 CAD Hold'em No Limit - Level II (15/30) - 2023/09/28 0:37:49 ET
Table '3651034066 1' 3-max Seat #3 is the button
Seat 1: CashMatteo (555 in chips) 
Seat 2: realme090 (660 in chips) 
Seat 3: raybinz (285 in chips) 
CashMatteo: posts small blind 15
realme090: posts big blind 30
*** HOLE CARDS ***
Dealt to CashMatteo [Kd 8s]
raybinz: calls 30
CashMatteo: calls 15
realme090: checks 
*** FLOP *** [Kh 3h 5c]
CashMatteo: bets 45
realme090: calls 45
raybinz: folds 
*** TURN *** [Kh 3h 5c] [9h]
CashMatteo: checks 
realme090: checks 
*** RIVER *** [Kh 3h 5c 9h] [Js]
CashMatteo: bets 60
realme090: calls 60
*** SHOW DOWN ***
CashMatteo: shows [Kd 8s] (a pair of Kings)
realme090: mucks hand 
CashMatteo collected 300 from pot
*** SUMMARY ***
Total pot 300 | Rake 0 
Board [Kh 3h 5c 9h Js]
Seat 1: CashMatteo (small blind) showed [Kd 8s] and won (300) with a pair of Kings
Seat 2: realme090 (big blind) mucked [6s Kc]
Seat 3: raybinz (button) folded on the Flop

Hand #163: 

PokerStars Hand #246223118098: Tournament #3651034066, $0.23+$0.02 CAD Hold'em No Limit - Level II (15/30) - 2023/09/28 0:38:18 ET
Table '3651034066 1' 3-max Seat #1 is the button
Seat 1: CashMatteo (720 in chips) 
Seat 2: realme090 (525 in chips) 
Seat 3: raybinz (255 in chips) 
realme090: posts small blind 15
raybinz: posts big blind 30
*** HOLE CARDS ***
Dealt to CashMatteo [9d 8h]
CashMatteo: folds 
realme090: raises 60 to 90
raybinz: calls 60
*** FLOP *** [Ts 4s Js]
realme090: bets 180
raybinz: calls 165 and is all-in
Uncalled bet (15) returned to realme090
*** TURN *** [Ts 4s Js] [3c]
*** RIVER *** [Ts 4s Js 3c] [As]
*** SHOW DOWN ***
realme090: shows [Td Jh] (two pair, Jacks and Tens)
raybinz: shows [Tc Ks] (a flush, Ace high)
raybinz collected 510 from pot
*** SUMMARY ***
Total pot 510 | Rake 0 
Board [Ts 4s Js 3c As]
Seat 1: CashMatteo (button) folded before Flop (didn't bet)
Seat 2: realme090 (small blind) showed [Td Jh] and lost with two pair, Jacks and Tens
Seat 3: raybinz (big blind) showed [Tc Ks] and won (510) with a flush, Ace high

Hand #164: 

PokerStars Hand #246223121179: Tournament #3651034066, $0.23+$0.02 CAD Hold'em No Limit - Level II (15/30) - 2023/09/28 0:38:45 ET
Table '3651034066 1' 3-max Seat #2 is the button
Seat 1: CashMatteo (720 in chips) 
Seat 2: realme090 (270 in chips) 
Seat 3: raybinz (510 in chips) 
raybinz: posts small blind 15
CashMatteo: posts big blind 30
*** HOLE CARDS ***
Dealt to CashMatteo [Kc 5h]
realme090: folds 
raybinz: calls 15
CashMatteo: checks 
*** FLOP *** [4s 7c Jc]
raybinz: checks 
CashMatteo: checks 
*** TURN *** [4s 7c Jc] [6c]
raybinz: checks 
CashMatteo: checks 
*** RIVER *** [4s 7c Jc 6c] [As]
raybinz: bets 30
CashMatteo: folds 
Uncalled bet (30) returned to raybinz
raybinz collected 60 from pot
*** SUMMARY ***
Total pot 60 | Rake 0 
Board [4s 7c Jc 6c As]
Seat 1: CashMatteo (big blind) folded on the River
Seat 2: realme090 (button) folded before Flop (didn't bet)
Seat 3: raybinz (small blind) collected (60)

Hand #165: 

PokerStars Hand #246223124063: Tournament #3651034066, $0.23+$0.02 CAD Hold'em No Limit - Level II (15/30) - 2023/09/28 0:39:13 ET
Table '3651034066 1' 3-max Seat #3 is the button
Seat 1: CashMatteo (690 in chips) 
Seat 2: realme090 (270 in chips) 
Seat 3: raybinz (540 in chips) 
CashMatteo: posts small blind 15
realme090: posts big blind 30
*** HOLE CARDS ***
Dealt to CashMatteo [Td 4c]
raybinz: calls 30
CashMatteo: folds 
realme090: checks 
*** FLOP *** [Kd 2c 9d]
realme090: bets 240 and is all-in
raybinz: folds 
Uncalled bet (240) returned to realme090
realme090 collected 75 from pot
*** SUMMARY ***
Total pot 75 | Rake 0 
Board [Kd 2c 9d]
Seat 1: CashMatteo (small blind) folded before Flop
Seat 2: realme090 (big blind) collected (75)
Seat 3: raybinz (button) folded on the Flop

Hand #166: 

PokerStars Hand #246223125629: Tournament #3651034066, $0.23+$0.02 CAD Hold'em No Limit - Level II (15/30) - 2023/09/28 0:39:27 ET
Table '3651034066 1' 3-max Seat #1 is the button
Seat 1: CashMatteo (675 in chips) 
Seat 2: realme090 (315 in chips) 
Seat 3: raybinz (510 in chips) 
realme090: posts small blind 15
raybinz: posts big blind 30
*** HOLE CARDS ***
Dealt to CashMatteo [Th 4c]
CashMatteo: folds 
realme090: calls 15
raybinz: checks 
*** FLOP *** [Js 2d Tc]
realme090: checks 
raybinz: checks 
*** TURN *** [Js 2d Tc] [Qs]
realme090: checks 
raybinz: checks 
*** RIVER *** [Js 2d Tc Qs] [9h]
realme090: bets 60
raybinz: folds 
Uncalled bet (60) returned to realme090
realme090 collected 60 from pot
*** SUMMARY ***
Total pot 60 | Rake 0 
Board [Js 2d Tc Qs 9h]
Seat 1: CashMatteo (button) folded before Flop (didn't bet)
Seat 2: realme090 (small blind) collected (60)
Seat 3: raybinz (big blind) folded on the River

Hand #167: 

PokerStars Hand #246223129360: Tournament #3651034066, $0.23+$0.02 CAD Hold'em No Limit - Level III (20/40) - 2023/09/28 0:40:02 ET
Table '3651034066 1' 3-max Seat #2 is the button
Seat 1: CashMatteo (675 in chips) 
Seat 2: realme090 (345 in chips) 
Seat 3: raybinz (480 in chips) 
raybinz: posts small blind 20
CashMatteo: posts big blind 40
*** HOLE CARDS ***
Dealt to CashMatteo [5s 6d]
realme090: folds 
raybinz: raises 40 to 80
CashMatteo: folds 
Uncalled bet (40) returned to raybinz
raybinz collected 80 from pot
*** SUMMARY ***
Total pot 80 | Rake 0 
Seat 1: CashMatteo (big blind) folded before Flop
Seat 2: realme090 (button) folded before Flop (didn't bet)
Seat 3: raybinz (small blind) collected (80)

Hand #168: 

PokerStars Hand #246223130341: Tournament #3651034066, $0.23+$0.02 CAD Hold'em No Limit - Level III (20/40) - 2023/09/28 0:40:11 ET
Table '3651034066 1' 3-max Seat #3 is the button
Seat 1: CashMatteo (635 in chips) 
Seat 2: realme090 (345 in chips) 
Seat 3: raybinz (520 in chips) 
CashMatteo: posts small blind 20
realme090: posts big blind 40
*** HOLE CARDS ***
Dealt to CashMatteo [Th Kd]
raybinz: calls 40
CashMatteo: calls 20
realme090: raises 40 to 80
raybinz: calls 40
CashMatteo: calls 40
*** FLOP *** [9h 8d Ac]
CashMatteo: checks 
realme090: bets 265 and is all-in
raybinz: folds 
CashMatteo: folds 
Uncalled bet (265) returned to realme090
realme090 collected 240 from pot
realme090: doesn't show hand 
*** SUMMARY ***
Total pot 240 | Rake 0 
Board [9h 8d Ac]
Seat 1: CashMatteo (small blind) folded on the Flop
Seat 2: realme090 (big blind) collected (240)
Seat 3: raybinz (button) folded on the Flop

Hand #169: 

PokerStars Hand #246223132949: Tournament #3651034066, $0.23+$0.02 CAD Hold'em No Limit - Level III (20/40) - 2023/09/28 0:40:35 ET
Table '3651034066 1' 3-max Seat #1 is the button
Seat 1: CashMatteo (555 in chips) 
Seat 2: realme090 (505 in chips) 
Seat 3: raybinz (440 in chips) 
realme090: posts small blind 20
raybinz: posts big blind 40
*** HOLE CARDS ***
Dealt to CashMatteo [As 8c]
CashMatteo: calls 40
realme090: calls 20
raybinz: checks 
*** FLOP *** [7d Ah 4d]
realme090: checks 
raybinz: checks 
CashMatteo: bets 60
realme090: folds 
raybinz: calls 60
*** TURN *** [7d Ah 4d] [2s]
raybinz: checks 
CashMatteo: checks 
*** RIVER *** [7d Ah 4d 2s] [Ts]
raybinz: checks 
CashMatteo: bets 120
raybinz: folds 
Uncalled bet (120) returned to CashMatteo
CashMatteo collected 240 from pot
CashMatteo: doesn't show hand 
*** SUMMARY ***
Total pot 240 | Rake 0 
Board [7d Ah 4d 2s Ts]
Seat 1: CashMatteo (button) collected (240)
Seat 2: realme090 (small blind) folded on the Flop
Seat 3: raybinz (big blind) folded on the River

Hand #170: 

PokerStars Hand #246223137433: Tournament #3651034066, $0.23+$0.02 CAD Hold'em No Limit - Level III (20/40) - 2023/09/28 0:41:16 ET
Table '3651034066 1' 3-max Seat #2 is the button
Seat 1: CashMatteo (695 in chips) 
Seat 2: realme090 (465 in chips) 
Seat 3: raybinz (340 in chips) 
raybinz: posts small blind 20
CashMatteo: posts big blind 40
*** HOLE CARDS ***
Dealt to CashMatteo [7s Ts]
realme090: calls 40
raybinz: folds 
CashMatteo: checks 
*** FLOP *** [Jc 7c Th]
CashMatteo: checks 
realme090: checks 
*** TURN *** [Jc 7c Th] [Qd]
CashMatteo: bets 50
realme090: calls 50
*** RIVER *** [Jc 7c Th Qd] [8h]
CashMatteo: checks 
realme090: checks 
*** SHOW DOWN ***
CashMatteo: shows [7s Ts] (two pair, Tens and Sevens)
realme090: mucks hand 
CashMatteo collected 200 from pot
*** SUMMARY ***
Total pot 200 | Rake 0 
Board [Jc 7c Th Qd 8h]
Seat 1: CashMatteo (big blind) showed [7s Ts] and won (200) with two pair, Tens and Sevens
Seat 2: realme090 (button) mucked [6s 8d]
Seat 3: raybinz (small blind) folded before Flop

Hand #171: 

PokerStars Hand #246223140768: Tournament #3651034066, $0.23+$0.02 CAD Hold'em No Limit - Level III (20/40) - 2023/09/28 0:41:47 ET
Table '3651034066 1' 3-max Seat #3 is the button
Seat 1: CashMatteo (805 in chips) 
Seat 2: realme090 (375 in chips) 
Seat 3: raybinz (320 in chips) 
CashMatteo: posts small blind 20
realme090: posts big blind 40
*** HOLE CARDS ***
Dealt to CashMatteo [8d Qd]
raybinz: folds 
CashMatteo: calls 20
realme090: checks 
*** FLOP *** [Td Ad 7h]
CashMatteo: checks 
realme090: checks 
*** TURN *** [Td Ad 7h] [Qh]
CashMatteo: bets 40
realme090: folds 
Uncalled bet (40) returned to CashMatteo
CashMatteo collected 80 from pot
CashMatteo: doesn't show hand 
*** SUMMARY ***
Total pot 80 | Rake 0 
Board [Td Ad 7h Qh]
Seat 1: CashMatteo (small blind) collected (80)
Seat 2: realme090 (big blind) folded on the Turn
Seat 3: raybinz (button) folded before Flop (didn't bet)

Hand #172: 

PokerStars Hand #246223142699: Tournament #3651034066, $0.23+$0.02 CAD Hold'em No Limit - Level III (20/40) - 2023/09/28 0:42:05 ET
Table '3651034066 1' 3-max Seat #1 is the button
Seat 1: CashMatteo (845 in chips) 
Seat 2: realme090 (335 in chips) 
Seat 3: raybinz (320 in chips) 
realme090: posts small blind 20
raybinz: posts big blind 40
*** HOLE CARDS ***
Dealt to CashMatteo [6d Qh]
CashMatteo: calls 40
realme090: calls 20
raybinz: checks 
*** FLOP *** [8c Qc Ad]
realme090: bets 60
raybinz: calls 60
CashMatteo: calls 60
*** TURN *** [8c Qc Ad] [Js]
realme090: checks 
raybinz: bets 190
CashMatteo: folds 
realme090: raises 45 to 235 and is all-in
raybinz: calls 30 and is all-in
Uncalled bet (15) returned to realme090
*** RIVER *** [8c Qc Ad Js] [7s]
*** SHOW DOWN ***
realme090: shows [4c 7c] (a pair of Sevens)
raybinz: shows [Kc Th] (a straight, Ten to Ace)
raybinz collected 740 from pot
*** SUMMARY ***
Total pot 740 | Rake 0 
Board [8c Qc Ad Js 7s]
Seat 1: CashMatteo (button) folded on the Turn
Seat 2: realme090 (small blind) showed [4c 7c] and lost with a pair of Sevens
Seat 3: raybinz (big blind) showed [Kc Th] and won (740) with a straight, Ten to Ace

Hand #173: 

PokerStars Hand #246223147305: Tournament #3651034066, $0.23+$0.02 CAD Hold'em No Limit - Level III (20/40) - 2023/09/28 0:42:47 ET
Table '3651034066 1' 3-max Seat #2 is the button
Seat 1: CashMatteo (745 in chips) 
Seat 2: realme090 (15 in chips) 
Seat 3: raybinz (740 in chips) 
raybinz: posts small blind 20
CashMatteo: posts big blind 40
*** HOLE CARDS ***
Dealt to CashMatteo [7s 2h]
realme090: calls 15 and is all-in
raybinz: calls 20
CashMatteo: checks 
*** FLOP *** [9d 9h 3s]
raybinz: checks 
CashMatteo: checks 
*** TURN *** [9d 9h 3s] [7d]
raybinz: checks 
CashMatteo: checks 
*** RIVER *** [9d 9h 3s 7d] [3d]
raybinz: checks 
CashMatteo: bets 48
raybinz: folds 
Uncalled bet (48) returned to CashMatteo
*** SHOW DOWN ***
CashMatteo: shows [7s 2h] (two pair, Nines and Sevens)
CashMatteo collected 50 from side pot
realme090: shows [Ac 5c] (two pair, Nines and Threes)
CashMatteo collected 45 from main pot
realme090 finished the tournament in 3rd place
*** SUMMARY ***
Total pot 95 Main pot 45. Side pot 50. | Rake 0 
Board [9d 9h 3s 7d 3d]
Seat 1: CashMatteo (big blind) showed [7s 2h] and won (95) with two pair, Nines and Sevens
Seat 2: realme090 (button) showed [Ac 5c] and lost with two pair, Nines and Threes
Seat 3: raybinz (small blind) folded on the River

Hand #174: 

PokerStars Hand #246223150161: Tournament #3651034066, $0.23+$0.02 CAD Hold'em No Limit - Level IV (30/60) - 2023/09/28 0:43:13 ET
Table '3651034066 1' 3-max Seat #1 is the button
Seat 1: CashMatteo (800 in chips) 
Seat 3: raybinz (700 in chips) 
CashMatteo: posts small blind 30
raybinz: posts big blind 60
*** HOLE CARDS ***
Dealt to CashMatteo [Kd 2c]
CashMatteo: calls 30
raybinz: checks 
*** FLOP *** [5c Th Ac]
raybinz: checks 
CashMatteo: checks 
*** TURN *** [5c Th Ac] [Qs]
raybinz: checks 
CashMatteo: checks 
*** RIVER *** [5c Th Ac Qs] [7h]
raybinz: checks 
CashMatteo: checks 
*** SHOW DOWN ***
raybinz: shows [8h 6d] (high card Ace)
CashMatteo: shows [Kd 2c] (high card Ace - King kicker)
CashMatteo collected 120 from pot
*** SUMMARY ***
Total pot 120 | Rake 0 
Board [5c Th Ac Qs 7h]
Seat 1: CashMatteo (button) (small blind) showed [Kd 2c] and won (120) with high card Ace
Seat 3: raybinz (big blind) showed [8h 6d] and lost with high card Ace

Hand #175: 

PokerStars Hand #246223152882: Tournament #3651034066, $0.23+$0.02 CAD Hold'em No Limit - Level IV (30/60) - 2023/09/28 0:43:40 ET
Table '3651034066 1' 3-max Seat #3 is the button
Seat 1: CashMatteo (860 in chips) 
Seat 3: raybinz (640 in chips) 
raybinz: posts small blind 30
CashMatteo: posts big blind 60
*** HOLE CARDS ***
Dealt to CashMatteo [4s 2c]
raybinz: calls 30
CashMatteo: checks 
*** FLOP *** [Kh Jc 6c]
CashMatteo: checks 
raybinz: bets 60
CashMatteo: folds 
Uncalled bet (60) returned to raybinz
raybinz collected 120 from pot
*** SUMMARY ***
Total pot 120 | Rake 0 
Board [Kh Jc 6c]
Seat 1: CashMatteo (big blind) folded on the Flop
Seat 3: raybinz (button) (small blind) collected (120)

Hand #176: 

PokerStars Hand #246223154748: Tournament #3651034066, $0.23+$0.02 CAD Hold'em No Limit - Level IV (30/60) - 2023/09/28 0:43:57 ET
Table '3651034066 1' 3-max Seat #1 is the button
Seat 1: CashMatteo (800 in chips) 
Seat 3: raybinz (700 in chips) 
CashMatteo: posts small blind 30
raybinz: posts big blind 60
*** HOLE CARDS ***
Dealt to CashMatteo [7s 5s]
CashMatteo: calls 30
raybinz: checks 
*** FLOP *** [As Ah Qc]
raybinz: checks 
CashMatteo: checks 
*** TURN *** [As Ah Qc] [6s]
raybinz: checks 
CashMatteo: checks 
*** RIVER *** [As Ah Qc 6s] [2s]
raybinz: checks 
CashMatteo: bets 60
raybinz: folds 
Uncalled bet (60) returned to CashMatteo
CashMatteo collected 120 from pot
CashMatteo: doesn't show hand 
*** SUMMARY ***
Total pot 120 | Rake 0 
Board [As Ah Qc 6s 2s]
Seat 1: CashMatteo (button) (small blind) collected (120)
Seat 3: raybinz (big blind) folded on the River

Hand #177: 

PokerStars Hand #246223157715: Tournament #3651034066, $0.23+$0.02 CAD Hold'em No Limit - Level IV (30/60) - 2023/09/28 0:44:25 ET
Table '3651034066 1' 3-max Seat #3 is the button
Seat 1: CashMatteo (860 in chips) 
Seat 3: raybinz (640 in chips) 
raybinz: posts small blind 30
CashMatteo: posts big blind 60
*** HOLE CARDS ***
Dealt to CashMatteo [9c Ts]
raybinz: calls 30
CashMatteo: checks 
*** FLOP *** [4c 4s 5d]
CashMatteo: checks 
raybinz: checks 
*** TURN *** [4c 4s 5d] [5c]
CashMatteo: bets 60
raybinz: folds 
Uncalled bet (60) returned to CashMatteo
CashMatteo collected 120 from pot
CashMatteo: doesn't show hand 
*** SUMMARY ***
Total pot 120 | Rake 0 
Board [4c 4s 5d 5c]
Seat 1: CashMatteo (big blind) collected (120)
Seat 3: raybinz (button) (small blind) folded on the Turn

Hand #178: 

PokerStars Hand #246223159332: Tournament #3651034066, $0.23+$0.02 CAD Hold'em No Limit - Level IV (30/60) - 2023/09/28 0:44:41 ET
Table '3651034066 1' 3-max Seat #1 is the button
Seat 1: CashMatteo (920 in chips) 
Seat 3: raybinz (580 in chips) 
CashMatteo: posts small blind 30
raybinz: posts big blind 60
*** HOLE CARDS ***
Dealt to CashMatteo [Td 7d]
CashMatteo: calls 30
raybinz: checks 
*** FLOP *** [Qs Qc Ts]
raybinz: checks 
CashMatteo: bets 60
raybinz: folds 
Uncalled bet (60) returned to CashMatteo
CashMatteo collected 120 from pot
CashMatteo: doesn't show hand 
*** SUMMARY ***
Total pot 120 | Rake 0 
Board [Qs Qc Ts]
Seat 1: CashMatteo (button) (small blind) collected (120)
Seat 3: raybinz (big blind) folded on the Flop

Hand #179: 

PokerStars Hand #246223160787: Tournament #3651034066, $0.23+$0.02 CAD Hold'em No Limit - Level IV (30/60) - 2023/09/28 0:44:54 ET
Table '3651034066 1' 3-max Seat #3 is the button
Seat 1: CashMatteo (980 in chips) 
Seat 3: raybinz (520 in chips) 
raybinz: posts small blind 30
CashMatteo: posts big blind 60
*** HOLE CARDS ***
Dealt to CashMatteo [Kd Ts]
raybinz: folds 
Uncalled bet (30) returned to CashMatteo
CashMatteo collected 60 from pot
CashMatteo: doesn't show hand 
*** SUMMARY ***
Total pot 60 | Rake 0 
Seat 1: CashMatteo (big blind) collected (60)
Seat 3: raybinz (button) (small blind) folded before Flop

Hand #180: 

PokerStars Hand #246223161315: Tournament #3651034066, $0.23+$0.02 CAD Hold'em No Limit - Level IV (30/60) - 2023/09/28 0:44:59 ET
Table '3651034066 1' 3-max Seat #1 is the button
Seat 1: CashMatteo (1010 in chips) 
Seat 3: raybinz (490 in chips) 
CashMatteo: posts small blind 30
raybinz: posts big blind 60
*** HOLE CARDS ***
Dealt to CashMatteo [5s 3h]
CashMatteo: folds 
Uncalled bet (30) returned to raybinz
raybinz collected 60 from pot
*** SUMMARY ***
Total pot 60 | Rake 0 
Seat 1: CashMatteo (button) (small blind) folded before Flop
Seat 3: raybinz (big blind) collected (60)

Hand #181: 

PokerStars Hand #246223162111: Tournament #3651034066, $0.23+$0.02 CAD Hold'em No Limit - Level IV (30/60) - 2023/09/28 0:45:07 ET
Table '3651034066 1' 3-max Seat #3 is the button
Seat 1: CashMatteo (980 in chips) 
Seat 3: raybinz (520 in chips) 
raybinz: posts small blind 30
CashMatteo: posts big blind 60
*** HOLE CARDS ***
Dealt to CashMatteo [Ts 9h]
raybinz: folds 
Uncalled bet (30) returned to CashMatteo
CashMatteo collected 60 from pot
CashMatteo: doesn't show hand 
*** SUMMARY ***
Total pot 60 | Rake 0 
Seat 1: CashMatteo (big blind) collected (60)
Seat 3: raybinz (button) (small blind) folded before Flop

Hand #182: 

PokerStars Hand #246223162641: Tournament #3651034066, $0.23+$0.02 CAD Hold'em No Limit - Level IV (30/60) - 2023/09/28 0:45:12 ET
Table '3651034066 1' 3-max Seat #1 is the button
Seat 1: CashMatteo (1010 in chips) 
Seat 3: raybinz (490 in chips) 
CashMatteo: posts small blind 30
raybinz: posts big blind 60
*** HOLE CARDS ***
Dealt to CashMatteo [9h Jc]
CashMatteo: calls 30
raybinz: checks 
*** FLOP *** [Kh Qh 7s]
raybinz: checks 
CashMatteo: checks 
*** TURN *** [Kh Qh 7s] [2h]
raybinz: checks 
CashMatteo: checks 
*** RIVER *** [Kh Qh 7s 2h] [3d]
raybinz: checks 
CashMatteo: checks 
*** SHOW DOWN ***
raybinz: shows [4d 5d] (high card King)
CashMatteo: shows [9h Jc] (high card King - Queen+Jack kicker)
CashMatteo collected 120 from pot
*** SUMMARY ***
Total pot 120 | Rake 0 
Board [Kh Qh 7s 2h 3d]
Seat 1: CashMatteo (button) (small blind) showed [9h Jc] and won (120) with high card King
Seat 3: raybinz (big blind) showed [4d 5d] and lost with high card King

Hand #183: 

PokerStars Hand #246223164308: Tournament #3651034066, $0.23+$0.02 CAD Hold'em No Limit - Level IV (30/60) - 2023/09/28 0:45:28 ET
Table '3651034066 1' 3-max Seat #3 is the button
Seat 1: CashMatteo (1070 in chips) 
Seat 3: raybinz (430 in chips) 
raybinz: posts small blind 30
CashMatteo: posts big blind 60
*** HOLE CARDS ***
Dealt to CashMatteo [9s Ah]
raybinz: raises 60 to 120
CashMatteo: calls 60
*** FLOP *** [5d 7d Kh]
CashMatteo: checks 
raybinz: checks 
*** TURN *** [5d 7d Kh] [Th]
CashMatteo: checks 
raybinz: checks 
*** RIVER *** [5d 7d Kh Th] [Jh]
CashMatteo: checks 
raybinz: checks 
*** SHOW DOWN ***
CashMatteo: shows [9s Ah] (high card Ace)
raybinz: shows [Ad 5s] (a pair of Fives)
raybinz collected 240 from pot
*** SUMMARY ***
Total pot 240 | Rake 0 
Board [5d 7d Kh Th Jh]
Seat 1: CashMatteo (big blind) showed [9s Ah] and lost with high card Ace
Seat 3: raybinz (button) (small blind) showed [Ad 5s] and won (240) with a pair of Fives

Hand #184: 

PokerStars Hand #246223166138: Tournament #3651034066, $0.23+$0.02 CAD Hold'em No Limit - Level IV (30/60) - 2023/09/28 0:45:46 ET
Table '3651034066 1' 3-max Seat #1 is the button
Seat 1: CashMatteo (950 in chips) 
Seat 3: raybinz (550 in chips) 
CashMatteo: posts small blind 30
raybinz: posts big blind 60
*** HOLE CARDS ***
Dealt to CashMatteo [Kh Kc]
CashMatteo: calls 30
raybinz: checks 
*** FLOP *** [4h Jd Tc]
raybinz: checks 
CashMatteo: checks 
*** TURN *** [4h Jd Tc] [Jh]
raybinz: checks 
CashMatteo: checks 
*** RIVER *** [4h Jd Tc Jh] [Qh]
raybinz: bets 120
CashMatteo: raises 360 to 480
raybinz: folds 
Uncalled bet (360) returned to CashMatteo
CashMatteo collected 360 from pot
CashMatteo: doesn't show hand 
*** SUMMARY ***
Total pot 360 | Rake 0 
Board [4h Jd Tc Jh Qh]
Seat 1: CashMatteo (button) (small blind) collected (360)
Seat 3: raybinz (big blind) folded on the River

Hand #185: 

PokerStars Hand #246223170955: Tournament #3651034066, $0.23+$0.02 CAD Hold'em No Limit - Level V (40/80) - 2023/09/28 0:46:31 ET
Table '3651034066 1' 3-max Seat #3 is the button
Seat 1: CashMatteo (1130 in chips) 
Seat 3: raybinz (370 in chips) 
raybinz: posts small blind 40
CashMatteo: posts big blind 80
*** HOLE CARDS ***
Dealt to CashMatteo [2h Th]
raybinz: calls 40
CashMatteo: checks 
*** FLOP *** [Td 8s 2s]
CashMatteo: checks 
raybinz: checks 
*** TURN *** [Td 8s 2s] [3h]
CashMatteo: checks 
raybinz: checks 
*** RIVER *** [Td 8s 2s 3h] [6c]
CashMatteo: bets 80
raybinz: folds 
Uncalled bet (80) returned to CashMatteo
CashMatteo collected 160 from pot
CashMatteo: doesn't show hand 
*** SUMMARY ***
Total pot 160 | Rake 0 
Board [Td 8s 2s 3h 6c]
Seat 1: CashMatteo (big blind) collected (160)
Seat 3: raybinz (button) (small blind) folded on the River

Hand #186: 

PokerStars Hand #246223172932: Tournament #3651034066, $0.23+$0.02 CAD Hold'em No Limit - Level V (40/80) - 2023/09/28 0:46:50 ET
Table '3651034066 1' 3-max Seat #1 is the button
Seat 1: CashMatteo (1210 in chips) 
Seat 3: raybinz (290 in chips) 
CashMatteo: posts small blind 40
raybinz: posts big blind 80
*** HOLE CARDS ***
Dealt to CashMatteo [2h 4d]
CashMatteo: folds 
Uncalled bet (40) returned to raybinz
raybinz collected 80 from pot
*** SUMMARY ***
Total pot 80 | Rake 0 
Seat 1: CashMatteo (button) (small blind) folded before Flop
Seat 3: raybinz (big blind) collected (80)

Hand #187: 

PokerStars Hand #246223173445: Tournament #3651034066, $0.23+$0.02 CAD Hold'em No Limit - Level V (40/80) - 2023/09/28 0:46:55 ET
Table '3651034066 1' 3-max Seat #3 is the button
Seat 1: CashMatteo (1170 in chips) 
Seat 3: raybinz (330 in chips) 
raybinz: posts small blind 40
CashMatteo: posts big blind 80
*** HOLE CARDS ***
Dealt to CashMatteo [4c Kd]
raybinz: folds 
Uncalled bet (40) returned to CashMatteo
CashMatteo collected 80 from pot
CashMatteo: doesn't show hand 
*** SUMMARY ***
Total pot 80 | Rake 0 
Seat 1: CashMatteo (big blind) collected (80)
Seat 3: raybinz (button) (small blind) folded before Flop

Hand #188: 

PokerStars Hand #246223173938: Tournament #3651034066, $0.23+$0.02 CAD Hold'em No Limit - Level V (40/80) - 2023/09/28 0:47:00 ET
Table '3651034066 1' 3-max Seat #1 is the button
Seat 1: CashMatteo (1210 in chips) 
Seat 3: raybinz (290 in chips) 
CashMatteo: posts small blind 40
raybinz: posts big blind 80
*** HOLE CARDS ***
Dealt to CashMatteo [2d Kd]
CashMatteo: calls 40
raybinz: checks 
*** FLOP *** [9d 7h 6s]
raybinz: checks 
CashMatteo: checks 
*** TURN *** [9d 7h 6s] [2h]
raybinz: checks 
CashMatteo: checks 
*** RIVER *** [9d 7h 6s 2h] [3s]
raybinz: checks 
CashMatteo: checks 
*** SHOW DOWN ***
raybinz: shows [4d 3h] (a pair of Threes)
CashMatteo: mucks hand 
raybinz collected 160 from pot
*** SUMMARY ***
Total pot 160 | Rake 0 
Board [9d 7h 6s 2h 3s]
Seat 1: CashMatteo (button) (small blind) mucked [2d Kd]
Seat 3: raybinz (big blind) showed [4d 3h] and won (160) with a pair of Threes

Hand #189: 

PokerStars Hand #246223175283: Tournament #3651034066, $0.23+$0.02 CAD Hold'em No Limit - Level V (40/80) - 2023/09/28 0:47:13 ET
Table '3651034066 1' 3-max Seat #3 is the button
Seat 1: CashMatteo (1130 in chips) 
Seat 3: raybinz (370 in chips) 
raybinz: posts small blind 40
CashMatteo: posts big blind 80
*** HOLE CARDS ***
Dealt to CashMatteo [5c 8s]
raybinz: folds 
Uncalled bet (40) returned to CashMatteo
CashMatteo collected 80 from pot
CashMatteo: doesn't show hand 
*** SUMMARY ***
Total pot 80 | Rake 0 
Seat 1: CashMatteo (big blind) collected (80)
Seat 3: raybinz (button) (small blind) folded before Flop

Hand #190: 

PokerStars Hand #246223176010: Tournament #3651034066, $0.23+$0.02 CAD Hold'em No Limit - Level V (40/80) - 2023/09/28 0:47:20 ET
Table '3651034066 1' 3-max Seat #1 is the button
Seat 1: CashMatteo (1170 in chips) 
Seat 3: raybinz (330 in chips) 
CashMatteo: posts small blind 40
raybinz: posts big blind 80
*** HOLE CARDS ***
Dealt to CashMatteo [Qc Ah]
CashMatteo: calls 40
raybinz: checks 
*** FLOP *** [Ks 7d Kh]
raybinz: checks 
CashMatteo: checks 
*** TURN *** [Ks 7d Kh] [7c]
raybinz: checks 
CashMatteo: checks 
*** RIVER *** [Ks 7d Kh 7c] [Td]
raybinz: checks 
CashMatteo: checks 
*** SHOW DOWN ***
raybinz: shows [Qd 4s] (two pair, Kings and Sevens)
CashMatteo: shows [Qc Ah] (two pair, Kings and Sevens - Ace kicker)
CashMatteo collected 160 from pot
*** SUMMARY ***
Total pot 160 | Rake 0 
Board [Ks 7d Kh 7c Td]
Seat 1: CashMatteo (button) (small blind) showed [Qc Ah] and won (160) with two pair, Kings and Sevens
Seat 3: raybinz (big blind) showed [Qd 4s] and lost with two pair, Kings and Sevens

Hand #191: 

PokerStars Hand #246223177596: Tournament #3651034066, $0.23+$0.02 CAD Hold'em No Limit - Level V (40/80) - 2023/09/28 0:47:35 ET
Table '3651034066 1' 3-max Seat #3 is the button
Seat 1: CashMatteo (1250 in chips) 
Seat 3: raybinz (250 in chips) 
raybinz: posts small blind 40
CashMatteo: posts big blind 80
*** HOLE CARDS ***
Dealt to CashMatteo [4h 3d]
raybinz: calls 40
CashMatteo: checks 
*** FLOP *** [Js 5d 4c]
CashMatteo: checks 
raybinz: checks 
*** TURN *** [Js 5d 4c] [Qc]
CashMatteo: checks 
raybinz: bets 80
CashMatteo: folds 
Uncalled bet (80) returned to raybinz
raybinz collected 160 from pot
*** SUMMARY ***
Total pot 160 | Rake 0 
Board [Js 5d 4c Qc]
Seat 1: CashMatteo (big blind) folded on the Turn
Seat 3: raybinz (button) (small blind) collected (160)

Hand #192: 

PokerStars Hand #246223179736: Tournament #3651034066, $0.23+$0.02 CAD Hold'em No Limit - Level V (40/80) - 2023/09/28 0:47:55 ET
Table '3651034066 1' 3-max Seat #1 is the button
Seat 1: CashMatteo (1170 in chips) 
Seat 3: raybinz (330 in chips) 
CashMatteo: posts small blind 40
raybinz: posts big blind 80
*** HOLE CARDS ***
Dealt to CashMatteo [Qd Ts]
CashMatteo: calls 40
raybinz: checks 
*** FLOP *** [Kd Qh 4h]
raybinz: checks 
CashMatteo: bets 80
raybinz: folds 
Uncalled bet (80) returned to CashMatteo
CashMatteo collected 160 from pot
CashMatteo: doesn't show hand 
*** SUMMARY ***
Total pot 160 | Rake 0 
Board [Kd Qh 4h]
Seat 1: CashMatteo (button) (small blind) collected (160)
Seat 3: raybinz (big blind) folded on the Flop

Hand #193: 

PokerStars Hand #246223180853: Tournament #3651034066, $0.23+$0.02 CAD Hold'em No Limit - Level V (40/80) - 2023/09/28 0:48:06 ET
Table '3651034066 1' 3-max Seat #3 is the button
Seat 1: CashMatteo (1250 in chips) 
Seat 3: raybinz (250 in chips) 
raybinz: posts small blind 40
CashMatteo: posts big blind 80
*** HOLE CARDS ***
Dealt to CashMatteo [4h 2s]
raybinz: folds 
Uncalled bet (40) returned to CashMatteo
CashMatteo collected 80 from pot
CashMatteo: doesn't show hand 
*** SUMMARY ***
Total pot 80 | Rake 0 
Seat 1: CashMatteo (big blind) collected (80)
Seat 3: raybinz (button) (small blind) folded before Flop

Hand #194: 

PokerStars Hand #246223181419: Tournament #3651034066, $0.23+$0.02 CAD Hold'em No Limit - Level V (40/80) - 2023/09/28 0:48:11 ET
Table '3651034066 1' 3-max Seat #1 is the button
Seat 1: CashMatteo (1290 in chips) 
Seat 3: raybinz (210 in chips) 
CashMatteo: posts small blind 40
raybinz: posts big blind 80
*** HOLE CARDS ***
Dealt to CashMatteo [9d 2d]
CashMatteo: folds 
Uncalled bet (40) returned to raybinz
raybinz collected 80 from pot
*** SUMMARY ***
Total pot 80 | Rake 0 
Seat 1: CashMatteo (button) (small blind) folded before Flop
Seat 3: raybinz (big blind) collected (80)

Hand #195: 

PokerStars Hand #246223181993: Tournament #3651034066, $0.23+$0.02 CAD Hold'em No Limit - Level V (40/80) - 2023/09/28 0:48:17 ET
Table '3651034066 1' 3-max Seat #3 is the button
Seat 1: CashMatteo (1250 in chips) 
Seat 3: raybinz (250 in chips) 
raybinz: posts small blind 40
CashMatteo: posts big blind 80
*** HOLE CARDS ***
Dealt to CashMatteo [Td 8s]
raybinz: raises 170 to 250 and is all-in
CashMatteo: folds 
Uncalled bet (170) returned to raybinz
raybinz collected 160 from pot
*** SUMMARY ***
Total pot 160 | Rake 0 
Seat 1: CashMatteo (big blind) folded before Flop
Seat 3: raybinz (button) (small blind) collected (160)

Hand #196: 

PokerStars Hand #246223182767: Tournament #3651034066, $0.23+$0.02 CAD Hold'em No Limit - Level V (40/80) - 2023/09/28 0:48:24 ET
Table '3651034066 1' 3-max Seat #1 is the button
Seat 1: CashMatteo (1170 in chips) 
Seat 3: raybinz (330 in chips) 
CashMatteo: posts small blind 40
raybinz: posts big blind 80
*** HOLE CARDS ***
Dealt to CashMatteo [4s 4d]
CashMatteo: calls 40
raybinz: raises 160 to 240
CashMatteo: calls 160
*** FLOP *** [Ad 7h 3d]
raybinz: bets 90 and is all-in
CashMatteo: calls 90
*** TURN *** [Ad 7h 3d] [Qs]
*** RIVER *** [Ad 7h 3d Qs] [8s]
*** SHOW DOWN ***
raybinz: shows [Ac Jh] (a pair of Aces)
CashMatteo: shows [4s 4d] (a pair of Fours)
raybinz collected 660 from pot
*** SUMMARY ***
Total pot 660 | Rake 0 
Board [Ad 7h 3d Qs 8s]
Seat 1: CashMatteo (button) (small blind) showed [4s 4d] and lost with a pair of Fours
Seat 3: raybinz (big blind) showed [Ac Jh] and won (660) with a pair of Aces

Hand #197: 

PokerStars Hand #246223185207: Tournament #3651034066, $0.23+$0.02 CAD Hold'em No Limit - Level V (40/80) - 2023/09/28 0:48:47 ET
Table '3651034066 1' 3-max Seat #3 is the button
Seat 1: CashMatteo (840 in chips) 
Seat 3: raybinz (660 in chips) 
raybinz: posts small blind 40
CashMatteo: posts big blind 80
*** HOLE CARDS ***
Dealt to CashMatteo [9h Ks]
raybinz: folds 
Uncalled bet (40) returned to CashMatteo
CashMatteo collected 80 from pot
CashMatteo: doesn't show hand 
*** SUMMARY ***
Total pot 80 | Rake 0 
Seat 1: CashMatteo (big blind) collected (80)
Seat 3: raybinz (button) (small blind) folded before Flop

Hand #198: 

PokerStars Hand #246223185668: Tournament #3651034066, $0.23+$0.02 CAD Hold'em No Limit - Level V (40/80) - 2023/09/28 0:48:52 ET
Table '3651034066 1' 3-max Seat #1 is the button
Seat 1: CashMatteo (880 in chips) 
Seat 3: raybinz (620 in chips) 
CashMatteo: posts small blind 40
raybinz: posts big blind 80
*** HOLE CARDS ***
Dealt to CashMatteo [Ks 2s]
CashMatteo: calls 40
raybinz: raises 160 to 240
CashMatteo: calls 160
*** FLOP *** [3c 7s 7h]
raybinz: bets 240
CashMatteo: folds 
Uncalled bet (240) returned to raybinz
raybinz collected 480 from pot
*** SUMMARY ***
Total pot 480 | Rake 0 
Board [3c 7s 7h]
Seat 1: CashMatteo (button) (small blind) folded on the Flop
Seat 3: raybinz (big blind) collected (480)

Hand #199: 

PokerStars Hand #246223187508: Tournament #3651034066, $0.23+$0.02 CAD Hold'em No Limit - Level VI (50/100) - 2023/09/28 0:49:09 ET
Table '3651034066 1' 3-max Seat #3 is the button
Seat 1: CashMatteo (640 in chips) 
Seat 3: raybinz (860 in chips) 
raybinz: posts small blind 50
CashMatteo: posts big blind 100
*** HOLE CARDS ***
Dealt to CashMatteo [9d Js]
raybinz: calls 50
CashMatteo: checks 
*** FLOP *** [3d Kc 8s]
CashMatteo: checks 
raybinz: checks 
*** TURN *** [3d Kc 8s] [Qh]
CashMatteo: checks 
raybinz: checks 
*** RIVER *** [3d Kc 8s Qh] [Qd]
CashMatteo: checks 
raybinz: checks 
*** SHOW DOWN ***
CashMatteo: shows [9d Js] (a pair of Queens)
raybinz: mucks hand 
CashMatteo collected 200 from pot
*** SUMMARY ***
Total pot 200 | Rake 0 
Board [3d Kc 8s Qh Qd]
Seat 1: CashMatteo (big blind) showed [9d Js] and won (200) with a pair of Queens
Seat 3: raybinz (button) (small blind) mucked [6d 2d]

Hand #200: 

PokerStars Hand #246223189304: Tournament #3651034066, $0.23+$0.02 CAD Hold'em No Limit - Level VI (50/100) - 2023/09/28 0:49:26 ET
Table '3651034066 1' 3-max Seat #1 is the button
Seat 1: CashMatteo (740 in chips) 
Seat 3: raybinz (760 in chips) 
CashMatteo: posts small blind 50
raybinz: posts big blind 100
*** HOLE CARDS ***
Dealt to CashMatteo [Jh 3s]
CashMatteo: calls 50
raybinz: raises 100 to 200
CashMatteo: folds 
Uncalled bet (100) returned to raybinz
raybinz collected 200 from pot
*** SUMMARY ***
Total pot 200 | Rake 0 
Seat 1: CashMatteo (button) (small blind) folded before Flop
Seat 3: raybinz (big blind) collected (200)

Hand #201: 

PokerStars Hand #246223190129: Tournament #3651034066, $0.23+$0.02 CAD Hold'em No Limit - Level VI (50/100) - 2023/09/28 0:49:34 ET
Table '3651034066 1' 3-max Seat #3 is the button
Seat 1: CashMatteo (640 in chips) 
Seat 3: raybinz (860 in chips) 
raybinz: posts small blind 50
CashMatteo: posts big blind 100
*** HOLE CARDS ***
Dealt to CashMatteo [Qh Td]
raybinz: calls 50
CashMatteo: raises 200 to 300
raybinz: folds 
Uncalled bet (200) returned to CashMatteo
CashMatteo collected 200 from pot
CashMatteo: doesn't show hand 
*** SUMMARY ***
Total pot 200 | Rake 0 
Seat 1: CashMatteo (big blind) collected (200)
Seat 3: raybinz (button) (small blind) folded before Flop

Hand #202: 

PokerStars Hand #246223190974: Tournament #3651034066, $0.23+$0.02 CAD Hold'em No Limit - Level VI (50/100) - 2023/09/28 0:49:42 ET
Table '3651034066 1' 3-max Seat #1 is the button
Seat 1: CashMatteo (740 in chips) 
Seat 3: raybinz (760 in chips) 
CashMatteo: posts small blind 50
raybinz: posts big blind 100
*** HOLE CARDS ***
Dealt to CashMatteo [9c Ac]
CashMatteo: raises 100 to 200
raybinz: folds 
Uncalled bet (100) returned to CashMatteo
CashMatteo collected 200 from pot
CashMatteo: doesn't show hand 
*** SUMMARY ***
Total pot 200 | Rake 0 
Seat 1: CashMatteo (button) (small blind) collected (200)
Seat 3: raybinz (big blind) folded before Flop

Hand #203: 

PokerStars Hand #246223191727: Tournament #3651034066, $0.23+$0.02 CAD Hold'em No Limit - Level VI (50/100) - 2023/09/28 0:49:49 ET
Table '3651034066 1' 3-max Seat #3 is the button
Seat 1: CashMatteo (840 in chips) 
Seat 3: raybinz (660 in chips) 
raybinz: posts small blind 50
CashMatteo: posts big blind 100
*** HOLE CARDS ***
Dealt to CashMatteo [Td 5h]
raybinz: raises 200 to 300
CashMatteo: folds 
Uncalled bet (200) returned to raybinz
raybinz collected 200 from pot
*** SUMMARY ***
Total pot 200 | Rake 0 
Seat 1: CashMatteo (big blind) folded before Flop
Seat 3: raybinz (button) (small blind) collected (200)

Hand #204: 

PokerStars Hand #246223192613: Tournament #3651034066, $0.23+$0.02 CAD Hold'em No Limit - Level VI (50/100) - 2023/09/28 0:49:58 ET
Table '3651034066 1' 3-max Seat #1 is the button
Seat 1: CashMatteo (740 in chips) 
Seat 3: raybinz (760 in chips) 
CashMatteo: posts small blind 50
raybinz: posts big blind 100
*** HOLE CARDS ***
Dealt to CashMatteo [5s 3h]
CashMatteo: folds 
Uncalled bet (50) returned to raybinz
raybinz collected 100 from pot
*** SUMMARY ***
Total pot 100 | Rake 0 
Seat 1: CashMatteo (button) (small blind) folded before Flop
Seat 3: raybinz (big blind) collected (100)

Hand #205: 

PokerStars Hand #246223193098: Tournament #3651034066, $0.23+$0.02 CAD Hold'em No Limit - Level VI (50/100) - 2023/09/28 0:50:03 ET
Table '3651034066 1' 3-max Seat #3 is the button
Seat 1: CashMatteo (690 in chips) 
Seat 3: raybinz (810 in chips) 
raybinz: posts small blind 50
CashMatteo: posts big blind 100
*** HOLE CARDS ***
Dealt to CashMatteo [Qh 6d]
raybinz: folds 
Uncalled bet (50) returned to CashMatteo
CashMatteo collected 100 from pot
CashMatteo: doesn't show hand 
*** SUMMARY ***
Total pot 100 | Rake 0 
Seat 1: CashMatteo (big blind) collected (100)
Seat 3: raybinz (button) (small blind) folded before Flop

Hand #206: 

PokerStars Hand #246223193534: Tournament #3651034066, $0.23+$0.02 CAD Hold'em No Limit - Level VI (50/100) - 2023/09/28 0:50:07 ET
Table '3651034066 1' 3-max Seat #1 is the button
Seat 1: CashMatteo (740 in chips) 
Seat 3: raybinz (760 in chips) 
CashMatteo: posts small blind 50
raybinz: posts big blind 100
*** HOLE CARDS ***
Dealt to CashMatteo [2s 2h]
CashMatteo: calls 50
raybinz: raises 200 to 300
CashMatteo: calls 200
*** FLOP *** [6d Ts Qh]
raybinz: bets 460 and is all-in
CashMatteo: folds 
Uncalled bet (460) returned to raybinz
raybinz collected 600 from pot
*** SUMMARY ***
Total pot 600 | Rake 0 
Board [6d Ts Qh]
Seat 1: CashMatteo (button) (small blind) folded on the Flop
Seat 3: raybinz (big blind) collected (600)

Hand #207: 

PokerStars Hand #246223195638: Tournament #3651034066, $0.23+$0.02 CAD Hold'em No Limit - Level VI (50/100) - 2023/09/28 0:50:27 ET
Table '3651034066 1' 3-max Seat #3 is the button
Seat 1: CashMatteo (440 in chips) 
Seat 3: raybinz (1060 in chips) 
raybinz: posts small blind 50
CashMatteo: posts big blind 100
*** HOLE CARDS ***
Dealt to CashMatteo [9c 5s]
raybinz: raises 200 to 300
CashMatteo: folds 
Uncalled bet (200) returned to raybinz
raybinz collected 200 from pot
*** SUMMARY ***
Total pot 200 | Rake 0 
Seat 1: CashMatteo (big blind) folded before Flop
Seat 3: raybinz (button) (small blind) collected (200)

Hand #208: 

PokerStars Hand #246223196712: Tournament #3651034066, $0.23+$0.02 CAD Hold'em No Limit - Level VI (50/100) - 2023/09/28 0:50:37 ET
Table '3651034066 1' 3-max Seat #1 is the button
Seat 1: CashMatteo (340 in chips) 
Seat 3: raybinz (1160 in chips) 
CashMatteo: posts small blind 50
raybinz: posts big blind 100
*** HOLE CARDS ***
Dealt to CashMatteo [Th 9h]
CashMatteo: calls 50
raybinz: raises 200 to 300
CashMatteo: raises 40 to 340 and is all-in
raybinz: calls 40
*** FLOP *** [4h 3h 3d]
*** TURN *** [4h 3h 3d] [Ah]
*** RIVER *** [4h 3h 3d Ah] [Td]
*** SHOW DOWN ***
raybinz: shows [9c 9d] (two pair, Nines and Threes)
CashMatteo: shows [Th 9h] (a flush, Ace high)
CashMatteo collected 680 from pot
*** SUMMARY ***
Total pot 680 | Rake 0 
Board [4h 3h 3d Ah Td]
Seat 1: CashMatteo (button) (small blind) showed [Th 9h] and won (680) with a flush, Ace high
Seat 3: raybinz (big blind) showed [9c 9d] and lost with two pair, Nines and Threes

Hand #209: 

PokerStars Hand #246223198416: Tournament #3651034066, $0.23+$0.02 CAD Hold'em No Limit - Level VI (50/100) - 2023/09/28 0:50:53 ET
Table '3651034066 1' 3-max Seat #3 is the button
Seat 1: CashMatteo (680 in chips) 
Seat 3: raybinz (820 in chips) 
raybinz: posts small blind 50
CashMatteo: posts big blind 100
*** HOLE CARDS ***
Dealt to CashMatteo [Ad 2h]
raybinz: raises 200 to 300
CashMatteo: folds 
Uncalled bet (200) returned to raybinz
raybinz collected 200 from pot
*** SUMMARY ***
Total pot 200 | Rake 0 
Seat 1: CashMatteo (big blind) folded before Flop
Seat 3: raybinz (button) (small blind) collected (200)

Hand #210: 

PokerStars Hand #246223199085: Tournament #3651034066, $0.23+$0.02 CAD Hold'em No Limit - Level VI (50/100) - 2023/09/28 0:51:00 ET
Table '3651034066 1' 3-max Seat #1 is the button
Seat 1: CashMatteo (580 in chips) 
Seat 3: raybinz (920 in chips) 
CashMatteo: posts small blind 50
raybinz: posts big blind 100
*** HOLE CARDS ***
Dealt to CashMatteo [Ad Jd]
CashMatteo: calls 50
raybinz: checks 
*** FLOP *** [9d 2d 4s]
raybinz: checks 
CashMatteo: checks 
*** TURN *** [9d 2d 4s] [6s]
raybinz: checks 
CashMatteo: checks 
*** RIVER *** [9d 2d 4s 6s] [8c]
raybinz: checks 
CashMatteo: checks 
*** SHOW DOWN ***
raybinz: shows [5c Td] (high card Ten)
CashMatteo: shows [Ad Jd] (high card Ace)
CashMatteo collected 200 from pot
*** SUMMARY ***
Total pot 200 | Rake 0 
Board [9d 2d 4s 6s 8c]
Seat 1: CashMatteo (button) (small blind) showed [Ad Jd] and won (200) with high card Ace
Seat 3: raybinz (big blind) showed [5c Td] and lost with high card Ten

Hand #211: 

PokerStars Hand #246223200839: Tournament #3651034066, $0.23+$0.02 CAD Hold'em No Limit - Level VI (50/100) - 2023/09/28 0:51:17 ET
Table '3651034066 1' 3-max Seat #3 is the button
Seat 1: CashMatteo (680 in chips) 
Seat 3: raybinz (820 in chips) 
raybinz: posts small blind 50
CashMatteo: posts big blind 100
*** HOLE CARDS ***
Dealt to CashMatteo [Ad 2d]
raybinz: folds 
Uncalled bet (50) returned to CashMatteo
CashMatteo collected 100 from pot
CashMatteo: doesn't show hand 
*** SUMMARY ***
Total pot 100 | Rake 0 
Seat 1: CashMatteo (big blind) collected (100)
Seat 3: raybinz (button) (small blind) folded before Flop

Hand #212: 

PokerStars Hand #246223201289: Tournament #3651034066, $0.23+$0.02 CAD Hold'em No Limit - Level VI (50/100) - 2023/09/28 0:51:21 ET
Table '3651034066 1' 3-max Seat #1 is the button
Seat 1: CashMatteo (730 in chips) 
Seat 3: raybinz (770 in chips) 
CashMatteo: posts small blind 50
raybinz: posts big blind 100
*** HOLE CARDS ***
Dealt to CashMatteo [2h 7c]
CashMatteo: folds 
Uncalled bet (50) returned to raybinz
raybinz collected 100 from pot
*** SUMMARY ***
Total pot 100 | Rake 0 
Seat 1: CashMatteo (button) (small blind) folded before Flop
Seat 3: raybinz (big blind) collected (100)

Hand #213: 

PokerStars Hand #246223201753: Tournament #3651034066, $0.23+$0.02 CAD Hold'em No Limit - Level VI (50/100) - 2023/09/28 0:51:26 ET
Table '3651034066 1' 3-max Seat #3 is the button
Seat 1: CashMatteo (680 in chips) 
Seat 3: raybinz (820 in chips) 
raybinz: posts small blind 50
CashMatteo: posts big blind 100
*** HOLE CARDS ***
Dealt to CashMatteo [5s 7h]
raybinz: calls 50
CashMatteo: checks 
*** FLOP *** [9h Tc Kd]
CashMatteo: checks 
raybinz: checks 
*** TURN *** [9h Tc Kd] [7s]
CashMatteo: checks 
raybinz: checks 
*** RIVER *** [9h Tc Kd 7s] [5c]
CashMatteo: bets 100
raybinz: calls 100
*** SHOW DOWN ***
CashMatteo: shows [5s 7h] (two pair, Sevens and Fives)
raybinz: mucks hand 
CashMatteo collected 400 from pot
*** SUMMARY ***
Total pot 400 | Rake 0 
Board [9h Tc Kd 7s 5c]
Seat 1: CashMatteo (big blind) showed [5s 7h] and won (400) with two pair, Sevens and Fives
Seat 3: raybinz (button) (small blind) mucked [7d 6s]

Hand #214: 

PokerStars Hand #246223203509: Tournament #3651034066, $0.23+$0.02 CAD Hold'em No Limit - Level VI (50/100) - 2023/09/28 0:51:43 ET
Table '3651034066 1' 3-max Seat #1 is the button
Seat 1: CashMatteo (880 in chips) 
Seat 3: raybinz (620 in chips) 
CashMatteo: posts small blind 50
raybinz: posts big blind 100
*** HOLE CARDS ***
Dealt to CashMatteo [Tc 7c]
CashMatteo: calls 50
raybinz: checks 
*** FLOP *** [Qs 7d 2c]
raybinz: checks 
CashMatteo: checks 
*** TURN *** [Qs 7d 2c] [3h]
raybinz: checks 
CashMatteo: checks 
*** RIVER *** [Qs 7d 2c 3h] [6c]
raybinz: checks 
CashMatteo: checks 
*** SHOW DOWN ***
raybinz: shows [4c Jc] (high card Queen)
CashMatteo: shows [Tc 7c] (a pair of Sevens)
CashMatteo collected 200 from pot
*** SUMMARY ***
Total pot 200 | Rake 0 
Board [Qs 7d 2c 3h 6c]
Seat 1: CashMatteo (button) (small blind) showed [Tc 7c] and won (200) with a pair of Sevens
Seat 3: raybinz (big blind) showed [4c Jc] and lost with high card Queen

Hand #215: 

PokerStars Hand #246223205473: Tournament #3651034066, $0.23+$0.02 CAD Hold'em No Limit - Level VII (60/120) - 2023/09/28 0:52:02 ET
Table '3651034066 1' 3-max Seat #3 is the button
Seat 1: CashMatteo (980 in chips) 
Seat 3: raybinz (520 in chips) 
raybinz: posts small blind 60
CashMatteo: posts big blind 120
*** HOLE CARDS ***
Dealt to CashMatteo [Qs 5h]
raybinz: folds 
Uncalled bet (60) returned to CashMatteo
CashMatteo collected 120 from pot
CashMatteo: doesn't show hand 
*** SUMMARY ***
Total pot 120 | Rake 0 
Seat 1: CashMatteo (big blind) collected (120)
Seat 3: raybinz (button) (small blind) folded before Flop

Hand #216: 

PokerStars Hand #246223206229: Tournament #3651034066, $0.23+$0.02 CAD Hold'em No Limit - Level VII (60/120) - 2023/09/28 0:52:09 ET
Table '3651034066 1' 3-max Seat #1 is the button
Seat 1: CashMatteo (1040 in chips) 
Seat 3: raybinz (460 in chips) 
CashMatteo: posts small blind 60
raybinz: posts big blind 120
*** HOLE CARDS ***
Dealt to CashMatteo [Tc 2d]
CashMatteo: folds 
Uncalled bet (60) returned to raybinz
raybinz collected 120 from pot
*** SUMMARY ***
Total pot 120 | Rake 0 
Seat 1: CashMatteo (button) (small blind) folded before Flop
Seat 3: raybinz (big blind) collected (120)

Hand #217: 

PokerStars Hand #246223207220: Tournament #3651034066, $0.23+$0.02 CAD Hold'em No Limit - Level VII (60/120) - 2023/09/28 0:52:18 ET
Table '3651034066 1' 3-max Seat #3 is the button
Seat 1: CashMatteo (980 in chips) 
Seat 3: raybinz (520 in chips) 
raybinz: posts small blind 60
CashMatteo: posts big blind 120
*** HOLE CARDS ***
Dealt to CashMatteo [Ad 6h]
raybinz: raises 120 to 240
CashMatteo: calls 120
*** FLOP *** [5d Td 3c]
CashMatteo: checks 
raybinz: checks 
*** TURN *** [5d Td 3c] [Ks]
CashMatteo: checks 
raybinz: checks 
*** RIVER *** [5d Td 3c Ks] [Jh]
CashMatteo: bets 120
raybinz: raises 120 to 240
CashMatteo: folds 
Uncalled bet (120) returned to raybinz
raybinz collected 720 from pot
*** SUMMARY ***
Total pot 720 | Rake 0 
Board [5d Td 3c Ks Jh]
Seat 1: CashMatteo (big blind) folded on the River
Seat 3: raybinz (button) (small blind) collected (720)

Hand #218: 

PokerStars Hand #246223210140: Tournament #3651034066, $0.23+$0.02 CAD Hold'em No Limit - Level VII (60/120) - 2023/09/28 0:52:46 ET
Table '3651034066 1' 3-max Seat #1 is the button
Seat 1: CashMatteo (620 in chips) 
Seat 3: raybinz (880 in chips) 
CashMatteo: posts small blind 60
raybinz: posts big blind 120
*** HOLE CARDS ***
Dealt to CashMatteo [7c Td]
CashMatteo: folds 
Uncalled bet (60) returned to raybinz
raybinz collected 120 from pot
*** SUMMARY ***
Total pot 120 | Rake 0 
Seat 1: CashMatteo (button) (small blind) folded before Flop
Seat 3: raybinz (big blind) collected (120)

Hand #219: 

PokerStars Hand #246223210675: Tournament #3651034066, $0.23+$0.02 CAD Hold'em No Limit - Level VII (60/120) - 2023/09/28 0:52:51 ET
Table '3651034066 1' 3-max Seat #3 is the button
Seat 1: CashMatteo (560 in chips) 
Seat 3: raybinz (940 in chips) 
raybinz: posts small blind 60
CashMatteo: posts big blind 120
*** HOLE CARDS ***
Dealt to CashMatteo [9c Ad]
raybinz: folds 
Uncalled bet (60) returned to CashMatteo
CashMatteo collected 120 from pot
CashMatteo: doesn't show hand 
*** SUMMARY ***
Total pot 120 | Rake 0 
Seat 1: CashMatteo (big blind) collected (120)
Seat 3: raybinz (button) (small blind) folded before Flop

Hand #220: 

PokerStars Hand #246223211158: Tournament #3651034066, $0.23+$0.02 CAD Hold'em No Limit - Level VII (60/120) - 2023/09/28 0:52:56 ET
Table '3651034066 1' 3-max Seat #1 is the button
Seat 1: CashMatteo (620 in chips) 
Seat 3: raybinz (880 in chips) 
CashMatteo: posts small blind 60
raybinz: posts big blind 120
*** HOLE CARDS ***
Dealt to CashMatteo [2s 8c]
CashMatteo: calls 60
raybinz: raises 240 to 360
CashMatteo: folds 
Uncalled bet (240) returned to raybinz
raybinz collected 240 from pot
*** SUMMARY ***
Total pot 240 | Rake 0 
Seat 1: CashMatteo (button) (small blind) folded before Flop
Seat 3: raybinz (big blind) collected (240)

Hand #221: 

PokerStars Hand #246223212154: Tournament #3651034066, $0.23+$0.02 CAD Hold'em No Limit - Level VII (60/120) - 2023/09/28 0:53:06 ET
Table '3651034066 1' 3-max Seat #3 is the button
Seat 1: CashMatteo (500 in chips) 
Seat 3: raybinz (1000 in chips) 
raybinz: posts small blind 60
CashMatteo: posts big blind 120
*** HOLE CARDS ***
Dealt to CashMatteo [As 6h]
raybinz: calls 60
CashMatteo: checks 
*** FLOP *** [Js Jh 2d]
CashMatteo: checks 
raybinz: checks 
*** TURN *** [Js Jh 2d] [Kc]
CashMatteo: checks 
raybinz: checks 
*** RIVER *** [Js Jh 2d Kc] [3s]
CashMatteo: checks 
raybinz: bets 240
CashMatteo: calls 240
*** SHOW DOWN ***
raybinz: shows [3c Jc] (a full house, Jacks full of Threes)
CashMatteo: mucks hand 
raybinz collected 720 from pot
*** SUMMARY ***
Total pot 720 | Rake 0 
Board [Js Jh 2d Kc 3s]
Seat 1: CashMatteo (big blind) mucked [As 6h]
Seat 3: raybinz (button) (small blind) showed [3c Jc] and won (720) with a full house, Jacks full of Threes

Hand #222: 

PokerStars Hand #246223214126: Tournament #3651034066, $0.23+$0.02 CAD Hold'em No Limit - Level VII (60/120) - 2023/09/28 0:53:24 ET
Table '3651034066 1' 3-max Seat #1 is the button
Seat 1: CashMatteo (140 in chips) 
Seat 3: raybinz (1360 in chips) 
CashMatteo: posts small blind 60
raybinz: posts big blind 120
*** HOLE CARDS ***
Dealt to CashMatteo [6c Ah]
CashMatteo: raises 20 to 140 and is all-in
raybinz: calls 20
*** FLOP *** [5d Tc 3c]
*** TURN *** [5d Tc 3c] [Jc]
*** RIVER *** [5d Tc 3c Jc] [Jd]
*** SHOW DOWN ***
raybinz: shows [7c As] (a pair of Jacks)
CashMatteo: shows [6c Ah] (a pair of Jacks - lower kicker)
raybinz collected 280 from pot
CashMatteo finished the tournament in 2nd place
raybinz wins the tournament and receives $0.75 - congratulations!
*** SUMMARY ***
Total pot 280 | Rake 0 
Board [5d Tc 3c Jc Jd]
Seat 1: CashMatteo (button) (small blind) showed [6c Ah] and lost with a pair of Jacks
Seat 3: raybinz (big blind) showed [7c As] and won (280) with a pair of Jacks

Hand #223: 

PokerStars Hand #246223220763: Tournament #3651037394, $0.23+$0.02 CAD Hold'em No Limit - Level I (10/20) - 2023/09/28 0:54:29 ET
Table '3651037394 1' 3-max Seat #1 is the button
Seat 1: ewlai (500 in chips) 
Seat 2: burilkasq (500 in chips) 
Seat 3: CashMatteo (500 in chips) 
burilkasq: posts small blind 10
CashMatteo: posts big blind 20
*** HOLE CARDS ***
Dealt to CashMatteo [Qs 3d]
ewlai: raises 20 to 40
burilkasq: calls 30
CashMatteo: folds 
*** FLOP *** [Ad 9s 6h]
burilkasq: checks 
ewlai: bets 40
burilkasq: calls 40
*** TURN *** [Ad 9s 6h] [3c]
burilkasq: checks 
ewlai: checks 
*** RIVER *** [Ad 9s 6h 3c] [Ah]
burilkasq: checks 
ewlai: bets 40
burilkasq: folds 
Uncalled bet (40) returned to ewlai
ewlai collected 180 from pot
ewlai: doesn't show hand 
*** SUMMARY ***
Total pot 180 | Rake 0 
Board [Ad 9s 6h 3c Ah]
Seat 1: ewlai (button) collected (180)
Seat 2: burilkasq (small blind) folded on the River
Seat 3: CashMatteo (big blind) folded before Flop

Hand #224: 

PokerStars Hand #246223225267: Tournament #3651037394, $0.23+$0.02 CAD Hold'em No Limit - Level I (10/20) - 2023/09/28 0:55:15 ET
Table '3651037394 1' 3-max Seat #2 is the button
Seat 1: ewlai (600 in chips) 
Seat 2: burilkasq (420 in chips) 
Seat 3: CashMatteo (480 in chips) 
CashMatteo: posts small blind 10
ewlai: posts big blind 20
*** HOLE CARDS ***
Dealt to CashMatteo [Jc 3s]
burilkasq: calls 20
CashMatteo: calls 10
ewlai: raises 20 to 40
burilkasq: calls 20
CashMatteo: folds 
*** FLOP *** [4s 9d 6s]
ewlai: checks 
burilkasq: checks 
*** TURN *** [4s 9d 6s] [6c]
ewlai: checks 
burilkasq: bets 20
ewlai: folds 
Uncalled bet (20) returned to burilkasq
burilkasq collected 100 from pot
*** SUMMARY ***
Total pot 100 | Rake 0 
Board [4s 9d 6s 6c]
Seat 1: ewlai (big blind) folded on the Turn
Seat 2: burilkasq (button) collected (100)
Seat 3: CashMatteo (small blind) folded before Flop

Hand #225: 

PokerStars Hand #246223227389: Tournament #3651037394, $0.23+$0.02 CAD Hold'em No Limit - Level I (10/20) - 2023/09/28 0:55:39 ET
Table '3651037394 1' 3-max Seat #3 is the button
Seat 1: ewlai (560 in chips) 
Seat 2: burilkasq (480 in chips) 
Seat 3: CashMatteo (460 in chips) 
ewlai: posts small blind 10
burilkasq: posts big blind 20
*** HOLE CARDS ***
Dealt to CashMatteo [Kc Qh]
CashMatteo: raises 20 to 40
ewlai: folds 
burilkasq: calls 20
*** FLOP *** [Kd Kh 6h]
burilkasq: checks 
CashMatteo: checks 
*** TURN *** [Kd Kh 6h] [4d]
burilkasq: checks 
CashMatteo: bets 45
burilkasq: folds 
Uncalled bet (45) returned to CashMatteo
CashMatteo collected 90 from pot
CashMatteo: doesn't show hand 
*** SUMMARY ***
Total pot 90 | Rake 0 
Board [Kd Kh 6h 4d]
Seat 1: ewlai (small blind) folded before Flop
Seat 2: burilkasq (big blind) folded on the Turn
Seat 3: CashMatteo (button) collected (90)

Hand #226: 

PokerStars Hand #246223228829: Tournament #3651037394, $0.23+$0.02 CAD Hold'em No Limit - Level I (10/20) - 2023/09/28 0:55:55 ET
Table '3651037394 1' 3-max Seat #1 is the button
Seat 1: ewlai (550 in chips) 
Seat 2: burilkasq (440 in chips) 
Seat 3: CashMatteo (510 in chips) 
burilkasq: posts small blind 10
CashMatteo: posts big blind 20
*** HOLE CARDS ***
Dealt to CashMatteo [Kc 8c]
ewlai: raises 40 to 60
burilkasq: folds 
CashMatteo: calls 40
*** FLOP *** [8s Qd 9c]
CashMatteo: bets 80
ewlai: calls 80
*** TURN *** [8s Qd 9c] [4s]
CashMatteo: checks 
ewlai: bets 60
CashMatteo: calls 60
*** RIVER *** [8s Qd 9c 4s] [Kd]
CashMatteo: checks 
ewlai: checks 
*** SHOW DOWN ***
CashMatteo: shows [Kc 8c] (two pair, Kings and Eights)
ewlai: mucks hand 
CashMatteo collected 410 from pot
*** SUMMARY ***
Total pot 410 | Rake 0 
Board [8s Qd 9c 4s Kd]
Seat 1: ewlai (button) mucked [Ah Tc]
Seat 2: burilkasq (small blind) folded before Flop
Seat 3: CashMatteo (big blind) showed [Kc 8c] and won (410) with two pair, Kings and Eights

Hand #227: 

PokerStars Hand #246223233136: Tournament #3651037394, $0.23+$0.02 CAD Hold'em No Limit - Level II (15/30) - 2023/09/28 0:56:43 ET
Table '3651037394 1' 3-max Seat #2 is the button
Seat 1: ewlai (350 in chips) 
Seat 2: burilkasq (430 in chips) 
Seat 3: CashMatteo (720 in chips) 
CashMatteo: posts small blind 15
ewlai: posts big blind 30
*** HOLE CARDS ***
Dealt to CashMatteo [8c Js]
burilkasq: folds 
CashMatteo: calls 15
ewlai: checks 
*** FLOP *** [Ac 3s Tc]
CashMatteo: checks 
ewlai: checks 
*** TURN *** [Ac 3s Tc] [Ad]
CashMatteo: checks 
ewlai: checks 
*** RIVER *** [Ac 3s Tc Ad] [6d]
CashMatteo: checks 
ewlai: checks 
*** SHOW DOWN ***
CashMatteo: shows [8c Js] (a pair of Aces)
ewlai: shows [9c 3h] (two pair, Aces and Threes)
ewlai collected 60 from pot
*** SUMMARY ***
Total pot 60 | Rake 0 
Board [Ac 3s Tc Ad 6d]
Seat 1: ewlai (big blind) showed [9c 3h] and won (60) with two pair, Aces and Threes
Seat 2: burilkasq (button) folded before Flop (didn't bet)
Seat 3: CashMatteo (small blind) showed [8c Js] and lost with a pair of Aces

Hand #228: 

PokerStars Hand #246223235120: Tournament #3651037394, $0.23+$0.02 CAD Hold'em No Limit - Level II (15/30) - 2023/09/28 0:57:05 ET
Table '3651037394 1' 3-max Seat #3 is the button
Seat 1: ewlai (380 in chips) 
Seat 2: burilkasq (430 in chips) 
Seat 3: CashMatteo (690 in chips) 
ewlai: posts small blind 15
burilkasq: posts big blind 30
*** HOLE CARDS ***
Dealt to CashMatteo [9c 7s]
CashMatteo: calls 30
ewlai: folds 
burilkasq: checks 
*** FLOP *** [Kh Td 8s]
burilkasq: bets 30
CashMatteo: calls 30
*** TURN *** [Kh Td 8s] [6h]
burilkasq: bets 60
CashMatteo: calls 60
*** RIVER *** [Kh Td 8s 6h] [Qh]
burilkasq: bets 120
CashMatteo: raises 248 to 368
burilkasq: calls 190 and is all-in
Uncalled bet (58) returned to CashMatteo
*** SHOW DOWN ***
CashMatteo: shows [9c 7s] (a straight, Six to Ten)
burilkasq: shows [6d Kc] (two pair, Kings and Sixes)
CashMatteo collected 875 from pot
burilkasq finished the tournament in 3rd place
*** SUMMARY ***
Total pot 875 | Rake 0 
Board [Kh Td 8s 6h Qh]
Seat 1: ewlai (small blind) folded before Flop
Seat 2: burilkasq (big blind) showed [6d Kc] and lost with two pair, Kings and Sixes
Seat 3: CashMatteo (button) showed [9c 7s] and won (875) with a straight, Six to Ten

Hand #229: 

PokerStars Hand #246223238191: Tournament #3651037394, $0.23+$0.02 CAD Hold'em No Limit - Level II (15/30) - 2023/09/28 0:57:41 ET
Table '3651037394 1' 3-max Seat #1 is the button
Seat 1: ewlai (365 in chips) 
Seat 3: CashMatteo (1135 in chips) 
ewlai: posts small blind 15
CashMatteo: posts big blind 30
*** HOLE CARDS ***
Dealt to CashMatteo [8s 5c]
ewlai: raises 60 to 90
CashMatteo: folds 
Uncalled bet (60) returned to ewlai
ewlai collected 60 from pot
ewlai: doesn't show hand 
*** SUMMARY ***
Total pot 60 | Rake 0 
Seat 1: ewlai (button) (small blind) collected (60)
Seat 3: CashMatteo (big blind) folded before Flop

Hand #230: 

PokerStars Hand #246223239052: Tournament #3651037394, $0.23+$0.02 CAD Hold'em No Limit - Level II (15/30) - 2023/09/28 0:57:51 ET
Table '3651037394 1' 3-max Seat #3 is the button
Seat 1: ewlai (395 in chips) 
Seat 3: CashMatteo (1105 in chips) 
CashMatteo: posts small blind 15
ewlai: posts big blind 30
*** HOLE CARDS ***
Dealt to CashMatteo [Qc Th]
CashMatteo: calls 15
ewlai: checks 
*** FLOP *** [Js 6h 7s]
ewlai: checks 
CashMatteo: checks 
*** TURN *** [Js 6h 7s] [Ts]
ewlai: checks 
CashMatteo: checks 
*** RIVER *** [Js 6h 7s Ts] [Td]
ewlai: checks 
CashMatteo: bets 30
ewlai: folds 
Uncalled bet (30) returned to CashMatteo
CashMatteo collected 60 from pot
CashMatteo: doesn't show hand 
*** SUMMARY ***
Total pot 60 | Rake 0 
Board [Js 6h 7s Ts Td]
Seat 1: ewlai (big blind) folded on the River
Seat 3: CashMatteo (button) (small blind) collected (60)

Hand #231: 

PokerStars Hand #246223242000: Tournament #3651037394, $0.23+$0.02 CAD Hold'em No Limit - Level II (15/30) - 2023/09/28 0:58:23 ET
Table '3651037394 1' 3-max Seat #1 is the button
Seat 1: ewlai (365 in chips) 
Seat 3: CashMatteo (1135 in chips) 
ewlai: posts small blind 15
CashMatteo: posts big blind 30
*** HOLE CARDS ***
Dealt to CashMatteo [Kh 6d]
ewlai: calls 15
CashMatteo: checks 
*** FLOP *** [5h 8s 3h]
CashMatteo: checks 
ewlai: bets 30
CashMatteo: folds 
Uncalled bet (30) returned to ewlai
ewlai collected 60 from pot
ewlai: doesn't show hand 
*** SUMMARY ***
Total pot 60 | Rake 0 
Board [5h 8s 3h]
Seat 1: ewlai (button) (small blind) collected (60)
Seat 3: CashMatteo (big blind) folded on the Flop

Hand #232: 

PokerStars Hand #246223243495: Tournament #3651037394, $0.23+$0.02 CAD Hold'em No Limit - Level III (20/40) - 2023/09/28 0:58:40 ET
Table '3651037394 1' 3-max Seat #3 is the button
Seat 1: ewlai (395 in chips) 
Seat 3: CashMatteo (1105 in chips) 
CashMatteo: posts small blind 20
ewlai: posts big blind 40
*** HOLE CARDS ***
Dealt to CashMatteo [3d 2c]
CashMatteo: calls 20
ewlai: raises 80 to 120
CashMatteo: folds 
Uncalled bet (80) returned to ewlai
ewlai collected 80 from pot
ewlai: doesn't show hand 
*** SUMMARY ***
Total pot 80 | Rake 0 
Seat 1: ewlai (big blind) collected (80)
Seat 3: CashMatteo (button) (small blind) folded before Flop

Hand #233: 

PokerStars Hand #246223244530: Tournament #3651037394, $0.23+$0.02 CAD Hold'em No Limit - Level III (20/40) - 2023/09/28 0:58:51 ET
Table '3651037394 1' 3-max Seat #1 is the button
Seat 1: ewlai (435 in chips) 
Seat 3: CashMatteo (1065 in chips) 
ewlai: posts small blind 20
CashMatteo: posts big blind 40
*** HOLE CARDS ***
Dealt to CashMatteo [Ks Js]
ewlai: raises 40 to 80
CashMatteo: raises 40 to 120
ewlai: calls 40
*** FLOP *** [Td 7s Qs]
CashMatteo: bets 120
ewlai: raises 195 to 315 and is all-in
CashMatteo: calls 195
*** TURN *** [Td 7s Qs] [Kc]
*** RIVER *** [Td 7s Qs Kc] [2c]
*** SHOW DOWN ***
CashMatteo: shows [Ks Js] (a pair of Kings)
ewlai: shows [7h Qd] (two pair, Queens and Sevens)
ewlai collected 870 from pot
*** SUMMARY ***
Total pot 870 | Rake 0 
Board [Td 7s Qs Kc 2c]
Seat 1: ewlai (button) (small blind) showed [7h Qd] and won (870) with two pair, Queens and Sevens
Seat 3: CashMatteo (big blind) showed [Ks Js] and lost with a pair of Kings

Hand #234: 

PokerStars Hand #246223247577: Tournament #3651037394, $0.23+$0.02 CAD Hold'em No Limit - Level III (20/40) - 2023/09/28 0:59:25 ET
Table '3651037394 1' 3-max Seat #3 is the button
Seat 1: ewlai (870 in chips) 
Seat 3: CashMatteo (630 in chips) 
CashMatteo: posts small blind 20
ewlai: posts big blind 40
*** HOLE CARDS ***
Dealt to CashMatteo [6c Ad]
CashMatteo: calls 20
ewlai: checks 
*** FLOP *** [4s Jh Qd]
ewlai: bets 40
CashMatteo: folds 
Uncalled bet (40) returned to ewlai
ewlai collected 80 from pot
ewlai: doesn't show hand 
*** SUMMARY ***
Total pot 80 | Rake 0 
Board [4s Jh Qd]
Seat 1: ewlai (big blind) collected (80)
Seat 3: CashMatteo (button) (small blind) folded on the Flop

Hand #235: 

PokerStars Hand #246223249490: Tournament #3651037394, $0.23+$0.02 CAD Hold'em No Limit - Level III (20/40) - 2023/09/28 0:59:47 ET
Table '3651037394 1' 3-max Seat #1 is the button
Seat 1: ewlai (910 in chips) 
Seat 3: CashMatteo (590 in chips) 
ewlai: posts small blind 20
CashMatteo: posts big blind 40
*** HOLE CARDS ***
Dealt to CashMatteo [Jd 2d]
ewlai: calls 20
CashMatteo: checks 
*** FLOP *** [6s 8h 4c]
CashMatteo: checks 
ewlai: bets 40
CashMatteo: folds 
Uncalled bet (40) returned to ewlai
ewlai collected 80 from pot
ewlai: doesn't show hand 
*** SUMMARY ***
Total pot 80 | Rake 0 
Board [6s 8h 4c]
Seat 1: ewlai (button) (small blind) collected (80)
Seat 3: CashMatteo (big blind) folded on the Flop

Hand #236: 

PokerStars Hand #246223250506: Tournament #3651037394, $0.23+$0.02 CAD Hold'em No Limit - Level III (20/40) - 2023/09/28 0:59:59 ET
Table '3651037394 1' 3-max Seat #3 is the button
Seat 1: ewlai (950 in chips) 
Seat 3: CashMatteo (550 in chips) 
CashMatteo: posts small blind 20
ewlai: posts big blind 40
*** HOLE CARDS ***
Dealt to CashMatteo [9d 8c]
CashMatteo: folds 
Uncalled bet (20) returned to ewlai
ewlai collected 40 from pot
ewlai: doesn't show hand 
*** SUMMARY ***
Total pot 40 | Rake 0 
Seat 1: ewlai (big blind) collected (40)
Seat 3: CashMatteo (button) (small blind) folded before Flop

Hand #237: 

PokerStars Hand #246223250991: Tournament #3651037394, $0.23+$0.02 CAD Hold'em No Limit - Level III (20/40) - 2023/09/28 1:00:04 ET
Table '3651037394 1' 3-max Seat #1 is the button
Seat 1: ewlai (970 in chips) 
Seat 3: CashMatteo (530 in chips) 
ewlai: posts small blind 20
CashMatteo: posts big blind 40
*** HOLE CARDS ***
Dealt to CashMatteo [9c 2d]
ewlai: calls 20
CashMatteo: checks 
*** FLOP *** [Ac Kh Jh]
CashMatteo: checks 
ewlai: checks 
*** TURN *** [Ac Kh Jh] [Ks]
CashMatteo: checks 
ewlai: checks 
*** RIVER *** [Ac Kh Jh Ks] [Td]
CashMatteo: checks 
ewlai: checks 
*** SHOW DOWN ***
CashMatteo: shows [9c 2d] (a pair of Kings)
ewlai: shows [5s 9h] (a pair of Kings)
CashMatteo collected 40 from pot
ewlai collected 40 from pot
*** SUMMARY ***
Total pot 80 | Rake 0 
Board [Ac Kh Jh Ks Td]
Seat 1: ewlai (button) (small blind) showed [5s 9h] and won (40) with a pair of Kings
Seat 3: CashMatteo (big blind) showed [9c 2d] and won (40) with a pair of Kings

Hand #238: 

PokerStars Hand #246223254414: Tournament #3651037394, $0.23+$0.02 CAD Hold'em No Limit - Level IV (30/60) - 2023/09/28 1:00:40 ET
Table '3651037394 1' 3-max Seat #3 is the button
Seat 1: ewlai (970 in chips) 
Seat 3: CashMatteo (530 in chips) 
CashMatteo: posts small blind 30
ewlai: posts big blind 60
*** HOLE CARDS ***
Dealt to CashMatteo [7c 2c]
CashMatteo: folds 
Uncalled bet (30) returned to ewlai
ewlai collected 60 from pot
ewlai: doesn't show hand 
*** SUMMARY ***
Total pot 60 | Rake 0 
Seat 1: ewlai (big blind) collected (60)
Seat 3: CashMatteo (button) (small blind) folded before Flop

Hand #239: 

PokerStars Hand #246223254872: Tournament #3651037394, $0.23+$0.02 CAD Hold'em No Limit - Level IV (30/60) - 2023/09/28 1:00:45 ET
Table '3651037394 1' 3-max Seat #1 is the button
Seat 1: ewlai (1000 in chips) 
Seat 3: CashMatteo (500 in chips) 
ewlai: posts small blind 30
CashMatteo: posts big blind 60
*** HOLE CARDS ***
Dealt to CashMatteo [As 8s]
ewlai: raises 120 to 180
CashMatteo: calls 120
*** FLOP *** [Kh Ks 2c]
CashMatteo: checks 
ewlai: bets 120
CashMatteo: folds 
Uncalled bet (120) returned to ewlai
ewlai collected 360 from pot
ewlai: doesn't show hand 
*** SUMMARY ***
Total pot 360 | Rake 0 
Board [Kh Ks 2c]
Seat 1: ewlai (button) (small blind) collected (360)
Seat 3: CashMatteo (big blind) folded on the Flop

Hand #240: 

PokerStars Hand #246223257074: Tournament #3651037394, $0.23+$0.02 CAD Hold'em No Limit - Level IV (30/60) - 2023/09/28 1:01:08 ET
Table '3651037394 1' 3-max Seat #3 is the button
Seat 1: ewlai (1180 in chips) 
Seat 3: CashMatteo (320 in chips) 
CashMatteo: posts small blind 30
ewlai: posts big blind 60
*** HOLE CARDS ***
Dealt to CashMatteo [4c Ts]
CashMatteo: folds 
Uncalled bet (30) returned to ewlai
ewlai collected 60 from pot
ewlai: doesn't show hand 
*** SUMMARY ***
Total pot 60 | Rake 0 
Seat 1: ewlai (big blind) collected (60)
Seat 3: CashMatteo (button) (small blind) folded before Flop

Hand #241: 

PokerStars Hand #246223257602: Tournament #3651037394, $0.23+$0.02 CAD Hold'em No Limit - Level IV (30/60) - 2023/09/28 1:01:13 ET
Table '3651037394 1' 3-max Seat #1 is the button
Seat 1: ewlai (1210 in chips) 
Seat 3: CashMatteo (290 in chips) 
ewlai: posts small blind 30
CashMatteo: posts big blind 60
*** HOLE CARDS ***
Dealt to CashMatteo [Kc 2h]
ewlai: calls 30
CashMatteo: checks 
*** FLOP *** [8c 5s 9d]
CashMatteo: checks 
ewlai: checks 
*** TURN *** [8c 5s 9d] [6h]
CashMatteo: checks 
ewlai: checks 
*** RIVER *** [8c 5s 9d 6h] [7s]
CashMatteo: checks 
ewlai: bets 240
CashMatteo: folds 
Uncalled bet (240) returned to ewlai
ewlai collected 120 from pot
ewlai: doesn't show hand 
*** SUMMARY ***
Total pot 120 | Rake 0 
Board [8c 5s 9d 6h 7s]
Seat 1: ewlai (button) (small blind) collected (120)
Seat 3: CashMatteo (big blind) folded on the River

Hand #242: 

PokerStars Hand #246223261301: Tournament #3651037394, $0.23+$0.02 CAD Hold'em No Limit - Level IV (30/60) - 2023/09/28 1:01:50 ET
Table '3651037394 1' 3-max Seat #3 is the button
Seat 1: ewlai (1270 in chips) 
Seat 3: CashMatteo (230 in chips) 
CashMatteo: posts small blind 30
ewlai: posts big blind 60
*** HOLE CARDS ***
Dealt to CashMatteo [Ts Qh]
CashMatteo: raises 60 to 120
ewlai: calls 60
*** FLOP *** [4d 2c 9s]
ewlai: checks 
CashMatteo: bets 110 and is all-in
ewlai: calls 110
*** TURN *** [4d 2c 9s] [2s]
*** RIVER *** [4d 2c 9s 2s] [Kd]
*** SHOW DOWN ***
ewlai: shows [Qd Kh] (two pair, Kings and Deuces)
CashMatteo: shows [Ts Qh] (a pair of Deuces)
ewlai collected 460 from pot
CashMatteo finished the tournament in 2nd place
ewlai wins the tournament and receives $0.50 - congratulations!
*** SUMMARY ***
Total pot 460 | Rake 0 
Board [4d 2c 9s 2s Kd]
Seat 1: ewlai (big blind) showed [Qd Kh] and won (460) with two pair, Kings and Deuces
Seat 3: CashMatteo (button) (small blind) showed [Ts Qh] and lost with a pair of Deuces

Hand #243: 

PokerStars Hand #246223267255: Tournament #3651038433, $0.23+$0.02 CAD Hold'em No Limit - Level I (10/20) - 2023/09/28 1:02:52 ET
Table '3651038433 1' 3-max Seat #1 is the button
Seat 1: hafpatorse23 (500 in chips) 
Seat 2: CashMatteo (500 in chips) 
Seat 3: ladybz (500 in chips) 
CashMatteo: posts small blind 10
ladybz: posts big blind 20
*** HOLE CARDS ***
Dealt to CashMatteo [2s 3d]
hafpatorse23: raises 20 to 40
CashMatteo: calls 30
ladybz: calls 20
*** FLOP *** [9d Kh 7s]
CashMatteo: checks 
ladybz: bets 20
hafpatorse23: calls 20
CashMatteo: folds 
*** TURN *** [9d Kh 7s] [Js]
ladybz: checks 
hafpatorse23: checks 
*** RIVER *** [9d Kh 7s Js] [Ah]
ladybz: checks 
hafpatorse23: checks 
*** SHOW DOWN ***
ladybz: shows [Kd 7d] (two pair, Kings and Sevens)
hafpatorse23: mucks hand 
ladybz collected 160 from pot
*** SUMMARY ***
Total pot 160 | Rake 0 
Board [9d Kh 7s Js Ah]
Seat 1: hafpatorse23 (button) mucked [5d 5h]
Seat 2: CashMatteo (small blind) folded on the Flop
Seat 3: ladybz (big blind) showed [Kd 7d] and won (160) with two pair, Kings and Sevens

Hand #244: 

PokerStars Hand #246223269004: Tournament #3651038433, $0.23+$0.02 CAD Hold'em No Limit - Level I (10/20) - 2023/09/28 1:03:09 ET
Table '3651038433 1' 3-max Seat #2 is the button
Seat 1: hafpatorse23 (440 in chips) 
Seat 2: CashMatteo (460 in chips) 
Seat 3: ladybz (600 in chips) 
ladybz: posts small blind 10
hafpatorse23: posts big blind 20
*** HOLE CARDS ***
Dealt to CashMatteo [2h Ts]
CashMatteo: folds 
ladybz: calls 10
hafpatorse23: checks 
*** FLOP *** [Jc 2c Ks]
ladybz: checks 
hafpatorse23: checks 
*** TURN *** [Jc 2c Ks] [3s]
ladybz: checks 
hafpatorse23: bets 20
ladybz: calls 20
*** RIVER *** [Jc 2c Ks 3s] [Tc]
ladybz: checks 
hafpatorse23: bets 20
ladybz: calls 20
*** SHOW DOWN ***
hafpatorse23: shows [Kh 3h] (two pair, Kings and Threes)
ladybz: mucks hand 
hafpatorse23 collected 120 from pot
*** SUMMARY ***
Total pot 120 | Rake 0 
Board [Jc 2c Ks 3s Tc]
Seat 1: hafpatorse23 (big blind) showed [Kh 3h] and won (120) with two pair, Kings and Threes
Seat 2: CashMatteo (button) folded before Flop (didn't bet)
Seat 3: ladybz (small blind) mucked [6c Td]

Hand #245: 

PokerStars Hand #246223271384: Tournament #3651038433, $0.23+$0.02 CAD Hold'em No Limit - Level I (10/20) - 2023/09/28 1:03:33 ET
Table '3651038433 1' 3-max Seat #3 is the button
Seat 1: hafpatorse23 (500 in chips) 
Seat 2: CashMatteo (460 in chips) 
Seat 3: ladybz (540 in chips) 
hafpatorse23: posts small blind 10
CashMatteo: posts big blind 20
*** HOLE CARDS ***
Dealt to CashMatteo [Qc 9c]
ladybz: calls 20
hafpatorse23: calls 10
CashMatteo: raises 40 to 60
ladybz: calls 40
hafpatorse23: calls 40
*** FLOP *** [4s Qd 2c]
hafpatorse23: checks 
CashMatteo: bets 90
ladybz: calls 90
hafpatorse23: folds 
*** TURN *** [4s Qd 2c] [Kc]
CashMatteo: bets 180
ladybz: folds 
Uncalled bet (180) returned to CashMatteo
CashMatteo collected 360 from pot
CashMatteo: doesn't show hand 
*** SUMMARY ***
Total pot 360 | Rake 0 
Board [4s Qd 2c Kc]
Seat 1: hafpatorse23 (small blind) folded on the Flop
Seat 2: CashMatteo (big blind) collected (360)
Seat 3: ladybz (button) folded on the Turn

Hand #246: 

PokerStars Hand #246223273478: Tournament #3651038433, $0.23+$0.02 CAD Hold'em No Limit - Level I (10/20) - 2023/09/28 1:03:54 ET
Table '3651038433 1' 3-max Seat #1 is the button
Seat 1: hafpatorse23 (440 in chips) 
Seat 2: CashMatteo (670 in chips) 
Seat 3: ladybz (390 in chips) 
CashMatteo: posts small blind 10
ladybz: posts big blind 20
*** HOLE CARDS ***
Dealt to CashMatteo [Ac Jh]
hafpatorse23: calls 20
CashMatteo: calls 10
ladybz: checks 
*** FLOP *** [Jd 2c 8s]
CashMatteo: bets 30
ladybz: calls 30
hafpatorse23: calls 30
*** TURN *** [Jd 2c 8s] [2d]
CashMatteo: bets 75
ladybz: folds 
hafpatorse23: raises 75 to 150
CashMatteo: calls 75
*** RIVER *** [Jd 2c 8s 2d] [9d]
CashMatteo: checks 
hafpatorse23: bets 60
CashMatteo: calls 60
*** SHOW DOWN ***
hafpatorse23: shows [6s 2h] (three of a kind, Deuces)
CashMatteo: mucks hand 
hafpatorse23 collected 570 from pot
*** SUMMARY ***
Total pot 570 | Rake 0 
Board [Jd 2c 8s 2d 9d]
Seat 1: hafpatorse23 (button) showed [6s 2h] and won (570) with three of a kind, Deuces
Seat 2: CashMatteo (small blind) mucked [Ac Jh]
Seat 3: ladybz (big blind) folded on the Turn

Hand #247: 

PokerStars Hand #246223276539: Tournament #3651038433, $0.23+$0.02 CAD Hold'em No Limit - Level I (10/20) - 2023/09/28 1:04:26 ET
Table '3651038433 1' 3-max Seat #2 is the button
Seat 1: hafpatorse23 (750 in chips) 
Seat 2: CashMatteo (410 in chips) 
Seat 3: ladybz (340 in chips) 
ladybz: posts small blind 10
hafpatorse23: posts big blind 20
*** HOLE CARDS ***
Dealt to CashMatteo [8c Ac]
CashMatteo: calls 20
ladybz: calls 10
hafpatorse23: raises 20 to 40
CashMatteo: calls 20
ladybz: calls 20
*** FLOP *** [6s 5d Ad]
ladybz: checks 
hafpatorse23: bets 20
CashMatteo: calls 20
ladybz: calls 20
*** TURN *** [6s 5d Ad] [5s]
ladybz: checks 
hafpatorse23: bets 60
CashMatteo: calls 60
ladybz: calls 60
*** RIVER *** [6s 5d Ad 5s] [Jh]
ladybz: checks 
hafpatorse23: bets 40
CashMatteo: calls 40
ladybz: folds 
*** SHOW DOWN ***
hafpatorse23: shows [Kc Ah] (two pair, Aces and Fives)
CashMatteo: mucks hand 
hafpatorse23 collected 440 from pot
*** SUMMARY ***
Total pot 440 | Rake 0 
Board [6s 5d Ad 5s Jh]
Seat 1: hafpatorse23 (big blind) showed [Kc Ah] and won (440) with two pair, Aces and Fives
Seat 2: CashMatteo (button) mucked [8c Ac]
Seat 3: ladybz (small blind) folded on the River

Hand #248: 

PokerStars Hand #246223280563: Tournament #3651038433, $0.23+$0.02 CAD Hold'em No Limit - Level I (10/20) - 2023/09/28 1:05:07 ET
Table '3651038433 1' 3-max Seat #3 is the button
Seat 1: hafpatorse23 (1030 in chips) 
Seat 2: CashMatteo (250 in chips) 
Seat 3: ladybz (220 in chips) 
hafpatorse23: posts small blind 10
CashMatteo: posts big blind 20
*** HOLE CARDS ***
Dealt to CashMatteo [9s 7d]
ladybz: calls 20
hafpatorse23: calls 10
CashMatteo: checks 
*** FLOP *** [5c 3c 4s]
hafpatorse23: checks 
CashMatteo: checks 
ladybz: checks 
*** TURN *** [5c 3c 4s] [5h]
hafpatorse23: bets 20
CashMatteo: folds 
ladybz: calls 20
*** RIVER *** [5c 3c 4s 5h] [Qs]
hafpatorse23: checks 
ladybz: checks 
*** SHOW DOWN ***
hafpatorse23: shows [9c 7c] (a pair of Fives)
ladybz: shows [9h Ad] (a pair of Fives - Ace kicker)
ladybz collected 100 from pot
*** SUMMARY ***
Total pot 100 | Rake 0 
Board [5c 3c 4s 5h Qs]
Seat 1: hafpatorse23 (small blind) showed [9c 7c] and lost with a pair of Fives
Seat 2: CashMatteo (big blind) folded on the Turn
Seat 3: ladybz (button) showed [9h Ad] and won (100) with a pair of Fives

Hand #249: 

PokerStars Hand #246223282331: Tournament #3651038433, $0.23+$0.02 CAD Hold'em No Limit - Level I (10/20) - 2023/09/28 1:05:25 ET
Table '3651038433 1' 3-max Seat #1 is the button
Seat 1: hafpatorse23 (990 in chips) 
Seat 2: CashMatteo (230 in chips) 
Seat 3: ladybz (280 in chips) 
CashMatteo: posts small blind 10
ladybz: posts big blind 20
*** HOLE CARDS ***
Dealt to CashMatteo [3s 5s]
hafpatorse23: calls 20
CashMatteo: calls 10
ladybz: checks 
*** FLOP *** [2c 5c Tc]
CashMatteo: checks 
ladybz: checks 
hafpatorse23: bets 20
CashMatteo: calls 20
ladybz: calls 20
*** TURN *** [2c 5c Tc] [8s]
CashMatteo: checks 
ladybz: checks 
hafpatorse23: checks 
*** RIVER *** [2c 5c Tc 8s] [As]
CashMatteo: checks 
ladybz: checks 
hafpatorse23: checks 
*** SHOW DOWN ***
CashMatteo: shows [3s 5s] (a pair of Fives)
ladybz: shows [Kd Kh] (a pair of Kings)
hafpatorse23: mucks hand 
ladybz collected 120 from pot
*** SUMMARY ***
Total pot 120 | Rake 0 
Board [2c 5c Tc 8s As]
Seat 1: hafpatorse23 (button) mucked [2d Kc]
Seat 2: CashMatteo (small blind) showed [3s 5s] and lost with a pair of Fives
Seat 3: ladybz (big blind) showed [Kd Kh] and won (120) with a pair of Kings

Hand #250: 

PokerStars Hand #246223284996: Tournament #3651038433, $0.23+$0.02 CAD Hold'em No Limit - Level I (10/20) - 2023/09/28 1:05:52 ET
Table '3651038433 1' 3-max Seat #2 is the button
Seat 1: hafpatorse23 (950 in chips) 
Seat 2: CashMatteo (190 in chips) 
Seat 3: ladybz (360 in chips) 
ladybz: posts small blind 10
hafpatorse23: posts big blind 20
*** HOLE CARDS ***
Dealt to CashMatteo [9d 7h]
CashMatteo: folds 
ladybz: calls 10
hafpatorse23: checks 
*** FLOP *** [Ks Jh Kd]
ladybz: checks 
hafpatorse23: bets 20
ladybz: calls 20
*** TURN *** [Ks Jh Kd] [Qs]
ladybz: bets 20
hafpatorse23: raises 20 to 40
ladybz: calls 20
*** RIVER *** [Ks Jh Kd Qs] [5s]
ladybz: bets 80
hafpatorse23: calls 80
*** SHOW DOWN ***
ladybz: shows [Th Ac] (a straight, Ten to Ace)
hafpatorse23: mucks hand 
ladybz collected 320 from pot
*** SUMMARY ***
Total pot 320 | Rake 0 
Board [Ks Jh Kd Qs 5s]
Seat 1: hafpatorse23 (big blind) mucked [9s Qd]
Seat 2: CashMatteo (button) folded before Flop (didn't bet)
Seat 3: ladybz (small blind) showed [Th Ac] and won (320) with a straight, Ten to Ace

Hand #251: 

PokerStars Hand #246223287555: Tournament #3651038433, $0.23+$0.02 CAD Hold'em No Limit - Level II (15/30) - 2023/09/28 1:06:18 ET
Table '3651038433 1' 3-max Seat #3 is the button
Seat 1: hafpatorse23 (790 in chips) 
Seat 2: CashMatteo (190 in chips) 
Seat 3: ladybz (520 in chips) 
hafpatorse23: posts small blind 15
CashMatteo: posts big blind 30
*** HOLE CARDS ***
Dealt to CashMatteo [As 8c]
ladybz: calls 30
hafpatorse23: calls 15
CashMatteo: checks 
*** FLOP *** [3c Qs 9s]
hafpatorse23: checks 
CashMatteo: checks 
ladybz: checks 
*** TURN *** [3c Qs 9s] [Ks]
hafpatorse23: checks 
CashMatteo: checks 
ladybz: checks 
*** RIVER *** [3c Qs 9s Ks] [Qc]
hafpatorse23: checks 
CashMatteo: checks 
ladybz: checks 
*** SHOW DOWN ***
hafpatorse23: shows [7c 4c] (a pair of Queens)
CashMatteo: shows [As 8c] (a pair of Queens - Ace kicker)
ladybz: mucks hand 
CashMatteo collected 90 from pot
*** SUMMARY ***
Total pot 90 | Rake 0 
Board [3c Qs 9s Ks Qc]
Seat 1: hafpatorse23 (small blind) showed [7c 4c] and lost with a pair of Queens
Seat 2: CashMatteo (big blind) showed [As 8c] and won (90) with a pair of Queens
Seat 3: ladybz (button) mucked [6c Js]

Hand #252: 

PokerStars Hand #246223290010: Tournament #3651038433, $0.23+$0.02 CAD Hold'em No Limit - Level II (15/30) - 2023/09/28 1:06:43 ET
Table '3651038433 1' 3-max Seat #1 is the button
Seat 1: hafpatorse23 (760 in chips) 
Seat 2: CashMatteo (250 in chips) 
Seat 3: ladybz (490 in chips) 
CashMatteo: posts small blind 15
ladybz: posts big blind 30
*** HOLE CARDS ***
Dealt to CashMatteo [7s 2s]
hafpatorse23: raises 30 to 60
CashMatteo: folds 
ladybz: calls 30
*** FLOP *** [Qd Ac 5c]
ladybz: checks 
hafpatorse23: bets 30
ladybz: calls 30
*** TURN *** [Qd Ac 5c] [Td]
ladybz: checks 
hafpatorse23: checks 
*** RIVER *** [Qd Ac 5c Td] [9s]
ladybz: checks 
hafpatorse23: checks 
*** SHOW DOWN ***
ladybz: shows [Tc Kd] (a pair of Tens)
hafpatorse23: shows [4d Ah] (a pair of Aces)
hafpatorse23 collected 195 from pot
*** SUMMARY ***
Total pot 195 | Rake 0 
Board [Qd Ac 5c Td 9s]
Seat 1: hafpatorse23 (button) showed [4d Ah] and won (195) with a pair of Aces
Seat 2: CashMatteo (small blind) folded before Flop
Seat 3: ladybz (big blind) showed [Tc Kd] and lost with a pair of Tens

Hand #253: 

PokerStars Hand #246223291962: Tournament #3651038433, $0.23+$0.02 CAD Hold'em No Limit - Level II (15/30) - 2023/09/28 1:07:02 ET
Table '3651038433 1' 3-max Seat #2 is the button
Seat 1: hafpatorse23 (865 in chips) 
Seat 2: CashMatteo (235 in chips) 
Seat 3: ladybz (400 in chips) 
ladybz: posts small blind 15
hafpatorse23: posts big blind 30
*** HOLE CARDS ***
Dealt to CashMatteo [7s Ks]
CashMatteo: calls 30
ladybz: calls 15
hafpatorse23: raises 30 to 60
CashMatteo: calls 30
ladybz: calls 30
*** FLOP *** [Kc 6d 6s]
ladybz: checks 
hafpatorse23: bets 60
CashMatteo: calls 60
ladybz: folds 
*** TURN *** [Kc 6d 6s] [3d]
hafpatorse23: checks 
CashMatteo: bets 115 and is all-in
hafpatorse23: folds 
Uncalled bet (115) returned to CashMatteo
CashMatteo collected 300 from pot
CashMatteo: doesn't show hand 
*** SUMMARY ***
Total pot 300 | Rake 0 
Board [Kc 6d 6s 3d]
Seat 1: hafpatorse23 (big blind) folded on the Turn
Seat 2: CashMatteo (button) collected (300)
Seat 3: ladybz (small blind) folded on the Flop

Hand #254: 

PokerStars Hand #246223293980: Tournament #3651038433, $0.23+$0.02 CAD Hold'em No Limit - Level II (15/30) - 2023/09/28 1:07:22 ET
Table '3651038433 1' 3-max Seat #3 is the button
Seat 1: hafpatorse23 (745 in chips) 
Seat 2: CashMatteo (415 in chips) 
Seat 3: ladybz (340 in chips) 
hafpatorse23: posts small blind 15
CashMatteo: posts big blind 30
*** HOLE CARDS ***
Dealt to CashMatteo [9h 8s]
ladybz: calls 30
hafpatorse23: calls 15
CashMatteo: checks 
*** FLOP *** [6h Ac Kc]
hafpatorse23: checks 
CashMatteo: checks 
ladybz: checks 
*** TURN *** [6h Ac Kc] [Qs]
hafpatorse23: bets 30
CashMatteo: folds 
ladybz: calls 30
*** RIVER *** [6h Ac Kc Qs] [Jc]
hafpatorse23: bets 150
ladybz: calls 150
*** SHOW DOWN ***
hafpatorse23: shows [5c Tc] (a flush, Ace high)
ladybz: mucks hand 
hafpatorse23 collected 450 from pot
*** SUMMARY ***
Total pot 450 | Rake 0 
Board [6h Ac Kc Qs Jc]
Seat 1: hafpatorse23 (small blind) showed [5c Tc] and won (450) with a flush, Ace high
Seat 2: CashMatteo (big blind) folded on the Turn
Seat 3: ladybz (button) mucked [8d 8c]

Hand #255: 

PokerStars Hand #246223296330: Tournament #3651038433, $0.23+$0.02 CAD Hold'em No Limit - Level II (15/30) - 2023/09/28 1:07:46 ET
Table '3651038433 1' 3-max Seat #1 is the button
Seat 1: hafpatorse23 (985 in chips) 
Seat 2: CashMatteo (385 in chips) 
Seat 3: ladybz (130 in chips) 
CashMatteo: posts small blind 15
ladybz: posts big blind 30
*** HOLE CARDS ***
Dealt to CashMatteo [9s 5c]
hafpatorse23: calls 30
CashMatteo: folds 
ladybz: checks 
*** FLOP *** [7h 6d As]
ladybz: checks 
hafpatorse23: bets 30
ladybz: folds 
Uncalled bet (30) returned to hafpatorse23
hafpatorse23 collected 75 from pot
*** SUMMARY ***
Total pot 75 | Rake 0 
Board [7h 6d As]
Seat 1: hafpatorse23 (button) collected (75)
Seat 2: CashMatteo (small blind) folded before Flop
Seat 3: ladybz (big blind) folded on the Flop

Hand #256: 

PokerStars Hand #246223297331: Tournament #3651038433, $0.23+$0.02 CAD Hold'em No Limit - Level II (15/30) - 2023/09/28 1:07:56 ET
Table '3651038433 1' 3-max Seat #2 is the button
Seat 1: hafpatorse23 (1030 in chips) 
Seat 2: CashMatteo (370 in chips) 
Seat 3: ladybz (100 in chips) 
ladybz: posts small blind 15
hafpatorse23: posts big blind 30
*** HOLE CARDS ***
Dealt to CashMatteo [Kd 4s]
CashMatteo: folds 
ladybz: folds 
Uncalled bet (15) returned to hafpatorse23
hafpatorse23 collected 30 from pot
*** SUMMARY ***
Total pot 30 | Rake 0 
Seat 1: hafpatorse23 (big blind) collected (30)
Seat 2: CashMatteo (button) folded before Flop (didn't bet)
Seat 3: ladybz (small blind) folded before Flop

Hand #257: 

PokerStars Hand #246223298045: Tournament #3651038433, $0.23+$0.02 CAD Hold'em No Limit - Level II (15/30) - 2023/09/28 1:08:04 ET
Table '3651038433 1' 3-max Seat #3 is the button
Seat 1: hafpatorse23 (1045 in chips) 
Seat 2: CashMatteo (370 in chips) 
Seat 3: ladybz (85 in chips) 
hafpatorse23: posts small blind 15
CashMatteo: posts big blind 30
*** HOLE CARDS ***
Dealt to CashMatteo [Qc 3h]
ladybz: calls 30
hafpatorse23: raises 30 to 60
CashMatteo: folds 
ladybz: calls 30
*** FLOP *** [Kd 3d Qs]
hafpatorse23: bets 30
ladybz: calls 25 and is all-in
Uncalled bet (5) returned to hafpatorse23
*** TURN *** [Kd 3d Qs] [5h]
*** RIVER *** [Kd 3d Qs 5h] [Ks]
*** SHOW DOWN ***
hafpatorse23: shows [Ah 8c] (a pair of Kings)
ladybz: shows [As 5c] (two pair, Kings and Fives)
ladybz collected 200 from pot
*** SUMMARY ***
Total pot 200 | Rake 0 
Board [Kd 3d Qs 5h Ks]
Seat 1: hafpatorse23 (small blind) showed [Ah 8c] and lost with a pair of Kings
Seat 2: CashMatteo (big blind) folded before Flop
Seat 3: ladybz (button) showed [As 5c] and won (200) with two pair, Kings and Fives

Hand #258: 

PokerStars Hand #246223299709: Tournament #3651038433, $0.23+$0.02 CAD Hold'em No Limit - Level II (15/30) - 2023/09/28 1:08:21 ET
Table '3651038433 1' 3-max Seat #1 is the button
Seat 1: hafpatorse23 (960 in chips) 
Seat 2: CashMatteo (340 in chips) 
Seat 3: ladybz (200 in chips) 
CashMatteo: posts small blind 15
ladybz: posts big blind 30
*** HOLE CARDS ***
Dealt to CashMatteo [4s Js]
hafpatorse23: calls 30
CashMatteo: calls 15
ladybz: checks 
*** FLOP *** [7d Jh Ad]
CashMatteo: checks 
ladybz: checks 
hafpatorse23: checks 
*** TURN *** [7d Jh Ad] [Ac]
CashMatteo: bets 45
ladybz: calls 45
hafpatorse23: calls 45
*** RIVER *** [7d Jh Ad Ac] [6s]
CashMatteo: checks 
ladybz: bets 60
hafpatorse23: calls 60
CashMatteo: calls 60
*** SHOW DOWN ***
ladybz: shows [3h Ah] (three of a kind, Aces)
hafpatorse23: mucks hand 
CashMatteo: mucks hand 
ladybz collected 405 from pot
*** SUMMARY ***
Total pot 405 | Rake 0 
Board [7d Jh Ad Ac 6s]
Seat 1: hafpatorse23 (button) mucked [7s Jd]
Seat 2: CashMatteo (small blind) mucked [4s Js]
Seat 3: ladybz (big blind) showed [3h Ah] and won (405) with three of a kind, Aces

Hand #259: 

PokerStars Hand #246223302161: Tournament #3651038433, $0.23+$0.02 CAD Hold'em No Limit - Level II (15/30) - 2023/09/28 1:08:46 ET
Table '3651038433 1' 3-max Seat #2 is the button
Seat 1: hafpatorse23 (825 in chips) 
Seat 2: CashMatteo (205 in chips) 
Seat 3: ladybz (470 in chips) 
ladybz: posts small blind 15
hafpatorse23: posts big blind 30
*** HOLE CARDS ***
Dealt to CashMatteo [6d As]
CashMatteo: calls 30
ladybz: calls 15
hafpatorse23: checks 
*** FLOP *** [Qs 3s 7h]
ladybz: checks 
hafpatorse23: checks 
CashMatteo: checks 
*** TURN *** [Qs 3s 7h] [Tc]
ladybz: checks 
hafpatorse23: checks 
CashMatteo: checks 
*** RIVER *** [Qs 3s 7h Tc] [Jh]
ladybz: checks 
hafpatorse23: checks 
CashMatteo: checks 
*** SHOW DOWN ***
ladybz: shows [4d 6c] (high card Queen)
hafpatorse23: shows [2h Ks] (high card King)
CashMatteo: shows [6d As] (high card Ace)
CashMatteo collected 90 from pot
*** SUMMARY ***
Total pot 90 | Rake 0 
Board [Qs 3s 7h Tc Jh]
Seat 1: hafpatorse23 (big blind) showed [2h Ks] and lost with high card King
Seat 2: CashMatteo (button) showed [6d As] and won (90) with high card Ace
Seat 3: ladybz (small blind) showed [4d 6c] and lost with high card Queen

Hand #260: 

PokerStars Hand #246223303964: Tournament #3651038433, $0.23+$0.02 CAD Hold'em No Limit - Level III (20/40) - 2023/09/28 1:09:04 ET
Table '3651038433 1' 3-max Seat #3 is the button
Seat 1: hafpatorse23 (795 in chips) 
Seat 2: CashMatteo (265 in chips) 
Seat 3: ladybz (440 in chips) 
hafpatorse23: posts small blind 20
CashMatteo: posts big blind 40
*** HOLE CARDS ***
Dealt to CashMatteo [Th 3d]
ladybz: calls 40
hafpatorse23: calls 20
CashMatteo: checks 
*** FLOP *** [4c 3c 5h]
hafpatorse23: bets 40
CashMatteo: folds 
ladybz: folds 
Uncalled bet (40) returned to hafpatorse23
hafpatorse23 collected 120 from pot
*** SUMMARY ***
Total pot 120 | Rake 0 
Board [4c 3c 5h]
Seat 1: hafpatorse23 (small blind) collected (120)
Seat 2: CashMatteo (big blind) folded on the Flop
Seat 3: ladybz (button) folded on the Flop

Hand #261: 

PokerStars Hand #246223305298: Tournament #3651038433, $0.23+$0.02 CAD Hold'em No Limit - Level III (20/40) - 2023/09/28 1:09:18 ET
Table '3651038433 1' 3-max Seat #1 is the button
Seat 1: hafpatorse23 (875 in chips) 
Seat 2: CashMatteo (225 in chips) 
Seat 3: ladybz (400 in chips) 
CashMatteo: posts small blind 20
ladybz: posts big blind 40
*** HOLE CARDS ***
Dealt to CashMatteo [Ks 2c]
hafpatorse23: calls 40
CashMatteo: calls 20
ladybz: checks 
*** FLOP *** [2s 8c 6s]
CashMatteo: checks 
ladybz: checks 
hafpatorse23: checks 
*** TURN *** [2s 8c 6s] [3s]
CashMatteo: checks 
ladybz: checks 
hafpatorse23: checks 
*** RIVER *** [2s 8c 6s 3s] [Qs]
CashMatteo: checks 
ladybz: checks 
hafpatorse23: checks 
*** SHOW DOWN ***
CashMatteo: shows [Ks 2c] (a flush, King high)
ladybz: mucks hand 
hafpatorse23: mucks hand 
CashMatteo collected 120 from pot
*** SUMMARY ***
Total pot 120 | Rake 0 
Board [2s 8c 6s 3s Qs]
Seat 1: hafpatorse23 (button) mucked [5c 7c]
Seat 2: CashMatteo (small blind) showed [Ks 2c] and won (120) with a flush, King high
Seat 3: ladybz (big blind) mucked [9d Qh]

Hand #262: 

PokerStars Hand #246223307760: Tournament #3651038433, $0.23+$0.02 CAD Hold'em No Limit - Level III (20/40) - 2023/09/28 1:09:43 ET
Table '3651038433 1' 3-max Seat #2 is the button
Seat 1: hafpatorse23 (835 in chips) 
Seat 2: CashMatteo (305 in chips) 
Seat 3: ladybz (360 in chips) 
ladybz: posts small blind 20
hafpatorse23: posts big blind 40
*** HOLE CARDS ***
Dealt to CashMatteo [Td Qh]
CashMatteo: raises 80 to 120
ladybz: calls 100
hafpatorse23: calls 80
*** FLOP *** [6h 6d 9s]
ladybz: checks 
hafpatorse23: checks 
CashMatteo: checks 
*** TURN *** [6h 6d 9s] [Th]
ladybz: checks 
hafpatorse23: checks 
CashMatteo: checks 
*** RIVER *** [6h 6d 9s Th] [5s]
ladybz: checks 
hafpatorse23: checks 
CashMatteo: bets 40
ladybz: folds 
hafpatorse23: folds 
Uncalled bet (40) returned to CashMatteo
CashMatteo collected 360 from pot
CashMatteo: doesn't show hand 
*** SUMMARY ***
Total pot 360 | Rake 0 
Board [6h 6d 9s Th 5s]
Seat 1: hafpatorse23 (big blind) folded on the River
Seat 2: CashMatteo (button) collected (360)
Seat 3: ladybz (small blind) folded on the River

Hand #263: 

PokerStars Hand #246223309809: Tournament #3651038433, $0.23+$0.02 CAD Hold'em No Limit - Level III (20/40) - 2023/09/28 1:10:04 ET
Table '3651038433 1' 3-max Seat #3 is the button
Seat 1: hafpatorse23 (715 in chips) 
Seat 2: CashMatteo (545 in chips) 
Seat 3: ladybz (240 in chips) 
hafpatorse23: posts small blind 20
CashMatteo: posts big blind 40
*** HOLE CARDS ***
Dealt to CashMatteo [3s 3d]
ladybz: folds 
hafpatorse23: calls 20
CashMatteo: raises 80 to 120
hafpatorse23: calls 80
*** FLOP *** [5d Qs 6s]
hafpatorse23: checks 
CashMatteo: checks 
*** TURN *** [5d Qs 6s] [9h]
hafpatorse23: checks 
CashMatteo: checks 
*** RIVER *** [5d Qs 6s 9h] [Ac]
hafpatorse23: checks 
CashMatteo: checks 
*** SHOW DOWN ***
hafpatorse23: shows [8s 3c] (high card Ace)
CashMatteo: shows [3s 3d] (a pair of Threes)
CashMatteo collected 240 from pot
*** SUMMARY ***
Total pot 240 | Rake 0 
Board [5d Qs 6s 9h Ac]
Seat 1: hafpatorse23 (small blind) showed [8s 3c] and lost with high card Ace
Seat 2: CashMatteo (big blind) showed [3s 3d] and won (240) with a pair of Threes
Seat 3: ladybz (button) folded before Flop (didn't bet)

Hand #264: 

PokerStars Hand #246223311403: Tournament #3651038433, $0.23+$0.02 CAD Hold'em No Limit - Level III (20/40) - 2023/09/28 1:10:20 ET
Table '3651038433 1' 3-max Seat #1 is the button
Seat 1: hafpatorse23 (595 in chips) 
Seat 2: CashMatteo (665 in chips) 
Seat 3: ladybz (240 in chips) 
CashMatteo: posts small blind 20
ladybz: posts big blind 40
*** HOLE CARDS ***
Dealt to CashMatteo [7h Qc]
hafpatorse23: calls 40
CashMatteo: calls 20
ladybz: checks 
*** FLOP *** [4d 9d Qd]
CashMatteo: bets 60
ladybz: folds 
hafpatorse23: folds 
Uncalled bet (60) returned to CashMatteo
CashMatteo collected 120 from pot
CashMatteo: doesn't show hand 
*** SUMMARY ***
Total pot 120 | Rake 0 
Board [4d 9d Qd]
Seat 1: hafpatorse23 (button) folded on the Flop
Seat 2: CashMatteo (small blind) collected (120)
Seat 3: ladybz (big blind) folded on the Flop

Hand #265: 

PokerStars Hand #246223312606: Tournament #3651038433, $0.23+$0.02 CAD Hold'em No Limit - Level III (20/40) - 2023/09/28 1:10:32 ET
Table '3651038433 1' 3-max Seat #2 is the button
Seat 1: hafpatorse23 (555 in chips) 
Seat 2: CashMatteo (745 in chips) 
Seat 3: ladybz (200 in chips) 
ladybz: posts small blind 20
hafpatorse23: posts big blind 40
*** HOLE CARDS ***
Dealt to CashMatteo [Kc 7h]
CashMatteo: calls 40
ladybz: folds 
hafpatorse23: checks 
*** FLOP *** [5h Qs 3s]
hafpatorse23: checks 
CashMatteo: checks 
*** TURN *** [5h Qs 3s] [6s]
hafpatorse23: checks 
CashMatteo: checks 
*** RIVER *** [5h Qs 3s 6s] [Kd]
hafpatorse23: checks 
CashMatteo: bets 40
hafpatorse23: folds 
Uncalled bet (40) returned to CashMatteo
CashMatteo collected 100 from pot
CashMatteo: doesn't show hand 
*** SUMMARY ***
Total pot 100 | Rake 0 
Board [5h Qs 3s 6s Kd]
Seat 1: hafpatorse23 (big blind) folded on the River
Seat 2: CashMatteo (button) collected (100)
Seat 3: ladybz (small blind) folded before Flop

Hand #266: 

PokerStars Hand #246223314810: Tournament #3651038433, $0.23+$0.02 CAD Hold'em No Limit - Level III (20/40) - 2023/09/28 1:10:54 ET
Table '3651038433 1' 3-max Seat #3 is the button
Seat 1: hafpatorse23 (515 in chips) 
Seat 2: CashMatteo (805 in chips) 
Seat 3: ladybz (180 in chips) 
hafpatorse23: posts small blind 20
CashMatteo: posts big blind 40
*** HOLE CARDS ***
Dealt to CashMatteo [2h 8h]
ladybz: calls 40
hafpatorse23: calls 20
CashMatteo: checks 
*** FLOP *** [Qh Td 9s]
hafpatorse23: bets 40
CashMatteo: folds 
ladybz: calls 40
*** TURN *** [Qh Td 9s] [Ah]
hafpatorse23: bets 40
ladybz: calls 40
*** RIVER *** [Qh Td 9s Ah] [Kh]
hafpatorse23: bets 80
ladybz: folds 
Uncalled bet (80) returned to hafpatorse23
hafpatorse23 collected 280 from pot
*** SUMMARY ***
Total pot 280 | Rake 0 
Board [Qh Td 9s Ah Kh]
Seat 1: hafpatorse23 (small blind) collected (280)
Seat 2: CashMatteo (big blind) folded on the Flop
Seat 3: ladybz (button) folded on the River

Hand #267: 

PokerStars Hand #246223317274: Tournament #3651038433, $0.23+$0.02 CAD Hold'em No Limit - Level III (20/40) - 2023/09/28 1:11:19 ET
Table '3651038433 1' 3-max Seat #1 is the button
Seat 1: hafpatorse23 (675 in chips) 
Seat 2: CashMatteo (765 in chips) 
Seat 3: ladybz (60 in chips) 
CashMatteo: posts small blind 20
ladybz: posts big blind 40
*** HOLE CARDS ***
Dealt to CashMatteo [5d Tc]
hafpatorse23: raises 40 to 80
CashMatteo: folds 
ladybz: calls 20 and is all-in
Uncalled bet (20) returned to hafpatorse23
*** FLOP *** [2d Th Qs]
*** TURN *** [2d Th Qs] [3s]
*** RIVER *** [2d Th Qs 3s] [8s]
*** SHOW DOWN ***
ladybz: shows [Ad 8d] (a pair of Eights)
hafpatorse23: shows [4d Kd] (high card King)
ladybz collected 140 from pot
*** SUMMARY ***
Total pot 140 | Rake 0 
Board [2d Th Qs 3s 8s]
Seat 1: hafpatorse23 (button) showed [4d Kd] and lost with high card King
Seat 2: CashMatteo (small blind) folded before Flop
Seat 3: ladybz (big blind) showed [Ad 8d] and won (140) with a pair of Eights

Hand #268: 

PokerStars Hand #246223318491: Tournament #3651038433, $0.23+$0.02 CAD Hold'em No Limit - Level III (20/40) - 2023/09/28 1:11:31 ET
Table '3651038433 1' 3-max Seat #2 is the button
Seat 1: hafpatorse23 (615 in chips) 
Seat 2: CashMatteo (745 in chips) 
Seat 3: ladybz (140 in chips) 
ladybz: posts small blind 20
hafpatorse23: posts big blind 40
*** HOLE CARDS ***
Dealt to CashMatteo [Jh 4d]
CashMatteo: calls 40
ladybz: calls 20
hafpatorse23: checks 
*** FLOP *** [3d 6s 2h]
ladybz: checks 
hafpatorse23: checks 
CashMatteo: checks 
*** TURN *** [3d 6s 2h] [6d]
ladybz: checks 
hafpatorse23: checks 
CashMatteo: checks 
*** RIVER *** [3d 6s 2h 6d] [7d]
ladybz: checks 
hafpatorse23: checks 
CashMatteo: checks 
*** SHOW DOWN ***
ladybz: shows [Qh Ad] (a pair of Sixes)
hafpatorse23: mucks hand 
CashMatteo: mucks hand 
ladybz collected 120 from pot
*** SUMMARY ***
Total pot 120 | Rake 0 
Board [3d 6s 2h 6d 7d]
Seat 1: hafpatorse23 (big blind) mucked [Jd 8c]
Seat 2: CashMatteo (button) mucked [Jh 4d]
Seat 3: ladybz (small blind) showed [Qh Ad] and won (120) with a pair of Sixes

Hand #269: 

PokerStars Hand #246223320283: Tournament #3651038433, $0.23+$0.02 CAD Hold'em No Limit - Level III (20/40) - 2023/09/28 1:11:49 ET
Table '3651038433 1' 3-max Seat #3 is the button
Seat 1: hafpatorse23 (575 in chips) 
Seat 2: CashMatteo (705 in chips) 
Seat 3: ladybz (220 in chips) 
hafpatorse23: posts small blind 20
CashMatteo: posts big blind 40
*** HOLE CARDS ***
Dealt to CashMatteo [Qd 7d]
ladybz: folds 
hafpatorse23: calls 20
CashMatteo: checks 
*** FLOP *** [8s 5s 5c]
hafpatorse23: checks 
CashMatteo: checks 
*** TURN *** [8s 5s 5c] [Tc]
hafpatorse23: bets 40
CashMatteo: folds 
Uncalled bet (40) returned to hafpatorse23
hafpatorse23 collected 80 from pot
*** SUMMARY ***
Total pot 80 | Rake 0 
Board [8s 5s 5c Tc]
Seat 1: hafpatorse23 (small blind) collected (80)
Seat 2: CashMatteo (big blind) folded on the Turn
Seat 3: ladybz (button) folded before Flop (didn't bet)

Hand #270: 

PokerStars Hand #246223321776: Tournament #3651038433, $0.23+$0.02 CAD Hold'em No Limit - Level IV (30/60) - 2023/09/28 1:12:05 ET
Table '3651038433 1' 3-max Seat #1 is the button
Seat 1: hafpatorse23 (615 in chips) 
Seat 2: CashMatteo (665 in chips) 
Seat 3: ladybz (220 in chips) 
CashMatteo: posts small blind 30
ladybz: posts big blind 60
*** HOLE CARDS ***
Dealt to CashMatteo [Ks 3c]
hafpatorse23: raises 60 to 120
CashMatteo: folds 
ladybz: folds 
Uncalled bet (60) returned to hafpatorse23
hafpatorse23 collected 150 from pot
*** SUMMARY ***
Total pot 150 | Rake 0 
Seat 1: hafpatorse23 (button) collected (150)
Seat 2: CashMatteo (small blind) folded before Flop
Seat 3: ladybz (big blind) folded before Flop

Hand #271: 

PokerStars Hand #246223322441: Tournament #3651038433, $0.23+$0.02 CAD Hold'em No Limit - Level IV (30/60) - 2023/09/28 1:12:12 ET
Table '3651038433 1' 3-max Seat #2 is the button
Seat 1: hafpatorse23 (705 in chips) 
Seat 2: CashMatteo (635 in chips) 
Seat 3: ladybz (160 in chips) 
ladybz: posts small blind 30
hafpatorse23: posts big blind 60
*** HOLE CARDS ***
Dealt to CashMatteo [6h 3s]
CashMatteo: folds 
ladybz: calls 30
hafpatorse23: raises 60 to 120
ladybz: calls 60
*** FLOP *** [8c 3c 6d]
ladybz: checks 
hafpatorse23: bets 60
ladybz: calls 40 and is all-in
Uncalled bet (20) returned to hafpatorse23
*** TURN *** [8c 3c 6d] [Qd]
*** RIVER *** [8c 3c 6d Qd] [2c]
*** SHOW DOWN ***
ladybz: shows [2h 5h] (a pair of Deuces)
hafpatorse23: shows [8s As] (a pair of Eights)
hafpatorse23 collected 320 from pot
ladybz finished the tournament in 3rd place
*** SUMMARY ***
Total pot 320 | Rake 0 
Board [8c 3c 6d Qd 2c]
Seat 1: hafpatorse23 (big blind) showed [8s As] and won (320) with a pair of Eights
Seat 2: CashMatteo (button) folded before Flop (didn't bet)
Seat 3: ladybz (small blind) showed [2h 5h] and lost with a pair of Deuces

Hand #272: 

PokerStars Hand #246223324373: Tournament #3651038433, $0.23+$0.02 CAD Hold'em No Limit - Level IV (30/60) - 2023/09/28 1:12:32 ET
Table '3651038433 1' 3-max Seat #1 is the button
Seat 1: hafpatorse23 (865 in chips) 
Seat 2: CashMatteo (635 in chips) 
hafpatorse23: posts small blind 30
CashMatteo: posts big blind 60
*** HOLE CARDS ***
Dealt to CashMatteo [Kc 4c]
hafpatorse23: raises 60 to 120
CashMatteo: calls 60
*** FLOP *** [9c Ac 5h]
CashMatteo: checks 
hafpatorse23: bets 120
CashMatteo: calls 120
*** TURN *** [9c Ac 5h] [9h]
CashMatteo: checks 
hafpatorse23: checks 
*** RIVER *** [9c Ac 5h 9h] [Tc]
CashMatteo: bets 240
hafpatorse23: folds 
Uncalled bet (240) returned to CashMatteo
CashMatteo collected 480 from pot
CashMatteo: doesn't show hand 
*** SUMMARY ***
Total pot 480 | Rake 0 
Board [9c Ac 5h 9h Tc]
Seat 1: hafpatorse23 (button) (small blind) folded on the River
Seat 2: CashMatteo (big blind) collected (480)

Hand #273: 

PokerStars Hand #246223326472: Tournament #3651038433, $0.23+$0.02 CAD Hold'em No Limit - Level IV (30/60) - 2023/09/28 1:12:54 ET
Table '3651038433 1' 3-max Seat #2 is the button
Seat 1: hafpatorse23 (625 in chips) 
Seat 2: CashMatteo (875 in chips) 
CashMatteo: posts small blind 30
hafpatorse23: posts big blind 60
*** HOLE CARDS ***
Dealt to CashMatteo [Qd 9h]
CashMatteo: calls 30
hafpatorse23: raises 60 to 120
CashMatteo: calls 60
*** FLOP *** [Jd 7d Ah]
hafpatorse23: bets 60
CashMatteo: folds 
Uncalled bet (60) returned to hafpatorse23
hafpatorse23 collected 240 from pot
*** SUMMARY ***
Total pot 240 | Rake 0 
Board [Jd 7d Ah]
Seat 1: hafpatorse23 (big blind) collected (240)
Seat 2: CashMatteo (button) (small blind) folded on the Flop

Hand #274: 

PokerStars Hand #246223327905: Tournament #3651038433, $0.23+$0.02 CAD Hold'em No Limit - Level IV (30/60) - 2023/09/28 1:13:09 ET
Table '3651038433 1' 3-max Seat #1 is the button
Seat 1: hafpatorse23 (745 in chips) 
Seat 2: CashMatteo (755 in chips) 
hafpatorse23: posts small blind 30
CashMatteo: posts big blind 60
*** HOLE CARDS ***
Dealt to CashMatteo [2d 8d]
hafpatorse23: raises 60 to 120
CashMatteo: folds 
Uncalled bet (60) returned to hafpatorse23
hafpatorse23 collected 120 from pot
*** SUMMARY ***
Total pot 120 | Rake 0 
Seat 1: hafpatorse23 (button) (small blind) collected (120)
Seat 2: CashMatteo (big blind) folded before Flop

Hand #275: 

PokerStars Hand #246223328524: Tournament #3651038433, $0.23+$0.02 CAD Hold'em No Limit - Level IV (30/60) - 2023/09/28 1:13:15 ET
Table '3651038433 1' 3-max Seat #2 is the button
Seat 1: hafpatorse23 (805 in chips) 
Seat 2: CashMatteo (695 in chips) 
CashMatteo: posts small blind 30
hafpatorse23: posts big blind 60
*** HOLE CARDS ***
Dealt to CashMatteo [Th 6c]
CashMatteo: folds 
Uncalled bet (30) returned to hafpatorse23
hafpatorse23 collected 60 from pot
*** SUMMARY ***
Total pot 60 | Rake 0 
Seat 1: hafpatorse23 (big blind) collected (60)
Seat 2: CashMatteo (button) (small blind) folded before Flop

Hand #276: 

PokerStars Hand #246223328961: Tournament #3651038433, $0.23+$0.02 CAD Hold'em No Limit - Level IV (30/60) - 2023/09/28 1:13:20 ET
Table '3651038433 1' 3-max Seat #1 is the button
Seat 1: hafpatorse23 (835 in chips) 
Seat 2: CashMatteo (665 in chips) 
hafpatorse23: posts small blind 30
CashMatteo: posts big blind 60
*** HOLE CARDS ***
Dealt to CashMatteo [6h Kc]
hafpatorse23: raises 60 to 120
CashMatteo: calls 60
*** FLOP *** [Th Jd 3c]
CashMatteo: checks 
hafpatorse23: bets 60
CashMatteo: folds 
Uncalled bet (60) returned to hafpatorse23
hafpatorse23 collected 240 from pot
*** SUMMARY ***
Total pot 240 | Rake 0 
Board [Th Jd 3c]
Seat 1: hafpatorse23 (button) (small blind) collected (240)
Seat 2: CashMatteo (big blind) folded on the Flop

Hand #277: 

PokerStars Hand #246223330068: Tournament #3651038433, $0.23+$0.02 CAD Hold'em No Limit - Level IV (30/60) - 2023/09/28 1:13:31 ET
Table '3651038433 1' 3-max Seat #2 is the button
Seat 1: hafpatorse23 (955 in chips) 
Seat 2: CashMatteo (545 in chips) 
CashMatteo: posts small blind 30
hafpatorse23: posts big blind 60
*** HOLE CARDS ***
Dealt to CashMatteo [9s 5s]
CashMatteo: folds 
Uncalled bet (30) returned to hafpatorse23
hafpatorse23 collected 60 from pot
*** SUMMARY ***
Total pot 60 | Rake 0 
Seat 1: hafpatorse23 (big blind) collected (60)
Seat 2: CashMatteo (button) (small blind) folded before Flop

Hand #278: 

PokerStars Hand #246223330582: Tournament #3651038433, $0.23+$0.02 CAD Hold'em No Limit - Level IV (30/60) - 2023/09/28 1:13:37 ET
Table '3651038433 1' 3-max Seat #1 is the button
Seat 1: hafpatorse23 (985 in chips) 
Seat 2: CashMatteo (515 in chips) 
hafpatorse23: posts small blind 30
CashMatteo: posts big blind 60
*** HOLE CARDS ***
Dealt to CashMatteo [3s 9h]
hafpatorse23: raises 60 to 120
CashMatteo: folds 
Uncalled bet (60) returned to hafpatorse23
hafpatorse23 collected 120 from pot
*** SUMMARY ***
Total pot 120 | Rake 0 
Seat 1: hafpatorse23 (button) (small blind) collected (120)
Seat 2: CashMatteo (big blind) folded before Flop

Hand #279: 

PokerStars Hand #246223331020: Tournament #3651038433, $0.23+$0.02 CAD Hold'em No Limit - Level IV (30/60) - 2023/09/28 1:13:41 ET
Table '3651038433 1' 3-max Seat #2 is the button
Seat 1: hafpatorse23 (1045 in chips) 
Seat 2: CashMatteo (455 in chips) 
CashMatteo: posts small blind 30
hafpatorse23: posts big blind 60
*** HOLE CARDS ***
Dealt to CashMatteo [7c Qc]
CashMatteo: raises 120 to 180
hafpatorse23: calls 120
*** FLOP *** [9c 2h 3s]
hafpatorse23: checks 
CashMatteo: checks 
*** TURN *** [9c 2h 3s] [5d]
hafpatorse23: checks 
CashMatteo: bets 180
hafpatorse23: calls 180
*** RIVER *** [9c 2h 3s 5d] [3c]
hafpatorse23: checks 
CashMatteo: checks 
*** SHOW DOWN ***
hafpatorse23: shows [Tc 9h] (two pair, Nines and Threes)
CashMatteo: mucks hand 
hafpatorse23 collected 720 from pot
*** SUMMARY ***
Total pot 720 | Rake 0 
Board [9c 2h 3s 5d 3c]
Seat 1: hafpatorse23 (big blind) showed [Tc 9h] and won (720) with two pair, Nines and Threes
Seat 2: CashMatteo (button) (small blind) mucked [7c Qc]

Hand #280: 

PokerStars Hand #246223332923: Tournament #3651038433, $0.23+$0.02 CAD Hold'em No Limit - Level IV (30/60) - 2023/09/28 1:14:01 ET
Table '3651038433 1' 3-max Seat #1 is the button
Seat 1: hafpatorse23 (1405 in chips) 
Seat 2: CashMatteo (95 in chips) 
hafpatorse23: posts small blind 30
CashMatteo: posts big blind 60
*** HOLE CARDS ***
Dealt to CashMatteo [Qd 9s]
hafpatorse23: raises 60 to 120
CashMatteo: calls 35 and is all-in
Uncalled bet (25) returned to hafpatorse23
*** FLOP *** [6c 7d 3c]
*** TURN *** [6c 7d 3c] [5c]
*** RIVER *** [6c 7d 3c 5c] [2h]
*** SHOW DOWN ***
CashMatteo: shows [Qd 9s] (high card Queen)
hafpatorse23: shows [Ts Th] (a pair of Tens)
hafpatorse23 collected 190 from pot
CashMatteo finished the tournament in 2nd place
hafpatorse23 wins the tournament and receives $0.75 - congratulations!
*** SUMMARY ***
Total pot 190 | Rake 0 
Board [6c 7d 3c 5c 2h]
Seat 1: hafpatorse23 (button) (small blind) showed [Ts Th] and won (190) with a pair of Tens
Seat 2: CashMatteo (big blind) showed [Qd 9s] and lost with high card Queen

Hand #281: 

PokerStars Hand #246223336399: Tournament #3651039901, $0.23+$0.02 CAD Hold'em No Limit - Level I (10/20) - 2023/09/28 1:14:37 ET
Table '3651039901 1' 3-max Seat #1 is the button
Seat 1: CashMatteo (500 in chips) 
Seat 2: ladybz (500 in chips) 
Seat 3: hafpatorse23 (500 in chips) 
ladybz: posts small blind 10
hafpatorse23: posts big blind 20
*** HOLE CARDS ***
Dealt to CashMatteo [Th 9c]
CashMatteo: calls 20
ladybz: folds 
hafpatorse23: checks 
*** FLOP *** [Ks Qc 3s]
hafpatorse23: bets 20
CashMatteo: folds 
Uncalled bet (20) returned to hafpatorse23
hafpatorse23 collected 50 from pot
*** SUMMARY ***
Total pot 50 | Rake 0 
Board [Ks Qc 3s]
Seat 1: CashMatteo (button) folded on the Flop
Seat 2: ladybz (small blind) folded before Flop
Seat 3: hafpatorse23 (big blind) collected (50)

Hand #282: 

PokerStars Hand #246223337512: Tournament #3651039901, $0.23+$0.02 CAD Hold'em No Limit - Level I (10/20) - 2023/09/28 1:14:48 ET
Table '3651039901 1' 3-max Seat #2 is the button
Seat 1: CashMatteo (480 in chips) 
Seat 2: ladybz (490 in chips) 
Seat 3: hafpatorse23 (530 in chips) 
hafpatorse23: posts small blind 10
CashMatteo: posts big blind 20
*** HOLE CARDS ***
Dealt to CashMatteo [7d Ks]
ladybz: calls 20
hafpatorse23: calls 10
CashMatteo: checks 
*** FLOP *** [Jc 6c 8c]
hafpatorse23: checks 
CashMatteo: checks 
ladybz: checks 
*** TURN *** [Jc 6c 8c] [5h]
hafpatorse23: checks 
CashMatteo: checks 
ladybz has timed out
ladybz: checks 
*** RIVER *** [Jc 6c 8c 5h] [2s]
hafpatorse23: bets 510 and is all-in
CashMatteo: folds 
ladybz: folds 
Uncalled bet (510) returned to hafpatorse23
hafpatorse23 collected 60 from pot
*** SUMMARY ***
Total pot 60 | Rake 0 
Board [Jc 6c 8c 5h 2s]
Seat 1: CashMatteo (big blind) folded on the River
Seat 2: ladybz (button) folded on the River
Seat 3: hafpatorse23 (small blind) collected (60)

Hand #283: 

PokerStars Hand #246223344120: Tournament #3651039901, $0.23+$0.02 CAD Hold'em No Limit - Level I (10/20) - 2023/09/28 1:15:57 ET
Table '3651039901 1' 3-max Seat #3 is the button
Seat 1: CashMatteo (460 in chips) 
Seat 2: ladybz (470 in chips) 
Seat 3: hafpatorse23 (570 in chips) 
CashMatteo: posts small blind 10
ladybz: posts big blind 20
*** HOLE CARDS ***
Dealt to CashMatteo [6s Th]
hafpatorse23: calls 20
CashMatteo: calls 10
ladybz has timed out
ladybz: checks 
*** FLOP *** [9s Td 5s]
CashMatteo: checks 
ladybz: checks 
hafpatorse23: checks 
*** TURN *** [9s Td 5s] [3h]
CashMatteo: bets 20
ladybz: calls 20
hafpatorse23: calls 20
*** RIVER *** [9s Td 5s 3h] [9d]
CashMatteo: bets 60
ladybz has timed out
ladybz: folds 
ladybz is sitting out
hafpatorse23: folds 
Uncalled bet (60) returned to CashMatteo
CashMatteo collected 120 from pot
CashMatteo: doesn't show hand 
*** SUMMARY ***
Total pot 120 | Rake 0 
Board [9s Td 5s 3h 9d]
Seat 1: CashMatteo (small blind) collected (120)
Seat 2: ladybz (big blind) folded on the River
Seat 3: hafpatorse23 (button) folded on the River

Hand #284: 

PokerStars Hand #246223349889: Tournament #3651039901, $0.23+$0.02 CAD Hold'em No Limit - Level II (15/30) - 2023/09/28 1:16:56 ET
Table '3651039901 1' 3-max Seat #1 is the button
Seat 1: CashMatteo (540 in chips) 
Seat 2: ladybz (430 in chips) is sitting out
Seat 3: hafpatorse23 (530 in chips) 
ladybz: posts small blind 15
hafpatorse23: posts big blind 30
*** HOLE CARDS ***
Dealt to CashMatteo [Qd Ad]
CashMatteo: raises 60 to 90
ladybz: folds 
hafpatorse23: calls 60
*** FLOP *** [Td Qc Ks]
hafpatorse23: checks 
CashMatteo: bets 30
hafpatorse23: calls 30
*** TURN *** [Td Qc Ks] [2h]
hafpatorse23: checks 
ladybz has returned
CashMatteo: bets 128
hafpatorse23: calls 128
*** RIVER *** [Td Qc Ks 2h] [7d]
hafpatorse23: checks 
CashMatteo: checks 
*** SHOW DOWN ***
hafpatorse23: shows [7s Js] (a pair of Sevens)
CashMatteo: shows [Qd Ad] (a pair of Queens)
CashMatteo collected 511 from pot
*** SUMMARY ***
Total pot 511 | Rake 0 
Board [Td Qc Ks 2h 7d]
Seat 1: CashMatteo (button) showed [Qd Ad] and won (511) with a pair of Queens
Seat 2: ladybz (small blind) folded before Flop
Seat 3: hafpatorse23 (big blind) showed [7s Js] and lost with a pair of Sevens

Hand #285: 

PokerStars Hand #246223351827: Tournament #3651039901, $0.23+$0.02 CAD Hold'em No Limit - Level II (15/30) - 2023/09/28 1:17:16 ET
Table '3651039901 1' 3-max Seat #2 is the button
Seat 1: CashMatteo (803 in chips) 
Seat 2: ladybz (415 in chips) 
Seat 3: hafpatorse23 (282 in chips) 
hafpatorse23: posts small blind 15
CashMatteo: posts big blind 30
*** HOLE CARDS ***
Dealt to CashMatteo [2c Qh]
ladybz: calls 30
hafpatorse23: calls 15
CashMatteo: checks 
*** FLOP *** [Th 5s Td]
hafpatorse23: checks 
CashMatteo: checks 
ladybz: checks 
*** TURN *** [Th 5s Td] [9s]
hafpatorse23: bets 30
CashMatteo: folds 
ladybz: calls 30
*** RIVER *** [Th 5s Td 9s] [Qc]
hafpatorse23: checks 
ladybz: checks 
*** SHOW DOWN ***
hafpatorse23: shows [8h 5d] (two pair, Tens and Fives)
ladybz: shows [9c 6d] (two pair, Tens and Nines)
ladybz collected 150 from pot
*** SUMMARY ***
Total pot 150 | Rake 0 
Board [Th 5s Td 9s Qc]
Seat 1: CashMatteo (big blind) folded on the Turn
Seat 2: ladybz (button) showed [9c 6d] and won (150) with two pair, Tens and Nines
Seat 3: hafpatorse23 (small blind) showed [8h 5d] and lost with two pair, Tens and Fives

Hand #286: 

PokerStars Hand #246223353534: Tournament #3651039901, $0.23+$0.02 CAD Hold'em No Limit - Level II (15/30) - 2023/09/28 1:17:33 ET
Table '3651039901 1' 3-max Seat #3 is the button
Seat 1: CashMatteo (773 in chips) 
Seat 2: ladybz (505 in chips) 
Seat 3: hafpatorse23 (222 in chips) 
CashMatteo: posts small blind 15
ladybz: posts big blind 30
*** HOLE CARDS ***
Dealt to CashMatteo [3s Td]
hafpatorse23: calls 30
CashMatteo: folds 
ladybz: checks 
*** FLOP *** [5c 5d Qh]
ladybz: checks 
hafpatorse23: bets 30
ladybz: calls 30
*** TURN *** [5c 5d Qh] [8c]
ladybz: checks 
hafpatorse23: checks 
*** RIVER *** [5c 5d Qh 8c] [As]
ladybz: checks 
hafpatorse23: checks 
*** SHOW DOWN ***
ladybz: shows [Qd 6s] (two pair, Queens and Fives)
hafpatorse23: mucks hand 
ladybz collected 135 from pot
*** SUMMARY ***
Total pot 135 | Rake 0 
Board [5c 5d Qh 8c As]
Seat 1: CashMatteo (small blind) folded before Flop
Seat 2: ladybz (big blind) showed [Qd 6s] and won (135) with two pair, Queens and Fives
Seat 3: hafpatorse23 (button) mucked [4d 6c]

Hand #287: 

PokerStars Hand #246223355130: Tournament #3651039901, $0.23+$0.02 CAD Hold'em No Limit - Level II (15/30) - 2023/09/28 1:17:50 ET
Table '3651039901 1' 3-max Seat #1 is the button
Seat 1: CashMatteo (758 in chips) 
Seat 2: ladybz (580 in chips) 
Seat 3: hafpatorse23 (162 in chips) 
ladybz: posts small blind 15
hafpatorse23: posts big blind 30
*** HOLE CARDS ***
Dealt to CashMatteo [6c 6s]
CashMatteo: raises 60 to 90
ladybz: calls 75
hafpatorse23: calls 60
*** FLOP *** [9h 8d Jd]
ladybz: checks 
hafpatorse23: bets 72 and is all-in
CashMatteo: calls 72
ladybz: calls 72
*** TURN *** [9h 8d Jd] [3s]
ladybz: checks 
CashMatteo: checks 
*** RIVER *** [9h 8d Jd 3s] [4s]
ladybz: checks 
CashMatteo: checks 
*** SHOW DOWN ***
ladybz: shows [Ah 7h] (high card Ace)
hafpatorse23: shows [Jh 7s] (a pair of Jacks)
CashMatteo: mucks hand 
hafpatorse23 collected 486 from pot
*** SUMMARY ***
Total pot 486 | Rake 0 
Board [9h 8d Jd 3s 4s]
Seat 1: CashMatteo (button) mucked [6c 6s]
Seat 2: ladybz (small blind) showed [Ah 7h] and lost with high card Ace
Seat 3: hafpatorse23 (big blind) showed [Jh 7s] and won (486) with a pair of Jacks

Hand #288: 

PokerStars Hand #246223358264: Tournament #3651039901, $0.23+$0.02 CAD Hold'em No Limit - Level II (15/30) - 2023/09/28 1:18:22 ET
Table '3651039901 1' 3-max Seat #2 is the button
Seat 1: CashMatteo (596 in chips) 
Seat 2: ladybz (418 in chips) 
Seat 3: hafpatorse23 (486 in chips) 
hafpatorse23: posts small blind 15
CashMatteo: posts big blind 30
*** HOLE CARDS ***
Dealt to CashMatteo [9d 3c]
ladybz: calls 30
hafpatorse23: raises 60 to 90
CashMatteo: folds 
ladybz: calls 60
*** FLOP *** [Th 2d 2s]
hafpatorse23: bets 90
ladybz: calls 90
*** TURN *** [Th 2d 2s] [8h]
hafpatorse23: bets 30
ladybz: calls 30
*** RIVER *** [Th 2d 2s 8h] [Kd]
hafpatorse23: checks 
ladybz: checks 
*** SHOW DOWN ***
hafpatorse23: shows [Ad Qc] (a pair of Deuces)
ladybz: shows [Ts 5h] (two pair, Tens and Deuces)
ladybz collected 450 from pot
*** SUMMARY ***
Total pot 450 | Rake 0 
Board [Th 2d 2s 8h Kd]
Seat 1: CashMatteo (big blind) folded before Flop
Seat 2: ladybz (button) showed [Ts 5h] and won (450) with two pair, Tens and Deuces
Seat 3: hafpatorse23 (small blind) showed [Ad Qc] and lost with a pair of Deuces

Hand #289: 

PokerStars Hand #246223360379: Tournament #3651039901, $0.23+$0.02 CAD Hold'em No Limit - Level III (20/40) - 2023/09/28 1:18:44 ET
Table '3651039901 1' 3-max Seat #3 is the button
Seat 1: CashMatteo (566 in chips) 
Seat 2: ladybz (658 in chips) 
Seat 3: hafpatorse23 (276 in chips) 
CashMatteo: posts small blind 20
ladybz: posts big blind 40
*** HOLE CARDS ***
Dealt to CashMatteo [3h Ks]
hafpatorse23: calls 40
CashMatteo: calls 20
ladybz: checks 
*** FLOP *** [Qs Td Ac]
CashMatteo: checks 
ladybz: checks 
hafpatorse23: checks 
*** TURN *** [Qs Td Ac] [7c]
CashMatteo: checks 
ladybz: checks 
hafpatorse23: checks 
*** RIVER *** [Qs Td Ac 7c] [4s]
CashMatteo: checks 
ladybz: checks 
hafpatorse23: checks 
*** SHOW DOWN ***
CashMatteo: shows [3h Ks] (high card Ace)
ladybz: shows [Jd 7d] (a pair of Sevens)
hafpatorse23: mucks hand 
ladybz collected 120 from pot
*** SUMMARY ***
Total pot 120 | Rake 0 
Board [Qs Td Ac 7c 4s]
Seat 1: CashMatteo (small blind) showed [3h Ks] and lost with high card Ace
Seat 2: ladybz (big blind) showed [Jd 7d] and won (120) with a pair of Sevens
Seat 3: hafpatorse23 (button) mucked [6d Js]

Hand #290: 

PokerStars Hand #246223362115: Tournament #3651039901, $0.23+$0.02 CAD Hold'em No Limit - Level III (20/40) - 2023/09/28 1:19:01 ET
Table '3651039901 1' 3-max Seat #1 is the button
Seat 1: CashMatteo (526 in chips) 
Seat 2: ladybz (738 in chips) 
Seat 3: hafpatorse23 (236 in chips) 
ladybz: posts small blind 20
hafpatorse23: posts big blind 40
*** HOLE CARDS ***
Dealt to CashMatteo [4d 9s]
CashMatteo: folds 
ladybz: calls 20
hafpatorse23: raises 40 to 80
ladybz: calls 40
*** FLOP *** [7d 7c 6s]
ladybz: checks 
hafpatorse23: bets 40
ladybz: calls 40
*** TURN *** [7d 7c 6s] [As]
ladybz: checks 
hafpatorse23: bets 40
ladybz: calls 40
*** RIVER *** [7d 7c 6s As] [8c]
ladybz: checks 
hafpatorse23: checks 
*** SHOW DOWN ***
ladybz: shows [9h Ah] (two pair, Aces and Sevens)
hafpatorse23: mucks hand 
ladybz collected 320 from pot
*** SUMMARY ***
Total pot 320 | Rake 0 
Board [7d 7c 6s As 8c]
Seat 1: CashMatteo (button) folded before Flop (didn't bet)
Seat 2: ladybz (small blind) showed [9h Ah] and won (320) with two pair, Aces and Sevens
Seat 3: hafpatorse23 (big blind) mucked [4s 4h]

Hand #291: 

PokerStars Hand #246223363986: Tournament #3651039901, $0.23+$0.02 CAD Hold'em No Limit - Level III (20/40) - 2023/09/28 1:19:21 ET
Table '3651039901 1' 3-max Seat #2 is the button
Seat 1: CashMatteo (526 in chips) 
Seat 2: ladybz (898 in chips) 
Seat 3: hafpatorse23 (76 in chips) 
hafpatorse23: posts small blind 20
CashMatteo: posts big blind 40
*** HOLE CARDS ***
Dealt to CashMatteo [Ad Td]
ladybz: calls 40
hafpatorse23: raises 36 to 76 and is all-in
CashMatteo: calls 36
ladybz: calls 36
*** FLOP *** [Kh 3c 3s]
CashMatteo: checks 
ladybz: checks 
*** TURN *** [Kh 3c 3s] [Ac]
CashMatteo: checks 
ladybz: checks 
*** RIVER *** [Kh 3c 3s Ac] [Ts]
CashMatteo: bets 450 and is all-in
ladybz: calls 450
*** SHOW DOWN ***
CashMatteo: shows [Ad Td] (two pair, Aces and Tens)
ladybz: shows [6s Ah] (two pair, Aces and Threes)
CashMatteo collected 900 from side pot
hafpatorse23: shows [5d 3h] (three of a kind, Threes)
hafpatorse23 collected 228 from main pot
*** SUMMARY ***
Total pot 1128 Main pot 228. Side pot 900. | Rake 0 
Board [Kh 3c 3s Ac Ts]
Seat 1: CashMatteo (big blind) showed [Ad Td] and won (900) with two pair, Aces and Tens
Seat 2: ladybz (button) showed [6s Ah] and lost with two pair, Aces and Threes
Seat 3: hafpatorse23 (small blind) showed [5d 3h] and won (228) with three of a kind, Threes

Hand #292: 

PokerStars Hand #246223366004: Tournament #3651039901, $0.23+$0.02 CAD Hold'em No Limit - Level III (20/40) - 2023/09/28 1:19:41 ET
Table '3651039901 1' 3-max Seat #3 is the button
Seat 1: CashMatteo (900 in chips) 
Seat 2: ladybz (372 in chips) 
Seat 3: hafpatorse23 (228 in chips) 
CashMatteo: posts small blind 20
ladybz: posts big blind 40
*** HOLE CARDS ***
Dealt to CashMatteo [Qc Jd]
hafpatorse23: calls 40
CashMatteo: calls 20
ladybz: checks 
*** FLOP *** [9h Ah 2h]
CashMatteo: checks 
ladybz: checks 
hafpatorse23: checks 
*** TURN *** [9h Ah 2h] [Js]
CashMatteo: checks 
ladybz: checks 
hafpatorse23: checks 
*** RIVER *** [9h Ah 2h Js] [4h]
CashMatteo: checks 
ladybz: bets 80
hafpatorse23: calls 80
CashMatteo: folds 
*** SHOW DOWN ***
ladybz: shows [8h 3h] (a flush, Ace high)
hafpatorse23: shows [9s Th] (a flush, Ace high - Ten higher)
hafpatorse23 collected 280 from pot
*** SUMMARY ***
Total pot 280 | Rake 0 
Board [9h Ah 2h Js 4h]
Seat 1: CashMatteo (small blind) folded on the River
Seat 2: ladybz (big blind) showed [8h 3h] and lost with a flush, Ace high
Seat 3: hafpatorse23 (button) showed [9s Th] and won (280) with a flush, Ace high

Hand #293: 

PokerStars Hand #246223368295: Tournament #3651039901, $0.23+$0.02 CAD Hold'em No Limit - Level III (20/40) - 2023/09/28 1:20:05 ET
Table '3651039901 1' 3-max Seat #1 is the button
Seat 1: CashMatteo (860 in chips) 
Seat 2: ladybz (252 in chips) 
Seat 3: hafpatorse23 (388 in chips) 
ladybz: posts small blind 20
hafpatorse23: posts big blind 40
*** HOLE CARDS ***
Dealt to CashMatteo [9c Jh]
CashMatteo: calls 40
ladybz: calls 20
hafpatorse23: checks 
*** FLOP *** [Js 6c 5s]
ladybz: checks 
hafpatorse23: checks 
CashMatteo: checks 
*** TURN *** [Js 6c 5s] [2c]
ladybz: checks 
hafpatorse23: bets 40
CashMatteo: calls 40
ladybz: folds 
*** RIVER *** [Js 6c 5s 2c] [Kc]
hafpatorse23: bets 40
CashMatteo: calls 40
*** SHOW DOWN ***
hafpatorse23: shows [2d 5c] (two pair, Fives and Deuces)
CashMatteo: mucks hand 
hafpatorse23 collected 280 from pot
*** SUMMARY ***
Total pot 280 | Rake 0 
Board [Js 6c 5s 2c Kc]
Seat 1: CashMatteo (button) mucked [9c Jh]
Seat 2: ladybz (small blind) folded on the Turn
Seat 3: hafpatorse23 (big blind) showed [2d 5c] and won (280) with two pair, Fives and Deuces

Hand #294: 

PokerStars Hand #246223370517: Tournament #3651039901, $0.23+$0.02 CAD Hold'em No Limit - Level III (20/40) - 2023/09/28 1:20:28 ET
Table '3651039901 1' 3-max Seat #2 is the button
Seat 1: CashMatteo (740 in chips) 
Seat 2: ladybz (212 in chips) 
Seat 3: hafpatorse23 (548 in chips) 
hafpatorse23: posts small blind 20
CashMatteo: posts big blind 40
*** HOLE CARDS ***
Dealt to CashMatteo [Ah 7s]
ladybz: calls 40
hafpatorse23: calls 20
CashMatteo: checks 
*** FLOP *** [Ac 8d 6d]
hafpatorse23: checks 
CashMatteo: bets 60
ladybz: folds 
hafpatorse23: calls 60
*** TURN *** [Ac 8d 6d] [Kh]
hafpatorse23: checks 
CashMatteo: checks 
*** RIVER *** [Ac 8d 6d Kh] [9h]
hafpatorse23: checks 
CashMatteo: bets 80
hafpatorse23: folds 
Uncalled bet (80) returned to CashMatteo
CashMatteo collected 240 from pot
CashMatteo: doesn't show hand 
*** SUMMARY ***
Total pot 240 | Rake 0 
Board [Ac 8d 6d Kh 9h]
Seat 1: CashMatteo (big blind) collected (240)
Seat 2: ladybz (button) folded on the Flop
Seat 3: hafpatorse23 (small blind) folded on the River

Hand #295: 

PokerStars Hand #246223373212: Tournament #3651039901, $0.23+$0.02 CAD Hold'em No Limit - Level IV (30/60) - 2023/09/28 1:20:56 ET
Table '3651039901 1' 3-max Seat #3 is the button
Seat 1: CashMatteo (880 in chips) 
Seat 2: ladybz (172 in chips) 
Seat 3: hafpatorse23 (448 in chips) 
CashMatteo: posts small blind 30
ladybz: posts big blind 60
*** HOLE CARDS ***
Dealt to CashMatteo [7d 9h]
hafpatorse23: calls 60
CashMatteo: folds 
ladybz: checks 
*** FLOP *** [2c 3d Kd]
ladybz: checks 
hafpatorse23: checks 
*** TURN *** [2c 3d Kd] [Qd]
ladybz: checks 
hafpatorse23: checks 
*** RIVER *** [2c 3d Kd Qd] [Qh]
ladybz: checks 
hafpatorse23: checks 
*** SHOW DOWN ***
ladybz: shows [Ac 4d] (a pair of Queens)
hafpatorse23: shows [2s Jh] (two pair, Queens and Deuces)
hafpatorse23 collected 150 from pot
*** SUMMARY ***
Total pot 150 | Rake 0 
Board [2c 3d Kd Qd Qh]
Seat 1: CashMatteo (small blind) folded before Flop
Seat 2: ladybz (big blind) showed [Ac 4d] and lost with a pair of Queens
Seat 3: hafpatorse23 (button) showed [2s Jh] and won (150) with two pair, Queens and Deuces

Hand #296: 

PokerStars Hand #246223374751: Tournament #3651039901, $0.23+$0.02 CAD Hold'em No Limit - Level IV (30/60) - 2023/09/28 1:21:12 ET
Table '3651039901 1' 3-max Seat #1 is the button
Seat 1: CashMatteo (850 in chips) 
Seat 2: ladybz (112 in chips) 
Seat 3: hafpatorse23 (538 in chips) 
ladybz: posts small blind 30
hafpatorse23: posts big blind 60
*** HOLE CARDS ***
Dealt to CashMatteo [9s 7d]
CashMatteo: folds 
ladybz: calls 30
hafpatorse23: raises 60 to 120
ladybz: folds 
Uncalled bet (60) returned to hafpatorse23
hafpatorse23 collected 120 from pot
*** SUMMARY ***
Total pot 120 | Rake 0 
Seat 1: CashMatteo (button) folded before Flop (didn't bet)
Seat 2: ladybz (small blind) folded before Flop
Seat 3: hafpatorse23 (big blind) collected (120)

Hand #297: 

PokerStars Hand #246223375736: Tournament #3651039901, $0.23+$0.02 CAD Hold'em No Limit - Level IV (30/60) - 2023/09/28 1:21:23 ET
Table '3651039901 1' 3-max Seat #2 is the button
Seat 1: CashMatteo (850 in chips) 
Seat 2: ladybz (52 in chips) 
Seat 3: hafpatorse23 (598 in chips) 
hafpatorse23: posts small blind 30
CashMatteo: posts big blind 60
*** HOLE CARDS ***
Dealt to CashMatteo [8d Qd]
ladybz: calls 52 and is all-in
hafpatorse23: raises 60 to 120
CashMatteo: calls 60
*** FLOP *** [6c Jd 3d]
hafpatorse23: checks 
CashMatteo: checks 
*** TURN *** [6c Jd 3d] [Tc]
hafpatorse23: checks 
CashMatteo: checks 
*** RIVER *** [6c Jd 3d Tc] [7s]
hafpatorse23: checks 
CashMatteo: checks 
*** SHOW DOWN ***
hafpatorse23: shows [9h 5s] (high card Jack)
CashMatteo: shows [8d Qd] (high card Queen)
CashMatteo collected 136 from side pot
ladybz: shows [5h Td] (a pair of Tens)
ladybz collected 156 from main pot
*** SUMMARY ***
Total pot 292 Main pot 156. Side pot 136. | Rake 0 
Board [6c Jd 3d Tc 7s]
Seat 1: CashMatteo (big blind) showed [8d Qd] and won (136) with high card Queen
Seat 2: ladybz (button) showed [5h Td] and won (156) with a pair of Tens
Seat 3: hafpatorse23 (small blind) showed [9h 5s] and lost with high card Jack

Hand #298: 

PokerStars Hand #246223377207: Tournament #3651039901, $0.23+$0.02 CAD Hold'em No Limit - Level IV (30/60) - 2023/09/28 1:21:38 ET
Table '3651039901 1' 3-max Seat #3 is the button
Seat 1: CashMatteo (866 in chips) 
Seat 2: ladybz (156 in chips) 
Seat 3: hafpatorse23 (478 in chips) 
CashMatteo: posts small blind 30
ladybz: posts big blind 60
*** HOLE CARDS ***
Dealt to CashMatteo [5d Qc]
hafpatorse23: raises 60 to 120
CashMatteo: folds 
ladybz: calls 60
*** FLOP *** [3s Kh Kc]
ladybz: checks 
hafpatorse23: bets 60
ladybz: calls 36 and is all-in
Uncalled bet (24) returned to hafpatorse23
*** TURN *** [3s Kh Kc] [Ad]
*** RIVER *** [3s Kh Kc Ad] [8d]
*** SHOW DOWN ***
ladybz: shows [3h Td] (two pair, Kings and Threes)
hafpatorse23: shows [Ts Qh] (a pair of Kings)
ladybz collected 342 from pot
*** SUMMARY ***
Total pot 342 | Rake 0 
Board [3s Kh Kc Ad 8d]
Seat 1: CashMatteo (small blind) folded before Flop
Seat 2: ladybz (big blind) showed [3h Td] and won (342) with two pair, Kings and Threes
Seat 3: hafpatorse23 (button) showed [Ts Qh] and lost with a pair of Kings

Hand #299: 

PokerStars Hand #246223378873: Tournament #3651039901, $0.23+$0.02 CAD Hold'em No Limit - Level IV (30/60) - 2023/09/28 1:21:55 ET
Table '3651039901 1' 3-max Seat #1 is the button
Seat 1: CashMatteo (836 in chips) 
Seat 2: ladybz (342 in chips) 
Seat 3: hafpatorse23 (322 in chips) 
ladybz: posts small blind 30
hafpatorse23: posts big blind 60
*** HOLE CARDS ***
Dealt to CashMatteo [8s 3s]
CashMatteo: folds 
ladybz: calls 30
hafpatorse23: checks 
*** FLOP *** [5h 4h 2c]
ladybz: checks 
hafpatorse23: bets 60
ladybz: calls 60
*** TURN *** [5h 4h 2c] [8c]
ladybz: checks 
hafpatorse23: bets 60
ladybz: calls 60
*** RIVER *** [5h 4h 2c 8c] [Ts]
ladybz: checks 
hafpatorse23: checks 
*** SHOW DOWN ***
ladybz: shows [As Ac] (a pair of Aces)
hafpatorse23: mucks hand 
ladybz collected 360 from pot
*** SUMMARY ***
Total pot 360 | Rake 0 
Board [5h 4h 2c 8c Ts]
Seat 1: CashMatteo (button) folded before Flop (didn't bet)
Seat 2: ladybz (small blind) showed [As Ac] and won (360) with a pair of Aces
Seat 3: hafpatorse23 (big blind) mucked [4d Qh]

Hand #300: 

PokerStars Hand #246223380563: Tournament #3651039901, $0.23+$0.02 CAD Hold'em No Limit - Level IV (30/60) - 2023/09/28 1:22:13 ET
Table '3651039901 1' 3-max Seat #2 is the button
Seat 1: CashMatteo (836 in chips) 
Seat 2: ladybz (522 in chips) 
Seat 3: hafpatorse23 (142 in chips) 
hafpatorse23: posts small blind 30
CashMatteo: posts big blind 60
*** HOLE CARDS ***
Dealt to CashMatteo [Js 6s]
ladybz: calls 60
hafpatorse23: raises 60 to 120
CashMatteo: calls 60
ladybz: calls 60
*** FLOP *** [5h 9h 2s]
hafpatorse23: bets 22 and is all-in
CashMatteo: calls 22
ladybz: calls 22
*** TURN *** [5h 9h 2s] [4h]
CashMatteo: checks 
ladybz: checks 
*** RIVER *** [5h 9h 2s 4h] [5c]
CashMatteo: checks 
ladybz: checks 
*** SHOW DOWN ***
hafpatorse23: shows [8c 7s] (a pair of Fives)
CashMatteo: shows [Js 6s] (a pair of Fives - Jack kicker)
ladybz: shows [7h Kc] (a pair of Fives - King kicker)
ladybz collected 426 from pot
hafpatorse23 finished the tournament in 3rd place
*** SUMMARY ***
Total pot 426 | Rake 0 
Board [5h 9h 2s 4h 5c]
Seat 1: CashMatteo (big blind) showed [Js 6s] and lost with a pair of Fives
Seat 2: ladybz (button) showed [7h Kc] and won (426) with a pair of Fives
Seat 3: hafpatorse23 (small blind) showed [8c 7s] and lost with a pair of Fives

Hand #301: 

PokerStars Hand #246223382575: Tournament #3651039901, $0.23+$0.02 CAD Hold'em No Limit - Level IV (30/60) - 2023/09/28 1:22:34 ET
Table '3651039901 1' 3-max Seat #1 is the button
Seat 1: CashMatteo (694 in chips) 
Seat 2: ladybz (806 in chips) 
CashMatteo: posts small blind 30
ladybz: posts big blind 60
*** HOLE CARDS ***
Dealt to CashMatteo [4h Jd]
CashMatteo: folds 
Uncalled bet (30) returned to ladybz
ladybz collected 60 from pot
ladybz: doesn't show hand 
*** SUMMARY ***
Total pot 60 | Rake 0 
Seat 1: CashMatteo (button) (small blind) folded before Flop
Seat 2: ladybz (big blind) collected (60)

Hand #302: 

PokerStars Hand #246223383374: Tournament #3651039901, $0.23+$0.02 CAD Hold'em No Limit - Level V (40/80) - 2023/09/28 1:22:42 ET
Table '3651039901 1' 3-max Seat #2 is the button
Seat 1: CashMatteo (664 in chips) 
Seat 2: ladybz (836 in chips) 
ladybz: posts small blind 40
CashMatteo: posts big blind 80
*** HOLE CARDS ***
Dealt to CashMatteo [9c 5h]
ladybz: calls 40
CashMatteo: checks 
*** FLOP *** [7h Ac As]
CashMatteo: checks 
ladybz: checks 
*** TURN *** [7h Ac As] [8c]
CashMatteo: checks 
ladybz: checks 
*** RIVER *** [7h Ac As 8c] [Jd]
CashMatteo: checks 
ladybz: checks 
*** SHOW DOWN ***
CashMatteo: shows [9c 5h] (a pair of Aces)
ladybz: shows [Jc 2c] (two pair, Aces and Jacks)
ladybz collected 160 from pot
*** SUMMARY ***
Total pot 160 | Rake 0 
Board [7h Ac As 8c Jd]
Seat 1: CashMatteo (big blind) showed [9c 5h] and lost with a pair of Aces
Seat 2: ladybz (button) (small blind) showed [Jc 2c] and won (160) with two pair, Aces and Jacks

Hand #303: 

PokerStars Hand #246223384938: Tournament #3651039901, $0.23+$0.02 CAD Hold'em No Limit - Level V (40/80) - 2023/09/28 1:22:58 ET
Table '3651039901 1' 3-max Seat #1 is the button
Seat 1: CashMatteo (584 in chips) 
Seat 2: ladybz (916 in chips) 
CashMatteo: posts small blind 40
ladybz: posts big blind 80
*** HOLE CARDS ***
Dealt to CashMatteo [4s 3d]
CashMatteo: folds 
Uncalled bet (40) returned to ladybz
ladybz collected 80 from pot
*** SUMMARY ***
Total pot 80 | Rake 0 
Seat 1: CashMatteo (button) (small blind) folded before Flop
Seat 2: ladybz (big blind) collected (80)

Hand #304: 

PokerStars Hand #246223385491: Tournament #3651039901, $0.23+$0.02 CAD Hold'em No Limit - Level V (40/80) - 2023/09/28 1:23:04 ET
Table '3651039901 1' 3-max Seat #2 is the button
Seat 1: CashMatteo (544 in chips) 
Seat 2: ladybz (956 in chips) 
ladybz: posts small blind 40
CashMatteo: posts big blind 80
*** HOLE CARDS ***
Dealt to CashMatteo [Kh 3c]
ladybz: calls 40
CashMatteo: checks 
*** FLOP *** [7c Jd 7h]
CashMatteo: checks 
ladybz: checks 
*** TURN *** [7c Jd 7h] [8s]
CashMatteo: checks 
ladybz: checks 
*** RIVER *** [7c Jd 7h 8s] [Kd]
CashMatteo: bets 80
ladybz: folds 
Uncalled bet (80) returned to CashMatteo
CashMatteo collected 160 from pot
CashMatteo: doesn't show hand 
*** SUMMARY ***
Total pot 160 | Rake 0 
Board [7c Jd 7h 8s Kd]
Seat 1: CashMatteo (big blind) collected (160)
Seat 2: ladybz (button) (small blind) folded on the River

Hand #305: 

PokerStars Hand #246223386910: Tournament #3651039901, $0.23+$0.02 CAD Hold'em No Limit - Level V (40/80) - 2023/09/28 1:23:19 ET
Table '3651039901 1' 3-max Seat #1 is the button
Seat 1: CashMatteo (624 in chips) 
Seat 2: ladybz (876 in chips) 
CashMatteo: posts small blind 40
ladybz: posts big blind 80
*** HOLE CARDS ***
Dealt to CashMatteo [8h Ts]
CashMatteo: folds 
Uncalled bet (40) returned to ladybz
ladybz collected 80 from pot
ladybz: doesn't show hand 
*** SUMMARY ***
Total pot 80 | Rake 0 
Seat 1: CashMatteo (button) (small blind) folded before Flop
Seat 2: ladybz (big blind) collected (80)

Hand #306: 

PokerStars Hand #246223387409: Tournament #3651039901, $0.23+$0.02 CAD Hold'em No Limit - Level V (40/80) - 2023/09/28 1:23:25 ET
Table '3651039901 1' 3-max Seat #2 is the button
Seat 1: CashMatteo (584 in chips) 
Seat 2: ladybz (916 in chips) 
ladybz: posts small blind 40
CashMatteo: posts big blind 80
*** HOLE CARDS ***
Dealt to CashMatteo [Kh 4c]
ladybz: calls 40
CashMatteo: checks 
*** FLOP *** [Js 6s 6h]
CashMatteo: checks 
ladybz: checks 
*** TURN *** [Js 6s 6h] [9c]
CashMatteo: checks 
ladybz: checks 
*** RIVER *** [Js 6s 6h 9c] [Jd]
CashMatteo: checks 
ladybz: checks 
*** SHOW DOWN ***
CashMatteo: shows [Kh 4c] (two pair, Jacks and Sixes)
ladybz: shows [Ad 2c] (two pair, Jacks and Sixes - Ace kicker)
ladybz collected 160 from pot
*** SUMMARY ***
Total pot 160 | Rake 0 
Board [Js 6s 6h 9c Jd]
Seat 1: CashMatteo (big blind) showed [Kh 4c] and lost with two pair, Jacks and Sixes
Seat 2: ladybz (button) (small blind) showed [Ad 2c] and won (160) with two pair, Jacks and Sixes

Hand #307: 

PokerStars Hand #246223388792: Tournament #3651039901, $0.23+$0.02 CAD Hold'em No Limit - Level V (40/80) - 2023/09/28 1:23:39 ET
Table '3651039901 1' 3-max Seat #1 is the button
Seat 1: CashMatteo (504 in chips) 
Seat 2: ladybz (996 in chips) 
CashMatteo: posts small blind 40
ladybz: posts big blind 80
*** HOLE CARDS ***
Dealt to CashMatteo [2s Js]
CashMatteo: calls 40
ladybz: checks 
*** FLOP *** [7s 7h Kc]
ladybz: checks 
CashMatteo: checks 
*** TURN *** [7s 7h Kc] [6h]
ladybz: checks 
CashMatteo: checks 
*** RIVER *** [7s 7h Kc 6h] [Qd]
ladybz: checks 
CashMatteo: checks 
*** SHOW DOWN ***
ladybz: shows [3d Tc] (a pair of Sevens)
CashMatteo: shows [2s Js] (a pair of Sevens - King+Queen+Jack kicker)
CashMatteo collected 160 from pot
*** SUMMARY ***
Total pot 160 | Rake 0 
Board [7s 7h Kc 6h Qd]
Seat 1: CashMatteo (button) (small blind) showed [2s Js] and won (160) with a pair of Sevens
Seat 2: ladybz (big blind) showed [3d Tc] and lost with a pair of Sevens

Hand #308: 

PokerStars Hand #246223390042: Tournament #3651039901, $0.23+$0.02 CAD Hold'em No Limit - Level V (40/80) - 2023/09/28 1:23:53 ET
Table '3651039901 1' 3-max Seat #2 is the button
Seat 1: CashMatteo (584 in chips) 
Seat 2: ladybz (916 in chips) 
ladybz: posts small blind 40
CashMatteo: posts big blind 80
*** HOLE CARDS ***
Dealt to CashMatteo [8c Tc]
ladybz: calls 40
CashMatteo: checks 
*** FLOP *** [6s Ts Qc]
CashMatteo: checks 
ladybz: checks 
*** TURN *** [6s Ts Qc] [7d]
CashMatteo: bets 80
ladybz: folds 
Uncalled bet (80) returned to CashMatteo
CashMatteo collected 160 from pot
CashMatteo: doesn't show hand 
*** SUMMARY ***
Total pot 160 | Rake 0 
Board [6s Ts Qc 7d]
Seat 1: CashMatteo (big blind) collected (160)
Seat 2: ladybz (button) (small blind) folded on the Turn

Hand #309: 

PokerStars Hand #246223391434: Tournament #3651039901, $0.23+$0.02 CAD Hold'em No Limit - Level V (40/80) - 2023/09/28 1:24:07 ET
Table '3651039901 1' 3-max Seat #1 is the button
Seat 1: CashMatteo (664 in chips) 
Seat 2: ladybz (836 in chips) 
CashMatteo: posts small blind 40
ladybz: posts big blind 80
*** HOLE CARDS ***
Dealt to CashMatteo [8c Qh]
CashMatteo: calls 40
ladybz: checks 
*** FLOP *** [4c 5s 8d]
ladybz: checks 
CashMatteo: bets 80
ladybz: folds 
Uncalled bet (80) returned to CashMatteo
CashMatteo collected 160 from pot
CashMatteo: doesn't show hand 
*** SUMMARY ***
Total pot 160 | Rake 0 
Board [4c 5s 8d]
Seat 1: CashMatteo (button) (small blind) collected (160)
Seat 2: ladybz (big blind) folded on the Flop

Hand #310: 

PokerStars Hand #246223392661: Tournament #3651039901, $0.23+$0.02 CAD Hold'em No Limit - Level V (40/80) - 2023/09/28 1:24:20 ET
Table '3651039901 1' 3-max Seat #2 is the button
Seat 1: CashMatteo (744 in chips) 
Seat 2: ladybz (756 in chips) 
ladybz: posts small blind 40
CashMatteo: posts big blind 80
*** HOLE CARDS ***
Dealt to CashMatteo [3s Ad]
ladybz: calls 40
CashMatteo: raises 160 to 240
ladybz: calls 160
*** FLOP *** [Kh 2s 4c]
CashMatteo: checks 
ladybz: checks 
*** TURN *** [Kh 2s 4c] [Ac]
CashMatteo: checks 
ladybz: checks 
*** RIVER *** [Kh 2s 4c Ac] [7c]
CashMatteo: bets 80
ladybz: folds 
Uncalled bet (80) returned to CashMatteo
CashMatteo collected 480 from pot
CashMatteo: doesn't show hand 
*** SUMMARY ***
Total pot 480 | Rake 0 
Board [Kh 2s 4c Ac 7c]
Seat 1: CashMatteo (big blind) collected (480)
Seat 2: ladybz (button) (small blind) folded on the River

Hand #311: 

PokerStars Hand #246223395108: Tournament #3651039901, $0.23+$0.02 CAD Hold'em No Limit - Level VI (50/100) - 2023/09/28 1:24:45 ET
Table '3651039901 1' 3-max Seat #1 is the button
Seat 1: CashMatteo (984 in chips) 
Seat 2: ladybz (516 in chips) 
CashMatteo: posts small blind 50
ladybz: posts big blind 100
*** HOLE CARDS ***
Dealt to CashMatteo [7c 8s]
CashMatteo: folds 
Uncalled bet (50) returned to ladybz
ladybz collected 100 from pot
ladybz: doesn't show hand 
*** SUMMARY ***
Total pot 100 | Rake 0 
Seat 1: CashMatteo (button) (small blind) folded before Flop
Seat 2: ladybz (big blind) collected (100)

Hand #312: 

PokerStars Hand #246223395596: Tournament #3651039901, $0.23+$0.02 CAD Hold'em No Limit - Level VI (50/100) - 2023/09/28 1:24:51 ET
Table '3651039901 1' 3-max Seat #2 is the button
Seat 1: CashMatteo (934 in chips) 
Seat 2: ladybz (566 in chips) 
ladybz: posts small blind 50
CashMatteo: posts big blind 100
*** HOLE CARDS ***
Dealt to CashMatteo [5c 5s]
ladybz: calls 50
CashMatteo: raises 100 to 200
ladybz: calls 100
*** FLOP *** [6h 3d 4d]
CashMatteo: bets 200
ladybz: folds 
Uncalled bet (200) returned to CashMatteo
CashMatteo collected 400 from pot
CashMatteo: doesn't show hand 
*** SUMMARY ***
Total pot 400 | Rake 0 
Board [6h 3d 4d]
Seat 1: CashMatteo (big blind) collected (400)
Seat 2: ladybz (button) (small blind) folded on the Flop

Hand #313: 

PokerStars Hand #246223396883: Tournament #3651039901, $0.23+$0.02 CAD Hold'em No Limit - Level VI (50/100) - 2023/09/28 1:25:04 ET
Table '3651039901 1' 3-max Seat #1 is the button
Seat 1: CashMatteo (1134 in chips) 
Seat 2: ladybz (366 in chips) 
CashMatteo: posts small blind 50
ladybz: posts big blind 100
*** HOLE CARDS ***
Dealt to CashMatteo [Qd 6c]
CashMatteo: calls 50
ladybz: checks 
*** FLOP *** [5s Td 4h]
ladybz: checks 
CashMatteo: checks 
*** TURN *** [5s Td 4h] [7c]
ladybz: checks 
CashMatteo: bets 100
ladybz: calls 100
*** RIVER *** [5s Td 4h 7c] [3c]
ladybz: checks 
CashMatteo: bets 200
ladybz: folds 
Uncalled bet (200) returned to CashMatteo
CashMatteo collected 400 from pot
CashMatteo: doesn't show hand 
*** SUMMARY ***
Total pot 400 | Rake 0 
Board [5s Td 4h 7c 3c]
Seat 1: CashMatteo (button) (small blind) collected (400)
Seat 2: ladybz (big blind) folded on the River

Hand #314: 

PokerStars Hand #246223398918: Tournament #3651039901, $0.23+$0.02 CAD Hold'em No Limit - Level VI (50/100) - 2023/09/28 1:25:26 ET
Table '3651039901 1' 3-max Seat #2 is the button
Seat 1: CashMatteo (1334 in chips) 
Seat 2: ladybz (166 in chips) 
ladybz: posts small blind 50
CashMatteo: posts big blind 100
*** HOLE CARDS ***
Dealt to CashMatteo [Ad Ks]
ladybz: calls 50
CashMatteo: raises 200 to 300
ladybz: folds 
Uncalled bet (200) returned to CashMatteo
CashMatteo collected 200 from pot
CashMatteo: doesn't show hand 
*** SUMMARY ***
Total pot 200 | Rake 0 
Seat 1: CashMatteo (big blind) collected (200)
Seat 2: ladybz (button) (small blind) folded before Flop

Hand #315: 

PokerStars Hand #246223400033: Tournament #3651039901, $0.23+$0.02 CAD Hold'em No Limit - Level VI (50/100) - 2023/09/28 1:25:38 ET
Table '3651039901 1' 3-max Seat #1 is the button
Seat 1: CashMatteo (1434 in chips) 
Seat 2: ladybz (66 in chips) 
CashMatteo: posts small blind 50
ladybz: posts big blind 66 and is all-in
*** HOLE CARDS ***
Dealt to CashMatteo [7h 3c]
CashMatteo: calls 16
*** FLOP *** [Qc 4h 2d]
*** TURN *** [Qc 4h 2d] [8c]
*** RIVER *** [Qc 4h 2d 8c] [Qd]
*** SHOW DOWN ***
ladybz: shows [3d 7d] (a pair of Queens)
CashMatteo: shows [7h 3c] (a pair of Queens)
ladybz collected 66 from pot
CashMatteo collected 66 from pot
*** SUMMARY ***
Total pot 132 | Rake 0 
Board [Qc 4h 2d 8c Qd]
Seat 1: CashMatteo (button) (small blind) showed [7h 3c] and won (66) with a pair of Queens
Seat 2: ladybz (big blind) showed [3d 7d] and won (66) with a pair of Queens

Hand #316: 

PokerStars Hand #246223401210: Tournament #3651039901, $0.23+$0.02 CAD Hold'em No Limit - Level VI (50/100) - 2023/09/28 1:25:50 ET
Table '3651039901 1' 3-max Seat #2 is the button
Seat 1: CashMatteo (1434 in chips) 
Seat 2: ladybz (66 in chips) 
ladybz: posts small blind 50
CashMatteo: posts big blind 100
*** HOLE CARDS ***
Dealt to CashMatteo [3c 2s]
ladybz: calls 16 and is all-in
Uncalled bet (34) returned to CashMatteo
*** FLOP *** [Ts Jc Jd]
*** TURN *** [Ts Jc Jd] [3h]
*** RIVER *** [Ts Jc Jd 3h] [Ks]
*** SHOW DOWN ***
CashMatteo: shows [3c 2s] (two pair, Jacks and Threes)
ladybz: shows [3d 9d] (two pair, Jacks and Threes)
CashMatteo collected 66 from pot
ladybz collected 66 from pot
*** SUMMARY ***
Total pot 132 | Rake 0 
Board [Ts Jc Jd 3h Ks]
Seat 1: CashMatteo (big blind) showed [3c 2s] and won (66) with two pair, Jacks and Threes
Seat 2: ladybz (button) (small blind) showed [3d 9d] and won (66) with two pair, Jacks and Threes

Hand #317: 

PokerStars Hand #246223402245: Tournament #3651039901, $0.23+$0.02 CAD Hold'em No Limit - Level VI (50/100) - 2023/09/28 1:26:01 ET
Table '3651039901 1' 3-max Seat #1 is the button
Seat 1: CashMatteo (1434 in chips) 
Seat 2: ladybz (66 in chips) 
CashMatteo: posts small blind 50
ladybz: posts big blind 66 and is all-in
*** HOLE CARDS ***
Dealt to CashMatteo [Ac 9d]
CashMatteo: calls 16
*** FLOP *** [7d Qc 2h]
*** TURN *** [7d Qc 2h] [Kd]
*** RIVER *** [7d Qc 2h Kd] [8s]
*** SHOW DOWN ***
ladybz: shows [5h Ts] (high card King)
CashMatteo: shows [Ac 9d] (high card Ace)
CashMatteo collected 132 from pot
ladybz finished the tournament in 2nd place
CashMatteo wins the tournament and receives $0.50 - congratulations!
*** SUMMARY ***
Total pot 132 | Rake 0 
Board [7d Qc 2h Kd 8s]
Seat 1: CashMatteo (button) (small blind) showed [Ac 9d] and won (132) with high card Ace
Seat 2: ladybz (big blind) showed [5h Ts] and lost with high card King

Hand #318: 

PokerStars Hand #246223463527:  Hold'em No Limit ($0.01/$0.02 CAD) - 2023/09/28 1:36:41 ET
Table 'Prokne II' 6-max Seat #5 is the button
Seat 1: CashMatteo ($1.60 in chips) 
Seat 2: 19HUNG58 ($3.77 in chips) 
Seat 3: Canguru19 ($1.72 in chips) 
Seat 4: bouchizzle ($2 in chips) 
Seat 5: coreybetterfold ($2.30 in chips) 
Seat 6: rich1717 ($0.80 in chips) 
rich1717: posts small blind $0.01
CashMatteo: posts big blind $0.02
*** HOLE CARDS ***
Dealt to CashMatteo [4d 3c]
19HUNG58: calls $0.02
Canguru19: calls $0.02
bouchizzle: folds 
coreybetterfold: raises $0.09 to $0.11
rich1717: folds 
CashMatteo: folds 
19HUNG58: calls $0.09
Canguru19: calls $0.09
*** FLOP *** [Qh 2c 5h]
19HUNG58: checks 
Canguru19: checks 
coreybetterfold: bets $0.35
19HUNG58: folds 
Canguru19: raises $0.35 to $0.70
coreybetterfold: calls $0.35
*** TURN *** [Qh 2c 5h] [Ac]
Canguru19: bets $0.91 and is all-in
coreybetterfold: folds 
Uncalled bet ($0.91) returned to Canguru19
Canguru19 collected $1.70 from pot
Canguru19: doesn't show hand 
*** SUMMARY ***
Total pot $1.76 | Rake $0.06 
Board [Qh 2c 5h Ac]
Seat 1: CashMatteo (big blind) folded before Flop
Seat 2: 19HUNG58 folded on the Flop
Seat 3: Canguru19 collected ($1.70)
Seat 4: bouchizzle folded before Flop (didn't bet)
Seat 5: coreybetterfold (button) folded on the Turn
Seat 6: rich1717 (small blind) folded before Flop

Hand #319: 

PokerStars Hand #246223468654:  Hold'em No Limit ($0.01/$0.02 CAD) - 2023/09/28 1:37:35 ET
Table 'Prokne II' 6-max Seat #6 is the button
Seat 1: CashMatteo ($1.58 in chips) 
Seat 2: 19HUNG58 ($3.66 in chips) 
Seat 3: Canguru19 ($2.61 in chips) 
Seat 4: bouchizzle ($2 in chips) 
Seat 5: coreybetterfold ($1.49 in chips) 
Seat 6: rich1717 ($0.79 in chips) 
CashMatteo: posts small blind $0.01
19HUNG58: posts big blind $0.02
*** HOLE CARDS ***
Dealt to CashMatteo [Qc Td]
Canguru19: calls $0.02
bouchizzle: raises $0.06 to $0.08
coreybetterfold: raises $1.41 to $1.49 and is all-in
rich1717: folds 
CashMatteo: folds 
19HUNG58: folds 
Canguru19: folds 
bouchizzle: folds 
Uncalled bet ($1.41) returned to coreybetterfold
coreybetterfold collected $0.21 from pot
coreybetterfold: doesn't show hand 
*** SUMMARY ***
Total pot $0.21 | Rake $0 
Seat 1: CashMatteo (small blind) folded before Flop
Seat 2: 19HUNG58 (big blind) folded before Flop
Seat 3: Canguru19 folded before Flop
Seat 4: bouchizzle folded before Flop
Seat 5: coreybetterfold collected ($0.21)
Seat 6: rich1717 (button) folded before Flop (didn't bet)

Hand #320: 

PokerStars Hand #246223471339:  Hold'em No Limit ($0.01/$0.02 CAD) - 2023/09/28 1:38:03 ET
Table 'Prokne II' 6-max Seat #1 is the button
Seat 1: CashMatteo ($1.57 in chips) 
Seat 2: 19HUNG58 ($3.64 in chips) 
Seat 3: Canguru19 ($2.59 in chips) 
Seat 4: bouchizzle ($2 in chips) 
Seat 5: coreybetterfold ($1.62 in chips) 
Seat 6: rich1717 ($0.79 in chips) 
19HUNG58: posts small blind $0.01
Canguru19: posts big blind $0.02
*** HOLE CARDS ***
Dealt to CashMatteo [Td 7s]
bouchizzle: folds 
coreybetterfold: raises $1.60 to $1.62 and is all-in
rich1717: folds 
CashMatteo: folds 
19HUNG58 said, "fck asso go sleep "
19HUNG58: folds 
Canguru19: folds 
Uncalled bet ($1.60) returned to coreybetterfold
coreybetterfold collected $0.05 from pot
coreybetterfold: doesn't show hand 
*** SUMMARY ***
Total pot $0.05 | Rake $0 
Seat 1: CashMatteo (button) folded before Flop (didn't bet)
Seat 2: 19HUNG58 (small blind) folded before Flop
Seat 3: Canguru19 (big blind) folded before Flop
Seat 4: bouchizzle folded before Flop (didn't bet)
Seat 5: coreybetterfold collected ($0.05)
Seat 6: rich1717 folded before Flop (didn't bet)

Hand #321: 

PokerStars Hand #246223474087:  Hold'em No Limit ($0.01/$0.02 CAD) - 2023/09/28 1:38:32 ET
Table 'Prokne II' 6-max Seat #2 is the button
Seat 1: CashMatteo ($1.57 in chips) 
Seat 2: 19HUNG58 ($3.63 in chips) 
Seat 3: Canguru19 ($2.57 in chips) 
Seat 4: bouchizzle ($2 in chips) 
Seat 5: coreybetterfold ($1.65 in chips) 
Seat 6: rich1717 ($0.79 in chips) 
Canguru19: posts small blind $0.01
bouchizzle: posts big blind $0.02
*** HOLE CARDS ***
Dealt to CashMatteo [5c 8s]
coreybetterfold: calls $0.02
rich1717: folds 
CashMatteo: folds 
19HUNG58: raises $0.14 to $0.16
Canguru19: folds 
bouchizzle: folds 
coreybetterfold: calls $0.14
*** FLOP *** [5d 3s 4c]
coreybetterfold: checks 
19HUNG58: bets $3.47 and is all-in
coreybetterfold: folds 
Uncalled bet ($3.47) returned to 19HUNG58
19HUNG58 collected $0.34 from pot
*** SUMMARY ***
Total pot $0.35 | Rake $0.01 
Board [5d 3s 4c]
Seat 1: CashMatteo folded before Flop (didn't bet)
Seat 2: 19HUNG58 (button) collected ($0.34)
Seat 3: Canguru19 (small blind) folded before Flop
Seat 4: bouchizzle (big blind) folded before Flop
Seat 5: coreybetterfold folded on the Flop
Seat 6: rich1717 folded before Flop (didn't bet)

Hand #322: 

PokerStars Hand #246223477078:  Hold'em No Limit ($0.01/$0.02 CAD) - 2023/09/28 1:39:04 ET
Table 'Prokne II' 6-max Seat #3 is the button
Seat 1: CashMatteo ($1.57 in chips) 
Seat 2: 19HUNG58 ($3.81 in chips) 
Seat 3: Canguru19 ($2.56 in chips) 
Seat 4: bouchizzle ($2 in chips) 
Seat 5: coreybetterfold ($1.49 in chips) 
Seat 6: rich1717 ($0.79 in chips) 
bouchizzle: posts small blind $0.01
coreybetterfold: posts big blind $0.02
*** HOLE CARDS ***
Dealt to CashMatteo [2d 3s]
rich1717: folds 
CashMatteo: calls $0.02
19HUNG58: raises $0.08 to $0.10
Canguru19: folds 
bouchizzle: folds 
coreybetterfold: raises $0.23 to $0.33
CashMatteo: folds 
19HUNG58: raises $3.48 to $3.81 and is all-in
coreybetterfold: calls $1.16 and is all-in
Uncalled bet ($2.32) returned to 19HUNG58
*** FLOP *** [7d 5s 6d]
*** TURN *** [7d 5s 6d] [8h]
*** RIVER *** [7d 5s 6d 8h] [Jd]
*** SHOW DOWN ***
coreybetterfold: shows [9c Qh] (a straight, Five to Nine)
19HUNG58: shows [Ks Kc] (a pair of Kings)
coreybetterfold collected $2.90 from pot
*** SUMMARY ***
Total pot $3.01 | Rake $0.11 
Board [7d 5s 6d 8h Jd]
Seat 1: CashMatteo folded before Flop
Seat 2: 19HUNG58 showed [Ks Kc] and lost with a pair of Kings
Seat 3: Canguru19 (button) folded before Flop (didn't bet)
Seat 4: bouchizzle (small blind) folded before Flop
Seat 5: coreybetterfold (big blind) showed [9c Qh] and won ($2.90) with a straight, Five to Nine
Seat 6: rich1717 folded before Flop (didn't bet)

Hand #323: 

PokerStars Hand #246223480194:  Hold'em No Limit ($0.01/$0.02 CAD) - 2023/09/28 1:39:37 ET
Table 'Prokne II' 6-max Seat #4 is the button
Seat 1: CashMatteo ($1.55 in chips) 
Seat 2: 19HUNG58 ($2.32 in chips) 
Seat 3: Canguru19 ($2.56 in chips) 
Seat 4: bouchizzle ($2 in chips) 
Seat 5: coreybetterfold ($2.90 in chips) 
Seat 6: rich1717 ($0.79 in chips) 
coreybetterfold: posts small blind $0.01
rich1717: posts big blind $0.02
*** HOLE CARDS ***
Dealt to CashMatteo [Qh 7h]
CashMatteo: calls $0.02
19HUNG58: raises $0.08 to $0.10
Canguru19: folds 
bouchizzle: calls $0.10
coreybetterfold: folds 
rich1717: folds 
CashMatteo: calls $0.08
*** FLOP *** [8c 2d 4s]
CashMatteo: checks 
19HUNG58: checks 
bouchizzle: bets $0.19
CashMatteo: folds 
19HUNG58 said, "fck asso u"
19HUNG58: folds 
Uncalled bet ($0.19) returned to bouchizzle
bouchizzle collected $0.32 from pot
bouchizzle: doesn't show hand 
*** SUMMARY ***
Total pot $0.33 | Rake $0.01 
Board [8c 2d 4s]
Seat 1: CashMatteo folded on the Flop
Seat 2: 19HUNG58 folded on the Flop
Seat 3: Canguru19 folded before Flop (didn't bet)
Seat 4: bouchizzle (button) collected ($0.32)
Seat 5: coreybetterfold (small blind) folded before Flop
Seat 6: rich1717 (big blind) folded before Flop

Hand #324: 

PokerStars Hand #246223484643:  Hold'em No Limit ($0.01/$0.02 CAD) - 2023/09/28 1:40:24 ET
Table 'Prokne II' 6-max Seat #5 is the button
Seat 1: CashMatteo ($1.45 in chips) 
Seat 2: 19HUNG58 ($2.22 in chips) 
Seat 3: Canguru19 ($2.56 in chips) 
Seat 4: bouchizzle ($2.22 in chips) 
Seat 5: coreybetterfold ($2.89 in chips) 
Seat 6: rich1717 ($0.77 in chips) 
rich1717: posts small blind $0.01
CashMatteo: posts big blind $0.02
*** HOLE CARDS ***
Dealt to CashMatteo [9d 7d]
19HUNG58: calls $0.02
Canguru19: calls $0.02
bouchizzle: raises $0.08 to $0.10
coreybetterfold: raises $2.79 to $2.89 and is all-in
rich1717: folds 
CashMatteo: folds 
19HUNG58: calls $2.20 and is all-in
Canguru19: folds 
bouchizzle: folds 
Uncalled bet ($0.67) returned to coreybetterfold
*** FLOP *** [8h Qd Ah]
*** TURN *** [8h Qd Ah] [Tc]
*** RIVER *** [8h Qd Ah Tc] [4d]
*** SHOW DOWN ***
19HUNG58: shows [As 9c] (a pair of Aces)
coreybetterfold: shows [Ac Qh] (two pair, Aces and Queens)
coreybetterfold collected $4.43 from pot
*** SUMMARY ***
Total pot $4.59 | Rake $0.16 
Board [8h Qd Ah Tc 4d]
Seat 1: CashMatteo (big blind) folded before Flop
Seat 2: 19HUNG58 showed [As 9c] and lost with a pair of Aces
Seat 3: Canguru19 folded before Flop
Seat 4: bouchizzle folded before Flop
Seat 5: coreybetterfold (button) showed [Ac Qh] and won ($4.43) with two pair, Aces and Queens
Seat 6: rich1717 (small blind) folded before Flop

Hand #325: 

PokerStars Hand #246223487680:  Hold'em No Limit ($0.01/$0.02 CAD) - 2023/09/28 1:40:57 ET
Table 'Prokne II' 6-max Seat #6 is the button
Seat 1: CashMatteo ($1.43 in chips) 
Seat 3: Canguru19 ($2.54 in chips) 
Seat 4: bouchizzle ($2.12 in chips) 
Seat 5: coreybetterfold ($5.10 in chips) 
Seat 6: rich1717 ($0.76 in chips) 
CashMatteo: posts small blind $0.01
Canguru19: posts big blind $0.02
*** HOLE CARDS ***
Dealt to CashMatteo [4h Ac]
bouchizzle: folds 
coreybetterfold: calls $0.02
rich1717: folds 
CashMatteo: calls $0.01
Canguru19: checks 
*** FLOP *** [9c Qc 4c]
CashMatteo: checks 
Canguru19: checks 
coreybetterfold: bets $0.06
CashMatteo: calls $0.06
Canguru19: folds 
*** TURN *** [9c Qc 4c] [2s]
CashMatteo: bets $0.09
coreybetterfold: raises $0.18 to $0.27
CashMatteo: calls $0.18
*** RIVER *** [9c Qc 4c 2s] [4d]
CashMatteo: checks 
coreybetterfold: bets $1.09
CashMatteo: folds 
Uncalled bet ($1.09) returned to coreybetterfold
coreybetterfold collected $0.69 from pot
coreybetterfold: doesn't show hand 
*** SUMMARY ***
Total pot $0.72 | Rake $0.03 
Board [9c Qc 4c 2s 4d]
Seat 1: CashMatteo (small blind) folded on the River
Seat 3: Canguru19 (big blind) folded on the Flop
Seat 4: bouchizzle folded before Flop (didn't bet)
Seat 5: coreybetterfold collected ($0.69)
Seat 6: rich1717 (button) folded before Flop (didn't bet)

Hand #326: 

PokerStars Hand #246223495591:  Hold'em No Limit ($0.01/$0.02 CAD) - 2023/09/28 1:42:20 ET
Table 'Prokne II' 6-max Seat #1 is the button
Seat 1: CashMatteo ($1.08 in chips) 
Seat 3: Canguru19 ($2.52 in chips) 
Seat 4: bouchizzle ($2.12 in chips) 
Seat 5: coreybetterfold ($5.44 in chips) 
Seat 6: rich1717 ($0.76 in chips) 
19HUNG58 will be allowed to play after the button
Canguru19: posts small blind $0.01
bouchizzle: posts big blind $0.02
*** HOLE CARDS ***
Dealt to CashMatteo [Tc 5c]
coreybetterfold: calls $0.02
rich1717: folds 
CashMatteo: calls $0.02
Canguru19: calls $0.01
bouchizzle: checks 
*** FLOP *** [Jd 4c Ad]
Canguru19: checks 
bouchizzle: checks 
coreybetterfold: checks 
CashMatteo: checks 
*** TURN *** [Jd 4c Ad] [8c]
Canguru19: bets $0.08
bouchizzle: folds 
coreybetterfold: calls $0.08
CashMatteo: calls $0.08
*** RIVER *** [Jd 4c Ad 8c] [4s]
Canguru19: bets $0.16
coreybetterfold: folds 
CashMatteo: folds 
Uncalled bet ($0.16) returned to Canguru19
19HUNG58 said, "fck bam mat lac"
Canguru19 collected $0.31 from pot
Canguru19: doesn't show hand 
*** SUMMARY ***
Total pot $0.32 | Rake $0.01 
Board [Jd 4c Ad 8c 4s]
Seat 1: CashMatteo (button) folded on the River
Seat 3: Canguru19 (small blind) collected ($0.31)
Seat 4: bouchizzle (big blind) folded on the Turn
Seat 5: coreybetterfold folded on the River
Seat 6: rich1717 folded before Flop (didn't bet)

Hand #327: 

PokerStars Hand #246223499896:  Hold'em No Limit ($0.01/$0.02 CAD) - 2023/09/28 1:43:06 ET
Table 'Prokne II' 6-max Seat #3 is the button
Seat 1: CashMatteo ($0.98 in chips) 
Seat 2: 19HUNG58 ($2 in chips) 
Seat 3: Canguru19 ($2.73 in chips) 
Seat 4: bouchizzle ($2.10 in chips) 
Seat 5: coreybetterfold ($5.34 in chips) 
Seat 6: rich1717 ($0.76 in chips) 
bouchizzle: posts small blind $0.01
coreybetterfold: posts big blind $0.02
19HUNG58: posts small & big blinds $0.03
*** HOLE CARDS ***
Dealt to CashMatteo [4h 4s]
rich1717: folds 
CashMatteo: raises $0.04 to $0.06
19HUNG58: folds 
Canguru19: folds 
bouchizzle: folds 
coreybetterfold: raises $0.16 to $0.22
CashMatteo: calls $0.16
*** FLOP *** [Kh 7c 9c]
coreybetterfold: checks 
CashMatteo: bets $0.23
coreybetterfold: calls $0.23
*** TURN *** [Kh 7c 9c] [3h]
coreybetterfold: bets $0.24
CashMatteo: folds 
Uncalled bet ($0.24) returned to coreybetterfold
coreybetterfold collected $0.91 from pot
coreybetterfold: doesn't show hand 
*** SUMMARY ***
Total pot $0.94 | Rake $0.03 
Board [Kh 7c 9c 3h]
Seat 1: CashMatteo folded on the Turn
Seat 2: 19HUNG58 folded before Flop (didn't bet)
Seat 3: Canguru19 (button) folded before Flop (didn't bet)
Seat 4: bouchizzle (small blind) folded before Flop
Seat 5: coreybetterfold (big blind) collected ($0.91)
Seat 6: rich1717 folded before Flop (didn't bet)

Hand #328: 

PokerStars Hand #246223504896:  Hold'em No Limit ($0.01/$0.02 CAD) - 2023/09/28 1:43:59 ET
Table 'Prokne II' 6-max Seat #4 is the button
Seat 1: CashMatteo ($0.53 in chips) 
Seat 2: 19HUNG58 ($1.97 in chips) 
Seat 3: Canguru19 ($2.73 in chips) 
Seat 4: bouchizzle ($2.09 in chips) 
Seat 5: coreybetterfold ($5.80 in chips) 
Seat 6: rich1717 ($0.76 in chips) 
coreybetterfold: posts small blind $0.01
rich1717: posts big blind $0.02
*** HOLE CARDS ***
Dealt to CashMatteo [Tc 7c]
CashMatteo: calls $0.02
19HUNG58: calls $0.02
Canguru19: calls $0.02
bouchizzle: calls $0.02
coreybetterfold: calls $0.01
rich1717: checks 
*** FLOP *** [Jh 8s 3d]
coreybetterfold: checks 
rich1717: checks 
CashMatteo: checks 
19HUNG58: checks 
Canguru19: checks 
bouchizzle: checks 
*** TURN *** [Jh 8s 3d] [Qh]
coreybetterfold: checks 
rich1717: checks 
CashMatteo: checks 
19HUNG58: bets $0.06
Canguru19: folds 
bouchizzle: calls $0.06
coreybetterfold: folds 
rich1717: folds 
CashMatteo: folds 
*** RIVER *** [Jh 8s 3d Qh] [8d]
19HUNG58: bets $0.23
bouchizzle: raises $0.69 to $0.92
19HUNG58: calls $0.69
*** SHOW DOWN ***
bouchizzle: shows [8c Td] (three of a kind, Eights)
19HUNG58: mucks hand 
bouchizzle collected $2.01 from pot
*** SUMMARY ***
Total pot $2.08 | Rake $0.07 
Board [Jh 8s 3d Qh 8d]
Seat 1: CashMatteo folded on the Turn
Seat 2: 19HUNG58 mucked [6c Qs]
Seat 3: Canguru19 folded on the Turn
Seat 4: bouchizzle (button) showed [8c Td] and won ($2.01) with three of a kind, Eights
Seat 5: coreybetterfold (small blind) folded on the Turn
Seat 6: rich1717 (big blind) folded on the Turn

Hand #329: 

PokerStars Hand #246223514588:  Hold'em No Limit ($0.01/$0.02 CAD) - 2023/09/28 1:45:44 ET
Table 'Prokne II' 6-max Seat #5 is the button
Seat 1: CashMatteo ($0.51 in chips) 
Seat 2: 19HUNG58 ($0.97 in chips) 
Seat 3: Canguru19 ($2.71 in chips) 
Seat 4: bouchizzle ($3.10 in chips) 
Seat 5: coreybetterfold ($5.78 in chips) 
Seat 6: rich1717 ($0.74 in chips) 
rich1717: posts small blind $0.01
CashMatteo: posts big blind $0.02
*** HOLE CARDS ***
Dealt to CashMatteo [7h Js]
19HUNG58: folds 
Canguru19: folds 
bouchizzle: folds 
coreybetterfold: raises $0.05 to $0.07
rich1717: folds 
CashMatteo: folds 
Uncalled bet ($0.05) returned to coreybetterfold
coreybetterfold collected $0.05 from pot
coreybetterfold: doesn't show hand 
*** SUMMARY ***
Total pot $0.05 | Rake $0 
Seat 1: CashMatteo (big blind) folded before Flop
Seat 2: 19HUNG58 folded before Flop (didn't bet)
Seat 3: Canguru19 folded before Flop (didn't bet)
Seat 4: bouchizzle folded before Flop (didn't bet)
Seat 5: coreybetterfold (button) collected ($0.05)
Seat 6: rich1717 (small blind) folded before Flop

Hand #330: 

PokerStars Hand #246223516952:  Hold'em No Limit ($0.01/$0.02 CAD) - 2023/09/28 1:46:09 ET
Table 'Prokne II' 6-max Seat #6 is the button
Seat 1: CashMatteo ($0.49 in chips) 
Seat 2: 19HUNG58 ($2 in chips) 
Seat 3: Canguru19 ($2.71 in chips) 
Seat 4: bouchizzle ($3.10 in chips) 
Seat 5: coreybetterfold ($5.81 in chips) 
Seat 6: rich1717 ($0.73 in chips) 
CashMatteo: posts small blind $0.01
19HUNG58: posts big blind $0.02
*** HOLE CARDS ***
Dealt to CashMatteo [Jc Ad]
Canguru19: folds 
bouchizzle: folds 
Canguru19 leaves the table
coreybetterfold: raises $0.04 to $0.06
rich1717: folds 
CashMatteo: raises $0.14 to $0.20
19HUNG58: folds 
coreybetterfold: calls $0.14
*** FLOP *** [6c 9s 5h]
CashMatteo: checks 
coreybetterfold: bets $0.29
CashMatteo: calls $0.29 and is all-in
*** TURN *** [6c 9s 5h] [Kh]
*** RIVER *** [6c 9s 5h Kh] [6d]
*** SHOW DOWN ***
CashMatteo: shows [Jc Ad] (a pair of Sixes)
coreybetterfold: shows [4d 6s] (three of a kind, Sixes)
coreybetterfold collected $0.96 from pot
*** SUMMARY ***
Total pot $1 | Rake $0.04 
Board [6c 9s 5h Kh 6d]
Seat 1: CashMatteo (small blind) showed [Jc Ad] and lost with a pair of Sixes
Seat 2: 19HUNG58 (big blind) folded before Flop
Seat 3: Canguru19 folded before Flop (didn't bet)
Seat 4: bouchizzle folded before Flop (didn't bet)
Seat 5: coreybetterfold showed [4d 6s] and won ($0.96) with three of a kind, Sixes
Seat 6: rich1717 (button) folded before Flop (didn't bet)

Hand #331: 

PokerStars Hand #246223527742:  Hold'em No Limit ($0.01/$0.02 CAD) - 2023/09/28 1:48:04 ET
Table 'Prokne II' 6-max Seat #4 is the button
Seat 1: CashMatteo ($1 in chips) 
Seat 2: 19HUNG58 ($1.81 in chips) 
Seat 4: bouchizzle ($3.08 in chips) 
Seat 5: coreybetterfold ($6.46 in chips) 
Seat 6: rich1717 ($0.73 in chips) 
coreybetterfold: posts small blind $0.01
rich1717: posts big blind $0.02
*** HOLE CARDS ***
Dealt to CashMatteo [Td 2d]
CashMatteo: folds 
19HUNG58: folds 
bouchizzle: raises $0.04 to $0.06
coreybetterfold: calls $0.05
19HUNG58 said, "fck asso"
rich1717: folds 
*** FLOP *** [Th 5s 9c]
coreybetterfold: checks 
bouchizzle: checks 
*** TURN *** [Th 5s 9c] [Jh]
coreybetterfold: bets $0.14
bouchizzle: calls $0.14
*** RIVER *** [Th 5s 9c Jh] [2c]
19HUNG58 said, "fck asso lucky"
coreybetterfold: bets $0.21
bouchizzle: calls $0.21
*** SHOW DOWN ***
coreybetterfold: shows [Jd 3d] (a pair of Jacks)
bouchizzle: shows [Js 7d] (a pair of Jacks - Ten+Nine+Seven kicker)
bouchizzle collected $0.81 from pot
liknidste585 joins the table at seat #3 
*** SUMMARY ***
Total pot $0.84 | Rake $0.03 
Board [Th 5s 9c Jh 2c]
Seat 1: CashMatteo folded before Flop (didn't bet)
Seat 2: 19HUNG58 folded before Flop (didn't bet)
Seat 4: bouchizzle (button) showed [Js 7d] and won ($0.81) with a pair of Jacks
Seat 5: coreybetterfold (small blind) showed [Jd 3d] and lost with a pair of Jacks
Seat 6: rich1717 (big blind) folded before Flop

Hand #332: 

PokerStars Hand #246223532797:  Hold'em No Limit ($0.01/$0.02 CAD) - 2023/09/28 1:48:58 ET
Table 'Prokne II' 6-max Seat #5 is the button
Seat 1: CashMatteo ($1 in chips) 
Seat 2: 19HUNG58 ($1.81 in chips) 
Seat 4: bouchizzle ($3.48 in chips) 
Seat 5: coreybetterfold ($6.05 in chips) 
Seat 6: rich1717 ($0.71 in chips) 
rich1717: posts small blind $0.01
CashMatteo: posts big blind $0.02
liknidste585: sits out 
*** HOLE CARDS ***
Dealt to CashMatteo [Ts Ad]
19HUNG58: calls $0.02
bouchizzle: raises $0.06 to $0.08
coreybetterfold: folds 
rich1717: folds 
CashMatteo: calls $0.06
19HUNG58: folds 
*** FLOP *** [5d Qd Tc]
CashMatteo: checks 
bouchizzle: bets $0.11
CashMatteo: calls $0.11
*** TURN *** [5d Qd Tc] [2s]
CashMatteo: checks 
bouchizzle: checks 
*** RIVER *** [5d Qd Tc 2s] [7h]
CashMatteo: checks 
bouchizzle: checks 
*** SHOW DOWN ***
CashMatteo: shows [Ts Ad] (a pair of Tens)
bouchizzle: mucks hand 
CashMatteo collected $0.40 from pot
*** SUMMARY ***
Total pot $0.41 | Rake $0.01 
Board [5d Qd Tc 2s 7h]
Seat 1: CashMatteo (big blind) showed [Ts Ad] and won ($0.40) with a pair of Tens
Seat 2: 19HUNG58 folded before Flop
Seat 4: bouchizzle mucked [8c 8s]
Seat 5: coreybetterfold (button) folded before Flop (didn't bet)
Seat 6: rich1717 (small blind) folded before Flop

Hand #333: 

PokerStars Hand #246223536512:  Hold'em No Limit ($0.01/$0.02 CAD) - 2023/09/28 1:49:39 ET
Table 'Prokne II' 6-max Seat #6 is the button
Seat 1: CashMatteo ($1.21 in chips) 
Seat 2: 19HUNG58 ($1.79 in chips) 
Seat 3: liknidste585 ($1.29 in chips) 
Seat 4: bouchizzle ($3.29 in chips) 
Seat 5: coreybetterfold ($6.05 in chips) 
Seat 6: rich1717 ($0.70 in chips) 
CashMatteo: posts small blind $0.01
19HUNG58: posts big blind $0.02
liknidste585: posts big blind $0.02
*** HOLE CARDS ***
Dealt to CashMatteo [Ac 2h]
liknidste585: raises $0.02 to $0.04
bouchizzle: calls $0.04
coreybetterfold: calls $0.04
rich1717: calls $0.04
CashMatteo: calls $0.03
19HUNG58: calls $0.02
*** FLOP *** [Ts 4c 9s]
CashMatteo: checks 
19HUNG58: checks 
liknidste585: bets $0.02
bouchizzle: calls $0.02
coreybetterfold: calls $0.02
rich1717: calls $0.02
CashMatteo: calls $0.02
19HUNG58: calls $0.02
*** TURN *** [Ts 4c 9s] [Ad]
CashMatteo: checks 
19HUNG58: checks 
liknidste585: bets $0.35
bouchizzle: calls $0.35
coreybetterfold: folds 
rich1717: folds 
CashMatteo: folds 
19HUNG58: folds 
*** RIVER *** [Ts 4c 9s Ad] [7s]
liknidste585: bets $0.88 and is all-in
bouchizzle: calls $0.88
*** SHOW DOWN ***
liknidste585: shows [Jh Jc] (a pair of Jacks)
bouchizzle: shows [Qc As] (a pair of Aces)
bouchizzle collected $2.72 from pot
*** SUMMARY ***
Total pot $2.82 | Rake $0.10 
Board [Ts 4c 9s Ad 7s]
Seat 1: CashMatteo (small blind) folded on the Turn
Seat 2: 19HUNG58 (big blind) folded on the Turn
Seat 3: liknidste585 showed [Jh Jc] and lost with a pair of Jacks
Seat 4: bouchizzle showed [Qc As] and won ($2.72) with a pair of Aces
Seat 5: coreybetterfold folded on the Turn
Seat 6: rich1717 (button) folded on the Turn

Hand #334: 

PokerStars Hand #246223544249:  Hold'em No Limit ($0.01/$0.02 CAD) - 2023/09/28 1:51:04 ET
Table 'Prokne II' 6-max Seat #1 is the button
Seat 1: CashMatteo ($1.15 in chips) 
Seat 2: 19HUNG58 ($1.73 in chips) 
Seat 4: bouchizzle ($4.72 in chips) 
Seat 5: coreybetterfold ($5.99 in chips) 
Seat 6: rich1717 ($0.64 in chips) 
19HUNG58: posts small blind $0.01
bouchizzle: posts big blind $0.02
*** HOLE CARDS ***
Dealt to CashMatteo [2h 2d]
coreybetterfold: calls $0.02
rich1717: calls $0.02
CashMatteo: raises $0.04 to $0.06
19HUNG58: calls $0.05
bouchizzle: calls $0.04
coreybetterfold: calls $0.04
rich1717: calls $0.04
*** FLOP *** [8d 2s 6s]
19HUNG58: checks 
bouchizzle: checks 
coreybetterfold: bets $0.15
rich1717: folds 
CashMatteo: raises $0.21 to $0.36
19HUNG58: folds 
bouchizzle: folds 
coreybetterfold: calls $0.21
*** TURN *** [8d 2s 6s] [9h]
coreybetterfold: checks 
CashMatteo: bets $0.73 and is all-in
coreybetterfold: calls $0.73
*** RIVER *** [8d 2s 6s 9h] [7d]
*** SHOW DOWN ***
coreybetterfold: shows [7c Jc] (a pair of Sevens)
CashMatteo: shows [2h 2d] (three of a kind, Deuces)
CashMatteo collected $2.39 from pot
*** SUMMARY ***
Total pot $2.48 | Rake $0.09 
Board [8d 2s 6s 9h 7d]
Seat 1: CashMatteo (button) showed [2h 2d] and won ($2.39) with three of a kind, Deuces
Seat 2: 19HUNG58 (small blind) folded on the Flop
Seat 4: bouchizzle (big blind) folded on the Flop
Seat 5: coreybetterfold showed [7c Jc] and lost with a pair of Sevens
Seat 6: rich1717 folded on the Flop

Hand #335: 

PokerStars Hand #246223551598:  Hold'em No Limit ($0.01/$0.02 CAD) - 2023/09/28 1:52:24 ET
Table 'Prokne II' 6-max Seat #2 is the button
Seat 1: CashMatteo ($2.39 in chips) 
Seat 2: 19HUNG58 ($1.67 in chips) 
Seat 4: bouchizzle ($4.66 in chips) 
Seat 5: coreybetterfold ($4.84 in chips) 
Seat 6: rich1717 ($0.58 in chips) 
bouchizzle: posts small blind $0.01
coreybetterfold: posts big blind $0.02
*** HOLE CARDS ***
Dealt to CashMatteo [3s 8h]
rich1717 has timed out
rich1717: folds 
CashMatteo: folds 
19HUNG58: folds 
bouchizzle: folds 
Uncalled bet ($0.01) returned to coreybetterfold
coreybetterfold collected $0.02 from pot
coreybetterfold: doesn't show hand 
*** SUMMARY ***
Total pot $0.02 | Rake $0 
Seat 1: CashMatteo folded before Flop (didn't bet)
Seat 2: 19HUNG58 (button) folded before Flop (didn't bet)
Seat 4: bouchizzle (small blind) folded before Flop
Seat 5: coreybetterfold (big blind) collected ($0.02)
Seat 6: rich1717 folded before Flop (didn't bet)

Hand #336: 

PokerStars Hand #246223553498:  Hold'em No Limit ($0.01/$0.02 CAD) - 2023/09/28 1:52:45 ET
Table 'Prokne II' 6-max Seat #4 is the button
Seat 1: CashMatteo ($2.39 in chips) 
Seat 2: 19HUNG58 ($1.67 in chips) 
Seat 4: bouchizzle ($4.65 in chips) 
Seat 5: coreybetterfold ($4.85 in chips) 
Seat 6: rich1717 ($0.58 in chips) 
coreybetterfold: posts small blind $0.01
rich1717: posts big blind $0.02
*** HOLE CARDS ***
Dealt to CashMatteo [8c Tc]
CashMatteo: calls $0.02
19HUNG58: raises $1.65 to $1.67 and is all-in
bouchizzle: folds 
coreybetterfold: folds 
rich1717: folds 
CashMatteo: folds 
Uncalled bet ($1.65) returned to 19HUNG58
19HUNG58 collected $0.07 from pot
*** SUMMARY ***
Total pot $0.07 | Rake $0 
Seat 1: CashMatteo folded before Flop
Seat 2: 19HUNG58 collected ($0.07)
Seat 4: bouchizzle (button) folded before Flop (didn't bet)
Seat 5: coreybetterfold (small blind) folded before Flop
Seat 6: rich1717 (big blind) folded before Flop

Hand #337: 

PokerStars Hand #246223555305:  Hold'em No Limit ($0.01/$0.02 CAD) - 2023/09/28 1:53:05 ET
Table 'Prokne II' 6-max Seat #5 is the button
Seat 1: CashMatteo ($2.37 in chips) 
Seat 2: 19HUNG58 ($1.72 in chips) 
Seat 4: bouchizzle ($4.65 in chips) 
Seat 5: coreybetterfold ($4.84 in chips) 
Seat 6: rich1717 ($0.56 in chips) 
rich1717: posts small blind $0.01
CashMatteo: posts big blind $0.02
*** HOLE CARDS ***
Dealt to CashMatteo [7d 6c]
19HUNG58: folds 
bouchizzle: raises $0.04 to $0.06
coreybetterfold: raises $0.15 to $0.21
rich1717: folds 
CashMatteo: folds 
bouchizzle: folds 
Uncalled bet ($0.15) returned to coreybetterfold
coreybetterfold collected $0.15 from pot
coreybetterfold: doesn't show hand 
*** SUMMARY ***
Total pot $0.15 | Rake $0 
Seat 1: CashMatteo (big blind) folded before Flop
Seat 2: 19HUNG58 folded before Flop (didn't bet)
Seat 4: bouchizzle folded before Flop
Seat 5: coreybetterfold (button) collected ($0.15)
Seat 6: rich1717 (small blind) folded before Flop

Hand #338: 

PokerStars Hand #246223557337:  Hold'em No Limit ($0.01/$0.02 CAD) - 2023/09/28 1:53:28 ET
Table 'Prokne II' 6-max Seat #6 is the button
Seat 1: CashMatteo ($2.35 in chips) 
Seat 2: 19HUNG58 ($1.72 in chips) 
Seat 3: liknidste585 ($2 in chips) 
Seat 4: bouchizzle ($4.59 in chips) 
Seat 5: coreybetterfold ($4.93 in chips) 
Seat 6: rich1717 ($0.55 in chips) 
CashMatteo: posts small blind $0.01
19HUNG58: posts big blind $0.02
liknidste585: posts small & big blinds $0.03
*** HOLE CARDS ***
Dealt to CashMatteo [2d 7d]
liknidste585: checks 
bouchizzle: folds 
coreybetterfold: folds 
rich1717: calls $0.02
CashMatteo: raises $0.04 to $0.06
19HUNG58: calls $0.04
liknidste585: folds 
rich1717: calls $0.04
*** FLOP *** [As Ks 2c]
CashMatteo: bets $0.10
19HUNG58: folds 
rich1717: folds 
Uncalled bet ($0.10) returned to CashMatteo
CashMatteo collected $0.20 from pot
CashMatteo: doesn't show hand 
*** SUMMARY ***
Total pot $0.21 | Rake $0.01 
Board [As Ks 2c]
Seat 1: CashMatteo (small blind) collected ($0.20)
Seat 2: 19HUNG58 (big blind) folded on the Flop
Seat 3: liknidste585 folded before Flop (didn't bet)
Seat 4: bouchizzle folded before Flop (didn't bet)
Seat 5: coreybetterfold folded before Flop (didn't bet)
Seat 6: rich1717 (button) folded on the Flop

Hand #339: 

PokerStars Hand #246223561139:  Hold'em No Limit ($0.01/$0.02 CAD) - 2023/09/28 1:54:10 ET
Table 'Prokne II' 6-max Seat #1 is the button
Seat 1: CashMatteo ($2.49 in chips) 
Seat 2: 19HUNG58 ($1.66 in chips) 
Seat 3: liknidste585 ($1.97 in chips) 
Seat 4: bouchizzle ($4.59 in chips) 
Seat 5: coreybetterfold ($4.93 in chips) 
Seat 6: rich1717 ($0.49 in chips) 
19HUNG58: posts small blind $0.01
liknidste585: posts big blind $0.02
*** HOLE CARDS ***
Dealt to CashMatteo [9h Ts]
bouchizzle: folds 
coreybetterfold: folds 
rich1717: folds 
CashMatteo: calls $0.02
19HUNG58: folds 
liknidste585: checks 
*** FLOP *** [3h 5c Td]
liknidste585: checks 
CashMatteo: checks 
*** TURN *** [3h 5c Td] [Qc]
liknidste585: checks 
CashMatteo: bets $0.03
liknidste585: folds 
Uncalled bet ($0.03) returned to CashMatteo
CashMatteo collected $0.05 from pot
CashMatteo: doesn't show hand 
*** SUMMARY ***
Total pot $0.05 | Rake $0 
Board [3h 5c Td Qc]
Seat 1: CashMatteo (button) collected ($0.05)
Seat 2: 19HUNG58 (small blind) folded before Flop
Seat 3: liknidste585 (big blind) folded on the Turn
Seat 4: bouchizzle folded before Flop (didn't bet)
Seat 5: coreybetterfold folded before Flop (didn't bet)
Seat 6: rich1717 folded before Flop (didn't bet)

Hand #340: 

PokerStars Hand #246223563977:  Hold'em No Limit ($0.01/$0.02 CAD) - 2023/09/28 1:54:42 ET
Table 'Prokne II' 6-max Seat #2 is the button
Seat 1: CashMatteo ($2.52 in chips) 
Seat 2: 19HUNG58 ($1.65 in chips) 
Seat 3: liknidste585 ($1.95 in chips) 
Seat 4: bouchizzle ($4.59 in chips) 
Seat 5: coreybetterfold ($4.93 in chips) 
Seat 6: rich1717 ($0.49 in chips) 
liknidste585: posts small blind $0.01
bouchizzle: posts big blind $0.02
*** HOLE CARDS ***
Dealt to CashMatteo [4s Js]
coreybetterfold: folds 
rich1717: folds 
CashMatteo: calls $0.02
19HUNG58: calls $0.02
liknidste585: calls $0.01
bouchizzle: raises $0.08 to $0.10
CashMatteo: calls $0.08
19HUNG58: calls $0.08
liknidste585: calls $0.08
*** FLOP *** [3c 8c 7h]
liknidste585: checks 
bouchizzle: bets $0.23
CashMatteo: folds 
19HUNG58: folds 
liknidste585: folds 
Uncalled bet ($0.23) returned to bouchizzle
bouchizzle collected $0.39 from pot
bouchizzle: doesn't show hand 
*** SUMMARY ***
Total pot $0.40 | Rake $0.01 
Board [3c 8c 7h]
Seat 1: CashMatteo folded on the Flop
Seat 2: 19HUNG58 (button) folded on the Flop
Seat 3: liknidste585 (small blind) folded on the Flop
Seat 4: bouchizzle (big blind) collected ($0.39)
Seat 5: coreybetterfold folded before Flop (didn't bet)
Seat 6: rich1717 folded before Flop (didn't bet)

Hand #341: 

PokerStars Hand #246223567120:  Hold'em No Limit ($0.01/$0.02 CAD) - 2023/09/28 1:55:18 ET
Table 'Prokne II' 6-max Seat #3 is the button
Seat 1: CashMatteo ($2.42 in chips) 
Seat 2: 19HUNG58 ($1.55 in chips) 
Seat 3: liknidste585 ($1.85 in chips) 
Seat 4: bouchizzle ($4.88 in chips) 
Seat 5: coreybetterfold ($4.93 in chips) 
Seat 6: rich1717 ($0.49 in chips) 
bouchizzle: posts small blind $0.01
coreybetterfold: posts big blind $0.02
*** HOLE CARDS ***
Dealt to CashMatteo [7c 2d]
rich1717: folds 
CashMatteo: raises $0.04 to $0.06
19HUNG58: folds 
liknidste585: calls $0.06
bouchizzle: folds 
coreybetterfold: raises $0.56 to $0.62
CashMatteo: folds 
liknidste585: folds 
Uncalled bet ($0.56) returned to coreybetterfold
coreybetterfold collected $0.19 from pot
coreybetterfold: doesn't show hand 
*** SUMMARY ***
Total pot $0.19 | Rake $0 
Seat 1: CashMatteo folded before Flop
Seat 2: 19HUNG58 folded before Flop (didn't bet)
Seat 3: liknidste585 (button) folded before Flop
Seat 4: bouchizzle (small blind) folded before Flop
Seat 5: coreybetterfold (big blind) collected ($0.19)
Seat 6: rich1717 folded before Flop (didn't bet)

Hand #342: 

PokerStars Hand #246223569782:  Hold'em No Limit ($0.01/$0.02 CAD) - 2023/09/28 1:55:51 ET
Table 'Prokne II' 6-max Seat #4 is the button
Seat 1: CashMatteo ($2.36 in chips) 
Seat 2: 19HUNG58 ($1.55 in chips) 
Seat 3: liknidste585 ($1.79 in chips) 
Seat 4: bouchizzle ($4.87 in chips) 
Seat 5: coreybetterfold ($5.06 in chips) 
Seat 6: rich1717 ($0.49 in chips) 
coreybetterfold: posts small blind $0.01
rich1717: posts big blind $0.02
*** HOLE CARDS ***
Dealt to CashMatteo [2d 6h]
CashMatteo: folds 
19HUNG58: folds 
liknidste585: calls $0.02
bouchizzle: folds 
coreybetterfold: calls $0.01
rich1717: checks 
*** FLOP *** [Ac 9s 8h]
coreybetterfold: checks 
rich1717: checks 
liknidste585: bets $0.16
coreybetterfold: folds 
rich1717: folds 
Uncalled bet ($0.16) returned to liknidste585
liknidste585 collected $0.06 from pot
*** SUMMARY ***
Total pot $0.06 | Rake $0 
Board [Ac 9s 8h]
Seat 1: CashMatteo folded before Flop (didn't bet)
Seat 2: 19HUNG58 folded before Flop (didn't bet)
Seat 3: liknidste585 collected ($0.06)
Seat 4: bouchizzle (button) folded before Flop (didn't bet)
Seat 5: coreybetterfold (small blind) folded on the Flop
Seat 6: rich1717 (big blind) folded on the Flop

Hand #343: 

PokerStars Hand #246223572683:  Hold'em No Limit ($0.01/$0.02 CAD) - 2023/09/28 1:56:27 ET
Table 'Prokne II' 6-max Seat #5 is the button
Seat 1: CashMatteo ($2.36 in chips) 
Seat 2: 19HUNG58 ($1.55 in chips) 
Seat 3: liknidste585 ($1.83 in chips) 
Seat 4: bouchizzle ($4.87 in chips) 
Seat 5: coreybetterfold ($5.04 in chips) 
Seat 6: rich1717 ($0.47 in chips) 
rich1717: posts small blind $0.01
CashMatteo: posts big blind $0.02
*** HOLE CARDS ***
Dealt to CashMatteo [2d 4c]
19HUNG58: calls $0.02
liknidste585: calls $0.02
bouchizzle: raises $0.08 to $0.10
coreybetterfold: raises $0.12 to $0.22
rich1717: folds 
CashMatteo: folds 
19HUNG58: folds 
liknidste585: folds 
bouchizzle: calls $0.12
*** FLOP *** [3h Kc 7c]
bouchizzle: checks 
coreybetterfold: bets $0.25
bouchizzle: calls $0.25
*** TURN *** [3h Kc 7c] [9d]
bouchizzle: checks 
coreybetterfold: checks 
*** RIVER *** [3h Kc 7c 9d] [8d]
bouchizzle: bets $0.97
coreybetterfold: folds [9h]
Uncalled bet ($0.97) returned to bouchizzle
bouchizzle collected $0.97 from pot
bouchizzle: doesn't show hand 
*** SUMMARY ***
Total pot $1.01 | Rake $0.04 
Board [3h Kc 7c 9d 8d]
Seat 1: CashMatteo (big blind) folded before Flop
Seat 2: 19HUNG58 folded before Flop
Seat 3: liknidste585 folded before Flop
Seat 4: bouchizzle collected ($0.97)
Seat 5: coreybetterfold (button) folded on the River
Seat 6: rich1717 (small blind) folded before Flop

Hand #344: 

PokerStars Hand #246223579621:  Hold'em No Limit ($0.01/$0.02 CAD) - 2023/09/28 1:57:52 ET
Table 'Prokne II' 6-max Seat #6 is the button
Seat 1: CashMatteo ($2.34 in chips) 
Seat 2: 19HUNG58 ($1.53 in chips) 
Seat 3: liknidste585 ($1.81 in chips) 
Seat 4: bouchizzle ($5.37 in chips) 
Seat 5: coreybetterfold ($4.57 in chips) 
Seat 6: rich1717 ($0.46 in chips) 
CashMatteo: posts small blind $0.01
19HUNG58: posts big blind $0.02
*** HOLE CARDS ***
Dealt to CashMatteo [Qc Kh]
liknidste585: folds 
bouchizzle: raises $0.18 to $0.20
coreybetterfold: calls $0.20
rich1717: folds 
CashMatteo: calls $0.19
19HUNG58: calls $0.18
*** FLOP *** [5c Ac 4s]
CashMatteo: checks 
19HUNG58: checks 
bouchizzle: bets $0.46
coreybetterfold: raises $0.46 to $0.92
CashMatteo: folds 
19HUNG58: raises $0.41 to $1.33 and is all-in
bouchizzle: folds 
coreybetterfold: calls $0.41
*** TURN *** [5c Ac 4s] [4h]
*** RIVER *** [5c Ac 4s 4h] [Td]
*** SHOW DOWN ***
19HUNG58: shows [Jc Ad] (two pair, Aces and Fours)
coreybetterfold: shows [Jh 3h] (a pair of Fours)
19HUNG58 collected $3.78 from pot
*** SUMMARY ***
Total pot $3.92 | Rake $0.14 
Board [5c Ac 4s 4h Td]
Seat 1: CashMatteo (small blind) folded on the Flop
Seat 2: 19HUNG58 (big blind) showed [Jc Ad] and won ($3.78) with two pair, Aces and Fours
Seat 3: liknidste585 folded before Flop (didn't bet)
Seat 4: bouchizzle folded on the Flop
Seat 5: coreybetterfold showed [Jh 3h] and lost with a pair of Fours
Seat 6: rich1717 (button) folded before Flop (didn't bet)

Hand #345: 

PokerStars Hand #246223584733:  Hold'em No Limit ($0.01/$0.02 CAD) - 2023/09/28 1:58:56 ET
Table 'Prokne II' 6-max Seat #1 is the button
Seat 1: CashMatteo ($2.14 in chips) 
Seat 2: 19HUNG58 ($3.78 in chips) 
Seat 3: liknidste585 ($1.81 in chips) 
Seat 4: bouchizzle ($4.71 in chips) 
Seat 5: coreybetterfold ($3.04 in chips) 
Seat 6: rich1717 ($0.46 in chips) 
19HUNG58: posts small blind $0.01
liknidste585: posts big blind $0.02
*** HOLE CARDS ***
Dealt to CashMatteo [2h 7c]
bouchizzle: folds 
coreybetterfold: raises $3.02 to $3.04 and is all-in
rich1717: folds 
CashMatteo: folds 
19HUNG58: raises $0.74 to $3.78 and is all-in
liknidste585: folds 
Uncalled bet ($0.74) returned to 19HUNG58
*** FLOP *** [Jh 3h 6d]
*** TURN *** [Jh 3h 6d] [3d]
*** RIVER *** [Jh 3h 6d 3d] [Qs]
*** SHOW DOWN ***
19HUNG58: shows [Td Th] (two pair, Tens and Threes)
coreybetterfold: shows [Qh Kd] (two pair, Queens and Threes)
coreybetterfold collected $5.89 from pot
*** SUMMARY ***
Total pot $6.10 | Rake $0.21 
Board [Jh 3h 6d 3d Qs]
Seat 1: CashMatteo (button) folded before Flop (didn't bet)
Seat 2: 19HUNG58 (small blind) showed [Td Th] and lost with two pair, Tens and Threes
Seat 3: liknidste585 (big blind) folded before Flop
Seat 4: bouchizzle folded before Flop (didn't bet)
Seat 5: coreybetterfold showed [Qh Kd] and won ($5.89) with two pair, Queens and Threes
Seat 6: rich1717 folded before Flop (didn't bet)

Hand #346: 

PokerStars Hand #246223587109:  Hold'em No Limit ($0.01/$0.02 CAD) - 2023/09/28 1:59:26 ET
Table 'Prokne II' 6-max Seat #2 is the button
Seat 1: CashMatteo ($2.14 in chips) 
Seat 2: 19HUNG58 ($0.74 in chips) 
Seat 3: liknidste585 ($1.79 in chips) 
Seat 4: bouchizzle ($4.71 in chips) 
Seat 5: coreybetterfold ($5.89 in chips) 
Seat 6: rich1717 ($0.46 in chips) 
liknidste585: posts small blind $0.01
bouchizzle: posts big blind $0.02
*** HOLE CARDS ***
Dealt to CashMatteo [6d Jc]
coreybetterfold: folds 
rich1717: raises $0.04 to $0.06
CashMatteo: folds 
19HUNG58: folds 
liknidste585: calls $0.05
bouchizzle: folds 
*** FLOP *** [7c 3d 2h]
liknidste585: bets $0.14
rich1717: folds 
Uncalled bet ($0.14) returned to liknidste585
liknidste585 collected $0.14 from pot
*** SUMMARY ***
Total pot $0.14 | Rake $0 
Board [7c 3d 2h]
Seat 1: CashMatteo folded before Flop (didn't bet)
Seat 2: 19HUNG58 (button) folded before Flop (didn't bet)
Seat 3: liknidste585 (small blind) collected ($0.14)
Seat 4: bouchizzle (big blind) folded before Flop
Seat 5: coreybetterfold folded before Flop (didn't bet)
Seat 6: rich1717 folded on the Flop

Hand #347: 

PokerStars Hand #246223590253:  Hold'em No Limit ($0.01/$0.02 CAD) - 2023/09/28 2:00:05 ET
Table 'Prokne II' 6-max Seat #3 is the button
Seat 1: CashMatteo ($2.14 in chips) 
Seat 2: 19HUNG58 ($2 in chips) 
Seat 3: liknidste585 ($1.87 in chips) 
Seat 4: bouchizzle ($4.69 in chips) 
Seat 5: coreybetterfold ($5.89 in chips) 
Seat 6: rich1717 ($0.40 in chips) 
bouchizzle: posts small blind $0.01
coreybetterfold: posts big blind $0.02
*** HOLE CARDS ***
Dealt to CashMatteo [2h Ks]
rich1717: calls $0.02
CashMatteo: calls $0.02
19HUNG58: calls $0.02
liknidste585: calls $0.02
bouchizzle: calls $0.01
coreybetterfold: raises $0.46 to $0.48
rich1717: calls $0.38 and is all-in
CashMatteo: folds 
19HUNG58: folds 
liknidste585: calls $0.46
bouchizzle: folds 
*** FLOP *** [2s 3c 3s]
coreybetterfold: bets $5.41 and is all-in
liknidste585: folds 
Uncalled bet ($5.41) returned to coreybetterfold
*** TURN *** [2s 3c 3s] [4h]
*** RIVER *** [2s 3c 3s 4h] [Kd]
*** SHOW DOWN ***
coreybetterfold: shows [9c 9h] (two pair, Nines and Threes)
coreybetterfold collected $0.15 from side pot
rich1717: shows [6h Ah] (a pair of Threes)
coreybetterfold collected $1.22 from main pot
*** SUMMARY ***
Total pot $1.42 Main pot $1.22. Side pot $0.15. | Rake $0.05 
Board [2s 3c 3s 4h Kd]
Seat 1: CashMatteo folded before Flop
Seat 2: 19HUNG58 folded before Flop
Seat 3: liknidste585 (button) folded on the Flop
Seat 4: bouchizzle (small blind) folded before Flop
Seat 5: coreybetterfold (big blind) showed [9c 9h] and won ($1.37) with two pair, Nines and Threes
Seat 6: rich1717 showed [6h Ah] and lost with a pair of Threes

Hand #348: 

PokerStars Hand #246223594717:  Hold'em No Limit ($0.01/$0.02 CAD) - 2023/09/28 2:00:58 ET
Table 'Prokne II' 6-max Seat #4 is the button
Seat 1: CashMatteo ($2.12 in chips) 
Seat 2: 19HUNG58 ($1.98 in chips) 
Seat 3: liknidste585 ($1.39 in chips) 
Seat 4: bouchizzle ($4.67 in chips) 
Seat 5: coreybetterfold ($6.78 in chips) 
coreybetterfold: posts small blind $0.01
CashMatteo: posts big blind $0.02
*** HOLE CARDS ***
Dealt to CashMatteo [Ah Td]
19HUNG58: calls $0.02
liknidste585: calls $0.02
bouchizzle: raises $0.08 to $0.10
coreybetterfold: calls $0.09
CashMatteo: calls $0.08
19HUNG58: folds 
rich1717 leaves the table
liknidste585: calls $0.08
*** FLOP *** [2h 2d 3h]
coreybetterfold: checks 
CashMatteo: checks 
liknidste585: bets $0.41
bouchizzle: folds 
coreybetterfold: folds 
zViveXz joins the table at seat #6 
CashMatteo: folds 
Uncalled bet ($0.41) returned to liknidste585
liknidste585 collected $0.41 from pot
*** SUMMARY ***
Total pot $0.42 | Rake $0.01 
Board [2h 2d 3h]
Seat 1: CashMatteo (big blind) folded on the Flop
Seat 2: 19HUNG58 folded before Flop
Seat 3: liknidste585 collected ($0.41)
Seat 4: bouchizzle (button) folded on the Flop
Seat 5: coreybetterfold (small blind) folded on the Flop

Hand #349: 

PokerStars Hand #246223598657:  Hold'em No Limit ($0.01/$0.02 CAD) - 2023/09/28 2:01:41 ET
Table 'Prokne II' 6-max Seat #5 is the button
Seat 1: CashMatteo ($2.02 in chips) 
Seat 2: 19HUNG58 ($1.96 in chips) 
Seat 3: liknidste585 ($1.70 in chips) 
Seat 4: bouchizzle ($4.57 in chips) 
Seat 5: coreybetterfold ($6.68 in chips) 
zViveXz will be allowed to play after the button
CashMatteo: posts small blind $0.01
19HUNG58: posts big blind $0.02
*** HOLE CARDS ***
Dealt to CashMatteo [Kd 9s]
19HUNG58 said, "fck lose all river ass"
liknidste585: raises $0.02 to $0.04
bouchizzle: folds 
coreybetterfold: folds 
CashMatteo: calls $0.03
19HUNG58: calls $0.02
*** FLOP *** [3c 5d Tc]
CashMatteo: checks 
19HUNG58: checks 
liknidste585: bets $0.02
CashMatteo: calls $0.02
19HUNG58: calls $0.02
*** TURN *** [3c 5d Tc] [3h]
CashMatteo: checks 
19HUNG58: checks 
liknidste585: bets $0.17
CashMatteo: folds 
19HUNG58: folds 
Uncalled bet ($0.17) returned to liknidste585
zViveXz said, "lol morning hung."
liknidste585 collected $0.17 from pot
*** SUMMARY ***
Total pot $0.18 | Rake $0.01 
Board [3c 5d Tc 3h]
Seat 1: CashMatteo (small blind) folded on the Turn
Seat 2: 19HUNG58 (big blind) folded on the Turn
Seat 3: liknidste585 collected ($0.17)
Seat 4: bouchizzle folded before Flop (didn't bet)
Seat 5: coreybetterfold (button) folded before Flop (didn't bet)

Hand #350: 

PokerStars Hand #246223602349:  Hold'em No Limit ($0.01/$0.02 CAD) - 2023/09/28 2:02:22 ET
Table 'Prokne II' 6-max Seat #1 is the button
Seat 1: CashMatteo ($1.96 in chips) 
Seat 2: 19HUNG58 ($1.90 in chips) 
Seat 3: liknidste585 ($1.81 in chips) 
Seat 4: bouchizzle ($4.57 in chips) 
Seat 5: coreybetterfold ($6.68 in chips) 
Seat 6: zViveXz ($2 in chips) 
19HUNG58: posts small blind $0.01
liknidste585: posts big blind $0.02
zViveXz: posts big blind $0.02
*** HOLE CARDS ***
Dealt to CashMatteo [Ks 2d]
bouchizzle: folds 
coreybetterfold: folds 
19HUNG58 said, "hi"
zViveXz: raises $0.04 to $0.06
CashMatteo: calls $0.06
19HUNG58: calls $0.05
liknidste585: raises $0.12 to $0.18
zViveXz: calls $0.12
CashMatteo: folds 
19HUNG58: folds 
*** FLOP *** [Jc Ah 5c]
19HUNG58 said, "fck asso there"
liknidste585: bets $0.46
zViveXz: calls $0.46
*** TURN *** [Jc Ah 5c] [7s]
liknidste585: checks 
zViveXz: bets $0.68
liknidste585: folds 
Uncalled bet ($0.68) returned to zViveXz
zViveXz collected $1.35 from pot
*** SUMMARY ***
Total pot $1.40 | Rake $0.05 
Board [Jc Ah 5c 7s]
Seat 1: CashMatteo (button) folded before Flop
Seat 2: 19HUNG58 (small blind) folded before Flop
Seat 3: liknidste585 (big blind) folded on the Turn
Seat 4: bouchizzle folded before Flop (didn't bet)
Seat 5: coreybetterfold folded before Flop (didn't bet)
Seat 6: zViveXz collected ($1.35)

Hand #351: 

PokerStars Hand #246223607471:  Hold'em No Limit ($0.01/$0.02 CAD) - 2023/09/28 2:03:19 ET
Table 'Prokne II' 6-max Seat #2 is the button
Seat 1: CashMatteo ($1.90 in chips) 
Seat 2: 19HUNG58 ($1.84 in chips) 
Seat 3: liknidste585 ($1.17 in chips) 
Seat 4: bouchizzle ($4.57 in chips) 
Seat 5: coreybetterfold ($6.68 in chips) 
Seat 6: zViveXz ($2.71 in chips) 
liknidste585: posts small blind $0.01
bouchizzle: posts big blind $0.02
*** HOLE CARDS ***
Dealt to CashMatteo [7h 3h]
coreybetterfold: raises $0.05 to $0.07
zViveXz: folds 
CashMatteo: folds 
19HUNG58: folds 
liknidste585: folds 
bouchizzle: folds 
Uncalled bet ($0.05) returned to coreybetterfold
zViveXz said, "lmao you st it again."
coreybetterfold collected $0.05 from pot
coreybetterfold: doesn't show hand 
*** SUMMARY ***
Total pot $0.05 | Rake $0 
Seat 1: CashMatteo folded before Flop (didn't bet)
Seat 2: 19HUNG58 (button) folded before Flop (didn't bet)
Seat 3: liknidste585 (small blind) folded before Flop
Seat 4: bouchizzle (big blind) folded before Flop
Seat 5: coreybetterfold collected ($0.05)
Seat 6: zViveXz folded before Flop (didn't bet)

Hand #352: 

PokerStars Hand #246223609167:  Hold'em No Limit ($0.01/$0.02 CAD) - 2023/09/28 2:03:39 ET
Table 'Prokne II' 6-max Seat #3 is the button
Seat 1: CashMatteo ($1.90 in chips) 
Seat 2: 19HUNG58 ($1.84 in chips) 
Seat 3: liknidste585 ($1.16 in chips) 
Seat 4: bouchizzle ($4.55 in chips) 
Seat 5: coreybetterfold ($6.71 in chips) 
Seat 6: zViveXz ($2.71 in chips) 
bouchizzle: posts small blind $0.01
coreybetterfold: posts big blind $0.02
*** HOLE CARDS ***
Dealt to CashMatteo [3d 3h]
zViveXz: folds 
CashMatteo: raises $0.04 to $0.06
19HUNG58: calls $0.06
liknidste585: folds 
bouchizzle: calls $0.05
coreybetterfold: calls $0.04
*** FLOP *** [2d 3c Ad]
bouchizzle: checks 
coreybetterfold: bets $0.12
CashMatteo: calls $0.12
19HUNG58: calls $0.12
bouchizzle: folds 
*** TURN *** [2d 3c Ad] [Qs]
coreybetterfold: checks 
CashMatteo: bets $0.29
19HUNG58: calls $0.29
coreybetterfold: folds 
*** RIVER *** [2d 3c Ad Qs] [6h]
CashMatteo: bets $0.16
19HUNG58: calls $0.16
*** SHOW DOWN ***
CashMatteo: shows [3d 3h] (three of a kind, Threes)
19HUNG58: mucks hand 
CashMatteo collected $1.45 from pot
*** SUMMARY ***
Total pot $1.50 | Rake $0.05 
Board [2d 3c Ad Qs 6h]
Seat 1: CashMatteo showed [3d 3h] and won ($1.45) with three of a kind, Threes
Seat 2: 19HUNG58 mucked [9s Ac]
Seat 3: liknidste585 (button) folded before Flop (didn't bet)
Seat 4: bouchizzle (small blind) folded on the Flop
Seat 5: coreybetterfold (big blind) folded on the Turn
Seat 6: zViveXz folded before Flop (didn't bet)

Hand #353: 

PokerStars Hand #246223615188:  Hold'em No Limit ($0.01/$0.02 CAD) - 2023/09/28 2:04:45 ET
Table 'Prokne II' 6-max Seat #4 is the button
Seat 1: CashMatteo ($2.72 in chips) 
Seat 2: 19HUNG58 ($1.21 in chips) 
Seat 3: liknidste585 ($1.16 in chips) 
Seat 4: bouchizzle ($4.49 in chips) 
Seat 5: coreybetterfold ($6.53 in chips) 
Seat 6: zViveXz ($2.71 in chips) 
coreybetterfold: posts small blind $0.01
zViveXz: posts big blind $0.02
*** HOLE CARDS ***
Dealt to CashMatteo [4c 5s]
CashMatteo: calls $0.02
19HUNG58: calls $0.02
liknidste585: calls $0.02
bouchizzle: raises $0.10 to $0.12
coreybetterfold: folds 
zViveXz: folds 
CashMatteo: folds 
19HUNG58: folds 
liknidste585: folds 
Uncalled bet ($0.10) returned to bouchizzle
bouchizzle collected $0.11 from pot
bouchizzle: doesn't show hand 
*** SUMMARY ***
Total pot $0.11 | Rake $0 
Seat 1: CashMatteo folded before Flop
Seat 2: 19HUNG58 folded before Flop
Seat 3: liknidste585 folded before Flop
Seat 4: bouchizzle (button) collected ($0.11)
Seat 5: coreybetterfold (small blind) folded before Flop
Seat 6: zViveXz (big blind) folded before Flop

Hand #354: 

PokerStars Hand #246223617444:  Hold'em No Limit ($0.01/$0.02 CAD) - 2023/09/28 2:05:10 ET
Table 'Prokne II' 6-max Seat #5 is the button
Seat 1: CashMatteo ($2.70 in chips) 
Seat 2: 19HUNG58 ($1.19 in chips) 
Seat 3: liknidste585 ($1.14 in chips) 
Seat 4: bouchizzle ($4.58 in chips) 
Seat 5: coreybetterfold ($6.52 in chips) 
Seat 6: zViveXz ($2.69 in chips) 
zViveXz: posts small blind $0.01
CashMatteo: posts big blind $0.02
*** HOLE CARDS ***
Dealt to CashMatteo [Kc 3c]
19HUNG58: calls $0.02
liknidste585: calls $0.02
bouchizzle: folds 
coreybetterfold: raises $0.09 to $0.11
zViveXz: folds 
CashMatteo: folds 
19HUNG58: calls $0.09
liknidste585: folds 
*** FLOP *** [3d 5h 2h]
19HUNG58: checks 
coreybetterfold: bets $0.13
19HUNG58: raises $0.95 to $1.08 and is all-in
coreybetterfold: calls $0.95
*** TURN *** [3d 5h 2h] [2s]
*** RIVER *** [3d 5h 2h 2s] [6s]
*** SHOW DOWN ***
19HUNG58: shows [Ac 5s] (two pair, Fives and Deuces)
coreybetterfold: shows [Ah 7s] (a pair of Deuces)
19HUNG58 collected $2.34 from pot
*** SUMMARY ***
Total pot $2.43 | Rake $0.09 
Board [3d 5h 2h 2s 6s]
Seat 1: CashMatteo (big blind) folded before Flop
Seat 2: 19HUNG58 showed [Ac 5s] and won ($2.34) with two pair, Fives and Deuces
Seat 3: liknidste585 folded before Flop
Seat 4: bouchizzle folded before Flop (didn't bet)
Seat 5: coreybetterfold (button) showed [Ah 7s] and lost with a pair of Deuces
Seat 6: zViveXz (small blind) folded before Flop

Hand #355: 

PokerStars Hand #246223622448:  Hold'em No Limit ($0.01/$0.02 CAD) - 2023/09/28 2:06:05 ET
Table 'Prokne II' 6-max Seat #6 is the button
Seat 1: CashMatteo ($2.68 in chips) 
Seat 2: 19HUNG58 ($2.34 in chips) 
Seat 3: liknidste585 ($1.12 in chips) 
Seat 4: bouchizzle ($4.58 in chips) 
Seat 5: coreybetterfold ($5.33 in chips) 
Seat 6: zViveXz ($2.68 in chips) 
CashMatteo: posts small blind $0.01
19HUNG58: posts big blind $0.02
*** HOLE CARDS ***
Dealt to CashMatteo [Qs 5s]
liknidste585: folds 
bouchizzle: folds 
coreybetterfold: raises $0.05 to $0.07
zViveXz: calls $0.07
CashMatteo: folds 
19HUNG58: folds 
*** FLOP *** [2c 3d Ac]
coreybetterfold: checks 
zViveXz: checks 
*** TURN *** [2c 3d Ac] [2h]
coreybetterfold: bets $0.16
zViveXz: folds 
Uncalled bet ($0.16) returned to coreybetterfold
coreybetterfold collected $0.16 from pot
coreybetterfold: doesn't show hand 
*** SUMMARY ***
Total pot $0.17 | Rake $0.01 
Board [2c 3d Ac 2h]
Seat 1: CashMatteo (small blind) folded before Flop
Seat 2: 19HUNG58 (big blind) folded before Flop
Seat 3: liknidste585 folded before Flop (didn't bet)
Seat 4: bouchizzle folded before Flop (didn't bet)
Seat 5: coreybetterfold collected ($0.16)
Seat 6: zViveXz (button) folded on the Turn

Hand #356: 

PokerStars Hand #246223626122:  Hold'em No Limit ($0.01/$0.02 CAD) - 2023/09/28 2:06:46 ET
Table 'Prokne II' 6-max Seat #1 is the button
Seat 1: CashMatteo ($2.67 in chips) 
Seat 2: 19HUNG58 ($2.32 in chips) 
Seat 3: liknidste585 ($1.12 in chips) 
Seat 4: bouchizzle ($4.58 in chips) 
Seat 5: coreybetterfold ($5.42 in chips) 
Seat 6: zViveXz ($2.61 in chips) 
19HUNG58: posts small blind $0.01
liknidste585: posts big blind $0.02
*** HOLE CARDS ***
Dealt to CashMatteo [3d 9s]
bouchizzle: folds 
coreybetterfold: raises $0.09 to $0.11
zViveXz: calls $0.11
CashMatteo: folds 
19HUNG58: folds 
liknidste585: raises $0.09 to $0.20
coreybetterfold: calls $0.09
zViveXz: calls $0.09
*** FLOP *** [Tc 7d 4s]
liknidste585: bets $0.59
coreybetterfold: folds 
zViveXz: folds 
Uncalled bet ($0.59) returned to liknidste585
liknidste585 collected $0.59 from pot
*** SUMMARY ***
Total pot $0.61 | Rake $0.02 
Board [Tc 7d 4s]
Seat 1: CashMatteo (button) folded before Flop (didn't bet)
Seat 2: 19HUNG58 (small blind) folded before Flop
Seat 3: liknidste585 (big blind) collected ($0.59)
Seat 4: bouchizzle folded before Flop (didn't bet)
Seat 5: coreybetterfold folded on the Flop
Seat 6: zViveXz folded on the Flop

Hand #357: 

PokerStars Hand #246223629608:  Hold'em No Limit ($0.01/$0.02 CAD) - 2023/09/28 2:07:25 ET
Table 'Prokne II' 6-max Seat #2 is the button
Seat 1: CashMatteo ($2.67 in chips) 
Seat 2: 19HUNG58 ($2.31 in chips) 
Seat 3: liknidste585 ($1.51 in chips) 
Seat 4: bouchizzle ($4.58 in chips) 
Seat 5: coreybetterfold ($5.22 in chips) 
Seat 6: zViveXz ($2.41 in chips) 
liknidste585: posts small blind $0.01
bouchizzle: posts big blind $0.02
*** HOLE CARDS ***
Dealt to CashMatteo [2s Jc]
coreybetterfold: calls $0.02
zViveXz: raises $0.04 to $0.06
CashMatteo: folds 
19HUNG58: folds 
liknidste585: calls $0.05
bouchizzle: calls $0.04
coreybetterfold: calls $0.04
*** FLOP *** [Jd 9c 4d]
liknidste585: checks 
bouchizzle: bets $0.14
coreybetterfold: calls $0.14
zViveXz: calls $0.14
liknidste585: folds 
*** TURN *** [Jd 9c 4d] [7d]
bouchizzle: bets $0.38
coreybetterfold: raises $0.38 to $0.76
zViveXz: calls $0.76
bouchizzle: calls $0.38
*** RIVER *** [Jd 9c 4d 7d] [Td]
bouchizzle: checks 
coreybetterfold: bets $1.42
19HUNG58 said, "go smoking"
zViveXz: raises $0.03 to $1.45 and is all-in
bouchizzle: folds 
coreybetterfold: folds 
Uncalled bet ($0.03) returned to zViveXz
zViveXz collected $5.58 from pot
*** SUMMARY ***
Total pot $5.78 | Rake $0.20 
Board [Jd 9c 4d 7d Td]
Seat 1: CashMatteo folded before Flop (didn't bet)
Seat 2: 19HUNG58 (button) folded before Flop (didn't bet)
Seat 3: liknidste585 (small blind) folded on the Flop
Seat 4: bouchizzle (big blind) folded on the River
Seat 5: coreybetterfold folded on the River
Seat 6: zViveXz collected ($5.58)

Hand #358: 

PokerStars Hand #246223636584:  Hold'em No Limit ($0.01/$0.02 CAD) - 2023/09/28 2:08:42 ET
Table 'Prokne II' 6-max Seat #3 is the button
Seat 1: CashMatteo ($2.67 in chips) 
Seat 3: liknidste585 ($1.45 in chips) 
Seat 4: bouchizzle ($3.62 in chips) 
Seat 5: coreybetterfold ($2.84 in chips) 
Seat 6: zViveXz ($5.61 in chips) 
bouchizzle: posts small blind $0.01
coreybetterfold: posts big blind $0.02
*** HOLE CARDS ***
Dealt to CashMatteo [9c Ad]
zViveXz: raises $0.04 to $0.06
CashMatteo: calls $0.06
liknidste585: folds 
bouchizzle: folds 
coreybetterfold: calls $0.04
*** FLOP *** [3h 3d Kh]
coreybetterfold: checks 
zViveXz: bets $0.09
zViveXz said, "lol folded 2c more"
CashMatteo: calls $0.09
coreybetterfold: raises $0.09 to $0.18
zViveXz: calls $0.09
CashMatteo: folds 
*** TURN *** [3h 3d Kh] [4h]
coreybetterfold: bets $0.62
zViveXz: calls $0.62
*** RIVER *** [3h 3d Kh 4h] [Js]
coreybetterfold: bets $0.91
zViveXz: raises $3.63 to $4.54
coreybetterfold: folds 
Uncalled bet ($3.63) returned to zViveXz
zViveXz collected $3.57 from pot
*** SUMMARY ***
Total pot $3.70 | Rake $0.13 
Board [3h 3d Kh 4h Js]
Seat 1: CashMatteo folded on the Flop
Seat 3: liknidste585 (button) folded before Flop (didn't bet)
Seat 4: bouchizzle (small blind) folded before Flop
Seat 5: coreybetterfold (big blind) folded on the River
Seat 6: zViveXz collected ($3.57)

Hand #359: 

PokerStars Hand #246223643431:  Hold'em No Limit ($0.01/$0.02 CAD) - 2023/09/28 2:09:58 ET
Table 'Prokne II' 6-max Seat #4 is the button
Seat 1: CashMatteo ($2.52 in chips) 
Seat 3: liknidste585 ($1.45 in chips) 
Seat 4: bouchizzle ($3.61 in chips) 
Seat 5: coreybetterfold ($1.07 in chips) 
Seat 6: zViveXz ($7.41 in chips) 
coreybetterfold: posts small blind $0.01
zViveXz: posts big blind $0.02
*** HOLE CARDS ***
Dealt to CashMatteo [3d 3h]
CashMatteo: raises $0.04 to $0.06
liknidste585: folds 
bouchizzle: folds 
coreybetterfold: raises $1.01 to $1.07 and is all-in
zViveXz: folds 
CashMatteo: calls $1.01
*** FLOP *** [Kd Qs 7s]
*** TURN *** [Kd Qs 7s] [8s]
*** RIVER *** [Kd Qs 7s 8s] [Ac]
*** SHOW DOWN ***
coreybetterfold: shows [4c Kc] (a pair of Kings)
CashMatteo: shows [3d 3h] (a pair of Threes)
coreybetterfold collected $2.08 from pot
*** SUMMARY ***
Total pot $2.16 | Rake $0.08 
Board [Kd Qs 7s 8s Ac]
Seat 1: CashMatteo showed [3d 3h] and lost with a pair of Threes
Seat 3: liknidste585 folded before Flop (didn't bet)
Seat 4: bouchizzle (button) folded before Flop (didn't bet)
Seat 5: coreybetterfold (small blind) showed [4c Kc] and won ($2.08) with a pair of Kings
Seat 6: zViveXz (big blind) folded before Flop

Hand #360: 

PokerStars Hand #246223647018:  Hold'em No Limit ($0.01/$0.02 CAD) - 2023/09/28 2:10:38 ET
Table 'Prokne II' 6-max Seat #5 is the button
Seat 1: CashMatteo ($1.45 in chips) 
Seat 3: liknidste585 ($1.45 in chips) 
Seat 4: bouchizzle ($3.61 in chips) 
Seat 5: coreybetterfold ($2.08 in chips) 
Seat 6: zViveXz ($7.39 in chips) 
zViveXz: posts small blind $0.01
CashMatteo: posts big blind $0.02
*** HOLE CARDS ***
Dealt to CashMatteo [2h 8d]
liknidste585: calls $0.02
bouchizzle: folds 
coreybetterfold: folds 
zViveXz: folds 
CashMatteo: checks 
*** FLOP *** [6d Qd Jd]
CashMatteo: checks 
liknidste585: checks 
*** TURN *** [6d Qd Jd] [2s]
CashMatteo: checks 
liknidste585: checks 
*** RIVER *** [6d Qd Jd 2s] [Ah]
CashMatteo: checks 
liknidste585: bets $0.04
CashMatteo: folds [2h]
Uncalled bet ($0.04) returned to liknidste585
liknidste585 collected $0.05 from pot
*** SUMMARY ***
Total pot $0.05 | Rake $0 
Board [6d Qd Jd 2s Ah]
Seat 1: CashMatteo (big blind) folded on the River
Seat 3: liknidste585 collected ($0.05)
Seat 4: bouchizzle folded before Flop (didn't bet)
Seat 5: coreybetterfold (button) folded before Flop (didn't bet)
Seat 6: zViveXz (small blind) folded before Flop

Hand #361: 

PokerStars Hand #246223653586:  Hold'em No Limit ($0.01/$0.02 CAD) - 2023/09/28 2:11:51 ET
Table 'Prokne II' 6-max Seat #6 is the button
Seat 1: CashMatteo ($1.43 in chips) 
Seat 2: 19HUNG58 ($2.31 in chips) 
Seat 3: liknidste585 ($1.48 in chips) 
Seat 4: bouchizzle ($3.61 in chips) 
Seat 5: coreybetterfold ($2.08 in chips) 
Seat 6: zViveXz ($7.38 in chips) 
CashMatteo: posts small blind $0.01
19HUNG58: posts big blind $0.02
*** HOLE CARDS ***
Dealt to CashMatteo [8s 6h]
liknidste585: folds 
bouchizzle: folds 
coreybetterfold: calls $0.02
zViveXz: raises $0.04 to $0.06
CashMatteo: folds 
19HUNG58: calls $0.04
coreybetterfold: calls $0.04
*** FLOP *** [Td 6s Kh]
19HUNG58: checks 
coreybetterfold: bets $0.09
zViveXz: calls $0.09
19HUNG58: folds 
*** TURN *** [Td 6s Kh] [3s]
coreybetterfold: bets $0.36
zViveXz: calls $0.36
*** RIVER *** [Td 6s Kh 3s] [Tc]
coreybetterfold: bets $1.57 and is all-in
zViveXz: calls $1.57
*** SHOW DOWN ***
coreybetterfold: shows [5h 9s] (a pair of Tens)
zViveXz: shows [Th Kc] (a full house, Tens full of Kings)
zViveXz collected $4.08 from pot
*** SUMMARY ***
Total pot $4.23 | Rake $0.15 
Board [Td 6s Kh 3s Tc]
Seat 1: CashMatteo (small blind) folded before Flop
Seat 2: 19HUNG58 (big blind) folded on the Flop
Seat 3: liknidste585 folded before Flop (didn't bet)
Seat 4: bouchizzle folded before Flop (didn't bet)
Seat 5: coreybetterfold showed [5h 9s] and lost with a pair of Tens
Seat 6: zViveXz (button) showed [Th Kc] and won ($4.08) with a full house, Tens full of Kings

Hand #362: 

PokerStars Hand #246223662568:  Hold'em No Limit ($0.01/$0.02 CAD) - 2023/09/28 2:13:30 ET
Table 'Prokne II' 6-max Seat #1 is the button
Seat 1: CashMatteo ($1.42 in chips) 
Seat 2: 19HUNG58 ($2.25 in chips) 
Seat 3: liknidste585 ($1.48 in chips) 
Seat 4: bouchizzle ($3.61 in chips) 
Seat 6: zViveXz ($9.38 in chips) 
19HUNG58: posts small blind $0.01
liknidste585: posts big blind $0.02
*** HOLE CARDS ***
Dealt to CashMatteo [Ts 8c]
coreybetterfold leaves the table
bouchizzle: raises $0.04 to $0.06
zViveXz: calls $0.06
CashMatteo: folds 
19HUNG58: folds 
liknidste585: calls $0.04
*** FLOP *** [4c As 3h]
zViveXz said, "haha he gone"
liknidste585: checks 
bouchizzle: bets $0.11
zViveXz: folds 
liknidste585: calls $0.11
*** TURN *** [4c As 3h] [Ad]
liknidste585: bets $0.02
bouchizzle: calls $0.02
*** RIVER *** [4c As 3h Ad] [Tc]
liknidste585: bets $0.43
bouchizzle: folds 
Uncalled bet ($0.43) returned to liknidste585
liknidste585 collected $0.43 from pot
*** SUMMARY ***
Total pot $0.45 | Rake $0.02 
Board [4c As 3h Ad Tc]
Seat 1: CashMatteo (button) folded before Flop (didn't bet)
Seat 2: 19HUNG58 (small blind) folded before Flop
Seat 3: liknidste585 (big blind) collected ($0.43)
Seat 4: bouchizzle folded on the River
Seat 6: zViveXz folded on the Flop

Hand #363: 

PokerStars Hand #246223666962:  Hold'em No Limit ($0.01/$0.02 CAD) - 2023/09/28 2:14:18 ET
Table 'Prokne II' 6-max Seat #2 is the button
Seat 1: CashMatteo ($1.42 in chips) 
Seat 2: 19HUNG58 ($2.24 in chips) 
Seat 3: liknidste585 ($1.72 in chips) 
Seat 4: bouchizzle ($3.42 in chips) 
Seat 6: zViveXz ($9.32 in chips) 
liknidste585: posts small blind $0.01
bouchizzle: posts big blind $0.02
*** HOLE CARDS ***
Dealt to CashMatteo [7d 8c]
zViveXz: raises $0.04 to $0.06
CashMatteo: folds 
19HUNG58: calls $0.06
liknidste585: calls $0.05
bouchizzle: folds 
*** FLOP *** [8d Jc 9h]
19HUNG58 said, "he lose 2 bucks"
liknidste585: checks 
zViveXz: bets $0.10
19HUNG58: calls $0.10
19HUNG58 said, "my money"
liknidste585: raises $0.10 to $0.20
zViveXz: folds 
19HUNG58: calls $0.10
*** TURN *** [8d Jc 9h] [9s]
liknidste585: bets $0.68
19HUNG58 said, "lose 10 bucks already"
19HUNG58: folds 
Uncalled bet ($0.68) returned to liknidste585
liknidste585 collected $0.68 from pot
*** SUMMARY ***
Total pot $0.70 | Rake $0.02 
Board [8d Jc 9h 9s]
Seat 1: CashMatteo folded before Flop (didn't bet)
Seat 2: 19HUNG58 (button) folded on the Turn
Seat 3: liknidste585 (small blind) collected ($0.68)
Seat 4: bouchizzle (big blind) folded before Flop
Seat 6: zViveXz folded on the Flop

Hand #364: 

PokerStars Hand #246223675987:  Hold'em No Limit ($0.01/$0.02 CAD) - 2023/09/28 2:15:58 ET
Table 'Prokne II' 6-max Seat #3 is the button
Seat 1: CashMatteo ($1.42 in chips) 
Seat 2: 19HUNG58 ($1.98 in chips) 
Seat 3: liknidste585 ($2.14 in chips) 
Seat 4: bouchizzle ($3.40 in chips) 
Seat 6: zViveXz ($9.16 in chips) 
bouchizzle: posts small blind $0.01
zViveXz: posts big blind $0.02
*** HOLE CARDS ***
Dealt to CashMatteo [2d Ac]
CashMatteo: calls $0.02
19HUNG58: calls $0.02
liknidste585: calls $0.02
bouchizzle: folds 
zViveXz: checks 
*** FLOP *** [8h Th Tc]
zViveXz: checks 
CashMatteo: checks 
19HUNG58: checks 
liknidste585: bets $0.09
zViveXz: folds 
CashMatteo: folds 
19HUNG58: folds 
Uncalled bet ($0.09) returned to liknidste585
liknidste585 collected $0.09 from pot
*** SUMMARY ***
Total pot $0.09 | Rake $0 
Board [8h Th Tc]
Seat 1: CashMatteo folded on the Flop
Seat 2: 19HUNG58 folded on the Flop
Seat 3: liknidste585 (button) collected ($0.09)
Seat 4: bouchizzle (small blind) folded before Flop
Seat 6: zViveXz (big blind) folded on the Flop

Hand #365: 

PokerStars Hand #246223679455:  Hold'em No Limit ($0.01/$0.02 CAD) - 2023/09/28 2:16:35 ET
Table 'Prokne II' 6-max Seat #4 is the button
Seat 1: CashMatteo ($1.40 in chips) 
Seat 2: 19HUNG58 ($1.96 in chips) 
Seat 3: liknidste585 ($2.21 in chips) 
Seat 4: bouchizzle ($3.39 in chips) 
Seat 6: zViveXz ($9.14 in chips) 
zViveXz: posts small blind $0.01
CashMatteo: posts big blind $0.02
*** HOLE CARDS ***
Dealt to CashMatteo [Tc 5h]
19HUNG58: calls $0.02
liknidste585: raises $0.02 to $0.04
bouchizzle: folds 
zViveXz: calls $0.03
CashMatteo: folds 
19HUNG58: calls $0.02
*** FLOP *** [Ts 2s Kd]
zViveXz said, "lol he Bluffs way to high. tdsook it all in 4 turns and some good hands lo"
kmcc1327 joins the table at seat #5 
zViveXz: checks 
19HUNG58: bets $0.20
liknidste585: raises $0.20 to $0.40
zViveXz: folds 
19HUNG58: calls $0.20
*** TURN *** [Ts 2s Kd] [3s]
19HUNG58: checks 
zViveXz said, "yall betting crazy for 1c/2c how you lose alot lol"
liknidste585: bets $0.91
19HUNG58: raises $0.61 to $1.52 and is all-in
liknidste585: calls $0.61
*** RIVER *** [Ts 2s Kd 3s] [4c]
*** SHOW DOWN ***
19HUNG58: shows [Ks Jh] (a pair of Kings)
liknidste585: shows [Td Qs] (a pair of Tens)
19HUNG58 collected $3.84 from pot
*** SUMMARY ***
Total pot $3.98 | Rake $0.14 
Board [Ts 2s Kd 3s 4c]
Seat 1: CashMatteo (big blind) folded before Flop
Seat 2: 19HUNG58 showed [Ks Jh] and won ($3.84) with a pair of Kings
Seat 3: liknidste585 showed [Td Qs] and lost with a pair of Tens
Seat 4: bouchizzle (button) folded before Flop (didn't bet)
Seat 6: zViveXz (small blind) folded on the Flop

Hand #366: 

PokerStars Hand #246223685599:  Hold'em No Limit ($0.01/$0.02 CAD) - 2023/09/28 2:17:43 ET
Table 'Prokne II' 6-max Seat #6 is the button
Seat 1: CashMatteo ($1.38 in chips) 
Seat 2: 19HUNG58 ($3.84 in chips) 
Seat 3: liknidste585 ($0.25 in chips) 
Seat 4: bouchizzle ($3.39 in chips) 
Seat 6: zViveXz ($9.10 in chips) 
CashMatteo: posts small blind $0.01
19HUNG58: posts big blind $0.02
kmcc1327: sits out 
*** HOLE CARDS ***
Dealt to CashMatteo [5d Tc]
liknidste585: raises $0.05 to $0.07
bouchizzle: folds 
zViveXz: folds 
CashMatteo: folds 
19HUNG58: calls $0.05
*** FLOP *** [5c Td Qc]
19HUNG58: checks 
liknidste585: bets $0.14
19HUNG58: raises $0.14 to $0.28
liknidste585: calls $0.04 and is all-in
Uncalled bet ($0.10) returned to 19HUNG58
*** TURN *** [5c Td Qc] [8s]
*** RIVER *** [5c Td Qc 8s] [6d]
*** SHOW DOWN ***
19HUNG58: shows [7h Th] (a pair of Tens)
liknidste585: shows [2d 7d] (high card Queen)
19HUNG58 collected $0.49 from pot
*** SUMMARY ***
Total pot $0.51 | Rake $0.02 
Board [5c Td Qc 8s 6d]
Seat 1: CashMatteo (small blind) folded before Flop
Seat 2: 19HUNG58 (big blind) showed [7h Th] and won ($0.49) with a pair of Tens
Seat 3: liknidste585 showed [2d 7d] and lost with high card Queen
Seat 4: bouchizzle folded before Flop (didn't bet)
Seat 6: zViveXz (button) folded before Flop (didn't bet)

Hand #367: 

PokerStars Hand #246223689071:  Hold'em No Limit ($0.01/$0.02 CAD) - 2023/09/28 2:18:20 ET
Table 'Prokne II' 6-max Seat #1 is the button
Seat 1: CashMatteo ($1.37 in chips) 
Seat 2: 19HUNG58 ($4.08 in chips) 
Seat 4: bouchizzle ($3.39 in chips) 
Seat 5: kmcc1327 ($1.56 in chips) 
Seat 6: zViveXz ($9.10 in chips) 
19HUNG58: posts small blind $0.01
bouchizzle: posts big blind $0.02
kmcc1327: posts big blind $0.02
*** HOLE CARDS ***
Dealt to CashMatteo [8d 2s]
kmcc1327: checks 
liknidste585 leaves the table
zViveXz: folds 
CashMatteo: folds 
19HUNG58 said, "i lose him all river rats"
19HUNG58: calls $0.01
bouchizzle: checks 
*** FLOP *** [Ks Jh 9h]
19HUNG58: checks 
bouchizzle: checks 
kmcc1327: checks 
*** TURN *** [Ks Jh 9h] [As]
19HUNG58: checks 
bouchizzle: checks 
kmcc1327: bets $0.04
19HUNG58: folds 
bouchizzle: folds 
Uncalled bet ($0.04) returned to kmcc1327
kmcc1327 collected $0.06 from pot
kmcc1327: doesn't show hand 
*** SUMMARY ***
Total pot $0.06 | Rake $0 
Board [Ks Jh 9h As]
Seat 1: CashMatteo (button) folded before Flop (didn't bet)
Seat 2: 19HUNG58 (small blind) folded on the Turn
Seat 4: bouchizzle (big blind) folded on the Turn
Seat 5: kmcc1327 collected ($0.06)
Seat 6: zViveXz folded before Flop (didn't bet)

Hand #368: 

PokerStars Hand #246223694241:  Hold'em No Limit ($0.01/$0.02 CAD) - 2023/09/28 2:19:17 ET
Table 'Prokne II' 6-max Seat #2 is the button
Seat 1: CashMatteo ($1.37 in chips) 
Seat 2: 19HUNG58 ($4.06 in chips) 
Seat 4: bouchizzle ($3.37 in chips) 
Seat 5: kmcc1327 ($1.60 in chips) 
Seat 6: zViveXz ($9.10 in chips) 
bouchizzle: posts small blind $0.01
kmcc1327: posts big blind $0.02
*** HOLE CARDS ***
Dealt to CashMatteo [5s 8h]
zViveXz: folds 
CashMatteo: folds 
19HUNG58: calls $0.02
bouchizzle: raises $0.08 to $0.10
kmcc1327: calls $0.08
19HUNG58: folds 
*** FLOP *** [2d 2h 5d]
bouchizzle: bets $0.13
kmcc1327: folds 
Uncalled bet ($0.13) returned to bouchizzle
bouchizzle collected $0.21 from pot
bouchizzle: doesn't show hand 
*** SUMMARY ***
Total pot $0.22 | Rake $0.01 
Board [2d 2h 5d]
Seat 1: CashMatteo folded before Flop (didn't bet)
Seat 2: 19HUNG58 (button) folded before Flop
Seat 4: bouchizzle (small blind) collected ($0.21)
Seat 5: kmcc1327 (big blind) folded on the Flop
Seat 6: zViveXz folded before Flop (didn't bet)

Hand #369: 

PokerStars Hand #246223697028:  Hold'em No Limit ($0.01/$0.02 CAD) - 2023/09/28 2:19:47 ET
Table 'Prokne II' 6-max Seat #4 is the button
Seat 1: CashMatteo ($1.37 in chips) 
Seat 2: 19HUNG58 ($4.04 in chips) 
Seat 4: bouchizzle ($3.48 in chips) 
Seat 5: kmcc1327 ($1.50 in chips) 
Seat 6: zViveXz ($9.10 in chips) 
kmcc1327: posts small blind $0.01
zViveXz: posts big blind $0.02
*** HOLE CARDS ***
Dealt to CashMatteo [Kc 4s]
CashMatteo has timed out
CashMatteo: folds 
19HUNG58: calls $0.02
bouchizzle: raises $0.06 to $0.08
kmcc1327: folds 
zViveXz: folds 
19HUNG58: folds 
Uncalled bet ($0.06) returned to bouchizzle
bouchizzle collected $0.07 from pot
bouchizzle: doesn't show hand 
*** SUMMARY ***
Total pot $0.07 | Rake $0 
Seat 1: CashMatteo folded before Flop (didn't bet)
Seat 2: 19HUNG58 folded before Flop
Seat 4: bouchizzle (button) collected ($0.07)
Seat 5: kmcc1327 (small blind) folded before Flop
Seat 6: zViveXz (big blind) folded before Flop

Hand #370: 

PokerStars Hand #246223702323:  Hold'em No Limit ($0.01/$0.02 CAD) - 2023/09/28 2:20:45 ET
Table 'Prokne II' 6-max Seat #2 is the button
Seat 1: CashMatteo ($1.37 in chips) 
Seat 2: 19HUNG58 ($3.99 in chips) 
Seat 4: bouchizzle ($3.54 in chips) 
Seat 5: kmcc1327 ($1.49 in chips) 
Seat 6: zViveXz ($9.10 in chips) 
bouchizzle: posts small blind $0.01
kmcc1327: posts big blind $0.02
CashMatteo: posts small & big blinds $0.03
*** HOLE CARDS ***
Dealt to CashMatteo [6h 6c]
zViveXz: raises $0.04 to $0.06
CashMatteo: raises $0.04 to $0.10
19HUNG58: folds 
zViveXz said, "unlucky  but happens to often "
bouchizzle: folds 
kmcc1327: calls $0.08
zViveXz: calls $0.04
*** FLOP *** [8d 9s 2h]
kmcc1327: checks 
zViveXz: checks 
CashMatteo: checks 
*** TURN *** [8d 9s 2h] [6s]
kmcc1327: checks 
Want 2 Dance joins the table at seat #3 
zViveXz: bets $0.16
CashMatteo: raises $0.32 to $0.48
kmcc1327: folds 
zViveXz: calls $0.32
*** RIVER *** [8d 9s 2h 6s] [Kh]
zViveXz: checks 
CashMatteo: bets $0.78 and is all-in
zViveXz: calls $0.78
*** SHOW DOWN ***
CashMatteo: shows [6h 6c] (three of a kind, Sixes)
zViveXz: shows [Kc 9c] (two pair, Kings and Nines)
CashMatteo collected $2.74 from pot
*** SUMMARY ***
Total pot $2.84 | Rake $0.10 
Board [8d 9s 2h 6s Kh]
Seat 1: CashMatteo showed [6h 6c] and won ($2.74) with three of a kind, Sixes
Seat 2: 19HUNG58 (button) folded before Flop (didn't bet)
Seat 4: bouchizzle (small blind) folded before Flop
Seat 5: kmcc1327 (big blind) folded on the Turn
Seat 6: zViveXz showed [Kc 9c] and lost with two pair, Kings and Nines

Hand #371: 

PokerStars Hand #246223709773:  Hold'em No Limit ($0.01/$0.02 CAD) - 2023/09/28 2:22:06 ET
Table 'Prokne II' 6-max Seat #4 is the button
Seat 1: CashMatteo ($2.74 in chips) 
Seat 2: 19HUNG58 ($3.99 in chips) 
Seat 4: bouchizzle ($3.53 in chips) 
Seat 5: kmcc1327 ($1.39 in chips) 
Seat 6: zViveXz ($7.74 in chips) 
kmcc1327: posts small blind $0.01
zViveXz: posts big blind $0.02
Want 2 Dance: sits out 
*** HOLE CARDS ***
Dealt to CashMatteo [8h 4h]
CashMatteo: calls $0.02
19HUNG58: folds 
bouchizzle: raises $0.06 to $0.08
kmcc1327: folds 
zViveXz: folds 
zViveXz said, "nh"
CashMatteo: calls $0.06
*** FLOP *** [Ad 6s 7c]
CashMatteo: checks 
bouchizzle: bets $0.11
CashMatteo: folds 
Uncalled bet ($0.11) returned to bouchizzle
bouchizzle collected $0.18 from pot
bouchizzle: doesn't show hand 
*** SUMMARY ***
Total pot $0.19 | Rake $0.01 
Board [Ad 6s 7c]
Seat 1: CashMatteo folded on the Flop
Seat 2: 19HUNG58 folded before Flop (didn't bet)
Seat 4: bouchizzle (button) collected ($0.18)
Seat 5: kmcc1327 (small blind) folded before Flop
Seat 6: zViveXz (big blind) folded before Flop

Hand #372: 

PokerStars Hand #246223712967:  Hold'em No Limit ($0.01/$0.02 CAD) - 2023/09/28 2:22:41 ET
Table 'Prokne II' 6-max Seat #5 is the button
Seat 1: CashMatteo ($2.66 in chips) 
Seat 2: 19HUNG58 ($3.99 in chips) 
Seat 4: bouchizzle ($3.63 in chips) 
Seat 5: kmcc1327 ($1.38 in chips) 
Seat 6: zViveXz ($7.72 in chips) 
zViveXz: posts small blind $0.01
CashMatteo: posts big blind $0.02
Want 2 Dance: sits out 
*** HOLE CARDS ***
Dealt to CashMatteo [9d 5d]
19HUNG58: calls $0.02
bouchizzle: folds 
kmcc1327: folds 
zViveXz: calls $0.01
CashMatteo: checks 
*** FLOP *** [Ad Ac 6h]
zViveXz: checks 
CashMatteo: checks 
19HUNG58: checks 
*** TURN *** [Ad Ac 6h] [3d]
zViveXz: checks 
CashMatteo: checks 
19HUNG58: checks 
*** RIVER *** [Ad Ac 6h 3d] [Kd]
zViveXz: checks 
CashMatteo: bets $0.08
19HUNG58: folds 
zViveXz: folds 
Uncalled bet ($0.08) returned to CashMatteo
CashMatteo collected $0.06 from pot
CashMatteo: doesn't show hand 
*** SUMMARY ***
Total pot $0.06 | Rake $0 
Board [Ad Ac 6h 3d Kd]
Seat 1: CashMatteo (big blind) collected ($0.06)
Seat 2: 19HUNG58 folded on the River
Seat 4: bouchizzle folded before Flop (didn't bet)
Seat 5: kmcc1327 (button) folded before Flop (didn't bet)
Seat 6: zViveXz (small blind) folded on the River

Hand #373: 

PokerStars Hand #246223717972:  Hold'em No Limit ($0.01/$0.02 CAD) - 2023/09/28 2:23:36 ET
Table 'Prokne II' 6-max Seat #6 is the button
Seat 1: CashMatteo ($2.70 in chips) 
Seat 2: 19HUNG58 ($3.97 in chips) 
Seat 4: bouchizzle ($3.63 in chips) 
Seat 5: kmcc1327 ($1.38 in chips) 
Seat 6: zViveXz ($7.70 in chips) 
CashMatteo: posts small blind $0.01
19HUNG58: posts big blind $0.02
Want 2 Dance: sits out 
*** HOLE CARDS ***
Dealt to CashMatteo [6c Jh]
bouchizzle: folds 
kmcc1327: folds 
zViveXz: folds 
CashMatteo: calls $0.01
19HUNG58: checks 
*** FLOP *** [8h 8d 7c]
CashMatteo: checks 
19HUNG58: checks 
*** TURN *** [8h 8d 7c] [2s]
CashMatteo: checks 
19HUNG58: checks 
*** RIVER *** [8h 8d 7c 2s] [4h]
CashMatteo: checks 
19HUNG58: checks 
*** SHOW DOWN ***
CashMatteo: shows [6c Jh] (a pair of Eights)
19HUNG58: mucks hand 
CashMatteo collected $0.04 from pot
*** SUMMARY ***
Total pot $0.04 | Rake $0 
Board [8h 8d 7c 2s 4h]
Seat 1: CashMatteo (small blind) showed [6c Jh] and won ($0.04) with a pair of Eights
Seat 2: 19HUNG58 (big blind) mucked [9h 5d]
Seat 4: bouchizzle folded before Flop (didn't bet)
Seat 5: kmcc1327 folded before Flop (didn't bet)
Seat 6: zViveXz (button) folded before Flop (didn't bet)

Hand #374: 

PokerStars Hand #246223721296:  Hold'em No Limit ($0.01/$0.02 CAD) - 2023/09/28 2:24:12 ET
Table 'Prokne II' 6-max Seat #1 is the button
Seat 1: CashMatteo ($2.72 in chips) 
Seat 2: 19HUNG58 ($3.95 in chips) 
Seat 3: Want 2 Dance ($2 in chips) 
Seat 4: bouchizzle ($3.63 in chips) 
Seat 5: kmcc1327 ($1.38 in chips) 
Seat 6: zViveXz ($7.70 in chips) 
19HUNG58: posts small blind $0.01
Want 2 Dance: posts big blind $0.02
*** HOLE CARDS ***
Dealt to CashMatteo [4c Td]
bouchizzle: folds 
kmcc1327: folds 
zViveXz: folds 
CashMatteo: folds 
19HUNG58: folds 
Uncalled bet ($0.01) returned to Want 2 Dance
Want 2 Dance collected $0.02 from pot
*** SUMMARY ***
Total pot $0.02 | Rake $0 
Seat 1: CashMatteo (button) folded before Flop (didn't bet)
Seat 2: 19HUNG58 (small blind) folded before Flop
Seat 3: Want 2 Dance (big blind) collected ($0.02)
Seat 4: bouchizzle folded before Flop (didn't bet)
Seat 5: kmcc1327 folded before Flop (didn't bet)
Seat 6: zViveXz folded before Flop (didn't bet)

Hand #375: 

PokerStars Hand #246223722440:  Hold'em No Limit ($0.01/$0.02 CAD) - 2023/09/28 2:24:25 ET
Table 'Prokne II' 6-max Seat #2 is the button
Seat 1: CashMatteo ($2.72 in chips) 
Seat 2: 19HUNG58 ($3.94 in chips) 
Seat 3: Want 2 Dance ($2.01 in chips) 
Seat 4: bouchizzle ($3.63 in chips) 
Seat 5: kmcc1327 ($1.38 in chips) 
Seat 6: zViveXz ($7.70 in chips) 
Want 2 Dance: posts small blind $0.01
bouchizzle: posts big blind $0.02
*** HOLE CARDS ***
Dealt to CashMatteo [8d Kd]
kmcc1327: folds 
zViveXz: folds 
CashMatteo: calls $0.02
19HUNG58: folds 
Want 2 Dance: folds 
bouchizzle: checks 
*** FLOP *** [Qd 4s 2h]
bouchizzle: checks 
CashMatteo: checks 
*** TURN *** [Qd 4s 2h] [As]
bouchizzle: checks 
CashMatteo: checks 
*** RIVER *** [Qd 4s 2h As] [5h]
bouchizzle: checks 
CashMatteo: checks 
*** SHOW DOWN ***
bouchizzle: shows [4d 7c] (a pair of Fours)
CashMatteo: mucks hand 
bouchizzle collected $0.05 from pot
*** SUMMARY ***
Total pot $0.05 | Rake $0 
Board [Qd 4s 2h As 5h]
Seat 1: CashMatteo mucked [8d Kd]
Seat 2: 19HUNG58 (button) folded before Flop (didn't bet)
Seat 3: Want 2 Dance (small blind) folded before Flop
Seat 4: bouchizzle (big blind) showed [4d 7c] and won ($0.05) with a pair of Fours
Seat 5: kmcc1327 folded before Flop (didn't bet)
Seat 6: zViveXz folded before Flop (didn't bet)

Hand #376: 

PokerStars Hand #246223725270:  Hold'em No Limit ($0.01/$0.02 CAD) - 2023/09/28 2:24:54 ET
Table 'Prokne II' 6-max Seat #3 is the button
Seat 1: CashMatteo ($2.70 in chips) 
Seat 2: 19HUNG58 ($3.94 in chips) 
Seat 3: Want 2 Dance ($2 in chips) 
Seat 4: bouchizzle ($3.66 in chips) 
Seat 5: kmcc1327 ($1.38 in chips) 
Seat 6: zViveXz ($7.70 in chips) 
bouchizzle: posts small blind $0.01
kmcc1327: posts big blind $0.02
*** HOLE CARDS ***
Dealt to CashMatteo [3h 9s]
zViveXz: raises $0.02 to $0.04
CashMatteo: folds 
19HUNG58: folds 
Want 2 Dance: folds 
bouchizzle: calls $0.03
kmcc1327: calls $0.02
*** FLOP *** [9h Ac 4d]
bouchizzle: checks 
kmcc1327: checks 
zViveXz: bets $0.06
bouchizzle: folds 
kmcc1327: folds 
Uncalled bet ($0.06) returned to zViveXz
zViveXz collected $0.12 from pot
*** SUMMARY ***
Total pot $0.12 | Rake $0 
Board [9h Ac 4d]
Seat 1: CashMatteo folded before Flop (didn't bet)
Seat 2: 19HUNG58 folded before Flop (didn't bet)
Seat 3: Want 2 Dance (button) folded before Flop (didn't bet)
Seat 4: bouchizzle (small blind) folded on the Flop
Seat 5: kmcc1327 (big blind) folded on the Flop
Seat 6: zViveXz collected ($0.12)

Hand #377: 

PokerStars Hand #246223730937:  Hold'em No Limit ($0.01/$0.02 CAD) - 2023/09/28 2:25:57 ET
Table 'Prokne II' 6-max Seat #4 is the button
Seat 1: CashMatteo ($2.70 in chips) 
Seat 2: 19HUNG58 ($3.94 in chips) 
Seat 3: Want 2 Dance ($2 in chips) 
Seat 4: bouchizzle ($3.62 in chips) 
Seat 5: kmcc1327 ($1.34 in chips) 
Seat 6: zViveXz ($7.78 in chips) 
kmcc1327: posts small blind $0.01
zViveXz: posts big blind $0.02
*** HOLE CARDS ***
Dealt to CashMatteo [Jc Td]
CashMatteo: raises $0.04 to $0.06
19HUNG58: folds 
Want 2 Dance: folds 
bouchizzle: folds 
kmcc1327: folds 
zViveXz: folds 
Uncalled bet ($0.04) returned to CashMatteo
CashMatteo collected $0.05 from pot
CashMatteo: doesn't show hand 
*** SUMMARY ***
Total pot $0.05 | Rake $0 
Seat 1: CashMatteo collected ($0.05)
Seat 2: 19HUNG58 folded before Flop (didn't bet)
Seat 3: Want 2 Dance folded before Flop (didn't bet)
Seat 4: bouchizzle (button) folded before Flop (didn't bet)
Seat 5: kmcc1327 (small blind) folded before Flop
Seat 6: zViveXz (big blind) folded before Flop

Hand #378: 

PokerStars Hand #246223732410:  Hold'em No Limit ($0.01/$0.02 CAD) - 2023/09/28 2:26:13 ET
Table 'Prokne II' 6-max Seat #5 is the button
Seat 1: CashMatteo ($2.73 in chips) 
Seat 2: 19HUNG58 ($3.94 in chips) 
Seat 3: Want 2 Dance ($2 in chips) 
Seat 4: bouchizzle ($3.62 in chips) 
Seat 5: kmcc1327 ($1.33 in chips) 
Seat 6: zViveXz ($7.76 in chips) 
zViveXz: posts small blind $0.01
CashMatteo: posts big blind $0.02
*** HOLE CARDS ***
Dealt to CashMatteo [Qh Jd]
19HUNG58: folds 
Want 2 Dance: folds 
bouchizzle: raises $0.04 to $0.06
kmcc1327: folds 
zViveXz: calls $0.05
CashMatteo: calls $0.04
*** FLOP *** [6c 5d 8c]
zViveXz: checks 
CashMatteo: checks 
bouchizzle: bets $0.10
zViveXz: folds 
CashMatteo: folds 
Uncalled bet ($0.10) returned to bouchizzle
bouchizzle collected $0.17 from pot
bouchizzle: doesn't show hand 
*** SUMMARY ***
Total pot $0.18 | Rake $0.01 
Board [6c 5d 8c]
Seat 1: CashMatteo (big blind) folded on the Flop
Seat 2: 19HUNG58 folded before Flop (didn't bet)
Seat 3: Want 2 Dance folded before Flop (didn't bet)
Seat 4: bouchizzle collected ($0.17)
Seat 5: kmcc1327 (button) folded before Flop (didn't bet)
Seat 6: zViveXz (small blind) folded on the Flop

Hand #379: 

PokerStars Hand #246223736838:  Hold'em No Limit ($0.01/$0.02 CAD) - 2023/09/28 2:27:02 ET
Table 'Prokne II' 6-max Seat #6 is the button
Seat 1: CashMatteo ($2.67 in chips) 
Seat 2: 19HUNG58 ($3.94 in chips) 
Seat 3: Want 2 Dance ($2 in chips) 
Seat 4: bouchizzle ($3.73 in chips) 
Seat 5: kmcc1327 ($1.33 in chips) 
Seat 6: zViveXz ($7.70 in chips) 
CashMatteo: posts small blind $0.01
19HUNG58: posts big blind $0.02
*** HOLE CARDS ***
Dealt to CashMatteo [3s 6h]
Want 2 Dance: folds 
bouchizzle: folds 
kmcc1327: folds 
zViveXz: folds 
CashMatteo: folds 
Uncalled bet ($0.01) returned to 19HUNG58
19HUNG58 collected $0.02 from pot
*** SUMMARY ***
Total pot $0.02 | Rake $0 
Seat 1: CashMatteo (small blind) folded before Flop
Seat 2: 19HUNG58 (big blind) collected ($0.02)
Seat 3: Want 2 Dance folded before Flop (didn't bet)
Seat 4: bouchizzle folded before Flop (didn't bet)
Seat 5: kmcc1327 folded before Flop (didn't bet)
Seat 6: zViveXz (button) folded before Flop (didn't bet)

Hand #380: 

PokerStars Hand #246223737927:  Hold'em No Limit ($0.01/$0.02 CAD) - 2023/09/28 2:27:14 ET
Table 'Prokne II' 6-max Seat #1 is the button
Seat 1: CashMatteo ($2.66 in chips) 
Seat 2: 19HUNG58 ($3.95 in chips) 
Seat 3: Want 2 Dance ($2 in chips) 
Seat 4: bouchizzle ($3.73 in chips) 
Seat 5: kmcc1327 ($1.33 in chips) 
Seat 6: zViveXz ($7.70 in chips) 
19HUNG58: posts small blind $0.01
Want 2 Dance: posts big blind $0.02
*** HOLE CARDS ***
Dealt to CashMatteo [Qd 4c]
bouchizzle: folds 
kmcc1327: folds 
zViveXz: folds 
CashMatteo: calls $0.02
19HUNG58: folds 
Want 2 Dance: checks 
*** FLOP *** [4s 9s Tc]
Want 2 Dance: checks 
CashMatteo: checks 
*** TURN *** [4s 9s Tc] [5c]
Want 2 Dance: bets $0.05
CashMatteo: calls $0.05
*** RIVER *** [4s 9s Tc 5c] [Ad]
Want 2 Dance: bets $0.40
CashMatteo: folds 
Uncalled bet ($0.40) returned to Want 2 Dance
Want 2 Dance collected $0.14 from pot
*** SUMMARY ***
Total pot $0.15 | Rake $0.01 
Board [4s 9s Tc 5c Ad]
Seat 1: CashMatteo (button) folded on the River
Seat 2: 19HUNG58 (small blind) folded before Flop
Seat 3: Want 2 Dance (big blind) collected ($0.14)
Seat 4: bouchizzle folded before Flop (didn't bet)
Seat 5: kmcc1327 folded before Flop (didn't bet)
Seat 6: zViveXz folded before Flop (didn't bet)

Hand #381: 

PokerStars Hand #246223742453:  Hold'em No Limit ($0.01/$0.02 CAD) - 2023/09/28 2:28:03 ET
Table 'Prokne II' 6-max Seat #2 is the button
Seat 1: CashMatteo ($2.59 in chips) 
Seat 2: 19HUNG58 ($3.94 in chips) 
Seat 3: Want 2 Dance ($2.07 in chips) 
Seat 4: bouchizzle ($3.73 in chips) 
Seat 5: kmcc1327 ($1.33 in chips) 
Seat 6: zViveXz ($7.70 in chips) 
Want 2 Dance: posts small blind $0.01
bouchizzle: posts big blind $0.02
*** HOLE CARDS ***
Dealt to CashMatteo [Jh 5d]
kmcc1327: calls $0.02
zViveXz: raises $0.04 to $0.06
CashMatteo: folds 
19HUNG58: folds 
Want 2 Dance: folds 
bouchizzle: folds 
kmcc1327: calls $0.04
*** FLOP *** [6c 8d Ah]
kmcc1327: checks 
zViveXz: checks 
*** TURN *** [6c 8d Ah] [8h]
kmcc1327: checks 
zViveXz: bets $0.07
kmcc1327: folds 
Uncalled bet ($0.07) returned to zViveXz
zViveXz collected $0.14 from pot
*** SUMMARY ***
Total pot $0.15 | Rake $0.01 
Board [6c 8d Ah 8h]
Seat 1: CashMatteo folded before Flop (didn't bet)
Seat 2: 19HUNG58 (button) folded before Flop (didn't bet)
Seat 3: Want 2 Dance (small blind) folded before Flop
Seat 4: bouchizzle (big blind) folded before Flop
Seat 5: kmcc1327 folded on the Turn
Seat 6: zViveXz collected ($0.14)

Hand #382: 

PokerStars Hand #246223748915:  Hold'em No Limit ($0.01/$0.02 CAD) - 2023/09/28 2:29:16 ET
Table 'Prokne II' 6-max Seat #3 is the button
Seat 1: CashMatteo ($2.59 in chips) 
Seat 2: 19HUNG58 ($3.94 in chips) 
Seat 3: Want 2 Dance ($2.06 in chips) 
Seat 4: bouchizzle ($3.71 in chips) 
Seat 5: kmcc1327 ($1.27 in chips) 
Seat 6: zViveXz ($7.78 in chips) 
bouchizzle: posts small blind $0.01
kmcc1327: posts big blind $0.02
*** HOLE CARDS ***
Dealt to CashMatteo [Th 3c]
zViveXz: calls $0.02
CashMatteo: folds 
19HUNG58: calls $0.02
Want 2 Dance: folds 
bouchizzle: folds 
kmcc1327: checks 
*** FLOP *** [2h 9s Ac]
kmcc1327: checks 
zViveXz: checks 
19HUNG58: checks 
*** TURN *** [2h 9s Ac] [Kd]
kmcc1327: bets $0.04
zViveXz: folds 
19HUNG58: folds 
Uncalled bet ($0.04) returned to kmcc1327
kmcc1327 collected $0.07 from pot
*** SUMMARY ***
Total pot $0.07 | Rake $0 
Board [2h 9s Ac Kd]
Seat 1: CashMatteo folded before Flop (didn't bet)
Seat 2: 19HUNG58 folded on the Turn
Seat 3: Want 2 Dance (button) folded before Flop (didn't bet)
Seat 4: bouchizzle (small blind) folded before Flop
Seat 5: kmcc1327 (big blind) collected ($0.07)
Seat 6: zViveXz folded on the Turn

Hand #383: 

PokerStars Hand #246223754043:  Hold'em No Limit ($0.01/$0.02 CAD) - 2023/09/28 2:30:13 ET
Table 'Prokne II' 6-max Seat #4 is the button
Seat 1: CashMatteo ($2.59 in chips) 
Seat 2: 19HUNG58 ($3.92 in chips) 
Seat 3: Want 2 Dance ($2.06 in chips) 
Seat 4: bouchizzle ($3.70 in chips) 
Seat 5: kmcc1327 ($1.32 in chips) 
Seat 6: zViveXz ($7.76 in chips) 
kmcc1327: posts small blind $0.01
zViveXz: posts big blind $0.02
*** HOLE CARDS ***
Dealt to CashMatteo [Qc Kh]
CashMatteo: raises $0.04 to $0.06
19HUNG58: folds 
Want 2 Dance: folds 
bouchizzle: folds 
kmcc1327: folds 
zViveXz: folds 
Uncalled bet ($0.04) returned to CashMatteo
CashMatteo collected $0.05 from pot
CashMatteo: doesn't show hand 
*** SUMMARY ***
Total pot $0.05 | Rake $0 
Seat 1: CashMatteo collected ($0.05)
Seat 2: 19HUNG58 folded before Flop (didn't bet)
Seat 3: Want 2 Dance folded before Flop (didn't bet)
Seat 4: bouchizzle (button) folded before Flop (didn't bet)
Seat 5: kmcc1327 (small blind) folded before Flop
Seat 6: zViveXz (big blind) folded before Flop

Hand #384: 

PokerStars Hand #246223755648:  Hold'em No Limit ($0.01/$0.02 CAD) - 2023/09/28 2:30:31 ET
Table 'Prokne II' 6-max Seat #5 is the button
Seat 1: CashMatteo ($2.62 in chips) 
Seat 2: 19HUNG58 ($3.92 in chips) 
Seat 3: Want 2 Dance ($2.06 in chips) 
Seat 4: bouchizzle ($3.70 in chips) 
Seat 5: kmcc1327 ($1.31 in chips) 
Seat 6: zViveXz ($7.74 in chips) 
zViveXz: posts small blind $0.01
CashMatteo: posts big blind $0.02
*** HOLE CARDS ***
Dealt to CashMatteo [Ah Ad]
19HUNG58: calls $0.02
Want 2 Dance: folds 
bouchizzle: folds 
kmcc1327: folds 
kmcc1327 leaves the table
zViveXz: folds 
CashMatteo: raises $0.04 to $0.06
19HUNG58: folds 
Uncalled bet ($0.04) returned to CashMatteo
CashMatteo collected $0.05 from pot
CashMatteo: doesn't show hand 
*** SUMMARY ***
Total pot $0.05 | Rake $0 
Seat 1: CashMatteo (big blind) collected ($0.05)
Seat 2: 19HUNG58 folded before Flop
Seat 3: Want 2 Dance folded before Flop (didn't bet)
Seat 4: bouchizzle folded before Flop (didn't bet)
Seat 5: kmcc1327 (button) folded before Flop (didn't bet)
Seat 6: zViveXz (small blind) folded before Flop

Hand #385: 

PokerStars Hand #246223758678:  Hold'em No Limit ($0.01/$0.02 CAD) - 2023/09/28 2:31:03 ET
Table 'Prokne II' 6-max Seat #6 is the button
Seat 1: CashMatteo ($2.65 in chips) 
Seat 2: 19HUNG58 ($3.90 in chips) 
Seat 3: Want 2 Dance ($2.06 in chips) 
Seat 4: bouchizzle ($3.70 in chips) 
Seat 6: zViveXz ($7.73 in chips) 
CashMatteo: posts small blind $0.01
19HUNG58: posts big blind $0.02
*** HOLE CARDS ***
Dealt to CashMatteo [4c 4h]
Want 2 Dance: folds 
bouchizzle: raises $0.04 to $0.06
zViveXz: folds 
CashMatteo: calls $0.05
19HUNG58: folds 
*** FLOP *** [Ks Ad 8s]
CashMatteo: checks 
bouchizzle: bets $0.08
CashMatteo: calls $0.08
*** TURN *** [Ks Ad 8s] [9c]
CashMatteo: checks 
InitialHC joins the table at seat #5 
bouchizzle: bets $0.17
CashMatteo: folds 
Uncalled bet ($0.17) returned to bouchizzle
bouchizzle collected $0.29 from pot
bouchizzle: doesn't show hand 
*** SUMMARY ***
Total pot $0.30 | Rake $0.01 
Board [Ks Ad 8s 9c]
Seat 1: CashMatteo (small blind) folded on the Turn
Seat 2: 19HUNG58 (big blind) folded before Flop
Seat 3: Want 2 Dance folded before Flop (didn't bet)
Seat 4: bouchizzle collected ($0.29)
Seat 6: zViveXz (button) folded before Flop (didn't bet)

Hand #386: 

PokerStars Hand #246223766957:  Hold'em No Limit ($0.01/$0.02 CAD) - 2023/09/28 2:32:31 ET
Table 'Prokne II' 6-max Seat #1 is the button
Seat 1: CashMatteo ($2.51 in chips) 
Seat 2: 19HUNG58 ($3.88 in chips) 
Seat 3: Want 2 Dance ($2.06 in chips) 
Seat 4: bouchizzle ($3.85 in chips) 
Seat 6: zViveXz ($7.73 in chips) 
19HUNG58: posts small blind $0.01
Want 2 Dance: posts big blind $0.02
InitialHC: sits out 
*** HOLE CARDS ***
Dealt to CashMatteo [Jd 5d]
bouchizzle: raises $0.16 to $0.18
zViveXz: folds 
CashMatteo: calls $0.18
19HUNG58: folds 
Want 2 Dance: calls $0.16
*** FLOP *** [Ah 8s 5h]
Want 2 Dance: checks 
bouchizzle: bets $0.32
CashMatteo: folds 
Want 2 Dance: folds 
Uncalled bet ($0.32) returned to bouchizzle
bouchizzle collected $0.53 from pot
bouchizzle: doesn't show hand 
*** SUMMARY ***
Total pot $0.55 | Rake $0.02 
Board [Ah 8s 5h]
Seat 1: CashMatteo (button) folded on the Flop
Seat 2: 19HUNG58 (small blind) folded before Flop
Seat 3: Want 2 Dance (big blind) folded on the Flop
Seat 4: bouchizzle collected ($0.53)
Seat 6: zViveXz folded before Flop (didn't bet)

Hand #387: 

PokerStars Hand #246223770096:  Hold'em No Limit ($0.01/$0.02 CAD) - 2023/09/28 2:33:04 ET
Table 'Prokne II' 6-max Seat #2 is the button
Seat 1: CashMatteo ($2.33 in chips) 
Seat 2: 19HUNG58 ($3.87 in chips) 
Seat 3: Want 2 Dance ($1.88 in chips) 
Seat 5: InitialHC ($2 in chips) 
Seat 6: zViveXz ($7.73 in chips) 
Want 2 Dance: posts small blind $0.01
bouchizzle: is sitting out 
InitialHC: posts big blind $0.02
*** HOLE CARDS ***
Dealt to CashMatteo [Ah 7s]
zViveXz: folds 
CashMatteo: calls $0.02
19HUNG58: folds 
bouchizzle leaves the table
Want 2 Dance: raises $0.18 to $0.20
InitialHC: folds 
CashMatteo: calls $0.18
*** FLOP *** [Kc 3s Ks]
Want 2 Dance: bets $0.41
CashMatteo: folds 
Uncalled bet ($0.41) returned to Want 2 Dance
Want 2 Dance collected $0.41 from pot
*** SUMMARY ***
Total pot $0.42 | Rake $0.01 
Board [Kc 3s Ks]
Seat 1: CashMatteo folded on the Flop
Seat 2: 19HUNG58 (button) folded before Flop (didn't bet)
Seat 3: Want 2 Dance (small blind) collected ($0.41)
Seat 5: InitialHC (big blind) folded before Flop
Seat 6: zViveXz folded before Flop (didn't bet)

Hand #388: 

PokerStars Hand #246223773063:  Hold'em No Limit ($0.01/$0.02 CAD) - 2023/09/28 2:33:36 ET
Table 'Prokne II' 6-max Seat #3 is the button
Seat 1: CashMatteo ($2.13 in chips) 
Seat 2: 19HUNG58 ($3.87 in chips) 
Seat 3: Want 2 Dance ($2.09 in chips) 
Seat 5: InitialHC ($2 in chips) 
Seat 6: zViveXz ($7.73 in chips) 
InitialHC: posts small blind $0.01
zViveXz: posts big blind $0.02
*** HOLE CARDS ***
Dealt to CashMatteo [8d Ks]
CashMatteo: calls $0.02
19HUNG58: folds 
Want 2 Dance: folds 
InitialHC: folds 
zViveXz: checks 
*** FLOP *** [Ac As 7c]
zViveXz: checks 
CashMatteo: checks 
*** TURN *** [Ac As 7c] [5c]
zViveXz: checks 
CashMatteo: checks 
*** RIVER *** [Ac As 7c 5c] [Qc]
zViveXz: checks 
CashMatteo: checks 
*** SHOW DOWN ***
zViveXz: shows [9d 9h] (two pair, Aces and Nines)
CashMatteo: mucks hand 
zViveXz collected $0.05 from pot
*** SUMMARY ***
Total pot $0.05 | Rake $0 
Board [Ac As 7c 5c Qc]
Seat 1: CashMatteo mucked [8d Ks]
Seat 2: 19HUNG58 folded before Flop (didn't bet)
Seat 3: Want 2 Dance (button) folded before Flop (didn't bet)
Seat 5: InitialHC (small blind) folded before Flop
Seat 6: zViveXz (big blind) showed [9d 9h] and won ($0.05) with two pair, Aces and Nines

Hand #389: 

PokerStars Hand #246223776811:  Hold'em No Limit ($0.01/$0.02 CAD) - 2023/09/28 2:34:16 ET
Table 'Prokne II' 6-max Seat #5 is the button
Seat 1: CashMatteo ($2.11 in chips) 
Seat 2: 19HUNG58 ($3.87 in chips) 
Seat 3: Want 2 Dance ($2.09 in chips) 
Seat 5: InitialHC ($2 in chips) 
Seat 6: zViveXz ($7.76 in chips) 
zViveXz: posts small blind $0.01
CashMatteo: posts big blind $0.02
*** HOLE CARDS ***
Dealt to CashMatteo [Jd Ks]
19HUNG58: calls $0.02
Want 2 Dance: calls $0.02
InitialHC: folds 
zViveXz: calls $0.01
CashMatteo: raises $0.04 to $0.06
19HUNG58: calls $0.04
Want 2 Dance: calls $0.04
zViveXz: calls $0.04
*** FLOP *** [8h Qh 3d]
zViveXz: checks 
CashMatteo: checks 
19HUNG58: checks 
Want 2 Dance: bets $0.23
zViveXz: folds 
CashMatteo: calls $0.23
19HUNG58: folds 
*** TURN *** [8h Qh 3d] [Th]
CashMatteo: folds 
CashMatteo leaves the table
Want 2 Dance collected $0.68 from pot
*** SUMMARY ***
Total pot $0.70 | Rake $0.02 
Board [8h Qh 3d Th]
Seat 1: CashMatteo (big blind) folded on the Turn
Seat 2: 19HUNG58 folded on the Flop
Seat 3: Want 2 Dance collected ($0.68)
Seat 5: InitialHC (button) folded before Flop (didn't bet)
Seat 6: zViveXz (small blind) folded on the Flop

Hand #390: 

PokerStars Hand #246242455830:  Hold'em No Limit ($0.01/$0.02 CAD) - 2023/09/29 2:42:30 ET
Table 'Almeisan' 6-max Seat #6 is the button
Seat 1: JokerDof ($2.01 in chips) 
Seat 2: CashMatteo ($1.16 in chips) 
Seat 3: bigdubs06 ($0.28 in chips) 
Seat 4: zViveXz ($1.49 in chips) 
Seat 5: robbbmansss ($3.86 in chips) 
Seat 6: james5085 ($0.90 in chips) 
JokerDof: posts small blind $0.01
CashMatteo: posts big blind $0.02
*** HOLE CARDS ***
Dealt to CashMatteo [9h 6d]
bigdubs06: folds 
zViveXz: folds 
robbbmansss: raises $0.05 to $0.07
james5085: folds 
JokerDof: folds 
CashMatteo: folds 
Uncalled bet ($0.05) returned to robbbmansss
robbbmansss collected $0.05 from pot
robbbmansss: doesn't show hand 
*** SUMMARY ***
Total pot $0.05 | Rake $0 
Seat 1: JokerDof (small blind) folded before Flop
Seat 2: CashMatteo (big blind) folded before Flop
Seat 3: bigdubs06 folded before Flop (didn't bet)
Seat 4: zViveXz folded before Flop (didn't bet)
Seat 5: robbbmansss collected ($0.05)
Seat 6: james5085 (button) folded before Flop (didn't bet)

Hand #391: 

PokerStars Hand #246242457248:  Hold'em No Limit ($0.01/$0.02 CAD) - 2023/09/29 2:42:44 ET
Table 'Almeisan' 6-max Seat #1 is the button
Seat 1: JokerDof ($2 in chips) 
Seat 2: CashMatteo ($1.14 in chips) 
Seat 3: bigdubs06 ($0.28 in chips) 
Seat 4: zViveXz ($1.49 in chips) 
Seat 5: robbbmansss ($3.89 in chips) 
Seat 6: james5085 ($0.90 in chips) 
CashMatteo: posts small blind $0.01
bigdubs06: posts big blind $0.02
*** HOLE CARDS ***
Dealt to CashMatteo [6h 7c]
zViveXz: folds 
robbbmansss: folds 
james5085: folds 
JokerDof: raises $0.02 to $0.04
CashMatteo: folds 
bigdubs06: folds 
Uncalled bet ($0.02) returned to JokerDof
JokerDof collected $0.05 from pot
JokerDof: doesn't show hand 
*** SUMMARY ***
Total pot $0.05 | Rake $0 
Seat 1: JokerDof (button) collected ($0.05)
Seat 2: CashMatteo (small blind) folded before Flop
Seat 3: bigdubs06 (big blind) folded before Flop
Seat 4: zViveXz folded before Flop (didn't bet)
Seat 5: robbbmansss folded before Flop (didn't bet)
Seat 6: james5085 folded before Flop (didn't bet)

Hand #392: 

PokerStars Hand #246242457620:  Hold'em No Limit ($0.02/$0.05 CAD) - 2023/09/29 2:42:48 ET
Table 'Arneb II' 6-max Seat #1 is the button
Seat 1: CashMatteo ($4 in chips) 
Seat 5: saschak3 ($4 in chips) 
CashMatteo: posts small blind $0.02
saschak3: posts big blind $0.05
*** HOLE CARDS ***
Dealt to CashMatteo [2d Th]
CashMatteo: folds 
Uncalled bet ($0.03) returned to saschak3
saschak3 collected $0.04 from pot
*** SUMMARY ***
Total pot $0.04 | Rake $0 
Seat 1: CashMatteo (button) (small blind) folded before Flop
Seat 5: saschak3 (big blind) collected ($0.04)

Hand #393: 

PokerStars Hand #246242458419:  Hold'em No Limit ($0.02/$0.05 CAD) - 2023/09/29 2:42:57 ET
Table 'Arneb II' 6-max Seat #5 is the button
Seat 1: CashMatteo ($3.98 in chips) 
Seat 5: saschak3 ($4.02 in chips) 
saschak3: posts small blind $0.02
CashMatteo: posts big blind $0.05
*** HOLE CARDS ***
Dealt to CashMatteo [Jd 9s]
saschak3: raises $0.05 to $0.10
CashMatteo: calls $0.05
*** FLOP *** [8d Jh 6d]
CashMatteo: bets $0.10
saschak3: calls $0.10
*** TURN *** [8d Jh 6d] [9d]
CashMatteo: bets $0.19
saschak3: folds 
Uncalled bet ($0.19) returned to CashMatteo
CashMatteo collected $0.38 from pot
CashMatteo: doesn't show hand 
*** SUMMARY ***
Total pot $0.40 | Rake $0.02 
Board [8d Jh 6d 9d]
Seat 1: CashMatteo (big blind) collected ($0.38)
Seat 5: saschak3 (button) (small blind) folded on the Turn

Hand #394: 

PokerStars Hand #246242458848:  Hold'em No Limit ($0.01/$0.02 CAD) - 2023/09/29 2:43:01 ET
Table 'Almeisan' 6-max Seat #2 is the button
Seat 1: JokerDof ($2.03 in chips) 
Seat 2: CashMatteo ($1.13 in chips) 
Seat 3: bigdubs06 ($0.26 in chips) 
Seat 4: zViveXz ($1.49 in chips) 
Seat 5: robbbmansss ($3.89 in chips) 
Seat 6: james5085 ($0.90 in chips) 
bigdubs06: posts small blind $0.01
zViveXz: posts big blind $0.02
*** HOLE CARDS ***
Dealt to CashMatteo [3d 2d]
robbbmansss: raises $0.05 to $0.07
james5085: folds 
JokerDof: folds 
CashMatteo: folds 
CashMatteo leaves the table
bigdubs06: folds 
zViveXz: calls $0.05
*** FLOP *** [Qs 7c 6h]
zViveXz: checks 
robbbmansss: checks 
*** TURN *** [Qs 7c 6h] [Js]
zViveXz: checks 
robbbmansss: checks 
*** RIVER *** [Qs 7c 6h Js] [2h]
zViveXz: checks 
robbbmansss: checks 
*** SHOW DOWN ***
zViveXz: shows [As 7h] (a pair of Sevens)
robbbmansss: mucks hand 
zViveXz collected $0.14 from pot
*** SUMMARY ***
Total pot $0.15 | Rake $0.01 
Board [Qs 7c 6h Js 2h]
Seat 1: JokerDof folded before Flop (didn't bet)
Seat 2: CashMatteo (button) folded before Flop (didn't bet)
Seat 3: bigdubs06 (small blind) folded before Flop
Seat 4: zViveXz (big blind) showed [As 7h] and won ($0.14) with a pair of Sevens
Seat 5: robbbmansss mucked [Ah Th]
Seat 6: james5085 folded before Flop (didn't bet)

Hand #395: 

PokerStars Hand #246242460766:  Hold'em No Limit ($0.02/$0.05 CAD) - 2023/09/29 2:43:21 ET
Table 'Arneb II' 6-max Seat #1 is the button
Seat 1: CashMatteo ($4.16 in chips) 
Seat 5: saschak3 ($3.82 in chips) 
CashMatteo: posts small blind $0.02
saschak3: posts big blind $0.05
*** HOLE CARDS ***
Dealt to CashMatteo [Jh 3s]
CashMatteo: calls $0.03
saschak3: raises $0.05 to $0.10
CashMatteo: calls $0.05
*** FLOP *** [Jd 2s 5d]
saschak3: bets $0.19
CashMatteo: calls $0.19
*** TURN *** [Jd 2s 5d] [3c]
saschak3: bets $0.56
CashMatteo: calls $0.56
*** RIVER *** [Jd 2s 5d 3c] [3d]
saschak3: bets $1.63
CashMatteo: raises $1.68 to $3.31 and is all-in
saschak3: folds 
Uncalled bet ($1.68) returned to CashMatteo
CashMatteo collected $4.75 from pot
CashMatteo: doesn't show hand 
*** SUMMARY ***
Total pot $4.96 | Rake $0.21 
Board [Jd 2s 5d 3c 3d]
Seat 1: CashMatteo (button) (small blind) collected ($4.75)
Seat 5: saschak3 (big blind) folded on the River

Hand #396: 

PokerStars Hand #246242464422:  Hold'em No Limit ($0.02/$0.05 CAD) - 2023/09/29 2:43:59 ET
Table 'Arneb II' 6-max Seat #5 is the button
Seat 1: CashMatteo ($6.43 in chips) 
Seat 5: saschak3 ($1.34 in chips) 
saschak3: posts small blind $0.02
CashMatteo: posts big blind $0.05
*** HOLE CARDS ***
Dealt to CashMatteo [Qd 7c]
saschak3: calls $0.03
CashMatteo: checks 
*** FLOP *** [6c Th 4d]
CashMatteo: checks 
saschak3: checks 
*** TURN *** [6c Th 4d] [2h]
CashMatteo: checks 
saschak3: checks 
*** RIVER *** [6c Th 4d 2h] [Jd]
CashMatteo: checks 
saschak3: checks 
*** SHOW DOWN ***
CashMatteo: shows [Qd 7c] (high card Queen)
saschak3: mucks hand 
CashMatteo collected $0.10 from pot
*** SUMMARY ***
Total pot $0.10 | Rake $0 
Board [6c Th 4d 2h Jd]
Seat 1: CashMatteo (big blind) showed [Qd 7c] and won ($0.10) with high card Queen
Seat 5: saschak3 (button) (small blind) mucked [9s 7s]

Hand #397: 

PokerStars Hand #246242467115:  Hold'em No Limit ($0.02/$0.05 CAD) - 2023/09/29 2:44:27 ET
Table 'Arneb II' 6-max Seat #1 is the button
Seat 1: CashMatteo ($6.48 in chips) 
Seat 5: saschak3 ($1.29 in chips) 
CashMatteo: posts small blind $0.02
saschak3: posts big blind $0.05
*** HOLE CARDS ***
Dealt to CashMatteo [3c 5d]
CashMatteo: folds 
Uncalled bet ($0.03) returned to saschak3
saschak3 collected $0.04 from pot
*** SUMMARY ***
Total pot $0.04 | Rake $0 
Seat 1: CashMatteo (button) (small blind) folded before Flop
Seat 5: saschak3 (big blind) collected ($0.04)

Hand #398: 

PokerStars Hand #246242467713:  Hold'em No Limit ($0.02/$0.05 CAD) - 2023/09/29 2:44:33 ET
Table 'Arneb II' 6-max Seat #5 is the button
Seat 1: CashMatteo ($6.46 in chips) 
Seat 5: saschak3 ($1.31 in chips) 
saschak3: posts small blind $0.02
CashMatteo: posts big blind $0.05
*** HOLE CARDS ***
Dealt to CashMatteo [2h 5h]
saschak3: calls $0.03
CashMatteo: checks 
*** FLOP *** [Kc 6d 8s]
CashMatteo: checks 
saschak3: bets $0.10
CashMatteo: folds 
Uncalled bet ($0.10) returned to saschak3
saschak3 collected $0.10 from pot
*** SUMMARY ***
Total pot $0.10 | Rake $0 
Board [Kc 6d 8s]
Seat 1: CashMatteo (big blind) folded on the Flop
Seat 5: saschak3 (button) (small blind) collected ($0.10)

Hand #399: 

PokerStars Hand #246242468888:  Hold'em No Limit ($0.02/$0.05 CAD) - 2023/09/29 2:44:45 ET
Table 'Arneb II' 6-max Seat #1 is the button
Seat 1: CashMatteo ($6.41 in chips) 
Seat 5: saschak3 ($1.36 in chips) 
CashMatteo: posts small blind $0.02
saschak3: posts big blind $0.05
*** HOLE CARDS ***
Dealt to CashMatteo [7c 7d]
CashMatteo: calls $0.03
saschak3: checks 
*** FLOP *** [3s Th 9c]
saschak3: bets $0.10
CashMatteo: calls $0.10
*** TURN *** [3s Th 9c] [4c]
saschak3: bets $0.29
CashMatteo: calls $0.29
*** RIVER *** [3s Th 9c 4c] [8h]
saschak3: checks 
CashMatteo: bets $0.42
saschak3: folds 
Uncalled bet ($0.42) returned to CashMatteo
CashMatteo collected $0.84 from pot
CashMatteo: doesn't show hand 
*** SUMMARY ***
Total pot $0.88 | Rake $0.04 
Board [3s Th 9c 4c 8h]
Seat 1: CashMatteo (button) (small blind) collected ($0.84)
Seat 5: saschak3 (big blind) folded on the River

Hand #400: 

PokerStars Hand #246242472333:  Hold'em No Limit ($0.02/$0.05 CAD) - 2023/09/29 2:45:20 ET
Table 'Arneb II' 6-max Seat #5 is the button
Seat 1: CashMatteo ($6.81 in chips) 
Seat 5: saschak3 ($0.92 in chips) 
saschak3: posts small blind $0.02
CashMatteo: posts big blind $0.05
*** HOLE CARDS ***
Dealt to CashMatteo [8s As]
saschak3: folds 
Uncalled bet ($0.03) returned to CashMatteo
CashMatteo collected $0.04 from pot
CashMatteo: doesn't show hand 
*** SUMMARY ***
Total pot $0.04 | Rake $0 
Seat 1: CashMatteo (big blind) collected ($0.04)
Seat 5: saschak3 (button) (small blind) folded before Flop

Hand #401: 

PokerStars Hand #246242472911:  Hold'em No Limit ($0.02/$0.05 CAD) - 2023/09/29 2:45:26 ET
Table 'Arneb II' 6-max Seat #1 is the button
Seat 1: CashMatteo ($6.83 in chips) 
Seat 5: saschak3 ($0.90 in chips) 
CashMatteo: posts small blind $0.02
saschak3: posts big blind $0.05
*** HOLE CARDS ***
Dealt to CashMatteo [6h 3c]
CashMatteo: folds 
Uncalled bet ($0.03) returned to saschak3
saschak3 collected $0.04 from pot
*** SUMMARY ***
Total pot $0.04 | Rake $0 
Seat 1: CashMatteo (button) (small blind) folded before Flop
Seat 5: saschak3 (big blind) collected ($0.04)

Hand #402: 

PokerStars Hand #246242473536:  Hold'em No Limit ($0.02/$0.05 CAD) - 2023/09/29 2:45:33 ET
Table 'Arneb II' 6-max Seat #5 is the button
Seat 1: CashMatteo ($6.81 in chips) 
Seat 5: saschak3 ($0.92 in chips) 
saschak3: posts small blind $0.02
CashMatteo: posts big blind $0.05
*** HOLE CARDS ***
Dealt to CashMatteo [9s 6s]
saschak3: calls $0.03
CashMatteo: raises $0.10 to $0.15
saschak3: calls $0.10
*** FLOP *** [8c Jd Kc]
CashMatteo: bets $0.15
saschak3: calls $0.15
*** TURN *** [8c Jd Kc] [3s]
CashMatteo: checks 
saschak3: checks 
*** RIVER *** [8c Jd Kc 3s] [4s]
CashMatteo: checks 
saschak3: checks 
*** SHOW DOWN ***
CashMatteo: shows [9s 6s] (high card King)
saschak3: shows [Tc Qs] (high card King - Queen kicker)
saschak3 collected $0.58 from pot
*** SUMMARY ***
Total pot $0.60 | Rake $0.02 
Board [8c Jd Kc 3s 4s]
Seat 1: CashMatteo (big blind) showed [9s 6s] and lost with high card King
Seat 5: saschak3 (button) (small blind) showed [Tc Qs] and won ($0.58) with high card King

Hand #403: 

PokerStars Hand #246242475744:  Hold'em No Limit ($0.02/$0.05 CAD) - 2023/09/29 2:45:55 ET
Table 'Arneb II' 6-max Seat #1 is the button
Seat 1: CashMatteo ($6.51 in chips) 
Seat 5: saschak3 ($1.20 in chips) 
CashMatteo: posts small blind $0.02
saschak3: posts big blind $0.05
*** HOLE CARDS ***
Dealt to CashMatteo [6s Td]
CashMatteo: folds 
Uncalled bet ($0.03) returned to saschak3
saschak3 collected $0.04 from pot
*** SUMMARY ***
Total pot $0.04 | Rake $0 
Seat 1: CashMatteo (button) (small blind) folded before Flop
Seat 5: saschak3 (big blind) collected ($0.04)

Hand #404: 

PokerStars Hand #246242476618:  Hold'em No Limit ($0.02/$0.05 CAD) - 2023/09/29 2:46:04 ET
Table 'Arneb II' 6-max Seat #5 is the button
Seat 1: CashMatteo ($6.49 in chips) 
Seat 5: saschak3 ($1.22 in chips) 
saschak3: posts small blind $0.02
CashMatteo: posts big blind $0.05
*** HOLE CARDS ***
Dealt to CashMatteo [3s 9d]
saschak3: folds 
Uncalled bet ($0.03) returned to CashMatteo
CashMatteo collected $0.04 from pot
CashMatteo: doesn't show hand 
*** SUMMARY ***
Total pot $0.04 | Rake $0 
Seat 1: CashMatteo (big blind) collected ($0.04)
Seat 5: saschak3 (button) (small blind) folded before Flop

Hand #405: 

PokerStars Hand #246242477283:  Hold'em No Limit ($0.02/$0.05 CAD) - 2023/09/29 2:46:10 ET
Table 'Arneb II' 6-max Seat #1 is the button
Seat 1: CashMatteo ($6.51 in chips) 
Seat 5: saschak3 ($5 in chips) 
CashMatteo: posts small blind $0.02
saschak3: posts big blind $0.05
*** HOLE CARDS ***
Dealt to CashMatteo [8d Kh]
CashMatteo: calls $0.03
saschak3: checks 
*** FLOP *** [2h 5h 3s]
saschak3: checks 
CashMatteo: checks 
*** TURN *** [2h 5h 3s] [Ac]
saschak3: checks 
CashMatteo: bets $0.10
saschak3: folds 
Uncalled bet ($0.10) returned to CashMatteo
CashMatteo collected $0.10 from pot
CashMatteo: doesn't show hand 
*** SUMMARY ***
Total pot $0.10 | Rake $0 
Board [2h 5h 3s Ac]
Seat 1: CashMatteo (button) (small blind) collected ($0.10)
Seat 5: saschak3 (big blind) folded on the Turn

Hand #406: 

PokerStars Hand #246242478859:  Hold'em No Limit ($0.02/$0.05 CAD) - 2023/09/29 2:46:26 ET
Table 'Arneb II' 6-max Seat #5 is the button
Seat 1: CashMatteo ($6.56 in chips) 
Seat 5: saschak3 ($4.95 in chips) 
saschak3: posts small blind $0.02
CashMatteo: posts big blind $0.05
*** HOLE CARDS ***
Dealt to CashMatteo [7d Jh]
saschak3: calls $0.03
CashMatteo: checks 
*** FLOP *** [6h 8d 6s]
CashMatteo: checks 
saschak3: checks 
*** TURN *** [6h 8d 6s] [4c]
CashMatteo: checks 
saschak3: checks 
*** RIVER *** [6h 8d 6s 4c] [4s]
CashMatteo: checks 
saschak3: checks 
*** SHOW DOWN ***
CashMatteo: shows [7d Jh] (two pair, Sixes and Fours)
saschak3: shows [Ac 5s] (two pair, Sixes and Fours - Ace kicker)
saschak3 collected $0.10 from pot
*** SUMMARY ***
Total pot $0.10 | Rake $0 
Board [6h 8d 6s 4c 4s]
Seat 1: CashMatteo (big blind) showed [7d Jh] and lost with two pair, Sixes and Fours
Seat 5: saschak3 (button) (small blind) showed [Ac 5s] and won ($0.10) with two pair, Sixes and Fours

Hand #407: 

PokerStars Hand #246242480498:  Hold'em No Limit ($0.02/$0.05 CAD) - 2023/09/29 2:46:43 ET
Table 'Arneb II' 6-max Seat #1 is the button
Seat 1: CashMatteo ($6.51 in chips) 
Seat 5: saschak3 ($5 in chips) 
CashMatteo: posts small blind $0.02
saschak3: posts big blind $0.05
*** HOLE CARDS ***
Dealt to CashMatteo [Th Kc]
CashMatteo: raises $0.10 to $0.15
saschak3: folds 
Uncalled bet ($0.10) returned to CashMatteo
CashMatteo collected $0.10 from pot
CashMatteo: doesn't show hand 
*** SUMMARY ***
Total pot $0.10 | Rake $0 
Seat 1: CashMatteo (button) (small blind) collected ($0.10)
Seat 5: saschak3 (big blind) folded before Flop

Hand #408: 

PokerStars Hand #246242481430:  Hold'em No Limit ($0.02/$0.05 CAD) - 2023/09/29 2:46:52 ET
Table 'Arneb II' 6-max Seat #5 is the button
Seat 1: CashMatteo ($6.56 in chips) 
Seat 5: saschak3 ($4.95 in chips) 
saschak3: posts small blind $0.02
CashMatteo: posts big blind $0.05
*** HOLE CARDS ***
Dealt to CashMatteo [4h 8h]
saschak3: calls $0.03
CashMatteo: checks 
*** FLOP *** [Kh 7d 3c]
CashMatteo: checks 
saschak3: bets $0.10
CashMatteo: folds 
Uncalled bet ($0.10) returned to saschak3
saschak3 collected $0.10 from pot
*** SUMMARY ***
Total pot $0.10 | Rake $0 
Board [Kh 7d 3c]
Seat 1: CashMatteo (big blind) folded on the Flop
Seat 5: saschak3 (button) (small blind) collected ($0.10)

Hand #409: 

PokerStars Hand #246242482866:  Hold'em No Limit ($0.02/$0.05 CAD) - 2023/09/29 2:47:07 ET
Table 'Arneb II' 6-max Seat #1 is the button
Seat 1: CashMatteo ($6.51 in chips) 
Seat 5: saschak3 ($5 in chips) 
CashMatteo: posts small blind $0.02
saschak3: posts big blind $0.05
*** HOLE CARDS ***
Dealt to CashMatteo [Qd 6h]
CashMatteo: calls $0.03
saschak3: checks 
*** FLOP *** [2d 5d 7s]
saschak3: checks 
CashMatteo: checks 
*** TURN *** [2d 5d 7s] [Kh]
saschak3: bets $0.10
CashMatteo: folds 
Uncalled bet ($0.10) returned to saschak3
saschak3 collected $0.10 from pot
*** SUMMARY ***
Total pot $0.10 | Rake $0 
Board [2d 5d 7s Kh]
Seat 1: CashMatteo (button) (small blind) folded on the Turn
Seat 5: saschak3 (big blind) collected ($0.10)

Hand #410: 

PokerStars Hand #246242484906:  Hold'em No Limit ($0.02/$0.05 CAD) - 2023/09/29 2:47:27 ET
Table 'Arneb II' 6-max Seat #5 is the button
Seat 1: CashMatteo ($6.46 in chips) 
Seat 5: saschak3 ($5.05 in chips) 
saschak3: posts small blind $0.02
CashMatteo: posts big blind $0.05
*** HOLE CARDS ***
Dealt to CashMatteo [Jh 3c]
saschak3: raises $0.05 to $0.10
CashMatteo: calls $0.05
*** FLOP *** [5c Jc Kd]
CashMatteo: bets $0.10
saschak3: calls $0.10
*** TURN *** [5c Jc Kd] [Ks]
CashMatteo: bets $0.19
saschak3: folds 
Uncalled bet ($0.19) returned to CashMatteo
CashMatteo collected $0.38 from pot
CashMatteo: doesn't show hand 
*** SUMMARY ***
Total pot $0.40 | Rake $0.02 
Board [5c Jc Kd Ks]
Seat 1: CashMatteo (big blind) collected ($0.38)
Seat 5: saschak3 (button) (small blind) folded on the Turn

Hand #411: 

PokerStars Hand #246242487102:  Hold'em No Limit ($0.02/$0.05 CAD) - 2023/09/29 2:47:49 ET
Table 'Arneb II' 6-max Seat #1 is the button
Seat 1: CashMatteo ($6.64 in chips) 
Seat 5: saschak3 ($4.85 in chips) 
CashMatteo: posts small blind $0.02
saschak3: posts big blind $0.05
*** HOLE CARDS ***
Dealt to CashMatteo [9d Ah]
CashMatteo: calls $0.03
saschak3: folds 
saschak3 leaves the table
CashMatteo collected $0.10 from pot
CashMatteo: doesn't show hand 
*** SUMMARY ***
Total pot $0.10 | Rake $0 
Seat 1: CashMatteo (button) (small blind) collected ($0.10)
Seat 5: saschak3 (big blind) folded before Flop

Hand #412: 

PokerStars Hand #246242505116:  Hold'em No Limit ($0.02/$0.05 CAD) - 2023/09/29 2:50:50 ET
Table 'Arneb II' 6-max Seat #2 is the button
Seat 1: CashMatteo ($6.69 in chips) 
Seat 2: brundi ($4 in chips) 
brundi: posts small blind $0.02
CashMatteo: posts big blind $0.05
*** HOLE CARDS ***
Dealt to CashMatteo [5s 6h]
brundi: calls $0.03
CashMatteo: checks 
*** FLOP *** [Ks 3c 9s]
CashMatteo: checks 
brundi: bets $0.05
CashMatteo: calls $0.05
*** TURN *** [Ks 3c 9s] [9c]
CashMatteo: checks 
brundi: checks 
*** RIVER *** [Ks 3c 9s 9c] [9d]
CashMatteo: bets $0.10
brundi: folds 
Uncalled bet ($0.10) returned to CashMatteo
CashMatteo collected $0.19 from pot
CashMatteo: doesn't show hand 
*** SUMMARY ***
Total pot $0.20 | Rake $0.01 
Board [Ks 3c 9s 9c 9d]
Seat 1: CashMatteo (big blind) collected ($0.19)
Seat 2: brundi (button) (small blind) folded on the River

Hand #413: 

PokerStars Hand #246242507941:  Hold'em No Limit ($0.02/$0.05 CAD) - 2023/09/29 2:51:18 ET
Table 'Arneb II' 6-max Seat #1 is the button
Seat 1: CashMatteo ($6.78 in chips) 
CashMatteo: posts small blind $0.02
brundi: is sitting out 
Hand cancelled
*** SUMMARY ***
Seat 1: CashMatteo (button) (small blind)

Hand #414: 

PokerStars Hand #246242509351:  Hold'em No Limit ($0.02/$0.05 CAD) - 2023/09/29 2:51:32 ET
Table 'Arneb II' 6-max Seat #1 is the button
Seat 1: CashMatteo ($6.78 in chips) 
Seat 2: brundi ($3.90 in chips) 
CashMatteo: posts small blind $0.02
brundi: posts big blind $0.05
*** HOLE CARDS ***
Dealt to CashMatteo [2d Ah]
CashMatteo: calls $0.03
brundi: checks 
*** FLOP *** [Ad 7s 7h]
brundi: checks 
Billybeer14 joins the table at seat #5 
CashMatteo: bets $0.05
brundi: folds 
Uncalled bet ($0.05) returned to CashMatteo
CashMatteo collected $0.10 from pot
CashMatteo: doesn't show hand 
bouchizzle joins the table at seat #3 
*** SUMMARY ***
Total pot $0.10 | Rake $0 
Board [Ad 7s 7h]
Seat 1: CashMatteo (button) (small blind) collected ($0.10)
Seat 2: brundi (big blind) folded on the Flop

Hand #415: 

PokerStars Hand #246242510758:  Hold'em No Limit ($0.02/$0.05 CAD) - 2023/09/29 2:51:46 ET
Table 'Arneb II' 6-max Seat #1 is the button
Seat 1: CashMatteo ($6.83 in chips) 
Seat 2: brundi ($3.85 in chips) 
Seat 3: bouchizzle ($5 in chips) 
brundi: posts small blind $0.02
bouchizzle is connected 
bouchizzle: posts big blind $0.05
Billybeer14: sits out 
*** HOLE CARDS ***
Dealt to CashMatteo [8h 3h]
CashMatteo: folds 
brundi: raises $0.10 to $0.15
bouchizzle: folds 
Uncalled bet ($0.10) returned to brundi
bouchizzle leaves the table
brundi collected $0.10 from pot
brundi: doesn't show hand 
*** SUMMARY ***
Total pot $0.10 | Rake $0 
Seat 1: CashMatteo (button) folded before Flop (didn't bet)
Seat 2: brundi (small blind) collected ($0.10)
Seat 3: bouchizzle (big blind) folded before Flop

Hand #416: 

PokerStars Hand #246242511902:  Hold'em No Limit ($0.02/$0.05 CAD) - 2023/09/29 2:51:57 ET
Table 'Arneb II' 6-max Seat #2 is the button
Seat 1: CashMatteo ($6.83 in chips) 
Seat 2: brundi ($3.90 in chips) 
Billybeer14 will be allowed to play after the button
brundi: posts small blind $0.02
CashMatteo: posts big blind $0.05
*** HOLE CARDS ***
Dealt to CashMatteo [5s Td]
brundi: folds 
Uncalled bet ($0.03) returned to CashMatteo
CashMatteo collected $0.04 from pot
CashMatteo: doesn't show hand 
*** SUMMARY ***
Total pot $0.04 | Rake $0 
Seat 1: CashMatteo (big blind) collected ($0.04)
Seat 2: brundi (button) (small blind) folded before Flop

Hand #417: 

PokerStars Hand #246242512572:  Hold'em No Limit ($0.02/$0.05 CAD) - 2023/09/29 2:52:04 ET
Table 'Arneb II' 6-max Seat #1 is the button
Seat 1: CashMatteo ($6.85 in chips) 
Seat 2: brundi ($3.88 in chips) 
Seat 5: Billybeer14 ($5 in chips) 
brundi: posts small blind $0.02
Billybeer14: posts big blind $0.05
*** HOLE CARDS ***
Dealt to CashMatteo [6h Tc]
CashMatteo: folds 
brundi: calls $0.03
Billybeer14: raises $0.05 to $0.10
brundi: calls $0.05
*** FLOP *** [9d 7h 8s]
brundi: checks 
Billybeer14: bets $0.10
brundi: folds 
Uncalled bet ($0.10) returned to Billybeer14
Billybeer14 collected $0.19 from pot
*** SUMMARY ***
Total pot $0.20 | Rake $0.01 
Board [9d 7h 8s]
Seat 1: CashMatteo (button) folded before Flop (didn't bet)
Seat 2: brundi (small blind) folded on the Flop
Seat 5: Billybeer14 (big blind) collected ($0.19)

Hand #418: 

PokerStars Hand #246242514838:  Hold'em No Limit ($0.02/$0.05 CAD) - 2023/09/29 2:52:27 ET
Table 'Arneb II' 6-max Seat #2 is the button
Seat 1: CashMatteo ($6.85 in chips) 
Seat 2: brundi ($3.78 in chips) 
Seat 5: Billybeer14 ($5.09 in chips) 
Billybeer14: posts small blind $0.02
CashMatteo: posts big blind $0.05
*** HOLE CARDS ***
Dealt to CashMatteo [Th 7d]
brundi: folds 
Billybeer14: calls $0.03
CashMatteo: checks 
*** FLOP *** [8h 3c 2d]
Billybeer14: bets $0.05
CashMatteo: folds 
Uncalled bet ($0.05) returned to Billybeer14
Billybeer14 collected $0.10 from pot
*** SUMMARY ***
Total pot $0.10 | Rake $0 
Board [8h 3c 2d]
Seat 1: CashMatteo (big blind) folded on the Flop
Seat 2: brundi (button) folded before Flop (didn't bet)
Seat 5: Billybeer14 (small blind) collected ($0.10)

Hand #419: 

PokerStars Hand #246242517193:  Hold'em No Limit ($0.02/$0.05 CAD) - 2023/09/29 2:52:50 ET
Table 'Arneb II' 6-max Seat #5 is the button
Seat 1: CashMatteo ($6.80 in chips) 
Seat 2: brundi ($3.78 in chips) 
Seat 5: Billybeer14 ($5.14 in chips) 
CashMatteo: posts small blind $0.02
brundi: posts big blind $0.05
*** HOLE CARDS ***
Dealt to CashMatteo [Jh Ad]
Billybeer14: folds 
CashMatteo: raises $0.10 to $0.15
brundi: folds 
Uncalled bet ($0.10) returned to CashMatteo
CashMatteo collected $0.10 from pot
CashMatteo: doesn't show hand 
*** SUMMARY ***
Total pot $0.10 | Rake $0 
Seat 1: CashMatteo (small blind) collected ($0.10)
Seat 2: brundi (big blind) folded before Flop
Seat 5: Billybeer14 (button) folded before Flop (didn't bet)

Hand #420: 

PokerStars Hand #246242519039:  Hold'em No Limit ($0.02/$0.05 CAD) - 2023/09/29 2:53:08 ET
Table 'Arneb II' 6-max Seat #1 is the button
Seat 1: CashMatteo ($6.85 in chips) 
Seat 2: brundi ($3.73 in chips) 
Seat 5: Billybeer14 ($5.14 in chips) 
brundi: posts small blind $0.02
Billybeer14: posts big blind $0.05
*** HOLE CARDS ***
Dealt to CashMatteo [3s 9d]
CashMatteo: folds 
brundi: raises $0.10 to $0.15
Billybeer14: calls $0.10
*** FLOP *** [6d 5h 4s]
brundi: bets $0.15
Billybeer14: calls $0.15
*** TURN *** [6d 5h 4s] [5s]
brundi: checks 
Billybeer14: bets $0.29
brundi: folds 
Uncalled bet ($0.29) returned to Billybeer14
Billybeer14 collected $0.58 from pot
*** SUMMARY ***
Total pot $0.60 | Rake $0.02 
Board [6d 5h 4s 5s]
Seat 1: CashMatteo (button) folded before Flop (didn't bet)
Seat 2: brundi (small blind) folded on the Turn
Seat 5: Billybeer14 (big blind) collected ($0.58)

Hand #421: 

PokerStars Hand #246242522396:  Hold'em No Limit ($0.02/$0.05 CAD) - 2023/09/29 2:53:42 ET
Table 'Arneb II' 6-max Seat #2 is the button
Seat 1: CashMatteo ($6.85 in chips) 
Seat 2: brundi ($3.43 in chips) 
Seat 5: Billybeer14 ($5.42 in chips) 
Billybeer14: posts small blind $0.02
CashMatteo: posts big blind $0.05
*** HOLE CARDS ***
Dealt to CashMatteo [9s 6h]
brundi: raises $0.12 to $0.17
Billybeer14: raises $0.12 to $0.29
CashMatteo: folds 
brundi: calls $0.12
*** FLOP *** [7s 3s 4s]
Billybeer14: checks 
brundi: checks 
*** TURN *** [7s 3s 4s] [3h]
Billybeer14: bets $0.05
brundi: folds 
Uncalled bet ($0.05) returned to Billybeer14
Billybeer14 collected $0.60 from pot
*** SUMMARY ***
Total pot $0.63 | Rake $0.03 
Board [7s 3s 4s 3h]
Seat 1: CashMatteo (big blind) folded before Flop
Seat 2: brundi (button) folded on the Turn
Seat 5: Billybeer14 (small blind) collected ($0.60)

Hand #422: 

PokerStars Hand #246242524919:  Hold'em No Limit ($0.02/$0.05 CAD) - 2023/09/29 2:54:06 ET
Table 'Arneb II' 6-max Seat #5 is the button
Seat 1: CashMatteo ($6.80 in chips) 
Seat 2: brundi ($3.14 in chips) 
Seat 5: Billybeer14 ($5.73 in chips) 
CashMatteo: posts small blind $0.02
brundi: posts big blind $0.05
*** HOLE CARDS ***
Dealt to CashMatteo [Ad 7d]
Billybeer14: calls $0.05
CashMatteo: calls $0.03
brundi: checks 
*** FLOP *** [Tc 4c Qc]
CashMatteo: checks 
brundi: checks 
Billybeer14: checks 
*** TURN *** [Tc 4c Qc] [Jh]
CashMatteo: checks 
brundi: checks 
Billybeer14: checks 
*** RIVER *** [Tc 4c Qc Jh] [2d]
CashMatteo: checks 
brundi: checks 
Billybeer14: bets $0.14
CashMatteo: folds 
brundi: folds 
Uncalled bet ($0.14) returned to Billybeer14
Billybeer14 collected $0.14 from pot
*** SUMMARY ***
Total pot $0.15 | Rake $0.01 
Board [Tc 4c Qc Jh 2d]
Seat 1: CashMatteo (small blind) folded on the River
Seat 2: brundi (big blind) folded on the River
Seat 5: Billybeer14 (button) collected ($0.14)

Hand #423: 

PokerStars Hand #246242530183:  Hold'em No Limit ($0.02/$0.05 CAD) - 2023/09/29 2:54:58 ET
Table 'Arneb II' 6-max Seat #1 is the button
Seat 1: CashMatteo ($6.75 in chips) 
Seat 2: brundi ($3.09 in chips) 
Seat 5: Billybeer14 ($5.82 in chips) 
brundi: posts small blind $0.02
Billybeer14: posts big blind $0.05
*** HOLE CARDS ***
Dealt to CashMatteo [9c 2d]
CashMatteo: folds 
brundi: raises $0.10 to $0.15
Billybeer14: calls $0.10
*** FLOP *** [Td 4h Kh]
brundi: bets $0.15
Billybeer14: folds 
Uncalled bet ($0.15) returned to brundi
brundi collected $0.29 from pot
brundi: doesn't show hand 
*** SUMMARY ***
Total pot $0.30 | Rake $0.01 
Board [Td 4h Kh]
Seat 1: CashMatteo (button) folded before Flop (didn't bet)
Seat 2: brundi (small blind) collected ($0.29)
Seat 5: Billybeer14 (big blind) folded on the Flop

Hand #424: 

PokerStars Hand #246242532318:  Hold'em No Limit ($0.02/$0.05 CAD) - 2023/09/29 2:55:21 ET
Table 'Arneb II' 6-max Seat #2 is the button
Seat 1: CashMatteo ($6.75 in chips) 
Seat 2: brundi ($3.23 in chips) 
Seat 5: Billybeer14 ($5.67 in chips) 
Billybeer14: posts small blind $0.02
CashMatteo: posts big blind $0.05
*** HOLE CARDS ***
Dealt to CashMatteo [Qd 4s]
brundi: raises $3.18 to $3.23 and is all-in
Billybeer14: folds 
CashMatteo: folds 
Uncalled bet ($3.18) returned to brundi
brundi collected $0.12 from pot
brundi: doesn't show hand 
*** SUMMARY ***
Total pot $0.12 | Rake $0 
Seat 1: CashMatteo (big blind) folded before Flop
Seat 2: brundi (button) collected ($0.12)
Seat 5: Billybeer14 (small blind) folded before Flop

Hand #425: 

PokerStars Hand #246242533819:  Hold'em No Limit ($0.02/$0.05 CAD) - 2023/09/29 2:55:38 ET
Table 'Arneb II' 6-max Seat #5 is the button
Seat 1: CashMatteo ($6.70 in chips) 
Seat 2: brundi ($3.30 in chips) 
Seat 5: Billybeer14 ($5.65 in chips) 
CashMatteo: posts small blind $0.02
brundi: posts big blind $0.05
*** HOLE CARDS ***
Dealt to CashMatteo [7c Jh]
Billybeer14: raises $0.05 to $0.10
CashMatteo: folds 
brundi: calls $0.05
*** FLOP *** [Qc 2d 2s]
brundi: checks 
Billybeer14: bets $0.11
brundi: folds 
Uncalled bet ($0.11) returned to Billybeer14
Billybeer14 collected $0.21 from pot
*** SUMMARY ***
Total pot $0.22 | Rake $0.01 
Board [Qc 2d 2s]
Seat 1: CashMatteo (small blind) folded before Flop
Seat 2: brundi (big blind) folded on the Flop
Seat 5: Billybeer14 (button) collected ($0.21)

Hand #426: 

PokerStars Hand #246242535791:  Hold'em No Limit ($0.02/$0.05 CAD) - 2023/09/29 2:56:00 ET
Table 'Arneb II' 6-max Seat #1 is the button
Seat 1: CashMatteo ($6.68 in chips) 
Seat 2: brundi ($3.20 in chips) 
Seat 5: Billybeer14 ($5.76 in chips) 
brundi: posts small blind $0.02
Billybeer14: posts big blind $0.05
*** HOLE CARDS ***
Dealt to CashMatteo [6s Qh]
saschak3 joins the table at seat #4 
CashMatteo: folds 
brundi: raises $3.15 to $3.20 and is all-in
Billybeer14: folds 
Uncalled bet ($3.15) returned to brundi
brundi collected $0.10 from pot
brundi: doesn't show hand 
*** SUMMARY ***
Total pot $0.10 | Rake $0 
Seat 1: CashMatteo (button) folded before Flop (didn't bet)
Seat 2: brundi (small blind) collected ($0.10)
Seat 5: Billybeer14 (big blind) folded before Flop

Hand #427: 

PokerStars Hand #246242537693:  Hold'em No Limit ($0.02/$0.05 CAD) - 2023/09/29 2:56:22 ET
Table 'Arneb II' 6-max Seat #2 is the button
Seat 1: CashMatteo ($6.68 in chips) 
Seat 2: brundi ($3.25 in chips) 
Seat 5: Billybeer14 ($5.71 in chips) 
saschak3 will be allowed to play after the button
Billybeer14: posts small blind $0.02
CashMatteo: posts big blind $0.05
*** HOLE CARDS ***
Dealt to CashMatteo [Kd 2c]
brundi: raises $3.20 to $3.25 and is all-in
Billybeer14: raises $2.46 to $5.71 and is all-in
CashMatteo: folds 
Uncalled bet ($2.46) returned to Billybeer14
*** FLOP *** [6d Tc 4d]
*** TURN *** [6d Tc 4d] [9s]
*** RIVER *** [6d Tc 4d 9s] [3s]
*** SHOW DOWN ***
Billybeer14: shows [Jd 9h] (a pair of Nines)
brundi: shows [Th 8h] (a pair of Tens)
brundi collected $6.28 from pot
*** SUMMARY ***
Total pot $6.55 | Rake $0.27 
Board [6d Tc 4d 9s 3s]
Seat 1: CashMatteo (big blind) folded before Flop
Seat 2: brundi (button) showed [Th 8h] and won ($6.28) with a pair of Tens
Seat 5: Billybeer14 (small blind) showed [Jd 9h] and lost with a pair of Nines

Hand #428: 

PokerStars Hand #246242540015:  Hold'em No Limit ($0.02/$0.05 CAD) - 2023/09/29 2:56:48 ET
Table 'Arneb II' 6-max Seat #5 is the button
Seat 1: CashMatteo ($6.63 in chips) 
Seat 2: brundi ($6.28 in chips) 
Seat 4: saschak3 ($4.80 in chips) 
Seat 5: Billybeer14 ($2.46 in chips) 
CashMatteo: posts small blind $0.02
brundi: posts big blind $0.05
saschak3: posts big blind $0.05
*** HOLE CARDS ***
Dealt to CashMatteo [2s 4s]
saschak3: checks 
Billybeer14: calls $0.05
CashMatteo: calls $0.03
brundi: checks 
*** FLOP *** [8d 5c Ks]
CashMatteo: checks 
brundi: checks 
saschak3: checks 
Billybeer14: checks 
*** TURN *** [8d 5c Ks] [Jc]
CashMatteo: checks 
brundi: checks 
saschak3: bets $0.19
Billybeer14: folds 
CashMatteo: folds 
brundi: folds 
Uncalled bet ($0.19) returned to saschak3
saschak3 collected $0.19 from pot
*** SUMMARY ***
Total pot $0.20 | Rake $0.01 
Board [8d 5c Ks Jc]
Seat 1: CashMatteo (small blind) folded on the Turn
Seat 2: brundi (big blind) folded on the Turn
Seat 4: saschak3 collected ($0.19)
Seat 5: Billybeer14 (button) folded on the Turn

Hand #429: 

PokerStars Hand #246242544578:  Hold'em No Limit ($0.02/$0.05 CAD) - 2023/09/29 2:57:39 ET
Table 'Arneb II' 6-max Seat #1 is the button
Seat 1: CashMatteo ($6.58 in chips) 
Seat 2: brundi ($6.23 in chips) 
Seat 4: saschak3 ($4.94 in chips) 
Seat 5: Billybeer14 ($2.41 in chips) 
brundi: posts small blind $0.02
saschak3: posts big blind $0.05
*** HOLE CARDS ***
Dealt to CashMatteo [9s Kd]
Billybeer14: folds 
CashMatteo: raises $0.10 to $0.15
brundi: calls $0.13
saschak3: folds 
*** FLOP *** [Qd Jh 3h]
brundi: checks 
CashMatteo: bets $0.17
brundi: folds 
Uncalled bet ($0.17) returned to CashMatteo
CashMatteo collected $0.34 from pot
CashMatteo: doesn't show hand 
*** SUMMARY ***
Total pot $0.35 | Rake $0.01 
Board [Qd Jh 3h]
Seat 1: CashMatteo (button) collected ($0.34)
Seat 2: brundi (small blind) folded on the Flop
Seat 4: saschak3 (big blind) folded before Flop
Seat 5: Billybeer14 folded before Flop (didn't bet)

Hand #430: 

PokerStars Hand #246242547033:  Hold'em No Limit ($0.02/$0.05 CAD) - 2023/09/29 2:58:07 ET
Table 'Arneb II' 6-max Seat #2 is the button
Seat 1: CashMatteo ($6.77 in chips) 
Seat 2: brundi ($6.08 in chips) 
Seat 4: saschak3 ($4.89 in chips) 
Seat 5: Billybeer14 ($2.41 in chips) 
saschak3: posts small blind $0.02
Billybeer14: posts big blind $0.05
*** HOLE CARDS ***
Dealt to CashMatteo [Ah As]
CashMatteo: raises $0.10 to $0.15
brundi: calls $0.15
saschak3: folds 
Billybeer14: folds 
*** FLOP *** [Qc Ks 6d]
CashMatteo: bets $0.18
brundi: calls $0.18
*** TURN *** [Qc Ks 6d] [Tc]
CashMatteo: bets $0.35
brundi: calls $0.35
*** RIVER *** [Qc Ks 6d Tc] [8h]
CashMatteo: checks 
brundi: bets $2.15
CashMatteo: calls $2.15
*** SHOW DOWN ***
brundi: shows [Qd Kh] (two pair, Kings and Queens)
CashMatteo: mucks hand 
brundi collected $5.49 from pot
*** SUMMARY ***
Total pot $5.73 | Rake $0.24 
Board [Qc Ks 6d Tc 8h]
Seat 1: CashMatteo mucked [Ah As]
Seat 2: brundi (button) showed [Qd Kh] and won ($5.49) with two pair, Kings and Queens
Seat 4: saschak3 (small blind) folded before Flop
Seat 5: Billybeer14 (big blind) folded before Flop

Hand #431: 

PokerStars Hand #246242551993:  Hold'em No Limit ($0.02/$0.05 CAD) - 2023/09/29 2:59:03 ET
Table 'Arneb II' 6-max Seat #4 is the button
Seat 1: CashMatteo ($3.94 in chips) 
Seat 2: brundi ($8.74 in chips) 
Seat 4: saschak3 ($4.87 in chips) 
Seat 5: Billybeer14 ($2.36 in chips) 
Billybeer14: posts small blind $0.02
CashMatteo: posts big blind $0.05
*** HOLE CARDS ***
Dealt to CashMatteo [Jh 6c]
brundi: folds 
brundi leaves the table
saschak3: folds 
Billybeer14: calls $0.03
CashMatteo: checks 
*** FLOP *** [7s 2h 6d]
Billybeer14: bets $0.10
CashMatteo: calls $0.10
*** TURN *** [7s 2h 6d] [Th]
Billybeer14: bets $0.05
CashMatteo: calls $0.05
*** RIVER *** [7s 2h 6d Th] [Ac]
Billybeer14: bets $0.05
CashMatteo: calls $0.05
*** SHOW DOWN ***
Billybeer14: shows [8d 7c] (a pair of Sevens)
CashMatteo: mucks hand 
Billybeer14 collected $0.48 from pot
*** SUMMARY ***
Total pot $0.50 | Rake $0.02 
Board [7s 2h 6d Th Ac]
Seat 1: CashMatteo (big blind) mucked [Jh 6c]
Seat 2: brundi folded before Flop (didn't bet)
Seat 4: saschak3 (button) folded before Flop (didn't bet)
Seat 5: Billybeer14 (small blind) showed [8d 7c] and won ($0.48) with a pair of Sevens

Hand #432: 

PokerStars Hand #246242555188:  Hold'em No Limit ($0.02/$0.05 CAD) - 2023/09/29 2:59:40 ET
Table 'Arneb II' 6-max Seat #5 is the button
Seat 1: CashMatteo ($3.69 in chips) 
Seat 4: saschak3 ($4.87 in chips) 
Seat 5: Billybeer14 ($2.59 in chips) 
CashMatteo: posts small blind $0.02
saschak3: posts big blind $0.05
*** HOLE CARDS ***
Dealt to CashMatteo [2c Jh]
Billybeer14: calls $0.05
CashMatteo: folds 
saschak3: checks 
*** FLOP *** [4s 7c 4h]
saschak3: checks 
Billybeer14: checks 
*** TURN *** [4s 7c 4h] [Kh]
saschak3: bets $0.12
Billybeer14: calls $0.12
*** RIVER *** [4s 7c 4h Kh] [4d]
saschak3: bets $0.35
Billybeer14: raises $1.05 to $1.40
saschak3: calls $1.05
*** SHOW DOWN ***
Billybeer14: shows [4c 6c] (four of a kind, Fours)
saschak3: mucks hand 
Billybeer14 collected $3.03 from pot
*** SUMMARY ***
Total pot $3.16 | Rake $0.13 
Board [4s 7c 4h Kh 4d]
Seat 1: CashMatteo (small blind) folded before Flop
Seat 4: saschak3 (big blind) mucked [Kd 6s]
Seat 5: Billybeer14 (button) showed [4c 6c] and won ($3.03) with four of a kind, Fours

Hand #433: 

PokerStars Hand #246242559428:  Hold'em No Limit ($0.02/$0.05 CAD) - 2023/09/29 3:00:27 ET
Table 'Arneb II' 6-max Seat #1 is the button
Seat 1: CashMatteo ($3.67 in chips) 
Seat 4: saschak3 ($3.30 in chips) 
Seat 5: Billybeer14 ($4.05 in chips) 
saschak3: posts small blind $0.02
Billybeer14: posts big blind $0.05
*** HOLE CARDS ***
Dealt to CashMatteo [7s Ad]
CashMatteo: calls $0.05
saschak3: calls $0.03
Billybeer14: checks 
*** FLOP *** [Th Td 3c]
saschak3: checks 
Billybeer14: checks 
CashMatteo: checks 
*** TURN *** [Th Td 3c] [Qs]
saschak3: bets $0.07
Billybeer14: folds 
CashMatteo: folds 
Uncalled bet ($0.07) returned to saschak3
saschak3 collected $0.14 from pot
*** SUMMARY ***
Total pot $0.15 | Rake $0.01 
Board [Th Td 3c Qs]
Seat 1: CashMatteo (button) folded on the Turn
Seat 4: saschak3 (small blind) collected ($0.14)
Seat 5: Billybeer14 (big blind) folded on the Turn

Hand #434: 

PokerStars Hand #246242561841:  Hold'em No Limit ($0.02/$0.05 CAD) - 2023/09/29 3:00:51 ET
Table 'Arneb II' 6-max Seat #4 is the button
Seat 1: CashMatteo ($3.62 in chips) 
Seat 4: saschak3 ($3.39 in chips) 
Seat 5: Billybeer14 ($4 in chips) 
Billybeer14: posts small blind $0.02
CashMatteo: posts big blind $0.05
*** HOLE CARDS ***
Dealt to CashMatteo [Ah 6h]
saschak3: folds 
Billybeer14: folds 
Uncalled bet ($0.03) returned to CashMatteo
CashMatteo collected $0.04 from pot
CashMatteo: doesn't show hand 
*** SUMMARY ***
Total pot $0.04 | Rake $0 
Seat 1: CashMatteo (big blind) collected ($0.04)
Seat 4: saschak3 (button) folded before Flop (didn't bet)
Seat 5: Billybeer14 (small blind) folded before Flop

Hand #435: 

PokerStars Hand #246242562650:  Hold'em No Limit ($0.02/$0.05 CAD) - 2023/09/29 3:01:00 ET
Table 'Arneb II' 6-max Seat #5 is the button
Seat 1: CashMatteo ($3.64 in chips) 
Seat 4: saschak3 ($3.39 in chips) 
Seat 5: Billybeer14 ($3.98 in chips) 
CashMatteo: posts small blind $0.02
saschak3: posts big blind $0.05
*** HOLE CARDS ***
Dealt to CashMatteo [Ah Qd]
Billybeer14: raises $0.05 to $0.10
CashMatteo: raises $0.25 to $0.35
saschak3: folds 
Billybeer14: raises $3.63 to $3.98 and is all-in
CashMatteo: calls $3.29 and is all-in
Uncalled bet ($0.34) returned to Billybeer14
*** FLOP *** [Ac 6c 5c]
*** TURN *** [Ac 6c 5c] [5s]
*** RIVER *** [Ac 6c 5c 5s] [2h]
*** SHOW DOWN ***
CashMatteo: shows [Ah Qd] (two pair, Aces and Fives)
Billybeer14: shows [Qh Kd] (a pair of Fives)
CashMatteo collected $7.03 from pot
*** SUMMARY ***
Total pot $7.33 | Rake $0.30 
Board [Ac 6c 5c 5s 2h]
Seat 1: CashMatteo (small blind) showed [Ah Qd] and won ($7.03) with two pair, Aces and Fives
Seat 4: saschak3 (big blind) folded before Flop
Seat 5: Billybeer14 (button) showed [Qh Kd] and lost with a pair of Fives

Hand #436: 

PokerStars Hand #246242565142:  Hold'em No Limit ($0.02/$0.05 CAD) - 2023/09/29 3:01:24 ET
Table 'Arneb II' 6-max Seat #1 is the button
Seat 1: CashMatteo ($7.03 in chips) 
Seat 4: saschak3 ($3.34 in chips) 
Seat 5: Billybeer14 ($0.34 in chips) 
saschak3: posts small blind $0.02
Billybeer14: posts big blind $0.05
*** HOLE CARDS ***
Dealt to CashMatteo [Jd 3d]
CashMatteo: calls $0.05
saschak3: raises $0.05 to $0.10
Billybeer14: folds 
CashMatteo: calls $0.05
*** FLOP *** [2s 6h 4c]
Billybeer14 leaves the table
saschak3: bets $0.24
CashMatteo: folds 
Uncalled bet ($0.24) returned to saschak3
saschak3 collected $0.24 from pot
*** SUMMARY ***
Total pot $0.25 | Rake $0.01 
Board [2s 6h 4c]
Seat 1: CashMatteo (button) folded on the Flop
Seat 4: saschak3 (small blind) collected ($0.24)
Seat 5: Billybeer14 (big blind) folded before Flop

Hand #437: 

PokerStars Hand #246242567501:  Hold'em No Limit ($0.02/$0.05 CAD) - 2023/09/29 3:01:48 ET
Table 'Arneb II' 6-max Seat #4 is the button
Seat 1: CashMatteo ($6.93 in chips) 
Seat 4: saschak3 ($3.48 in chips) 
saschak3: posts small blind $0.02
CashMatteo: posts big blind $0.05
*** HOLE CARDS ***
Dealt to CashMatteo [9c 9h]
saschak3: raises $0.10 to $0.15
CashMatteo: raises $0.10 to $0.25
saschak3: calls $0.10
*** FLOP *** [6h 5h Tc]
CashMatteo: bets $0.24
saschak3: raises $0.24 to $0.48
CashMatteo: calls $0.24
*** TURN *** [6h 5h Tc] [4h]
CashMatteo: checks 
saschak3: bets $1.40
CashMatteo: folds 
Uncalled bet ($1.40) returned to saschak3
saschak3 collected $1.40 from pot
*** SUMMARY ***
Total pot $1.46 | Rake $0.06 
Board [6h 5h Tc 4h]
Seat 1: CashMatteo (big blind) folded on the Turn
Seat 4: saschak3 (button) (small blind) collected ($1.40)

Hand #438: 

PokerStars Hand #246242571529:  Hold'em No Limit ($0.02/$0.05 CAD) - 2023/09/29 3:02:28 ET
Table 'Arneb II' 6-max Seat #1 is the button
Seat 1: CashMatteo ($6.20 in chips) 
Seat 4: saschak3 ($4.15 in chips) 
CashMatteo: posts small blind $0.02
saschak3: posts big blind $0.05
*** HOLE CARDS ***
Dealt to CashMatteo [9h Td]
CashMatteo: calls $0.03
saschak3: raises $0.10 to $0.15
CashMatteo: calls $0.10
*** FLOP *** [Qh 9c Th]
saschak3: bets $0.29
CashMatteo: calls $0.29
*** TURN *** [Qh 9c Th] [Js]
saschak3: bets $0.84
CashMatteo: folds 
Uncalled bet ($0.84) returned to saschak3
saschak3 collected $0.84 from pot
*** SUMMARY ***
Total pot $0.88 | Rake $0.04 
Board [Qh 9c Th Js]
Seat 1: CashMatteo (button) (small blind) folded on the Turn
Seat 4: saschak3 (big blind) collected ($0.84)

Hand #439: 

PokerStars Hand #246242578052:  Hold'em No Limit ($0.02/$0.05 CAD) - 2023/09/29 3:03:32 ET
Table 'Arneb II' 6-max Seat #4 is the button
Seat 1: CashMatteo ($5.76 in chips) 
Seat 4: saschak3 ($4.55 in chips) 
saschak3: posts small blind $0.02
CashMatteo: posts big blind $0.05
*** HOLE CARDS ***
Dealt to CashMatteo [5c 4d]
saschak3: calls $0.03
CashMatteo: checks 
*** FLOP *** [4h 4c 8s]
CashMatteo: checks 
saschak3: checks 
*** TURN *** [4h 4c 8s] [Ks]
CashMatteo: checks 
saschak3: checks 
*** RIVER *** [4h 4c 8s Ks] [Th]
CashMatteo: bets $0.10
saschak3: folds 
Uncalled bet ($0.10) returned to CashMatteo
CashMatteo collected $0.10 from pot
CashMatteo: doesn't show hand 
*** SUMMARY ***
Total pot $0.10 | Rake $0 
Board [4h 4c 8s Ks Th]
Seat 1: CashMatteo (big blind) collected ($0.10)
Seat 4: saschak3 (button) (small blind) folded on the River

Hand #440: 

PokerStars Hand #246242580167:  Hold'em No Limit ($0.02/$0.05 CAD) - 2023/09/29 3:03:55 ET
Table 'Arneb II' 6-max Seat #1 is the button
Seat 1: CashMatteo ($5.81 in chips) 
Seat 4: saschak3 ($4.50 in chips) 
CashMatteo: posts small blind $0.02
saschak3: posts big blind $0.05
*** HOLE CARDS ***
Dealt to CashMatteo [8h 7c]
CashMatteo: calls $0.03
saschak3: checks 
*** FLOP *** [2c Ks Ac]
saschak3: bets $0.10
CashMatteo: folds 
Uncalled bet ($0.10) returned to saschak3
saschak3 collected $0.10 from pot
*** SUMMARY ***
Total pot $0.10 | Rake $0 
Board [2c Ks Ac]
Seat 1: CashMatteo (button) (small blind) folded on the Flop
Seat 4: saschak3 (big blind) collected ($0.10)

Hand #441: 

PokerStars Hand #246242581476:  Hold'em No Limit ($0.02/$0.05 CAD) - 2023/09/29 3:04:08 ET
Table 'Arneb II' 6-max Seat #4 is the button
Seat 1: CashMatteo ($5.76 in chips) 
Seat 4: saschak3 ($4.55 in chips) 
saschak3: posts small blind $0.02
CashMatteo: posts big blind $0.05
*** HOLE CARDS ***
Dealt to CashMatteo [9h 6h]
saschak3: calls $0.03
CashMatteo: raises $0.10 to $0.15
saschak3: calls $0.10
*** FLOP *** [3h Jh Ks]
CashMatteo: bets $0.15
saschak3: folds 
Uncalled bet ($0.15) returned to CashMatteo
CashMatteo collected $0.29 from pot
CashMatteo: doesn't show hand 
*** SUMMARY ***
Total pot $0.30 | Rake $0.01 
Board [3h Jh Ks]
Seat 1: CashMatteo (big blind) collected ($0.29)
Seat 4: saschak3 (button) (small blind) folded on the Flop

Hand #442: 

PokerStars Hand #246242583574:  Hold'em No Limit ($0.02/$0.05 CAD) - 2023/09/29 3:04:29 ET
Table 'Arneb II' 6-max Seat #1 is the button
Seat 1: CashMatteo ($5.90 in chips) 
Seat 4: saschak3 ($4.40 in chips) 
CashMatteo: posts small blind $0.02
saschak3: posts big blind $0.05
*** HOLE CARDS ***
Dealt to CashMatteo [Tc 8h]
CashMatteo: folds 
Uncalled bet ($0.03) returned to saschak3
saschak3 collected $0.04 from pot
*** SUMMARY ***
Total pot $0.04 | Rake $0 
Seat 1: CashMatteo (button) (small blind) folded before Flop
Seat 4: saschak3 (big blind) collected ($0.04)

Hand #443: 

PokerStars Hand #246242584270:  Hold'em No Limit ($0.02/$0.05 CAD) - 2023/09/29 3:04:37 ET
Table 'Arneb II' 6-max Seat #4 is the button
Seat 1: CashMatteo ($5.88 in chips) 
Seat 4: saschak3 ($4.42 in chips) 
saschak3: posts small blind $0.02
CashMatteo: posts big blind $0.05
*** HOLE CARDS ***
Dealt to CashMatteo [4s 5s]
saschak3: calls $0.03
CashMatteo: checks 
*** FLOP *** [Qc 9d 8c]
CashMatteo: checks 
saschak3: checks 
*** TURN *** [Qc 9d 8c] [Th]
CashMatteo: checks 
saschak3: checks 
*** RIVER *** [Qc 9d 8c Th] [As]
CashMatteo: checks 
saschak3: checks 
*** SHOW DOWN ***
CashMatteo: shows [4s 5s] (high card Ace)
saschak3: shows [9h 3h] (a pair of Nines)
saschak3 collected $0.10 from pot
*** SUMMARY ***
Total pot $0.10 | Rake $0 
Board [Qc 9d 8c Th As]
Seat 1: CashMatteo (big blind) showed [4s 5s] and lost with high card Ace
Seat 4: saschak3 (button) (small blind) showed [9h 3h] and won ($0.10) with a pair of Nines

Hand #444: 

PokerStars Hand #246242585921:  Hold'em No Limit ($0.02/$0.05 CAD) - 2023/09/29 3:04:54 ET
Table 'Arneb II' 6-max Seat #1 is the button
Seat 1: CashMatteo ($5.83 in chips) 
Seat 4: saschak3 ($4.47 in chips) 
CashMatteo: posts small blind $0.02
saschak3: posts big blind $0.05
*** HOLE CARDS ***
Dealt to CashMatteo [5h 8c]
CashMatteo: folds 
Uncalled bet ($0.03) returned to saschak3
saschak3 collected $0.04 from pot
*** SUMMARY ***
Total pot $0.04 | Rake $0 
Seat 1: CashMatteo (button) (small blind) folded before Flop
Seat 4: saschak3 (big blind) collected ($0.04)

Hand #445: 

PokerStars Hand #246242586611:  Hold'em No Limit ($0.02/$0.05 CAD) - 2023/09/29 3:05:01 ET
Table 'Arneb II' 6-max Seat #4 is the button
Seat 1: CashMatteo ($5.81 in chips) 
Seat 4: saschak3 ($4.49 in chips) 
saschak3: posts small blind $0.02
CashMatteo: posts big blind $0.05
*** HOLE CARDS ***
Dealt to CashMatteo [6c 7h]
saschak3: calls $0.03
CashMatteo: checks 
*** FLOP *** [5c Ac Jc]
CashMatteo: checks 
saschak3: checks 
*** TURN *** [5c Ac Jc] [4h]
CashMatteo: bets $0.05
saschak3: folds 
Uncalled bet ($0.05) returned to CashMatteo
CashMatteo collected $0.10 from pot
CashMatteo: doesn't show hand 
*** SUMMARY ***
Total pot $0.10 | Rake $0 
Board [5c Ac Jc 4h]
Seat 1: CashMatteo (big blind) collected ($0.10)
Seat 4: saschak3 (button) (small blind) folded on the Turn

Hand #446: 

PokerStars Hand #246242588361:  Hold'em No Limit ($0.02/$0.05 CAD) - 2023/09/29 3:05:19 ET
Table 'Arneb II' 6-max Seat #1 is the button
Seat 1: CashMatteo ($5.86 in chips) 
Seat 4: saschak3 ($4.44 in chips) 
CashMatteo: posts small blind $0.02
saschak3: posts big blind $0.05
*** HOLE CARDS ***
Dealt to CashMatteo [Jh 4h]
CashMatteo: calls $0.03
saschak3: raises $0.05 to $0.10
CashMatteo: calls $0.05
*** FLOP *** [4d 3s Qs]
saschak3: bets $0.19
CashMatteo: calls $0.19
*** TURN *** [4d 3s Qs] [3d]
saschak3: bets $0.56
CashMatteo: folds 
Uncalled bet ($0.56) returned to saschak3
saschak3 collected $0.56 from pot
*** SUMMARY ***
Total pot $0.58 | Rake $0.02 
Board [4d 3s Qs 3d]
Seat 1: CashMatteo (button) (small blind) folded on the Turn
Seat 4: saschak3 (big blind) collected ($0.56)

Hand #447: 

PokerStars Hand #246242591872:  Hold'em No Limit ($0.02/$0.05 CAD) - 2023/09/29 3:05:55 ET
Table 'Arneb II' 6-max Seat #4 is the button
Seat 1: CashMatteo ($5.57 in chips) 
Seat 4: saschak3 ($4.71 in chips) 
saschak3: posts small blind $0.02
CashMatteo: posts big blind $0.05
*** HOLE CARDS ***
Dealt to CashMatteo [2h 6d]
saschak3: folds 
Uncalled bet ($0.03) returned to CashMatteo
CashMatteo collected $0.04 from pot
CashMatteo: doesn't show hand 
*** SUMMARY ***
Total pot $0.04 | Rake $0 
Seat 1: CashMatteo (big blind) collected ($0.04)
Seat 4: saschak3 (button) (small blind) folded before Flop

Hand #448: 

PokerStars Hand #246242592653:  Hold'em No Limit ($0.02/$0.05 CAD) - 2023/09/29 3:06:04 ET
Table 'Arneb II' 6-max Seat #1 is the button
Seat 1: CashMatteo ($5.59 in chips) 
Seat 4: saschak3 ($4.69 in chips) 
CashMatteo: posts small blind $0.02
saschak3: posts big blind $0.05
*** HOLE CARDS ***
Dealt to CashMatteo [Qs 5h]
CashMatteo: calls $0.03
saschak3: checks 
*** FLOP *** [3c 2d Ah]
saschak3: checks 
CashMatteo: checks 
*** TURN *** [3c 2d Ah] [6h]
saschak3: bets $0.10
CashMatteo: folds 
Uncalled bet ($0.10) returned to saschak3
saschak3 collected $0.10 from pot
*** SUMMARY ***
Total pot $0.10 | Rake $0 
Board [3c 2d Ah 6h]
Seat 1: CashMatteo (button) (small blind) folded on the Turn
Seat 4: saschak3 (big blind) collected ($0.10)

Hand #449: 

PokerStars Hand #246242594641:  Hold'em No Limit ($0.02/$0.05 CAD) - 2023/09/29 3:06:23 ET
Table 'Arneb II' 6-max Seat #4 is the button
Seat 1: CashMatteo ($5.54 in chips) 
Seat 4: saschak3 ($4.74 in chips) 
saschak3: posts small blind $0.02
CashMatteo: posts big blind $0.05
*** HOLE CARDS ***
Dealt to CashMatteo [7d 3h]
saschak3: calls $0.03
CashMatteo: checks 
*** FLOP *** [7h 2s Kc]
CashMatteo: bets $0.05
saschak3: folds 
Uncalled bet ($0.05) returned to CashMatteo
CashMatteo collected $0.10 from pot
CashMatteo: doesn't show hand 
*** SUMMARY ***
Total pot $0.10 | Rake $0 
Board [7h 2s Kc]
Seat 1: CashMatteo (big blind) collected ($0.10)
Seat 4: saschak3 (button) (small blind) folded on the Flop

Hand #450: 

PokerStars Hand #246242596139:  Hold'em No Limit ($0.02/$0.05 CAD) - 2023/09/29 3:06:39 ET
Table 'Arneb II' 6-max Seat #1 is the button
Seat 1: CashMatteo ($5.59 in chips) 
Seat 4: saschak3 ($4.69 in chips) 
CashMatteo: posts small blind $0.02
saschak3: posts big blind $0.05
*** HOLE CARDS ***
Dealt to CashMatteo [9d 5h]
CashMatteo: folds 
Uncalled bet ($0.03) returned to saschak3
saschak3 collected $0.04 from pot
*** SUMMARY ***
Total pot $0.04 | Rake $0 
Seat 1: CashMatteo (button) (small blind) folded before Flop
Seat 4: saschak3 (big blind) collected ($0.04)

Hand #451: 

PokerStars Hand #246242596830:  Hold'em No Limit ($0.02/$0.05 CAD) - 2023/09/29 3:06:45 ET
Table 'Arneb II' 6-max Seat #4 is the button
Seat 1: CashMatteo ($5.57 in chips) 
Seat 4: saschak3 ($4.71 in chips) 
saschak3: posts small blind $0.02
CashMatteo: posts big blind $0.05
*** HOLE CARDS ***
Dealt to CashMatteo [6c Ah]
saschak3: calls $0.03
CashMatteo: checks 
*** FLOP *** [5s Tc 4s]
CashMatteo: checks 
saschak3: bets $0.10
CashMatteo: calls $0.10
*** TURN *** [5s Tc 4s] [As]
CashMatteo: bets $0.20
saschak3: folds 
Uncalled bet ($0.20) returned to CashMatteo
CashMatteo collected $0.29 from pot
CashMatteo: doesn't show hand 
*** SUMMARY ***
Total pot $0.30 | Rake $0.01 
Board [5s Tc 4s As]
Seat 1: CashMatteo (big blind) collected ($0.29)
Seat 4: saschak3 (button) (small blind) folded on the Turn

Hand #452: 

PokerStars Hand #246242599058:  Hold'em No Limit ($0.02/$0.05 CAD) - 2023/09/29 3:07:08 ET
Table 'Arneb II' 6-max Seat #1 is the button
Seat 1: CashMatteo ($5.71 in chips) 
Seat 4: saschak3 ($4.56 in chips) 
CashMatteo: posts small blind $0.02
saschak3: posts big blind $0.05
*** HOLE CARDS ***
Dealt to CashMatteo [9h Jc]
CashMatteo: calls $0.03
saschak3: checks 
*** FLOP *** [8h 3c Tc]
saschak3: checks 
CashMatteo: bets $0.05
saschak3: folds 
Uncalled bet ($0.05) returned to CashMatteo
CashMatteo collected $0.10 from pot
CashMatteo: doesn't show hand 
*** SUMMARY ***
Total pot $0.10 | Rake $0 
Board [8h 3c Tc]
Seat 1: CashMatteo (button) (small blind) collected ($0.10)
Seat 4: saschak3 (big blind) folded on the Flop

Hand #453: 

PokerStars Hand #246242600516:  Hold'em No Limit ($0.02/$0.05 CAD) - 2023/09/29 3:07:23 ET
Table 'Arneb II' 6-max Seat #4 is the button
Seat 1: CashMatteo ($5.76 in chips) 
Seat 4: saschak3 ($4.51 in chips) 
saschak3: posts small blind $0.02
CashMatteo: posts big blind $0.05
*** HOLE CARDS ***
Dealt to CashMatteo [8d 9c]
saschak3: folds 
Uncalled bet ($0.03) returned to CashMatteo
CashMatteo collected $0.04 from pot
CashMatteo: doesn't show hand 
*** SUMMARY ***
Total pot $0.04 | Rake $0 
Seat 1: CashMatteo (big blind) collected ($0.04)
Seat 4: saschak3 (button) (small blind) folded before Flop

Hand #454: 

PokerStars Hand #246242601091:  Hold'em No Limit ($0.02/$0.05 CAD) - 2023/09/29 3:07:28 ET
Table 'Arneb II' 6-max Seat #1 is the button
Seat 1: CashMatteo ($5.78 in chips) 
Seat 4: saschak3 ($4.49 in chips) 
CashMatteo: posts small blind $0.02
saschak3: posts big blind $0.05
*** HOLE CARDS ***
Dealt to CashMatteo [4c 6d]
CashMatteo: folds 
Uncalled bet ($0.03) returned to saschak3
saschak3 collected $0.04 from pot
*** SUMMARY ***
Total pot $0.04 | Rake $0 
Seat 1: CashMatteo (button) (small blind) folded before Flop
Seat 4: saschak3 (big blind) collected ($0.04)

Hand #455: 

PokerStars Hand #246242601803:  Hold'em No Limit ($0.02/$0.05 CAD) - 2023/09/29 3:07:35 ET
Table 'Arneb II' 6-max Seat #4 is the button
Seat 1: CashMatteo ($5.76 in chips) 
Seat 4: saschak3 ($4.51 in chips) 
saschak3: posts small blind $0.02
CashMatteo: posts big blind $0.05
*** HOLE CARDS ***
Dealt to CashMatteo [4s 2d]
saschak3: calls $0.03
CashMatteo: checks 
*** FLOP *** [3c Js 7d]
CashMatteo: checks 
saschak3: bets $0.10
CashMatteo: folds 
Uncalled bet ($0.10) returned to saschak3
saschak3 collected $0.10 from pot
*** SUMMARY ***
Total pot $0.10 | Rake $0 
Board [3c Js 7d]
Seat 1: CashMatteo (big blind) folded on the Flop
Seat 4: saschak3 (button) (small blind) collected ($0.10)

Hand #456: 

PokerStars Hand #246242603050:  Hold'em No Limit ($0.02/$0.05 CAD) - 2023/09/29 3:07:48 ET
Table 'Arneb II' 6-max Seat #1 is the button
Seat 1: CashMatteo ($5.71 in chips) 
Seat 4: saschak3 ($4.56 in chips) 
CashMatteo: posts small blind $0.02
saschak3: posts big blind $0.05
*** HOLE CARDS ***
Dealt to CashMatteo [7c Kh]
CashMatteo: calls $0.03
saschak3: checks 
*** FLOP *** [Jd Qc Tc]
saschak3: checks 
CashMatteo: bets $0.05
saschak3: folds 
Uncalled bet ($0.05) returned to CashMatteo
CashMatteo collected $0.10 from pot
CashMatteo: doesn't show hand 
*** SUMMARY ***
Total pot $0.10 | Rake $0 
Board [Jd Qc Tc]
Seat 1: CashMatteo (button) (small blind) collected ($0.10)
Seat 4: saschak3 (big blind) folded on the Flop

Hand #457: 

PokerStars Hand #246242604350:  Hold'em No Limit ($0.02/$0.05 CAD) - 2023/09/29 3:08:01 ET
Table 'Arneb II' 6-max Seat #4 is the button
Seat 1: CashMatteo ($5.76 in chips) 
Seat 4: saschak3 ($4.51 in chips) 
saschak3: posts small blind $0.02
CashMatteo: posts big blind $0.05
*** HOLE CARDS ***
Dealt to CashMatteo [5h Kd]
saschak3: raises $0.05 to $0.10
CashMatteo: calls $0.05
*** FLOP *** [Kh 2s 2h]
CashMatteo: checks 
Dingleballzz joins the table at seat #6 
saschak3: bets $0.19
CashMatteo: calls $0.19
*** TURN *** [Kh 2s 2h] [Ks]
CashMatteo: checks 
saschak3: checks 
*** RIVER *** [Kh 2s 2h Ks] [Jd]
CashMatteo: checks 
saschak3: checks 
*** SHOW DOWN ***
CashMatteo: shows [5h Kd] (a full house, Kings full of Deuces)
saschak3: mucks hand 
CashMatteo collected $0.56 from pot
*** SUMMARY ***
Total pot $0.58 | Rake $0.02 
Board [Kh 2s 2h Ks Jd]
Seat 1: CashMatteo (big blind) showed [5h Kd] and won ($0.56) with a full house, Kings full of Deuces
Seat 4: saschak3 (button) (small blind) mucked [Js 9h]

Hand #458: 

PokerStars Hand #246242607654:  Hold'em No Limit ($0.02/$0.05 CAD) - 2023/09/29 3:08:34 ET
Table 'Arneb II' 6-max Seat #1 is the button
Seat 1: CashMatteo ($6.03 in chips) 
Seat 4: saschak3 ($4.22 in chips) 
Seat 6: Dingleballzz ($2.60 in chips) 
saschak3: posts small blind $0.02
Dingleballzz: posts big blind $0.05
*** HOLE CARDS ***
Dealt to CashMatteo [Jh 3s]
CashMatteo: calls $0.05
saschak3: calls $0.03
Dingleballzz: checks 
*** FLOP *** [5h 9s 6d]
saschak3: checks 
Dingleballzz: checks 
CashMatteo: checks 
*** TURN *** [5h 9s 6d] [6h]
saschak3: checks 
Dingleballzz: bets $0.07
CashMatteo: folds 
saschak3: folds 
Uncalled bet ($0.07) returned to Dingleballzz
Dingleballzz collected $0.14 from pot
*** SUMMARY ***
Total pot $0.15 | Rake $0.01 
Board [5h 9s 6d 6h]
Seat 1: CashMatteo (button) folded on the Turn
Seat 4: saschak3 (small blind) folded on the Turn
Seat 6: Dingleballzz (big blind) collected ($0.14)

Hand #459: 

PokerStars Hand #246242610085:  Hold'em No Limit ($0.02/$0.05 CAD) - 2023/09/29 3:08:58 ET
Table 'Arneb II' 6-max Seat #4 is the button
Seat 1: CashMatteo ($5.98 in chips) 
Seat 4: saschak3 ($4.17 in chips) 
Seat 6: Dingleballzz ($2.69 in chips) 
Dingleballzz: posts small blind $0.02
CashMatteo: posts big blind $0.05
*** HOLE CARDS ***
Dealt to CashMatteo [Ts 7s]
saschak3: raises $0.05 to $0.10
Dingleballzz: calls $0.08
CashMatteo: calls $0.05
*** FLOP *** [Jh 8d 3c]
Dingleballzz: checks 
CashMatteo: checks 
saschak3: bets $0.29
Dingleballzz: folds 
CashMatteo: folds 
Uncalled bet ($0.29) returned to saschak3
saschak3 collected $0.29 from pot
*** SUMMARY ***
Total pot $0.30 | Rake $0.01 
Board [Jh 8d 3c]
Seat 1: CashMatteo (big blind) folded on the Flop
Seat 4: saschak3 (button) collected ($0.29)
Seat 6: Dingleballzz (small blind) folded on the Flop

Hand #460: 

PokerStars Hand #246242612700:  Hold'em No Limit ($0.02/$0.05 CAD) - 2023/09/29 3:09:25 ET
Table 'Arneb II' 6-max Seat #6 is the button
Seat 1: CashMatteo ($5.88 in chips) 
Seat 4: saschak3 ($4.36 in chips) 
Seat 6: Dingleballzz ($2.59 in chips) 
CashMatteo: posts small blind $0.02
saschak3: posts big blind $0.05
*** HOLE CARDS ***
Dealt to CashMatteo [Tc Td]
Dingleballzz: folds 
CashMatteo: raises $0.05 to $0.10
saschak3: folds 
Uncalled bet ($0.05) returned to CashMatteo
CashMatteo collected $0.10 from pot
CashMatteo: doesn't show hand 
*** SUMMARY ***
Total pot $0.10 | Rake $0 
Seat 1: CashMatteo (small blind) collected ($0.10)
Seat 4: saschak3 (big blind) folded before Flop
Seat 6: Dingleballzz (button) folded before Flop (didn't bet)

Hand #461: 

PokerStars Hand #246242613806:  Hold'em No Limit ($0.02/$0.05 CAD) - 2023/09/29 3:09:36 ET
Table 'Arneb II' 6-max Seat #1 is the button
Seat 1: CashMatteo ($5.93 in chips) 
Seat 4: saschak3 ($4.31 in chips) 
Seat 6: Dingleballzz ($2.59 in chips) 
saschak3: posts small blind $0.02
Dingleballzz: posts big blind $0.05
*** HOLE CARDS ***
Dealt to CashMatteo [2c 8c]
CashMatteo: folds 
saschak3: calls $0.03
Dingleballzz: checks 
*** FLOP *** [8s Qs 4c]
saschak3: checks 
Dingleballzz: checks 
*** TURN *** [8s Qs 4c] [Ks]
saschak3: bets $0.05
Dingleballzz: folds 
Uncalled bet ($0.05) returned to saschak3
saschak3 collected $0.10 from pot
*** SUMMARY ***
Total pot $0.10 | Rake $0 
Board [8s Qs 4c Ks]
Seat 1: CashMatteo (button) folded before Flop (didn't bet)
Seat 4: saschak3 (small blind) collected ($0.10)
Seat 6: Dingleballzz (big blind) folded on the Turn

Hand #462: 

PokerStars Hand #246242616024:  Hold'em No Limit ($0.02/$0.05 CAD) - 2023/09/29 3:09:58 ET
Table 'Arneb II' 6-max Seat #4 is the button
Seat 1: CashMatteo ($5.93 in chips) 
Seat 4: saschak3 ($4.36 in chips) 
Seat 6: Dingleballzz ($2.54 in chips) 
Dingleballzz: posts small blind $0.02
CashMatteo: posts big blind $0.05
*** HOLE CARDS ***
Dealt to CashMatteo [9h 2c]
saschak3: calls $0.05
Dingleballzz: calls $0.03
CashMatteo: checks 
*** FLOP *** [4c Qs 5s]
Dingleballzz: checks 
CashMatteo: checks 
saschak3: checks 
*** TURN *** [4c Qs 5s] [Kc]
Dingleballzz: bets $0.07
CashMatteo: folds 
saschak3: folds 
Uncalled bet ($0.07) returned to Dingleballzz
Dingleballzz collected $0.14 from pot
*** SUMMARY ***
Total pot $0.15 | Rake $0.01 
Board [4c Qs 5s Kc]
Seat 1: CashMatteo (big blind) folded on the Turn
Seat 4: saschak3 (button) folded on the Turn
Seat 6: Dingleballzz (small blind) collected ($0.14)

Hand #463: 

PokerStars Hand #246242618482:  Hold'em No Limit ($0.02/$0.05 CAD) - 2023/09/29 3:10:22 ET
Table 'Arneb II' 6-max Seat #6 is the button
Seat 1: CashMatteo ($5.88 in chips) 
Seat 4: saschak3 ($4.31 in chips) 
Seat 6: Dingleballzz ($2.63 in chips) 
CashMatteo: posts small blind $0.02
saschak3: posts big blind $0.05
*** HOLE CARDS ***
Dealt to CashMatteo [Td Kd]
Dingleballzz: raises $0.10 to $0.15
CashMatteo: calls $0.13
saschak3: folds 
*** FLOP *** [5d Th Jd]
CashMatteo: checks 
Dingleballzz: bets $0.15
CashMatteo: calls $0.15
*** TURN *** [5d Th Jd] [7d]
CashMatteo: checks 
Dingleballzz: bets $0.36
CashMatteo: calls $0.36
*** RIVER *** [5d Th Jd 7d] [8s]
CashMatteo: checks 
Dingleballzz: bets $1.97 and is all-in
CashMatteo: calls $1.97
*** SHOW DOWN ***
Dingleballzz: shows [Ad 9s] (a straight, Seven to Jack)
CashMatteo: shows [Td Kd] (a flush, King high)
CashMatteo collected $5.09 from pot
*** SUMMARY ***
Total pot $5.31 | Rake $0.22 
Board [5d Th Jd 7d 8s]
Seat 1: CashMatteo (small blind) showed [Td Kd] and won ($5.09) with a flush, King high
Seat 4: saschak3 (big blind) folded before Flop
Seat 6: Dingleballzz (button) showed [Ad 9s] and lost with a straight, Seven to Jack

Hand #464: 

PokerStars Hand #246242624853:  Hold'em No Limit ($0.02/$0.05 CAD) - 2023/09/29 3:11:25 ET
Table 'Arneb II' 6-max Seat #4 is the button
Seat 1: CashMatteo ($8.34 in chips) 
Seat 4: saschak3 ($4.26 in chips) 
saschak3: posts small blind $0.02
CashMatteo: posts big blind $0.05
*** HOLE CARDS ***
Dealt to CashMatteo [5d Th]
saschak3: raises $0.05 to $0.10
CashMatteo: folds 
Uncalled bet ($0.05) returned to saschak3
Dingleballzz is disconnected 
saschak3 collected $0.10 from pot
*** SUMMARY ***
Total pot $0.10 | Rake $0 
Seat 1: CashMatteo (big blind) folded before Flop
Seat 4: saschak3 (button) (small blind) collected ($0.10)

Hand #465: 

PokerStars Hand #246242625907:  Hold'em No Limit ($0.02/$0.05 CAD) - 2023/09/29 3:11:35 ET
Table 'Arneb II' 6-max Seat #1 is the button
Seat 1: CashMatteo ($8.29 in chips) 
Seat 4: saschak3 ($4.31 in chips) 
CashMatteo: posts small blind $0.02
saschak3: posts big blind $0.05
*** HOLE CARDS ***
Dealt to CashMatteo [9s Ad]
CashMatteo: calls $0.03
saschak3: checks 
*** FLOP *** [8h 5c 5s]
saschak3: checks 
CashMatteo: checks 
*** TURN *** [8h 5c 5s] [Th]
saschak3: checks 
CashMatteo: checks 
*** RIVER *** [8h 5c 5s Th] [5d]
saschak3: checks 
CashMatteo: checks 
*** SHOW DOWN ***
saschak3: shows [3d 7s] (three of a kind, Fives)
CashMatteo: shows [9s Ad] (three of a kind, Fives - Ace kicker)
CashMatteo collected $0.10 from pot
*** SUMMARY ***
Total pot $0.10 | Rake $0 
Board [8h 5c 5s Th 5d]
Seat 1: CashMatteo (button) (small blind) showed [9s Ad] and won ($0.10) with three of a kind, Fives
Seat 4: saschak3 (big blind) showed [3d 7s] and lost with three of a kind, Fives

Hand #466: 

PokerStars Hand #246242627977:  Hold'em No Limit ($0.02/$0.05 CAD) - 2023/09/29 3:11:56 ET
Table 'Arneb II' 6-max Seat #4 is the button
Seat 1: CashMatteo ($8.34 in chips) 
Seat 4: saschak3 ($4.26 in chips) 
saschak3: posts small blind $0.02
CashMatteo: posts big blind $0.05
*** HOLE CARDS ***
Dealt to CashMatteo [Ts 6h]
saschak3: calls $0.03
CashMatteo: checks 
*** FLOP *** [7c 9c 2c]
CashMatteo: checks 
saschak3: bets $0.10
CashMatteo: folds 
Uncalled bet ($0.10) returned to saschak3
saschak3 collected $0.10 from pot
*** SUMMARY ***
Total pot $0.10 | Rake $0 
Board [7c 9c 2c]
Seat 1: CashMatteo (big blind) folded on the Flop
Seat 4: saschak3 (button) (small blind) collected ($0.10)

Hand #467: 

PokerStars Hand #246242629436:  Hold'em No Limit ($0.02/$0.05 CAD) - 2023/09/29 3:12:10 ET
Table 'Arneb II' 6-max Seat #1 is the button
Seat 1: CashMatteo ($8.29 in chips) 
Seat 4: saschak3 ($4.31 in chips) 
CashMatteo: posts small blind $0.02
saschak3: posts big blind $0.05
*** HOLE CARDS ***
Dealt to CashMatteo [As 3c]
CashMatteo: calls $0.03
saschak3: checks 
*** FLOP *** [7s 4s 9h]
saschak3: bets $0.10
CashMatteo: calls $0.10
*** TURN *** [7s 4s 9h] [Jc]
saschak3: bets $0.29
CashMatteo: folds 
Uncalled bet ($0.29) returned to saschak3
saschak3 collected $0.29 from pot
*** SUMMARY ***
Total pot $0.30 | Rake $0.01 
Board [7s 4s 9h Jc]
Seat 1: CashMatteo (button) (small blind) folded on the Turn
Seat 4: saschak3 (big blind) collected ($0.29)

Hand #468: 

PokerStars Hand #246242631401:  Hold'em No Limit ($0.02/$0.05 CAD) - 2023/09/29 3:12:29 ET
Table 'Arneb II' 6-max Seat #4 is the button
Seat 1: CashMatteo ($8.14 in chips) 
Seat 4: saschak3 ($4.45 in chips) 
saschak3: posts small blind $0.02
CashMatteo: posts big blind $0.05
*** HOLE CARDS ***
Dealt to CashMatteo [4c Qs]
saschak3: folds 
Uncalled bet ($0.03) returned to CashMatteo
CashMatteo collected $0.04 from pot
CashMatteo: doesn't show hand 
*** SUMMARY ***
Total pot $0.04 | Rake $0 
Seat 1: CashMatteo (big blind) collected ($0.04)
Seat 4: saschak3 (button) (small blind) folded before Flop

Hand #469: 

PokerStars Hand #246242632012:  Hold'em No Limit ($0.02/$0.05 CAD) - 2023/09/29 3:12:35 ET
Table 'Arneb II' 6-max Seat #1 is the button
Seat 1: CashMatteo ($8.16 in chips) 
Seat 4: saschak3 ($4.43 in chips) 
CashMatteo: posts small blind $0.02
saschak3: posts big blind $0.05
*** HOLE CARDS ***
Dealt to CashMatteo [Js 4s]
CashMatteo: calls $0.03
saschak3: checks 
*** FLOP *** [4h 7h Qh]
saschak3: checks 
CashMatteo: checks 
*** TURN *** [4h 7h Qh] [6h]
saschak3: checks 
CashMatteo: bets $0.05
saschak3: calls $0.05
*** RIVER *** [4h 7h Qh 6h] [Ah]
saschak3: checks 
CashMatteo: checks 
*** SHOW DOWN ***
saschak3: shows [8h Td] (a flush, Ace high)
CashMatteo: mucks hand 
saschak3 collected $0.19 from pot
*** SUMMARY ***
Total pot $0.20 | Rake $0.01 
Board [4h 7h Qh 6h Ah]
Seat 1: CashMatteo (button) (small blind) mucked [Js 4s]
Seat 4: saschak3 (big blind) showed [8h Td] and won ($0.19) with a flush, Ace high

Hand #470: 

PokerStars Hand #246242634545:  Hold'em No Limit ($0.02/$0.05 CAD) - 2023/09/29 3:13:00 ET
Table 'Arneb II' 6-max Seat #4 is the button
Seat 1: CashMatteo ($8.06 in chips) 
Seat 4: saschak3 ($4.52 in chips) 
saschak3: posts small blind $0.02
CashMatteo: posts big blind $0.05
*** HOLE CARDS ***
Dealt to CashMatteo [8d 6c]
saschak3: raises $0.05 to $0.10
CashMatteo: folds 
Uncalled bet ($0.05) returned to saschak3
saschak3 collected $0.10 from pot
*** SUMMARY ***
Total pot $0.10 | Rake $0 
Seat 1: CashMatteo (big blind) folded before Flop
Seat 4: saschak3 (button) (small blind) collected ($0.10)

Hand #471: 

PokerStars Hand #246242635421:  Hold'em No Limit ($0.02/$0.05 CAD) - 2023/09/29 3:13:09 ET
Table 'Arneb II' 6-max Seat #1 is the button
Seat 1: CashMatteo ($8.01 in chips) 
Seat 4: saschak3 ($4.57 in chips) 
CashMatteo: posts small blind $0.02
saschak3: posts big blind $0.05
*** HOLE CARDS ***
Dealt to CashMatteo [Kd Jd]
CashMatteo: raises $0.10 to $0.15
saschak3: calls $0.10
*** FLOP *** [3c Qs 6h]
saschak3: checks 
CashMatteo: checks 
*** TURN *** [3c Qs 6h] [2c]
saschak3: bets $0.29
CashMatteo: folds 
Uncalled bet ($0.29) returned to saschak3
saschak3 collected $0.29 from pot
*** SUMMARY ***
Total pot $0.30 | Rake $0.01 
Board [3c Qs 6h 2c]
Seat 1: CashMatteo (button) (small blind) folded on the Turn
Seat 4: saschak3 (big blind) collected ($0.29)

Hand #472: 

PokerStars Hand #246242637091:  Hold'em No Limit ($0.02/$0.05 CAD) - 2023/09/29 3:13:25 ET
Table 'Arneb II' 6-max Seat #4 is the button
Seat 1: CashMatteo ($7.86 in chips) 
Seat 4: saschak3 ($4.71 in chips) 
saschak3: posts small blind $0.02
CashMatteo: posts big blind $0.05
*** HOLE CARDS ***
Dealt to CashMatteo [9d Qs]
saschak3: calls $0.03
CashMatteo: checks 
*** FLOP *** [Ts 3s Qd]
CashMatteo: bets $0.05
saschak3: calls $0.05
*** TURN *** [Ts 3s Qd] [2c]
CashMatteo: checks 
saschak3: bets $0.19
CashMatteo: calls $0.19
*** RIVER *** [Ts 3s Qd 2c] [2h]
CashMatteo: bets $0.28
saschak3: calls $0.28
*** SHOW DOWN ***
CashMatteo: shows [9d Qs] (two pair, Queens and Deuces)
saschak3: mucks hand 
CashMatteo collected $1.09 from pot
*** SUMMARY ***
Total pot $1.14 | Rake $0.05 
Board [Ts 3s Qd 2c 2h]
Seat 1: CashMatteo (big blind) showed [9d Qs] and won ($1.09) with two pair, Queens and Deuces
Seat 4: saschak3 (button) (small blind) mucked [7d Td]

Hand #473: 

PokerStars Hand #246242641431:  Hold'em No Limit ($0.02/$0.05 CAD) - 2023/09/29 3:14:08 ET
Table 'Arneb II' 6-max Seat #1 is the button
Seat 1: CashMatteo ($8.38 in chips) 
Seat 4: saschak3 ($4.14 in chips) 
CashMatteo: posts small blind $0.02
saschak3: posts big blind $0.05
*** HOLE CARDS ***
Dealt to CashMatteo [3s 9s]
CashMatteo: folds 
Uncalled bet ($0.03) returned to saschak3
saschak3 collected $0.04 from pot
*** SUMMARY ***
Total pot $0.04 | Rake $0 
Seat 1: CashMatteo (button) (small blind) folded before Flop
Seat 4: saschak3 (big blind) collected ($0.04)

Hand #474: 

PokerStars Hand #246242642272:  Hold'em No Limit ($0.02/$0.05 CAD) - 2023/09/29 3:14:16 ET
Table 'Arneb II' 6-max Seat #4 is the button
Seat 1: CashMatteo ($8.36 in chips) 
Seat 4: saschak3 ($4.16 in chips) 
saschak3: posts small blind $0.02
CashMatteo: posts big blind $0.05
*** HOLE CARDS ***
Dealt to CashMatteo [Qc Ad]
saschak3: raises $0.05 to $0.10
CashMatteo: raises $0.05 to $0.15
saschak3: calls $0.05
*** FLOP *** [Jc Js 9h]
CashMatteo: bets $0.15
saschak3: raises $0.15 to $0.30
CashMatteo: folds 
Uncalled bet ($0.15) returned to saschak3
saschak3 collected $0.58 from pot
*** SUMMARY ***
Total pot $0.60 | Rake $0.02 
Board [Jc Js 9h]
Seat 1: CashMatteo (big blind) folded on the Flop
Seat 4: saschak3 (button) (small blind) collected ($0.58)

Hand #475: 

PokerStars Hand #246242644609:  Hold'em No Limit ($0.02/$0.05 CAD) - 2023/09/29 3:14:40 ET
Table 'Arneb II' 6-max Seat #1 is the button
Seat 1: CashMatteo ($8.06 in chips) 
Seat 4: saschak3 ($4.44 in chips) 
CashMatteo: posts small blind $0.02
saschak3: posts big blind $0.05
*** HOLE CARDS ***
Dealt to CashMatteo [7s Js]
CashMatteo: calls $0.03
saschak3: checks 
*** FLOP *** [Ks As 3c]
saschak3: checks 
CashMatteo: checks 
*** TURN *** [Ks As 3c] [Ah]
saschak3: checks 
CashMatteo: checks 
*** RIVER *** [Ks As 3c Ah] [9h]
saschak3: checks 
CashMatteo: checks 
*** SHOW DOWN ***
saschak3: shows [6s 7d] (a pair of Aces)
CashMatteo: shows [7s Js] (a pair of Aces - King+Jack kicker)
CashMatteo collected $0.10 from pot
*** SUMMARY ***
Total pot $0.10 | Rake $0 
Board [Ks As 3c Ah 9h]
Seat 1: CashMatteo (button) (small blind) showed [7s Js] and won ($0.10) with a pair of Aces
Seat 4: saschak3 (big blind) showed [6s 7d] and lost with a pair of Aces

Hand #476: 

PokerStars Hand #246242646182:  Hold'em No Limit ($0.02/$0.05 CAD) - 2023/09/29 3:14:56 ET
Table 'Arneb II' 6-max Seat #4 is the button
Seat 1: CashMatteo ($8.11 in chips) 
Seat 4: saschak3 ($4.39 in chips) 
saschak3: posts small blind $0.02
CashMatteo: posts big blind $0.05
*** HOLE CARDS ***
Dealt to CashMatteo [2d 7d]
saschak3: folds 
Uncalled bet ($0.03) returned to CashMatteo
CashMatteo collected $0.04 from pot
CashMatteo: doesn't show hand 
*** SUMMARY ***
Total pot $0.04 | Rake $0 
Seat 1: CashMatteo (big blind) collected ($0.04)
Seat 4: saschak3 (button) (small blind) folded before Flop

Hand #477: 

PokerStars Hand #246242646774:  Hold'em No Limit ($0.02/$0.05 CAD) - 2023/09/29 3:15:01 ET
Table 'Arneb II' 6-max Seat #1 is the button
Seat 1: CashMatteo ($8.13 in chips) 
Seat 4: saschak3 ($4.37 in chips) 
CashMatteo: posts small blind $0.02
saschak3: posts big blind $0.05
*** HOLE CARDS ***
Dealt to CashMatteo [Qc Ad]
CashMatteo: raises $0.10 to $0.15
saschak3: calls $0.10
*** FLOP *** [6s Ks Ts]
saschak3: checks 
CashMatteo: bets $0.15
saschak3: calls $0.15
*** TURN *** [6s Ks Ts] [2c]
saschak3: checks 
CashMatteo: bets $0.29
saschak3: raises $3.78 to $4.07 and is all-in
CashMatteo: folds 
Uncalled bet ($3.78) returned to saschak3
saschak3 collected $1.13 from pot
*** SUMMARY ***
Total pot $1.18 | Rake $0.05 
Board [6s Ks Ts 2c]
Seat 1: CashMatteo (button) (small blind) folded on the Turn
Seat 4: saschak3 (big blind) collected ($1.13)

Hand #478: 

PokerStars Hand #246242649976:  Hold'em No Limit ($0.02/$0.05 CAD) - 2023/09/29 3:15:32 ET
Table 'Arneb II' 6-max Seat #4 is the button
Seat 1: CashMatteo ($7.54 in chips) 
Seat 4: saschak3 ($4.91 in chips) 
saschak3: posts small blind $0.02
CashMatteo: posts big blind $0.05
*** HOLE CARDS ***
Dealt to CashMatteo [3d 8s]
saschak3: calls $0.03
CashMatteo: checks 
*** FLOP *** [Kd 3s 9h]
CashMatteo: bets $0.05
saschak3: calls $0.05
*** TURN *** [Kd 3s 9h] [Kh]
CashMatteo: checks 
saschak3: checks 
*** RIVER *** [Kd 3s 9h Kh] [Jc]
CashMatteo: checks 
saschak3: checks 
*** SHOW DOWN ***
CashMatteo: shows [3d 8s] (two pair, Kings and Threes)
saschak3: mucks hand 
CashMatteo collected $0.19 from pot
*** SUMMARY ***
Total pot $0.20 | Rake $0.01 
Board [Kd 3s 9h Kh Jc]
Seat 1: CashMatteo (big blind) showed [3d 8s] and won ($0.19) with two pair, Kings and Threes
Seat 4: saschak3 (button) (small blind) mucked [4d 6d]

Hand #479: 

PokerStars Hand #246242652032:  Hold'em No Limit ($0.02/$0.05 CAD) - 2023/09/29 3:15:53 ET
Table 'Arneb II' 6-max Seat #1 is the button
Seat 1: CashMatteo ($7.63 in chips) 
Seat 4: saschak3 ($4.81 in chips) 
CashMatteo: posts small blind $0.02
saschak3: posts big blind $0.05
*** HOLE CARDS ***
Dealt to CashMatteo [As 4s]
CashMatteo: raises $0.10 to $0.15
saschak3: calls $0.10
*** FLOP *** [Ah 4h 6d]
saschak3: checks 
CashMatteo: bets $0.15
saschak3: calls $0.15
*** TURN *** [Ah 4h 6d] [8h]
saschak3: checks 
CashMatteo: bets $0.58
saschak3: folds 
Uncalled bet ($0.58) returned to CashMatteo
CashMatteo collected $0.58 from pot
CashMatteo: doesn't show hand 
*** SUMMARY ***
Total pot $0.60 | Rake $0.02 
Board [Ah 4h 6d 8h]
Seat 1: CashMatteo (button) (small blind) collected ($0.58)
Seat 4: saschak3 (big blind) folded on the Turn

Hand #480: 

PokerStars Hand #246242654065:  Hold'em No Limit ($0.02/$0.05 CAD) - 2023/09/29 3:16:13 ET
Table 'Arneb II' 6-max Seat #4 is the button
Seat 1: CashMatteo ($7.91 in chips) 
Seat 4: saschak3 ($4.51 in chips) 
saschak3: posts small blind $0.02
CashMatteo: posts big blind $0.05
*** HOLE CARDS ***
Dealt to CashMatteo [Js 8s]
saschak3 is disconnected 
saschak3 has timed out while disconnected
saschak3: folds 
Uncalled bet ($0.03) returned to CashMatteo
CashMatteo collected $0.04 from pot
CashMatteo: doesn't show hand 
*** SUMMARY ***
Total pot $0.04 | Rake $0 
Seat 1: CashMatteo (big blind) collected ($0.04)
Seat 4: saschak3 (button) (small blind) folded before Flop

Hand #481: 

PokerStars Hand #246242684691:  Hold'em No Limit ($0.05/$0.10 CAD) - 2023/09/29 3:21:14 ET
Table 'Periphas III' 6-max Seat #4 is the button
Seat 4: ontheone ($12.94 in chips) 
Seat 5: CashMatteo ($5.10 in chips) 
ontheone: posts small blind $0.05
CashMatteo: posts big blind $0.10
*** HOLE CARDS ***
Dealt to CashMatteo [3c 5h]
ontheone: raises $0.20 to $0.30
CashMatteo: folds 
Uncalled bet ($0.20) returned to ontheone
ontheone collected $0.20 from pot
ontheone: doesn't show hand 
*** SUMMARY ***
Total pot $0.20 | Rake $0 
Seat 4: ontheone (button) (small blind) collected ($0.20)
Seat 5: CashMatteo (big blind) folded before Flop

Hand #482: 

PokerStars Hand #246242685635:  Hold'em No Limit ($0.05/$0.10 CAD) - 2023/09/29 3:21:24 ET
Table 'Periphas III' 6-max Seat #5 is the button
Seat 4: ontheone ($13.04 in chips) 
Seat 5: CashMatteo ($5 in chips) 
CashMatteo: posts small blind $0.05
ontheone: posts big blind $0.10
*** HOLE CARDS ***
Dealt to CashMatteo [Js Ad]
CashMatteo: raises $0.20 to $0.30
ontheone: folds 
Uncalled bet ($0.20) returned to CashMatteo
CashMatteo collected $0.20 from pot
CashMatteo: doesn't show hand 
*** SUMMARY ***
Total pot $0.20 | Rake $0 
Seat 4: ontheone (big blind) folded before Flop
Seat 5: CashMatteo (button) (small blind) collected ($0.20)

Hand #483: 

PokerStars Hand #246242686645:  Hold'em No Limit ($0.05/$0.10 CAD) - 2023/09/29 3:21:34 ET
Table 'Periphas III' 6-max Seat #4 is the button
Seat 4: ontheone ($12.94 in chips) 
Seat 5: CashMatteo ($5.10 in chips) 
ontheone: posts small blind $0.05
CashMatteo: posts big blind $0.10
*** HOLE CARDS ***
Dealt to CashMatteo [6d Jc]
ontheone: raises $0.20 to $0.30
CashMatteo: calls $0.20
*** FLOP *** [3s 6h Ac]
CashMatteo: checks 
ontheone: bets $0.30
CashMatteo: calls $0.30
*** TURN *** [3s 6h Ac] [Jh]
CashMatteo: checks 
ontheone: checks 
*** RIVER *** [3s 6h Ac Jh] [3c]
CashMatteo: checks 
ontheone: checks 
*** SHOW DOWN ***
CashMatteo: shows [6d Jc] (two pair, Jacks and Sixes)
ontheone: mucks hand 
CashMatteo collected $1.15 from pot
*** SUMMARY ***
Total pot $1.20 | Rake $0.05 
Board [3s 6h Ac Jh 3c]
Seat 4: ontheone (button) (small blind) mucked [7c 9h]
Seat 5: CashMatteo (big blind) showed [6d Jc] and won ($1.15) with two pair, Jacks and Sixes

Hand #484: 

PokerStars Hand #246242690184:  Hold'em No Limit ($0.05/$0.10 CAD) - 2023/09/29 3:22:09 ET
Table 'Periphas III' 6-max Seat #5 is the button
Seat 4: ontheone ($12.34 in chips) 
Seat 5: CashMatteo ($5.65 in chips) 
CashMatteo: posts small blind $0.05
ontheone: posts big blind $0.10
*** HOLE CARDS ***
Dealt to CashMatteo [Ks 3c]
CashMatteo: calls $0.05
ontheone: checks 
*** FLOP *** [Qc 8h 5d]
ontheone: checks 
CashMatteo: checks 
*** TURN *** [Qc 8h 5d] [9s]
ontheone: bets $0.10
CashMatteo: folds 
Uncalled bet ($0.10) returned to ontheone
ontheone collected $0.19 from pot
ontheone: doesn't show hand 
*** SUMMARY ***
Total pot $0.20 | Rake $0.01 
Board [Qc 8h 5d 9s]
Seat 4: ontheone (big blind) collected ($0.19)
Seat 5: CashMatteo (button) (small blind) folded on the Turn

Hand #485: 

PokerStars Hand #246242691839:  Hold'em No Limit ($0.05/$0.10 CAD) - 2023/09/29 3:22:24 ET
Table 'Periphas III' 6-max Seat #4 is the button
Seat 4: ontheone ($12.43 in chips) 
Seat 5: CashMatteo ($5.55 in chips) 
ontheone: posts small blind $0.05
CashMatteo: posts big blind $0.10
*** HOLE CARDS ***
Dealt to CashMatteo [9d Kh]
ontheone: raises $0.20 to $0.30
CashMatteo: calls $0.20
*** FLOP *** [8d 7c 2c]
CashMatteo: checks 
ontheone: bets $0.38
GFBJEH joins the table at seat #6 
CashMatteo: folds 
Uncalled bet ($0.38) returned to ontheone
ontheone collected $0.57 from pot
ontheone: doesn't show hand 
*** SUMMARY ***
Total pot $0.60 | Rake $0.03 
Board [8d 7c 2c]
Seat 4: ontheone (button) (small blind) collected ($0.57)
Seat 5: CashMatteo (big blind) folded on the Flop

Hand #486: 

PokerStars Hand #246242694198:  Hold'em No Limit ($0.05/$0.10 CAD) - 2023/09/29 3:22:48 ET
Table 'Periphas III' 6-max Seat #4 is the button
Seat 4: ontheone ($12.70 in chips) 
Seat 5: CashMatteo ($5.25 in chips) 
Seat 6: GFBJEH ($10 in chips) 
CashMatteo: posts small blind $0.05
GFBJEH: posts big blind $0.10
stevo420ca: sits out 
*** HOLE CARDS ***
Dealt to CashMatteo [Qd 5d]
ontheone: folds 
CashMatteo: calls $0.05
GFBJEH: checks 
*** FLOP *** [8d 8h Jh]
CashMatteo: bets $0.19
GFBJEH: calls $0.19
*** TURN *** [8d 8h Jh] [8s]
CashMatteo: checks 
GFBJEH: checks 
*** RIVER *** [8d 8h Jh 8s] [8c]
CashMatteo: checks 
GFBJEH: checks 
*** SHOW DOWN ***
CashMatteo: shows [Qd 5d] (four of a kind, Eights)
GFBJEH: mucks hand 
CashMatteo collected $0.55 from pot
*** SUMMARY ***
Total pot $0.58 | Rake $0.03 
Board [8d 8h Jh 8s 8c]
Seat 4: ontheone (button) folded before Flop (didn't bet)
Seat 5: CashMatteo (small blind) showed [Qd 5d] and won ($0.55) with four of a kind, Eights
Seat 6: GFBJEH (big blind) mucked [Js 7h]

Hand #487: 

PokerStars Hand #246242697148:  Hold'em No Limit ($0.05/$0.10 CAD) - 2023/09/29 3:23:17 ET
Table 'Periphas III' 6-max Seat #5 is the button
Seat 1: stevo420ca ($5.94 in chips) 
Seat 4: ontheone ($12.70 in chips) 
Seat 5: CashMatteo ($5.51 in chips) 
Seat 6: GFBJEH ($9.71 in chips) 
GFBJEH: posts small blind $0.05
stevo420ca: posts big blind $0.10
*** HOLE CARDS ***
Dealt to CashMatteo [7c 9c]
ontheone: folds 
CashMatteo: calls $0.10
GFBJEH: calls $0.05
stevo420ca: checks 
*** FLOP *** [4s Kd Qc]
GFBJEH: checks 
stevo420ca: checks 
CashMatteo: checks 
*** TURN *** [4s Kd Qc] [Jd]
GFBJEH: bets $0.29
stevo420ca: folds 
CashMatteo: folds 
Uncalled bet ($0.29) returned to GFBJEH
GFBJEH collected $0.29 from pot
*** SUMMARY ***
Total pot $0.30 | Rake $0.01 
Board [4s Kd Qc Jd]
Seat 1: stevo420ca (big blind) folded on the Turn
Seat 4: ontheone folded before Flop (didn't bet)
Seat 5: CashMatteo (button) folded on the Turn
Seat 6: GFBJEH (small blind) collected ($0.29)

Hand #488: 

PokerStars Hand #246242699329:  Hold'em No Limit ($0.05/$0.10 CAD) - 2023/09/29 3:23:39 ET
Table 'Periphas III' 6-max Seat #6 is the button
Seat 1: stevo420ca ($5.84 in chips) 
Seat 4: ontheone ($12.70 in chips) 
Seat 5: CashMatteo ($5.41 in chips) 
Seat 6: GFBJEH ($9.90 in chips) 
stevo420ca: posts small blind $0.05
ontheone: posts big blind $0.10
*** HOLE CARDS ***
Dealt to CashMatteo [9h 2d]
CashMatteo: folds 
GFBJEH: calls $0.10
stevo420ca: calls $0.05
ontheone: checks 
*** FLOP *** [Qc 4h Kd]
stevo420ca: checks 
ontheone: checks 
GFBJEH: bets $0.15
stevo420ca: folds 
ontheone: folds 
Uncalled bet ($0.15) returned to GFBJEH
GFBJEH collected $0.29 from pot
*** SUMMARY ***
Total pot $0.30 | Rake $0.01 
Board [Qc 4h Kd]
Seat 1: stevo420ca (small blind) folded on the Flop
Seat 4: ontheone (big blind) folded on the Flop
Seat 5: CashMatteo folded before Flop (didn't bet)
Seat 6: GFBJEH (button) collected ($0.29)

Hand #489: 

PokerStars Hand #246242703066:  Hold'em No Limit ($0.05/$0.10 CAD) - 2023/09/29 3:24:16 ET
Table 'Periphas III' 6-max Seat #1 is the button
Seat 1: stevo420ca ($5.74 in chips) 
Seat 4: ontheone ($12.60 in chips) 
Seat 5: CashMatteo ($5.41 in chips) 
Seat 6: GFBJEH ($10.09 in chips) 
ontheone: posts small blind $0.05
CashMatteo: posts big blind $0.10
*** HOLE CARDS ***
Dealt to CashMatteo [9s Qs]
GFBJEH: calls $0.10
stevo420ca: folds 
ontheone: calls $0.05
CashMatteo: raises $0.20 to $0.30
guap44 joins the table at seat #2 
GFBJEH: calls $0.20
TheKaKaMann joins the table at seat #3 
ontheone: folds 
*** FLOP *** [4c 7h 9h]
CashMatteo: bets $0.34
GFBJEH: calls $0.34
*** TURN *** [4c 7h 9h] [5c]
CashMatteo: checks 
GFBJEH: checks 
*** RIVER *** [4c 7h 9h 5c] [2s]
CashMatteo: bets $0.30
GFBJEH: calls $0.30
*** SHOW DOWN ***
CashMatteo: shows [9s Qs] (a pair of Nines)
GFBJEH: mucks hand 
CashMatteo collected $1.89 from pot
*** SUMMARY ***
Total pot $1.98 | Rake $0.09 
Board [4c 7h 9h 5c 2s]
Seat 1: stevo420ca (button) folded before Flop (didn't bet)
Seat 4: ontheone (small blind) folded before Flop
Seat 5: CashMatteo (big blind) showed [9s Qs] and won ($1.89) with a pair of Nines
Seat 6: GFBJEH mucked [8h 7s]

Hand #490: 

PokerStars Hand #246242708670:  Hold'em No Limit ($0.05/$0.10 CAD) - 2023/09/29 3:25:12 ET
Table 'Periphas III' 6-max Seat #4 is the button
Seat 1: stevo420ca ($5.74 in chips) 
Seat 2: guap44 ($9.33 in chips) 
Seat 4: ontheone ($12.50 in chips) 
Seat 5: CashMatteo ($6.36 in chips) 
Seat 6: GFBJEH ($9.15 in chips) 
CashMatteo: posts small blind $0.05
GFBJEH: posts big blind $0.10
guap44: posts big blind $0.10
TheKaKaMann: sits out 
*** HOLE CARDS ***
Dealt to CashMatteo [5s 7h]
stevo420ca: raises $0.12 to $0.22
guap44: calls $0.12
ontheone: folds 
CashMatteo: folds 
GFBJEH: raises $0.81 to $1.03
TheKaKaMann leaves the table
stevo420ca: folds 
guap44: folds 
Uncalled bet ($0.81) returned to GFBJEH
GFBJEH collected $0.71 from pot
*** SUMMARY ***
Total pot $0.71 | Rake $0 
Seat 1: stevo420ca folded before Flop
Seat 2: guap44 folded before Flop
Seat 4: ontheone (button) folded before Flop (didn't bet)
Seat 5: CashMatteo (small blind) folded before Flop
Seat 6: GFBJEH (big blind) collected ($0.71)

Hand #491: 

PokerStars Hand #246242711586:  Hold'em No Limit ($0.05/$0.10 CAD) - 2023/09/29 3:25:41 ET
Table 'Periphas III' 6-max Seat #5 is the button
Seat 1: stevo420ca ($5.52 in chips) 
Seat 2: guap44 ($9.11 in chips) 
Seat 4: ontheone ($12.50 in chips) 
Seat 5: CashMatteo ($6.31 in chips) 
Seat 6: GFBJEH ($9.64 in chips) 
GFBJEH: posts small blind $0.05
stevo420ca: posts big blind $0.10
*** HOLE CARDS ***
Dealt to CashMatteo [Qc 5h]
guap44: raises $0.10 to $0.20
ontheone: folds 
CashMatteo: folds 
GFBJEH: raises $0.10 to $0.30
stevo420ca: folds 
guap44: calls $0.10
*** FLOP *** [Jd Qs Qh]
GFBJEH: checks 
guap44: bets $0.34
GFBJEH: calls $0.34
*** TURN *** [Jd Qs Qh] [2c]
GFBJEH: checks 
guap44: checks 
*** RIVER *** [Jd Qs Qh 2c] [Kh]
GFBJEH: checks 
guap44: checks 
*** SHOW DOWN ***
GFBJEH: shows [Ks Tc] (two pair, Kings and Queens)
guap44: mucks hand 
GFBJEH collected $1.32 from pot
*** SUMMARY ***
Total pot $1.38 | Rake $0.06 
Board [Jd Qs Qh 2c Kh]
Seat 1: stevo420ca (big blind) folded before Flop
Seat 2: guap44 mucked [Ts 8s]
Seat 4: ontheone folded before Flop (didn't bet)
Seat 5: CashMatteo (button) folded before Flop (didn't bet)
Seat 6: GFBJEH (small blind) showed [Ks Tc] and won ($1.32) with two pair, Kings and Queens

Hand #492: 

PokerStars Hand #246242714366:  Hold'em No Limit ($0.05/$0.10 CAD) - 2023/09/29 3:26:08 ET
Table 'Periphas III' 6-max Seat #6 is the button
Seat 1: stevo420ca ($5.42 in chips) 
Seat 2: guap44 ($8.47 in chips) 
Seat 4: ontheone ($12.50 in chips) 
Seat 5: CashMatteo ($6.31 in chips) 
Seat 6: GFBJEH ($10.32 in chips) 
stevo420ca: posts small blind $0.05
guap44: posts big blind $0.10
*** HOLE CARDS ***
Dealt to CashMatteo [8s 4c]
ontheone: raises $0.20 to $0.30
CashMatteo: folds 
GFBJEH: folds 
stevo420ca: folds 
guap44: calls $0.20
*** FLOP *** [2d Qc Tc]
guap44: bets $0.31
ontheone: calls $0.31
*** TURN *** [2d Qc Tc] [4d]
guap44: checks 
ontheone: checks 
*** RIVER *** [2d Qc Tc 4d] [5c]
guap44: checks 
ontheone: checks 
*** SHOW DOWN ***
guap44: shows [Js Ah] (high card Ace)
ontheone: shows [Jh Ad] (high card Ace)
guap44 collected $0.61 from pot
ontheone collected $0.60 from pot
*** SUMMARY ***
Total pot $1.27 | Rake $0.06 
Board [2d Qc Tc 4d 5c]
Seat 1: stevo420ca (small blind) folded before Flop
Seat 2: guap44 (big blind) showed [Js Ah] and won ($0.61) with high card Ace
Seat 4: ontheone showed [Jh Ad] and won ($0.60) with high card Ace
Seat 5: CashMatteo folded before Flop (didn't bet)
Seat 6: GFBJEH (button) folded before Flop (didn't bet)

Hand #493: 

PokerStars Hand #246242716752:  Hold'em No Limit ($0.05/$0.10 CAD) - 2023/09/29 3:26:32 ET
Table 'Periphas III' 6-max Seat #1 is the button
Seat 1: stevo420ca ($5.37 in chips) 
Seat 2: guap44 ($8.47 in chips) 
Seat 4: ontheone ($12.49 in chips) 
Seat 5: CashMatteo ($6.31 in chips) 
Seat 6: GFBJEH ($10.32 in chips) 
guap44: posts small blind $0.05
ontheone: posts big blind $0.10
*** HOLE CARDS ***
Dealt to CashMatteo [2h 7s]
CashMatteo: calls $0.10
GFBJEH: folds 
stevo420ca: raises $0.12 to $0.22
guap44: calls $0.17
ontheone: calls $0.12
CashMatteo: folds 
*** FLOP *** [Qs 9h 3c]
guap44: checks 
ontheone: checks 
stevo420ca: bets $0.48
guap44: folds 
ontheone: folds 
Uncalled bet ($0.48) returned to stevo420ca
stevo420ca collected $0.73 from pot
stevo420ca: doesn't show hand 
*** SUMMARY ***
Total pot $0.76 | Rake $0.03 
Board [Qs 9h 3c]
Seat 1: stevo420ca (button) collected ($0.73)
Seat 2: guap44 (small blind) folded on the Flop
Seat 4: ontheone (big blind) folded on the Flop
Seat 5: CashMatteo folded before Flop
Seat 6: GFBJEH folded before Flop (didn't bet)

Hand #494: 

PokerStars Hand #246242720024:  Hold'em No Limit ($0.05/$0.10 CAD) - 2023/09/29 3:27:04 ET
Table 'Periphas III' 6-max Seat #2 is the button
Seat 1: stevo420ca ($5.88 in chips) 
Seat 2: guap44 ($8.25 in chips) 
Seat 4: ontheone ($12.27 in chips) 
Seat 5: CashMatteo ($6.21 in chips) 
Seat 6: GFBJEH ($10.32 in chips) 
ontheone: posts small blind $0.05
CashMatteo: posts big blind $0.10
*** HOLE CARDS ***
Dealt to CashMatteo [9c Qc]
GFBJEH: raises $0.10 to $0.20
stevo420ca: folds 
guap44: folds 
ontheone: raises $0.50 to $0.70
CashMatteo: calls $0.60
GFBJEH: calls $0.50
*** FLOP *** [2c 8h 7h]
ontheone: checks 
CashMatteo: checks 
GFBJEH: bets $1.11
ontheone: calls $1.11
CashMatteo: calls $1.11
*** TURN *** [2c 8h 7h] [Kc]
ontheone: checks 
CashMatteo: checks 
GFBJEH: checks 
*** RIVER *** [2c 8h 7h Kc] [Ks]
ontheone: bets $3.48
CashMatteo: folds 
GFBJEH: calls $3.48
*** SHOW DOWN ***
ontheone: shows [Qd Ad] (a pair of Kings)
GFBJEH: shows [Qh 8c] (two pair, Kings and Eights)
GFBJEH collected $11.83 from pot
*** SUMMARY ***
Total pot $12.39 | Rake $0.56 
Board [2c 8h 7h Kc Ks]
Seat 1: stevo420ca folded before Flop (didn't bet)
Seat 2: guap44 (button) folded before Flop (didn't bet)
Seat 4: ontheone (small blind) showed [Qd Ad] and lost with a pair of Kings
Seat 5: CashMatteo (big blind) folded on the River
Seat 6: GFBJEH showed [Qh 8c] and won ($11.83) with two pair, Kings and Eights

Hand #495: 

PokerStars Hand #246242725004:  Hold'em No Limit ($0.05/$0.10 CAD) - 2023/09/29 3:27:52 ET
Table 'Periphas III' 6-max Seat #4 is the button
Seat 1: stevo420ca ($5.88 in chips) 
Seat 2: guap44 ($8.25 in chips) 
Seat 4: ontheone ($6.98 in chips) 
Seat 5: CashMatteo ($4.40 in chips) 
Seat 6: GFBJEH ($16.86 in chips) 
CashMatteo: posts small blind $0.05
GFBJEH: posts big blind $0.10
*** HOLE CARDS ***
Dealt to CashMatteo [Ac 2h]
stevo420ca: folds 
guap44: folds 
ontheone said, "oh"
ontheone: folds 
CashMatteo: calls $0.05
GFBJEH: raises $0.40 to $0.50
CashMatteo: calls $0.40
*** FLOP *** [Qc 4h 2s]
CashMatteo: checks 
GFBJEH: checks 
*** TURN *** [Qc 4h 2s] [3c]
CashMatteo: bets $0.48
GFBJEH: calls $0.48
*** RIVER *** [Qc 4h 2s 3c] [4c]
CashMatteo: checks 
GFBJEH: checks 
*** SHOW DOWN ***
CashMatteo: shows [Ac 2h] (two pair, Fours and Deuces)
GFBJEH: mucks hand 
CashMatteo collected $1.87 from pot
*** SUMMARY ***
Total pot $1.96 | Rake $0.09 
Board [Qc 4h 2s 3c 4c]
Seat 1: stevo420ca folded before Flop (didn't bet)
Seat 2: guap44 folded before Flop (didn't bet)
Seat 4: ontheone (button) folded before Flop (didn't bet)
Seat 5: CashMatteo (small blind) showed [Ac 2h] and won ($1.87) with two pair, Fours and Deuces
Seat 6: GFBJEH (big blind) mucked [As 9d]

Hand #496: 

PokerStars Hand #246242729145:  Hold'em No Limit ($0.05/$0.10 CAD) - 2023/09/29 3:28:34 ET
Table 'Periphas III' 6-max Seat #5 is the button
Seat 1: stevo420ca ($5.88 in chips) 
Seat 2: guap44 ($8.25 in chips) 
Seat 4: ontheone ($10 in chips) 
Seat 5: CashMatteo ($5.29 in chips) 
Seat 6: GFBJEH ($15.88 in chips) 
GFBJEH: posts small blind $0.05
stevo420ca: posts big blind $0.10
*** HOLE CARDS ***
Dealt to CashMatteo [2d 6d]
guap44: calls $0.10
ontheone: folds 
CashMatteo: folds 
GFBJEH: raises $0.30 to $0.40
stevo420ca: folds 
guap44: calls $0.30
*** FLOP *** [Qc 9d Kc]
GFBJEH: bets $0.43
guap44: folds 
Uncalled bet ($0.43) returned to GFBJEH
GFBJEH collected $0.86 from pot
*** SUMMARY ***
Total pot $0.90 | Rake $0.04 
Board [Qc 9d Kc]
Seat 1: stevo420ca (big blind) folded before Flop
Seat 2: guap44 folded on the Flop
Seat 4: ontheone folded before Flop (didn't bet)
Seat 5: CashMatteo (button) folded before Flop (didn't bet)
Seat 6: GFBJEH (small blind) collected ($0.86)

Hand #497: 

PokerStars Hand #246242731095:  Hold'em No Limit ($0.05/$0.10 CAD) - 2023/09/29 3:28:52 ET
Table 'Periphas III' 6-max Seat #6 is the button
Seat 1: stevo420ca ($5.78 in chips) 
Seat 2: guap44 ($7.85 in chips) 
Seat 4: ontheone ($10 in chips) 
Seat 5: CashMatteo ($5.29 in chips) 
Seat 6: GFBJEH ($16.34 in chips) 
stevo420ca: posts small blind $0.05
guap44: posts big blind $0.10
*** HOLE CARDS ***
Dealt to CashMatteo [Js 8s]
ontheone has timed out
ontheone: folds 
CashMatteo: calls $0.10
GFBJEH: raises $0.10 to $0.20
stevo420ca: folds 
guap44: folds 
CashMatteo: calls $0.10
*** FLOP *** [Qd Ac Jd]
CashMatteo: checks 
GFBJEH: checks 
*** TURN *** [Qd Ac Jd] [6s]
CashMatteo: checks 
GFBJEH: checks 
*** RIVER *** [Qd Ac Jd 6s] [Qh]
CashMatteo: checks 
GFBJEH: checks 
*** SHOW DOWN ***
CashMatteo: shows [Js 8s] (two pair, Queens and Jacks)
GFBJEH: mucks hand 
CashMatteo collected $0.53 from pot
*** SUMMARY ***
Total pot $0.55 | Rake $0.02 
Board [Qd Ac Jd 6s Qh]
Seat 1: stevo420ca (small blind) folded before Flop
Seat 2: guap44 (big blind) folded before Flop
Seat 4: ontheone folded before Flop (didn't bet)
Seat 5: CashMatteo showed [Js 8s] and won ($0.53) with two pair, Queens and Jacks
Seat 6: GFBJEH (button) mucked [Kc 9s]

Hand #498: 

PokerStars Hand #246242734949:  Hold'em No Limit ($0.05/$0.10 CAD) - 2023/09/29 3:29:30 ET
Table 'Periphas III' 6-max Seat #1 is the button
Seat 1: stevo420ca ($5.73 in chips) 
Seat 2: guap44 ($7.75 in chips) 
Seat 4: ontheone ($10 in chips) 
Seat 5: CashMatteo ($5.62 in chips) 
Seat 6: GFBJEH ($16.14 in chips) 
guap44: posts small blind $0.05
ontheone: posts big blind $0.10
*** HOLE CARDS ***
Dealt to CashMatteo [Qc As]
CashMatteo: raises $0.20 to $0.30
GFBJEH: raises $15.84 to $16.14 and is all-in
stevo420ca: folds 
guap44: folds 
ontheone: folds 
CashMatteo: calls $5.32 and is all-in
Uncalled bet ($10.52) returned to GFBJEH
*** FLOP *** [Jc 5h 8s]
*** TURN *** [Jc 5h 8s] [Qs]
*** RIVER *** [Jc 5h 8s Qs] [8c]
*** SHOW DOWN ***
CashMatteo: shows [Qc As] (two pair, Queens and Eights)
GFBJEH: shows [Kd Ac] (a pair of Eights)
CashMatteo collected $10.88 from pot
*** SUMMARY ***
Total pot $11.39 | Rake $0.51 
Board [Jc 5h 8s Qs 8c]
Seat 1: stevo420ca (button) folded before Flop (didn't bet)
Seat 2: guap44 (small blind) folded before Flop
Seat 4: ontheone (big blind) folded before Flop
Seat 5: CashMatteo showed [Qc As] and won ($10.88) with two pair, Queens and Eights
Seat 6: GFBJEH showed [Kd Ac] and lost with a pair of Eights

Hand #499: 

PokerStars Hand #246242737804:  Hold'em No Limit ($0.05/$0.10 CAD) - 2023/09/29 3:29:58 ET
Table 'Periphas III' 6-max Seat #2 is the button
Seat 1: stevo420ca ($5.73 in chips) 
Seat 2: guap44 ($7.70 in chips) 
Seat 4: ontheone ($9.90 in chips) 
Seat 5: CashMatteo ($10.88 in chips) 
Seat 6: GFBJEH ($10.52 in chips) 
ontheone: posts small blind $0.05
CashMatteo: posts big blind $0.10
*** HOLE CARDS ***
Dealt to CashMatteo [Qh 9h]
GFBJEH: raises $0.10 to $0.20
stevo420ca: folds 
guap44: calls $0.20
ontheone: folds 
GFBJEH said, "Moron"
CashMatteo: calls $0.10
*** FLOP *** [6c Ad Jd]
CashMatteo: checks 
GFBJEH: bets $0.62
guap44: calls $0.62
CashMatteo: folds 
*** TURN *** [6c Ad Jd] [Ks]
GFBJEH: checks 
guap44: bets $1.80
GFBJEH: calls $1.80
*** RIVER *** [6c Ad Jd Ks] [Jh]
GFBJEH: checks 
guap44: checks 
*** SHOW DOWN ***
GFBJEH: shows [8d Td] (a pair of Jacks)
guap44: shows [6h Ac] (two pair, Aces and Jacks)
guap44 collected $5.24 from pot
*** SUMMARY ***
Total pot $5.49 | Rake $0.25 
Board [6c Ad Jd Ks Jh]
Seat 1: stevo420ca folded before Flop (didn't bet)
Seat 2: guap44 (button) showed [6h Ac] and won ($5.24) with two pair, Aces and Jacks
Seat 4: ontheone (small blind) folded before Flop
Seat 5: CashMatteo (big blind) folded on the Flop
Seat 6: GFBJEH showed [8d Td] and lost with a pair of Jacks

Hand #500: 

PokerStars Hand #246242743881:  Hold'em No Limit ($0.05/$0.10 CAD) - 2023/09/29 3:30:56 ET
Table 'Periphas III' 6-max Seat #4 is the button
Seat 1: stevo420ca ($5.73 in chips) 
Seat 2: guap44 ($10.32 in chips) 
Seat 4: ontheone ($9.85 in chips) 
Seat 5: CashMatteo ($10.68 in chips) 
Seat 6: GFBJEH ($7.90 in chips) 
CashMatteo: posts small blind $0.05
GFBJEH: posts big blind $0.10
*** HOLE CARDS ***
Dealt to CashMatteo [5s 7c]
stevo420ca: folds 
guap44: folds 
ontheone: folds 
CashMatteo: folds 
Uncalled bet ($0.05) returned to GFBJEH
GFBJEH collected $0.10 from pot
*** SUMMARY ***
Total pot $0.10 | Rake $0 
Seat 1: stevo420ca folded before Flop (didn't bet)
Seat 2: guap44 folded before Flop (didn't bet)
Seat 4: ontheone (button) folded before Flop (didn't bet)
Seat 5: CashMatteo (small blind) folded before Flop
Seat 6: GFBJEH (big blind) collected ($0.10)

Hand #501: 

PokerStars Hand #246242744885:  Hold'em No Limit ($0.05/$0.10 CAD) - 2023/09/29 3:31:06 ET
Table 'Periphas III' 6-max Seat #5 is the button
Seat 1: stevo420ca ($5.73 in chips) 
Seat 2: guap44 ($10.32 in chips) 
Seat 4: ontheone ($9.85 in chips) 
Seat 5: CashMatteo ($10.63 in chips) 
Seat 6: GFBJEH ($7.95 in chips) 
GFBJEH: posts small blind $0.05
stevo420ca: posts big blind $0.10
*** HOLE CARDS ***
Dealt to CashMatteo [Qs 7h]
guap44: folds 
ontheone: folds 
CashMatteo: folds 
GFBJEH: raises $0.40 to $0.50
stevo420ca: folds 
Uncalled bet ($0.40) returned to GFBJEH
GFBJEH collected $0.20 from pot
*** SUMMARY ***
Total pot $0.20 | Rake $0 
Seat 1: stevo420ca (big blind) folded before Flop
Seat 2: guap44 folded before Flop (didn't bet)
Seat 4: ontheone folded before Flop (didn't bet)
Seat 5: CashMatteo (button) folded before Flop (didn't bet)
Seat 6: GFBJEH (small blind) collected ($0.20)

Hand #502: 

PokerStars Hand #246242746760:  Hold'em No Limit ($0.05/$0.10 CAD) - 2023/09/29 3:31:23 ET
Table 'Periphas III' 6-max Seat #6 is the button
Seat 1: stevo420ca ($5.63 in chips) 
Seat 2: guap44 ($10.32 in chips) 
Seat 4: ontheone ($9.85 in chips) 
Seat 5: CashMatteo ($10.63 in chips) 
Seat 6: GFBJEH ($8.05 in chips) 
stevo420ca: posts small blind $0.05
guap44: posts big blind $0.10
*** HOLE CARDS ***
Dealt to CashMatteo [3d Ac]
ontheone: folds 
CashMatteo: calls $0.10
GFBJEH: folds 
stevo420ca: calls $0.05
guap44: checks 
*** FLOP *** [As 2s 9c]
stevo420ca: checks 
guap44: bets $0.15
CashMatteo: calls $0.15
stevo420ca: folds 
*** TURN *** [As 2s 9c] [Kd]
guap44: checks 
CashMatteo: bets $0.29
guap44: folds 
Uncalled bet ($0.29) returned to CashMatteo
CashMatteo collected $0.57 from pot
CashMatteo: doesn't show hand 
*** SUMMARY ***
Total pot $0.60 | Rake $0.03 
Board [As 2s 9c Kd]
Seat 1: stevo420ca (small blind) folded on the Flop
Seat 2: guap44 (big blind) folded on the Turn
Seat 4: ontheone folded before Flop (didn't bet)
Seat 5: CashMatteo collected ($0.57)
Seat 6: GFBJEH (button) folded before Flop (didn't bet)

Hand #503: 

PokerStars Hand #246242750763:  Hold'em No Limit ($0.05/$0.10 CAD) - 2023/09/29 3:32:02 ET
Table 'Periphas III' 6-max Seat #1 is the button
Seat 1: stevo420ca ($5.53 in chips) 
Seat 2: guap44 ($10.07 in chips) 
Seat 4: ontheone ($9.85 in chips) 
Seat 5: CashMatteo ($10.95 in chips) 
Seat 6: GFBJEH ($8.05 in chips) 
guap44: posts small blind $0.05
ontheone: posts big blind $0.10
*** HOLE CARDS ***
Dealt to CashMatteo [8c 9s]
CashMatteo: calls $0.10
GFBJEH: raises $0.35 to $0.45
stevo420ca: folds 
guap44: folds 
ontheone: folds 
CashMatteo: folds 
Uncalled bet ($0.35) returned to GFBJEH
GFBJEH collected $0.35 from pot
*** SUMMARY ***
Total pot $0.35 | Rake $0 
Seat 1: stevo420ca (button) folded before Flop (didn't bet)
Seat 2: guap44 (small blind) folded before Flop
Seat 4: ontheone (big blind) folded before Flop
Seat 5: CashMatteo folded before Flop
Seat 6: GFBJEH collected ($0.35)

Hand #504: 

PokerStars Hand #246242752285:  Hold'em No Limit ($0.05/$0.10 CAD) - 2023/09/29 3:32:16 ET
Table 'Periphas III' 6-max Seat #2 is the button
Seat 1: stevo420ca ($5.53 in chips) 
Seat 2: guap44 ($10.02 in chips) 
Seat 4: ontheone ($9.75 in chips) 
Seat 5: CashMatteo ($10.85 in chips) 
Seat 6: GFBJEH ($8.30 in chips) 
ontheone: posts small blind $0.05
CashMatteo: posts big blind $0.10
*** HOLE CARDS ***
Dealt to CashMatteo [2c 6d]
GFBJEH: raises $0.65 to $0.75
stevo420ca: folds 
guap44: folds 
ontheone: folds 
CashMatteo: folds 
Uncalled bet ($0.65) returned to GFBJEH
GFBJEH collected $0.25 from pot
*** SUMMARY ***
Total pot $0.25 | Rake $0 
Seat 1: stevo420ca folded before Flop (didn't bet)
Seat 2: guap44 (button) folded before Flop (didn't bet)
Seat 4: ontheone (small blind) folded before Flop
Seat 5: CashMatteo (big blind) folded before Flop
Seat 6: GFBJEH collected ($0.25)

Hand #505: 

PokerStars Hand #246242753613:  Hold'em No Limit ($0.05/$0.10 CAD) - 2023/09/29 3:32:29 ET
Table 'Periphas III' 6-max Seat #4 is the button
Seat 1: stevo420ca ($5.53 in chips) 
Seat 2: guap44 ($10.02 in chips) 
Seat 4: ontheone ($9.70 in chips) 
Seat 5: CashMatteo ($10.75 in chips) 
Seat 6: GFBJEH ($8.45 in chips) 
CashMatteo: posts small blind $0.05
GFBJEH: posts big blind $0.10
*** HOLE CARDS ***
Dealt to CashMatteo [Js Jd]
stevo420ca: folds 
guap44: folds 
ontheone: folds 
CashMatteo: calls $0.05
GFBJEH: checks 
*** FLOP *** [3s 4c 7s]
CashMatteo: checks 
GFBJEH: checks 
*** TURN *** [3s 4c 7s] [Ac]
CashMatteo: checks 
GFBJEH: checks 
*** RIVER *** [3s 4c 7s Ac] [4d]
CashMatteo: bets $0.19
GFBJEH: folds 
Uncalled bet ($0.19) returned to CashMatteo
CashMatteo collected $0.19 from pot
CashMatteo: doesn't show hand 
*** SUMMARY ***
Total pot $0.20 | Rake $0.01 
Board [3s 4c 7s Ac 4d]
Seat 1: stevo420ca folded before Flop (didn't bet)
Seat 2: guap44 folded before Flop (didn't bet)
Seat 4: ontheone (button) folded before Flop (didn't bet)
Seat 5: CashMatteo (small blind) collected ($0.19)
Seat 6: GFBJEH (big blind) folded on the River

Hand #506: 

PokerStars Hand #246242756834:  Hold'em No Limit ($0.05/$0.10 CAD) - 2023/09/29 3:33:00 ET
Table 'Periphas III' 6-max Seat #5 is the button
Seat 1: stevo420ca ($5.53 in chips) 
Seat 2: guap44 ($10.02 in chips) 
Seat 4: ontheone ($9.70 in chips) 
Seat 5: CashMatteo ($10.84 in chips) 
Seat 6: GFBJEH ($8.35 in chips) 
GFBJEH: posts small blind $0.05
stevo420ca: posts big blind $0.10
*** HOLE CARDS ***
Dealt to CashMatteo [Jd 2h]
guap44: folds 
ontheone: folds 
CashMatteo: calls $0.10
GFBJEH: calls $0.05
stevo420ca: raises $0.40 to $0.50
AzlerOne272 joins the table at seat #3 
CashMatteo: folds 
GFBJEH: calls $0.40
*** FLOP *** [9c 8c 2s]
GFBJEH: checks 
stevo420ca: bets $0.69
GFBJEH: folds 
Uncalled bet ($0.69) returned to stevo420ca
stevo420ca collected $1.05 from pot
stevo420ca: doesn't show hand 
*** SUMMARY ***
Total pot $1.10 | Rake $0.05 
Board [9c 8c 2s]
Seat 1: stevo420ca (big blind) collected ($1.05)
Seat 2: guap44 folded before Flop (didn't bet)
Seat 4: ontheone folded before Flop (didn't bet)
Seat 5: CashMatteo (button) folded before Flop
Seat 6: GFBJEH (small blind) folded on the Flop

Hand #507: 

PokerStars Hand #246242760828:  Hold'em No Limit ($0.05/$0.10 CAD) - 2023/09/29 3:33:38 ET
Table 'Periphas III' 6-max Seat #6 is the button
Seat 1: stevo420ca ($6.08 in chips) 
Seat 2: guap44 ($10.02 in chips) 
Seat 4: ontheone ($9.70 in chips) 
Seat 5: CashMatteo ($10.74 in chips) 
Seat 6: GFBJEH ($7.85 in chips) 
stevo420ca: posts small blind $0.05
guap44: posts big blind $0.10
AzlerOne272: sits out 
*** HOLE CARDS ***
Dealt to CashMatteo [Qh 9d]
ontheone: folds 
CashMatteo: calls $0.10
GFBJEH: raises $7.75 to $7.85 and is all-in
stevo420ca: folds 
guap44: folds 
CashMatteo: folds 
Uncalled bet ($7.75) returned to GFBJEH
GFBJEH collected $0.35 from pot
*** SUMMARY ***
Total pot $0.35 | Rake $0 
Seat 1: stevo420ca (small blind) folded before Flop
Seat 2: guap44 (big blind) folded before Flop
Seat 4: ontheone folded before Flop (didn't bet)
Seat 5: CashMatteo folded before Flop
Seat 6: GFBJEH (button) collected ($0.35)

Hand #508: 

PokerStars Hand #246242762793:  Hold'em No Limit ($0.05/$0.10 CAD) - 2023/09/29 3:33:58 ET
Table 'Periphas III' 6-max Seat #1 is the button
Seat 1: stevo420ca ($6.03 in chips) 
Seat 2: guap44 ($9.92 in chips) 
Seat 3: AzlerOne272 ($8 in chips) 
Seat 4: ontheone ($9.70 in chips) 
Seat 5: CashMatteo ($10.64 in chips) 
Seat 6: GFBJEH ($8.10 in chips) 
guap44: posts small blind $0.05
AzlerOne272: posts big blind $0.10
*** HOLE CARDS ***
Dealt to CashMatteo [3h Qd]
ontheone: folds 
CashMatteo: calls $0.10
GFBJEH: folds 
stevo420ca: calls $0.10
guap44: calls $0.05
AzlerOne272: raises $0.10 to $0.20
CashMatteo: calls $0.10
stevo420ca: calls $0.10
guap44: calls $0.10
*** FLOP *** [3s 5d 4d]
guap44: bets $0.38
AzlerOne272: calls $0.38
CashMatteo: folds 
stevo420ca: folds 
*** TURN *** [3s 5d 4d] [4s]
guap44: checks 
AzlerOne272: bets $7.42 and is all-in
guap44: folds 
Uncalled bet ($7.42) returned to AzlerOne272
AzlerOne272 collected $1.49 from pot
*** SUMMARY ***
Total pot $1.56 | Rake $0.07 
Board [3s 5d 4d 4s]
Seat 1: stevo420ca (button) folded on the Flop
Seat 2: guap44 (small blind) folded on the Turn
Seat 3: AzlerOne272 (big blind) collected ($1.49)
Seat 4: ontheone folded before Flop (didn't bet)
Seat 5: CashMatteo folded on the Flop
Seat 6: GFBJEH folded before Flop (didn't bet)

Hand #509: 

PokerStars Hand #246242766639:  Hold'em No Limit ($0.05/$0.10 CAD) - 2023/09/29 3:34:36 ET
Table 'Periphas III' 6-max Seat #2 is the button
Seat 1: stevo420ca ($5.83 in chips) 
Seat 2: guap44 ($9.34 in chips) 
Seat 3: AzlerOne272 ($8.91 in chips) 
Seat 4: ontheone ($9.70 in chips) 
Seat 5: CashMatteo ($10.44 in chips) 
Seat 6: GFBJEH ($8.10 in chips) 
AzlerOne272: posts small blind $0.05
ontheone: posts big blind $0.10
*** HOLE CARDS ***
Dealt to CashMatteo [4s Ad]
CashMatteo: calls $0.10
GFBJEH: folds 
stevo420ca: raises $0.30 to $0.40
guap44: folds 
AzlerOne272: calls $0.35
ontheone: folds 
CashMatteo: calls $0.30
*** FLOP *** [8s 3d 8h]
AzlerOne272: checks 
CashMatteo: checks 
stevo420ca: bets $0.82
AzlerOne272: calls $0.82
CashMatteo: folds 
*** TURN *** [8s 3d 8h] [3h]
AzlerOne272: checks 
stevo420ca: bets $4.61 and is all-in
AzlerOne272: calls $4.61
*** RIVER *** [8s 3d 8h 3h] [9c]
*** SHOW DOWN ***
AzlerOne272: shows [Kh 6h] (two pair, Eights and Threes)
stevo420ca: shows [Qs Qh] (two pair, Queens and Eights)
stevo420ca collected $11.61 from pot
*** SUMMARY ***
Total pot $12.16 | Rake $0.55 
Board [8s 3d 8h 3h 9c]
Seat 1: stevo420ca showed [Qs Qh] and won ($11.61) with two pair, Queens and Eights
Seat 2: guap44 (button) folded before Flop (didn't bet)
Seat 3: AzlerOne272 (small blind) showed [Kh 6h] and lost with two pair, Eights and Threes
Seat 4: ontheone (big blind) folded before Flop
Seat 5: CashMatteo folded on the Flop
Seat 6: GFBJEH folded before Flop (didn't bet)

Hand #510: 

PokerStars Hand #246242771132:  Hold'em No Limit ($0.05/$0.10 CAD) - 2023/09/29 3:35:20 ET
Table 'Periphas III' 6-max Seat #3 is the button
Seat 1: stevo420ca ($11.61 in chips) 
Seat 2: guap44 ($9.34 in chips) 
Seat 3: AzlerOne272 ($3.08 in chips) 
Seat 4: ontheone ($9.60 in chips) 
Seat 5: CashMatteo ($10.04 in chips) 
Seat 6: GFBJEH ($8.10 in chips) 
ontheone: posts small blind $0.05
CashMatteo: posts big blind $0.10
*** HOLE CARDS ***
Dealt to CashMatteo [7d 4c]
GFBJEH: folds 
stevo420ca: folds 
guap44: folds 
AzlerOne272: calls $0.10
GFBJEH leaves the table
ontheone: calls $0.05
CashMatteo: checks 
*** FLOP *** [5s 2h Ts]
ontheone: checks 
CashMatteo: checks 
AzlerOne272: checks 
*** TURN *** [5s 2h Ts] [2s]
ontheone: checks 
CashMatteo: checks 
AzlerOne272: checks 
*** RIVER *** [5s 2h Ts 2s] [7s]
ontheone: checks 
CashMatteo: checks 
AzlerOne272: checks 
*** SHOW DOWN ***
ontheone: shows [9h Jh] (a pair of Deuces)
CashMatteo: shows [7d 4c] (two pair, Sevens and Deuces)
AzlerOne272: mucks hand 
CashMatteo collected $0.29 from pot
*** SUMMARY ***
Total pot $0.30 | Rake $0.01 
Board [5s 2h Ts 2s 7s]
Seat 1: stevo420ca folded before Flop (didn't bet)
Seat 2: guap44 folded before Flop (didn't bet)
Seat 3: AzlerOne272 (button) mucked [8c 3c]
Seat 4: ontheone (small blind) showed [9h Jh] and lost with a pair of Deuces
Seat 5: CashMatteo (big blind) showed [7d 4c] and won ($0.29) with two pair, Sevens and Deuces
Seat 6: GFBJEH folded before Flop (didn't bet)

Hand #511: 

PokerStars Hand #246242775302:  Hold'em No Limit ($0.05/$0.10 CAD) - 2023/09/29 3:36:01 ET
Table 'Periphas III' 6-max Seat #4 is the button
Seat 1: stevo420ca ($11.61 in chips) 
Seat 2: guap44 ($9.34 in chips) 
Seat 3: AzlerOne272 ($2.98 in chips) 
Seat 4: ontheone ($9.50 in chips) 
Seat 5: CashMatteo ($10.23 in chips) 
CashMatteo: posts small blind $0.05
stevo420ca: posts big blind $0.10
*** HOLE CARDS ***
Dealt to CashMatteo [8s Kd]
TheDoctor7778 joins the table at seat #6 
guap44: folds 
AzlerOne272: calls $0.10
ontheone: folds 
CashMatteo: calls $0.05
stevo420ca: checks 
*** FLOP *** [9c Td 9d]
CashMatteo: checks 
stevo420ca: checks 
AzlerOne272: bets $0.10
CashMatteo: calls $0.10
stevo420ca: folds 
*** TURN *** [9c Td 9d] [6s]
CashMatteo: checks 
AzlerOne272: bets $2.78 and is all-in
CashMatteo: folds 
Uncalled bet ($2.78) returned to AzlerOne272
AzlerOne272 collected $0.48 from pot
*** SUMMARY ***
Total pot $0.50 | Rake $0.02 
Board [9c Td 9d 6s]
Seat 1: stevo420ca (big blind) folded on the Flop
Seat 2: guap44 folded before Flop (didn't bet)
Seat 3: AzlerOne272 collected ($0.48)
Seat 4: ontheone (button) folded before Flop (didn't bet)
Seat 5: CashMatteo (small blind) folded on the Turn

Hand #512: 

PokerStars Hand #246242778605:  Hold'em No Limit ($0.05/$0.10 CAD) - 2023/09/29 3:36:33 ET
Table 'Periphas III' 6-max Seat #5 is the button
Seat 1: stevo420ca ($11.51 in chips) 
Seat 2: guap44 ($9.34 in chips) 
Seat 3: AzlerOne272 ($3.26 in chips) 
Seat 4: ontheone ($9.50 in chips) 
Seat 5: CashMatteo ($10.03 in chips) 
TheDoctor7778 will be allowed to play after the button
stevo420ca: posts small blind $0.05
guap44: posts big blind $0.10
*** HOLE CARDS ***
Dealt to CashMatteo [7d Ks]
AzlerOne272: calls $0.10
ontheone: folds 
CashMatteo: calls $0.10
stevo420ca: calls $0.05
guap44: raises $0.10 to $0.20
AzlerOne272: calls $0.10
CashMatteo: calls $0.10
stevo420ca: calls $0.10
*** FLOP *** [Jc 2d Qh]
stevo420ca: checks 
guap44: bets $0.38
AzlerOne272: folds 
CashMatteo: folds 
stevo420ca: folds 
Uncalled bet ($0.38) returned to guap44
AzlerOne272 leaves the table
guap44 collected $0.76 from pot
*** SUMMARY ***
Total pot $0.80 | Rake $0.04 
Board [Jc 2d Qh]
Seat 1: stevo420ca (small blind) folded on the Flop
Seat 2: guap44 (big blind) collected ($0.76)
Seat 3: AzlerOne272 folded on the Flop
Seat 4: ontheone folded before Flop (didn't bet)
Seat 5: CashMatteo (button) folded on the Flop

Hand #513: 

PokerStars Hand #246242781292:  Hold'em No Limit ($0.05/$0.10 CAD) - 2023/09/29 3:37:00 ET
Table 'Periphas III' 6-max Seat #1 is the button
Seat 1: stevo420ca ($11.31 in chips) 
Seat 2: guap44 ($9.90 in chips) 
Seat 4: ontheone ($9.50 in chips) 
Seat 5: CashMatteo ($9.83 in chips) 
Seat 6: TheDoctor7778 ($4 in chips) 
guap44: posts small blind $0.05
ontheone: posts big blind $0.10
TheDoctor7778: posts big blind $0.10
*** HOLE CARDS ***
Dealt to CashMatteo [3h Jd]
CashMatteo: calls $0.10
TheDoctor7778: checks 
stevo420ca: raises $0.12 to $0.22
guap44: folds 
ontheone: calls $0.12
CashMatteo: calls $0.12
TheDoctor7778: raises $0.38 to $0.60
stevo420ca: calls $0.38
ontheone: calls $0.38
CashMatteo: folds 
*** FLOP *** [Js Qs 6h]
ontheone: checks 
TheDoctor7778: checks 
stevo420ca: checks 
*** TURN *** [Js Qs 6h] [Jh]
ontheone: checks 
TheDoctor7778: bets $0.95
stevo420ca: folds 
ontheone: folds 
Uncalled bet ($0.95) returned to TheDoctor7778
TheDoctor7778 collected $1.98 from pot
TheDoctor7778: doesn't show hand 
*** SUMMARY ***
Total pot $2.07 | Rake $0.09 
Board [Js Qs 6h Jh]
Seat 1: stevo420ca (button) folded on the Turn
Seat 2: guap44 (small blind) folded before Flop
Seat 4: ontheone (big blind) folded on the Turn
Seat 5: CashMatteo folded before Flop
Seat 6: TheDoctor7778 collected ($1.98)

Hand #514: 

PokerStars Hand #246242789146:  Hold'em No Limit ($0.05/$0.10 CAD) - 2023/09/29 3:38:16 ET
Table 'Periphas III' 6-max Seat #2 is the button
Seat 1: stevo420ca ($10.71 in chips) 
Seat 2: guap44 ($9.85 in chips) 
Seat 4: ontheone ($8.90 in chips) 
Seat 5: CashMatteo ($9.61 in chips) 
Seat 6: TheDoctor7778 ($5.38 in chips) 
ontheone: posts small blind $0.05
CashMatteo: posts big blind $0.10
*** HOLE CARDS ***
Dealt to CashMatteo [5s 6s]
TheDoctor7778: raises $0.15 to $0.25
stevo420ca: folds 
Derrrr6 joins the table at seat #3 
guap44: folds 
ontheone: calls $0.20
CashMatteo: calls $0.15
*** FLOP *** [5c 4d 6d]
ontheone: checks 
CashMatteo: bets $0.36
TheDoctor7778: raises $0.36 to $0.72
ontheone: folds 
CashMatteo: raises $2.16 to $2.88
TheDoctor7778: calls $2.16
*** TURN *** [5c 4d 6d] [5d]
CashMatteo: checks 
TheDoctor7778: checks 
*** RIVER *** [5c 4d 6d 5d] [Qs]
CashMatteo: bets $2.50
TheDoctor7778: folds 
Uncalled bet ($2.50) returned to CashMatteo
CashMatteo collected $6.22 from pot
CashMatteo: doesn't show hand 
*** SUMMARY ***
Total pot $6.51 | Rake $0.29 
Board [5c 4d 6d 5d Qs]
Seat 1: stevo420ca folded before Flop (didn't bet)
Seat 2: guap44 (button) folded before Flop (didn't bet)
Seat 4: ontheone (small blind) folded on the Flop
Seat 5: CashMatteo (big blind) collected ($6.22)
Seat 6: TheDoctor7778 folded on the River

Hand #515: 

PokerStars Hand #246242796227:  Hold'em No Limit ($0.05/$0.10 CAD) - 2023/09/29 3:39:25 ET
Table 'Periphas III' 6-max Seat #4 is the button
Seat 1: stevo420ca ($10.71 in chips) 
Seat 2: guap44 ($9.85 in chips) 
Seat 4: ontheone ($8.65 in chips) 
Seat 5: CashMatteo ($12.70 in chips) 
Seat 6: TheDoctor7778 ($2.25 in chips) 
CashMatteo: posts small blind $0.05
TheDoctor7778: posts big blind $0.10
Derrrr6: sits out 
*** HOLE CARDS ***
Dealt to CashMatteo [7h 2h]
stevo420ca: calls $0.10
guap44: calls $0.10
ontheone: raises $0.30 to $0.40
CashMatteo: folds 
TheDoctor7778: folds 
stevo420ca: folds 
guap44: calls $0.30
*** FLOP *** [3s 7c 6d]
guap44: checks 
ontheone: bets $0.67
guap44: folds 
Uncalled bet ($0.67) returned to ontheone
ontheone collected $1 from pot
ontheone: doesn't show hand 
*** SUMMARY ***
Total pot $1.05 | Rake $0.05 
Board [3s 7c 6d]
Seat 1: stevo420ca folded before Flop
Seat 2: guap44 folded on the Flop
Seat 4: ontheone (button) collected ($1)
Seat 5: CashMatteo (small blind) folded before Flop
Seat 6: TheDoctor7778 (big blind) folded before Flop

Hand #516: 

PokerStars Hand #246242799397:  Hold'em No Limit ($0.05/$0.10 CAD) - 2023/09/29 3:39:55 ET
Table 'Periphas III' 6-max Seat #5 is the button
Seat 1: stevo420ca ($10.61 in chips) 
Seat 2: guap44 ($9.45 in chips) 
Seat 4: ontheone ($9.25 in chips) 
Seat 5: CashMatteo ($12.65 in chips) 
Seat 6: TheDoctor7778 ($2.15 in chips) 
TheDoctor7778: posts small blind $0.05
stevo420ca: posts big blind $0.10
Derrrr6: sits out 
*** HOLE CARDS ***
Dealt to CashMatteo [Qs 3c]
guap44: folds 
ontheone: folds 
CashMatteo: calls $0.10
TheDoctor7778: calls $0.05
stevo420ca: checks 
*** FLOP *** [8c 4c 4d]
TheDoctor7778: checks 
stevo420ca: checks 
CashMatteo: checks 
*** TURN *** [8c 4c 4d] [Ts]
TheDoctor7778: checks 
stevo420ca: bets $0.19
CashMatteo: folds 
TheDoctor7778: folds 
Uncalled bet ($0.19) returned to stevo420ca
stevo420ca collected $0.29 from pot
stevo420ca: doesn't show hand 
*** SUMMARY ***
Total pot $0.30 | Rake $0.01 
Board [8c 4c 4d Ts]
Seat 1: stevo420ca (big blind) collected ($0.29)
Seat 2: guap44 folded before Flop (didn't bet)
Seat 4: ontheone folded before Flop (didn't bet)
Seat 5: CashMatteo (button) folded on the Turn
Seat 6: TheDoctor7778 (small blind) folded on the Turn

Hand #517: 

PokerStars Hand #246242802603:  Hold'em No Limit ($0.05/$0.10 CAD) - 2023/09/29 3:40:26 ET
Table 'Periphas III' 6-max Seat #6 is the button
Seat 1: stevo420ca ($10.80 in chips) 
Seat 2: guap44 ($9.45 in chips) 
Seat 4: ontheone ($9.25 in chips) 
Seat 5: CashMatteo ($12.55 in chips) 
Seat 6: TheDoctor7778 ($2.05 in chips) 
stevo420ca: posts small blind $0.05
guap44: posts big blind $0.10
Derrrr6: sits out 
*** HOLE CARDS ***
Dealt to CashMatteo [5c 6s]
ontheone: folds 
CashMatteo: folds 
ontheone leaves the table
TheDoctor7778: raises $0.15 to $0.25
stevo420ca: folds 
guap44: folds 
Uncalled bet ($0.15) returned to TheDoctor7778
TheDoctor7778 collected $0.25 from pot
TheDoctor7778: doesn't show hand 
*** SUMMARY ***
Total pot $0.25 | Rake $0 
Seat 1: stevo420ca (small blind) folded before Flop
Seat 2: guap44 (big blind) folded before Flop
Seat 4: ontheone folded before Flop (didn't bet)
Seat 5: CashMatteo folded before Flop (didn't bet)
Seat 6: TheDoctor7778 (button) collected ($0.25)

Hand #518: 

PokerStars Hand #246242804304:  Hold'em No Limit ($0.05/$0.10 CAD) - 2023/09/29 3:40:41 ET
Table 'Periphas III' 6-max Seat #1 is the button
Seat 1: stevo420ca ($10.75 in chips) 
Seat 2: guap44 ($9.35 in chips) 
Seat 3: Derrrr6 ($6.74 in chips) 
Seat 5: CashMatteo ($12.55 in chips) 
Seat 6: TheDoctor7778 ($2.20 in chips) 
guap44: posts small blind $0.05
Derrrr6: posts big blind $0.10
*** HOLE CARDS ***
Dealt to CashMatteo [Td 6h]
CashMatteo: folds 
TheDoctor7778: raises $0.20 to $0.30
stevo420ca: folds 
guap44: calls $0.25
Derrrr6: folds 
*** FLOP *** [6d Jh Kc]
guap44: checks 
TheDoctor7778: checks 
*** TURN *** [6d Jh Kc] [Qc]
guap44: checks 
TheDoctor7778: bets $0.31
guap44: calls $0.31
*** RIVER *** [6d Jh Kc Qc] [2d]
guap44: bets $0.63
TheDoctor7778: raises $0.63 to $1.26
guap44: folds 
Uncalled bet ($0.63) returned to TheDoctor7778
TheDoctor7778 collected $2.46 from pot
TheDoctor7778: doesn't show hand 
*** SUMMARY ***
Total pot $2.58 | Rake $0.12 
Board [6d Jh Kc Qc 2d]
Seat 1: stevo420ca (button) folded before Flop (didn't bet)
Seat 2: guap44 (small blind) folded on the River
Seat 3: Derrrr6 (big blind) folded before Flop
Seat 5: CashMatteo folded before Flop (didn't bet)
Seat 6: TheDoctor7778 collected ($2.46)

Hand #519: 

PokerStars Hand #246242810636:  Hold'em No Limit ($0.05/$0.10 CAD) - 2023/09/29 3:41:43 ET
Table 'Periphas III' 6-max Seat #2 is the button
Seat 1: stevo420ca ($10.75 in chips) 
Seat 2: guap44 ($8.11 in chips) 
Seat 3: Derrrr6 ($6.64 in chips) 
Seat 5: CashMatteo ($12.55 in chips) 
Seat 6: TheDoctor7778 ($3.42 in chips) 
Derrrr6: posts small blind $0.05
CashMatteo: posts big blind $0.10
*** HOLE CARDS ***
Dealt to CashMatteo [4s 8d]
TheDoctor7778: folds 
stevo420ca: folds 
guap44: calls $0.10
Derrrr6: folds 
CashMatteo: checks 
*** FLOP *** [3d As Jd]
CashMatteo: checks 
guap44: checks 
*** TURN *** [3d As Jd] [Tc]
CashMatteo: checks 
guap44: checks 
*** RIVER *** [3d As Jd Tc] [7h]
CashMatteo: checks 
guap44: bets $0.24
CashMatteo: folds 
Uncalled bet ($0.24) returned to guap44
guap44 collected $0.24 from pot
*** SUMMARY ***
Total pot $0.25 | Rake $0.01 
Board [3d As Jd Tc 7h]
Seat 1: stevo420ca folded before Flop (didn't bet)
Seat 2: guap44 (button) collected ($0.24)
Seat 3: Derrrr6 (small blind) folded before Flop
Seat 5: CashMatteo (big blind) folded on the River
Seat 6: TheDoctor7778 folded before Flop (didn't bet)

Hand #520: 

PokerStars Hand #246242813202:  Hold'em No Limit ($0.05/$0.10 CAD) - 2023/09/29 3:42:08 ET
Table 'Periphas III' 6-max Seat #3 is the button
Seat 1: stevo420ca ($10.75 in chips) 
Seat 2: guap44 ($8.25 in chips) 
Seat 3: Derrrr6 ($6.59 in chips) 
Seat 5: CashMatteo ($12.45 in chips) 
Seat 6: TheDoctor7778 ($3.42 in chips) 
CashMatteo: posts small blind $0.05
TheDoctor7778: posts big blind $0.10
*** HOLE CARDS ***
Dealt to CashMatteo [6d 6c]
stevo420ca: folds 
guap44: calls $0.10
Derrrr6: folds 
CashMatteo: raises $0.10 to $0.20
TheDoctor7778: raises $0.10 to $0.30
guap44: raises $0.80 to $1.10
CashMatteo: calls $0.90
TheDoctor7778: folds 
*** FLOP *** [4h Ac 2h]
CashMatteo: checks 
guap44: checks 
*** TURN *** [4h Ac 2h] [2d]
CashMatteo: checks 
guap44: bets $1.20
CashMatteo: folds 
Uncalled bet ($1.20) returned to guap44
guap44 collected $2.39 from pot
*** SUMMARY ***
Total pot $2.50 | Rake $0.11 
Board [4h Ac 2h 2d]
Seat 1: stevo420ca folded before Flop (didn't bet)
Seat 2: guap44 collected ($2.39)
Seat 3: Derrrr6 (button) folded before Flop (didn't bet)
Seat 5: CashMatteo (small blind) folded on the Turn
Seat 6: TheDoctor7778 (big blind) folded before Flop

Hand #521: 

PokerStars Hand #246242820141:  Hold'em No Limit ($0.05/$0.10 CAD) - 2023/09/29 3:43:16 ET
Table 'Periphas III' 6-max Seat #5 is the button
Seat 1: stevo420ca ($10.75 in chips) 
Seat 2: guap44 ($9.54 in chips) 
Seat 3: Derrrr6 ($6.59 in chips) 
Seat 5: CashMatteo ($11.35 in chips) 
Seat 6: TheDoctor7778 ($3.12 in chips) 
TheDoctor7778: posts small blind $0.05
stevo420ca: posts big blind $0.10
*** HOLE CARDS ***
Dealt to CashMatteo [7c As]
guap44: raises $0.25 to $0.35
Derrrr6: folds 
CashMatteo: calls $0.35
TheDoctor7778: raises $0.35 to $0.70
stevo420ca: folds 
guap44: calls $0.35
CashMatteo: calls $0.35
*** FLOP *** [Kh Qd 6s]
TheDoctor7778: bets $0.43
guap44: calls $0.43
Zorba1978 joins the table at seat #4 
CashMatteo: calls $0.43
*** TURN *** [Kh Qd 6s] [4c]
TheDoctor7778: bets $0.50
guap44: raises $2 to $2.50
CashMatteo: folds 
TheDoctor7778: calls $1.49 and is all-in
Uncalled bet ($0.51) returned to guap44
*** RIVER *** [Kh Qd 6s 4c] [Kc]
*** SHOW DOWN ***
TheDoctor7778: shows [Ks Ad] (three of a kind, Kings)
guap44: shows [Ac Jh] (a pair of Kings)
TheDoctor7778 collected $7.13 from pot
*** SUMMARY ***
Total pot $7.47 | Rake $0.34 
Board [Kh Qd 6s 4c Kc]
Seat 1: stevo420ca (big blind) folded before Flop
Seat 2: guap44 showed [Ac Jh] and lost with a pair of Kings
Seat 3: Derrrr6 folded before Flop (didn't bet)
Seat 5: CashMatteo (button) folded on the Turn
Seat 6: TheDoctor7778 (small blind) showed [Ks Ad] and won ($7.13) with three of a kind, Kings

Hand #522: 

PokerStars Hand #246242827233:  Hold'em No Limit ($0.05/$0.10 CAD) - 2023/09/29 3:44:24 ET
Table 'Periphas III' 6-max Seat #6 is the button
Seat 1: stevo420ca ($10.65 in chips) 
Seat 2: guap44 ($6.42 in chips) 
Seat 3: Derrrr6 ($8.59 in chips) 
Seat 5: CashMatteo ($10.22 in chips) 
Seat 6: TheDoctor7778 ($7.13 in chips) 
stevo420ca: posts small blind $0.05
guap44: posts big blind $0.10
Zorba1978: sits out 
*** HOLE CARDS ***
Dealt to CashMatteo [8h 3s]
Derrrr6: raises $0.20 to $0.30
CashMatteo: folds 
TheDoctor7778: folds 
stevo420ca: folds 
guap44: folds 
Uncalled bet ($0.20) returned to Derrrr6
Derrrr6 collected $0.25 from pot
Derrrr6: doesn't show hand 
*** SUMMARY ***
Total pot $0.25 | Rake $0 
Seat 1: stevo420ca (small blind) folded before Flop
Seat 2: guap44 (big blind) folded before Flop
Seat 3: Derrrr6 collected ($0.25)
Seat 5: CashMatteo folded before Flop (didn't bet)
Seat 6: TheDoctor7778 (button) folded before Flop (didn't bet)

Hand #523: 

PokerStars Hand #246242828606:  Hold'em No Limit ($0.05/$0.10 CAD) - 2023/09/29 3:44:38 ET
Table 'Periphas III' 6-max Seat #1 is the button
Seat 1: stevo420ca ($10.60 in chips) 
Seat 2: guap44 ($6.32 in chips) 
Seat 3: Derrrr6 ($8.74 in chips) 
Seat 5: CashMatteo ($10.22 in chips) 
Seat 6: TheDoctor7778 ($7.13 in chips) 
guap44: posts small blind $0.05
Derrrr6: posts big blind $0.10
Zorba1978: sits out 
*** HOLE CARDS ***
Dealt to CashMatteo [4h Th]
CashMatteo: folds 
TheDoctor7778: folds 
stevo420ca: folds 
guap44: raises $6.22 to $6.32 and is all-in
Derrrr6: folds 
Uncalled bet ($6.22) returned to guap44
guap44 collected $0.20 from pot
*** SUMMARY ***
Total pot $0.20 | Rake $0 
Seat 1: stevo420ca (button) folded before Flop (didn't bet)
Seat 2: guap44 (small blind) collected ($0.20)
Seat 3: Derrrr6 (big blind) folded before Flop
Seat 5: CashMatteo folded before Flop (didn't bet)
Seat 6: TheDoctor7778 folded before Flop (didn't bet)

Hand #524: 

PokerStars Hand #246242829999:  Hold'em No Limit ($0.05/$0.10 CAD) - 2023/09/29 3:44:51 ET
Table 'Periphas III' 6-max Seat #2 is the button
Seat 1: stevo420ca ($10.60 in chips) 
Seat 2: guap44 ($6.42 in chips) 
Seat 3: Derrrr6 ($8.64 in chips) 
Seat 4: Zorba1978 ($8 in chips) 
Seat 5: CashMatteo ($10.22 in chips) 
Seat 6: TheDoctor7778 ($7.13 in chips) 
Derrrr6: posts small blind $0.05
Zorba1978: posts big blind $0.10
*** HOLE CARDS ***
Dealt to CashMatteo [8h 2d]
CashMatteo: folds 
TheDoctor7778: folds 
stevo420ca: folds 
guap44: raises $6.32 to $6.42 and is all-in
Derrrr6: folds 
Zorba1978: folds 
Uncalled bet ($6.32) returned to guap44
guap44 collected $0.25 from pot
guap44: shows [6d 6h] (a pair of Sixes)
*** SUMMARY ***
Total pot $0.25 | Rake $0 
Seat 1: stevo420ca folded before Flop (didn't bet)
Seat 2: guap44 (button) collected ($0.25)
Seat 3: Derrrr6 (small blind) folded before Flop
Seat 4: Zorba1978 (big blind) folded before Flop
Seat 5: CashMatteo folded before Flop (didn't bet)
Seat 6: TheDoctor7778 folded before Flop (didn't bet)

Hand #525: 

PokerStars Hand #246242834630:  Hold'em No Limit ($0.05/$0.10 CAD) - 2023/09/29 3:45:36 ET
Table 'Periphas III' 6-max Seat #3 is the button
Seat 1: stevo420ca ($10.60 in chips) 
Seat 2: guap44 ($6.57 in chips) 
Seat 3: Derrrr6 ($8.59 in chips) 
Seat 4: Zorba1978 ($7.90 in chips) 
Seat 5: CashMatteo ($10.22 in chips) 
Seat 6: TheDoctor7778 ($7.13 in chips) 
Zorba1978: posts small blind $0.05
CashMatteo: posts big blind $0.10
*** HOLE CARDS ***
Dealt to CashMatteo [Kc 8d]
TheDoctor7778: raises $0.20 to $0.30
stevo420ca: folds 
guap44: calls $0.30
Derrrr6: calls $0.30
Zorba1978: folds 
CashMatteo: calls $0.20
*** FLOP *** [7h 6h 7c]
CashMatteo: checks 
TheDoctor7778: bets $0.30
guap44: folds 
Derrrr6: calls $0.30
CashMatteo: folds 
*** TURN *** [7h 6h 7c] [4s]
TheDoctor7778: bets $0.78
Derrrr6: calls $0.78
*** RIVER *** [7h 6h 7c 4s] [6d]
TheDoctor7778: bets $3.26
Derrrr6: folds 
Uncalled bet ($3.26) returned to TheDoctor7778
TheDoctor7778 collected $3.26 from pot
TheDoctor7778: doesn't show hand 
*** SUMMARY ***
Total pot $3.41 | Rake $0.15 
Board [7h 6h 7c 4s 6d]
Seat 1: stevo420ca folded before Flop (didn't bet)
Seat 2: guap44 folded on the Flop
Seat 3: Derrrr6 (button) folded on the River
Seat 4: Zorba1978 (small blind) folded before Flop
Seat 5: CashMatteo (big blind) folded on the Flop
Seat 6: TheDoctor7778 collected ($3.26)

Hand #526: 

PokerStars Hand #246242842191:  Hold'em No Limit ($0.05/$0.10 CAD) - 2023/09/29 3:46:48 ET
Table 'Periphas III' 6-max Seat #4 is the button
Seat 1: stevo420ca ($10.60 in chips) 
Seat 2: guap44 ($6.27 in chips) 
Seat 3: Derrrr6 ($7.21 in chips) 
Seat 4: Zorba1978 ($7.85 in chips) 
Seat 5: CashMatteo ($9.92 in chips) 
Seat 6: TheDoctor7778 ($9.01 in chips) 
CashMatteo: posts small blind $0.05
TheDoctor7778: posts big blind $0.10
*** HOLE CARDS ***
Dealt to CashMatteo [8s 9c]
stevo420ca: folds 
guap44: folds 
Derrrr6 has timed out
Derrrr6: folds 
Zorba1978: raises $0.10 to $0.20
CashMatteo: calls $0.15
TheDoctor7778: raises $0.20 to $0.40
Zorba1978: raises $0.80 to $1.20
CashMatteo: folds 
TheDoctor7778: raises $1.20 to $2.40
Zorba1978: raises $5.45 to $7.85 and is all-in
Zorba1978 said, "KK"
TheDoctor7778: folds 
Uncalled bet ($5.45) returned to Zorba1978
Zorba1978 collected $5 from pot
*** SUMMARY ***
Total pot $5 | Rake $0 
Seat 1: stevo420ca folded before Flop (didn't bet)
Seat 2: guap44 folded before Flop (didn't bet)
Seat 3: Derrrr6 folded before Flop (didn't bet)
Seat 4: Zorba1978 (button) collected ($5)
Seat 5: CashMatteo (small blind) folded before Flop
Seat 6: TheDoctor7778 (big blind) folded before Flop

Hand #527: 

PokerStars Hand #246242849635:  Hold'em No Limit ($0.05/$0.10 CAD) - 2023/09/29 3:47:59 ET
Table 'Periphas III' 6-max Seat #5 is the button
Seat 1: stevo420ca ($10.60 in chips) 
Seat 2: guap44 ($6.27 in chips) 
Seat 3: Derrrr6 ($7.21 in chips) 
Seat 4: Zorba1978 ($10.45 in chips) 
Seat 5: CashMatteo ($9.72 in chips) 
Seat 6: TheDoctor7778 ($6.61 in chips) 
TheDoctor7778: posts small blind $0.05
stevo420ca: posts big blind $0.10
*** HOLE CARDS ***
Dealt to CashMatteo [4d Ks]
TheDoctor7778 said, "AQ"
guap44: folds 
Derrrr6: folds 
Zorba1978: folds 
CashMatteo: folds 
TheDoctor7778: calls $0.05
stevo420ca: raises $0.22 to $0.32
TheDoctor7778: folds 
Uncalled bet ($0.22) returned to stevo420ca
stevo420ca collected $0.20 from pot
stevo420ca: doesn't show hand 
*** SUMMARY ***
Total pot $0.20 | Rake $0 
Seat 1: stevo420ca (big blind) collected ($0.20)
Seat 2: guap44 folded before Flop (didn't bet)
Seat 3: Derrrr6 folded before Flop (didn't bet)
Seat 4: Zorba1978 folded before Flop (didn't bet)
Seat 5: CashMatteo (button) folded before Flop (didn't bet)
Seat 6: TheDoctor7778 (small blind) folded before Flop

Hand #528: 

PokerStars Hand #246242851765:  Hold'em No Limit ($0.05/$0.10 CAD) - 2023/09/29 3:48:20 ET
Table 'Periphas III' 6-max Seat #6 is the button
Seat 1: stevo420ca ($10.70 in chips) 
Seat 2: guap44 ($6.27 in chips) 
Seat 3: Derrrr6 ($7.21 in chips) 
Seat 4: Zorba1978 ($10.45 in chips) 
Seat 5: CashMatteo ($9.72 in chips) 
Seat 6: TheDoctor7778 ($6.51 in chips) 
stevo420ca: posts small blind $0.05
guap44: posts big blind $0.10
*** HOLE CARDS ***
Dealt to CashMatteo [6h 7s]
Derrrr6: calls $0.10
Zorba1978: folds 
CashMatteo: calls $0.10
TheDoctor7778: raises $0.15 to $0.25
stevo420ca: folds 
guap44: calls $0.15
Derrrr6: calls $0.15
CashMatteo: calls $0.15
*** FLOP *** [7c 8d 8c]
guap44: checks 
Derrrr6: checks 
CashMatteo: checks 
TheDoctor7778: checks 
*** TURN *** [7c 8d 8c] [9s]
guap44: checks 
Derrrr6: checks 
CashMatteo: checks 
TheDoctor7778: checks 
*** RIVER *** [7c 8d 8c 9s] [5h]
guap44: checks 
Derrrr6: bets $0.50
CashMatteo: calls $0.50
TheDoctor7778: folds 
guap44: folds 
*** SHOW DOWN ***
Derrrr6: shows [6s Ad] (a straight, Five to Nine)
CashMatteo: shows [6h 7s] (a straight, Five to Nine)
Derrrr6 collected $0.98 from pot
CashMatteo collected $0.98 from pot
*** SUMMARY ***
Total pot $2.05 | Rake $0.09 
Board [7c 8d 8c 9s 5h]
Seat 1: stevo420ca (small blind) folded before Flop
Seat 2: guap44 (big blind) folded on the River
Seat 3: Derrrr6 showed [6s Ad] and won ($0.98) with a straight, Five to Nine
Seat 4: Zorba1978 folded before Flop (didn't bet)
Seat 5: CashMatteo showed [6h 7s] and won ($0.98) with a straight, Five to Nine
Seat 6: TheDoctor7778 (button) folded on the River

Hand #529: 

PokerStars Hand #246242859478:  Hold'em No Limit ($0.05/$0.10 CAD) - 2023/09/29 3:49:33 ET
Table 'Periphas III' 6-max Seat #1 is the button
Seat 1: stevo420ca ($10.65 in chips) 
Seat 2: guap44 ($6.02 in chips) 
Seat 3: Derrrr6 ($7.44 in chips) 
Seat 4: Zorba1978 ($10.45 in chips) 
Seat 5: CashMatteo ($9.95 in chips) 
Seat 6: TheDoctor7778 ($6.26 in chips) 
guap44: posts small blind $0.05
Derrrr6: posts big blind $0.10
*** HOLE CARDS ***
Dealt to CashMatteo [Ac As]
Zorba1978: raises $0.14 to $0.24
CashMatteo: raises $0.34 to $0.58
TheDoctor7778: folds 
stevo420ca: folds 
guap44: folds 
Derrrr6: folds 
Derrrr6 is disconnected 
Zorba1978: calls $0.34
*** FLOP *** [3h 7h 6d]
Zorba1978: checks 
CashMatteo: checks 
*** TURN *** [3h 7h 6d] [Tc]
Zorba1978: bets $0.63
CashMatteo: calls $0.63
*** RIVER *** [3h 7h 6d Tc] [Ks]
Zorba1978: checks 
CashMatteo: bets $1.23
Zorba1978: calls $1.23
*** SHOW DOWN ***
CashMatteo: shows [Ac As] (a pair of Aces)
Zorba1978: mucks hand 
CashMatteo collected $4.80 from pot
*** SUMMARY ***
Total pot $5.03 | Rake $0.23 
Board [3h 7h 6d Tc Ks]
Seat 1: stevo420ca (button) folded before Flop (didn't bet)
Seat 2: guap44 (small blind) folded before Flop
Seat 3: Derrrr6 (big blind) folded before Flop
Seat 4: Zorba1978 mucked [9h 9c]
Seat 5: CashMatteo showed [Ac As] and won ($4.80) with a pair of Aces
Seat 6: TheDoctor7778 folded before Flop (didn't bet)

Hand #530: 

PokerStars Hand #246242867180:  Hold'em No Limit ($0.05/$0.10 CAD) - 2023/09/29 3:50:46 ET
Table 'Periphas III' 6-max Seat #2 is the button
Seat 1: stevo420ca ($10.65 in chips) 
Seat 2: guap44 ($5.97 in chips) 
Seat 4: Zorba1978 ($8.01 in chips) 
Seat 5: CashMatteo ($12.31 in chips) 
Seat 6: TheDoctor7778 ($6.26 in chips) 
Zorba1978: posts small blind $0.05
CashMatteo: posts big blind $0.10
*** HOLE CARDS ***
Dealt to CashMatteo [5h Qh]
TheDoctor7778: raises $0.15 to $0.25
stevo420ca: folds 
guap44: folds 
Zorba1978: folds 
CashMatteo: calls $0.15
*** FLOP *** [2c Jc Kh]
CashMatteo: checks 
TheDoctor7778: bets $0.28
CashMatteo: folds 
Uncalled bet ($0.28) returned to TheDoctor7778
TheDoctor7778 collected $0.53 from pot
TheDoctor7778: doesn't show hand 
*** SUMMARY ***
Total pot $0.55 | Rake $0.02 
Board [2c Jc Kh]
Seat 1: stevo420ca folded before Flop (didn't bet)
Seat 2: guap44 (button) folded before Flop (didn't bet)
Seat 4: Zorba1978 (small blind) folded before Flop
Seat 5: CashMatteo (big blind) folded on the Flop
Seat 6: TheDoctor7778 collected ($0.53)

Hand #531: 

PokerStars Hand #246242872358:  Hold'em No Limit ($0.05/$0.10 CAD) - 2023/09/29 3:51:35 ET
Table 'Periphas III' 6-max Seat #4 is the button
Seat 1: stevo420ca ($10.65 in chips) 
Seat 2: guap44 ($5.97 in chips) 
Seat 4: Zorba1978 ($7.96 in chips) 
Seat 5: CashMatteo ($12.06 in chips) 
Seat 6: TheDoctor7778 ($6.54 in chips) 
CashMatteo: posts small blind $0.05
TheDoctor7778: posts big blind $0.10
*** HOLE CARDS ***
Dealt to CashMatteo [Th 6c]
stevo420ca: folds 
guap44: raises $0.10 to $0.20
Zorba1978: folds 
CashMatteo: folds 
TheDoctor7778: calls $0.10
*** FLOP *** [Ac 4s 6s]
TheDoctor7778: bets $0.12
guap44: folds 
Uncalled bet ($0.12) returned to TheDoctor7778
TheDoctor7778 collected $0.43 from pot
TheDoctor7778: doesn't show hand 
*** SUMMARY ***
Total pot $0.45 | Rake $0.02 
Board [Ac 4s 6s]
Seat 1: stevo420ca folded before Flop (didn't bet)
Seat 2: guap44 folded on the Flop
Seat 4: Zorba1978 (button) folded before Flop (didn't bet)
Seat 5: CashMatteo (small blind) folded before Flop
Seat 6: TheDoctor7778 (big blind) collected ($0.43)

Hand #532: 

PokerStars Hand #246242876027:  Hold'em No Limit ($0.05/$0.10 CAD) - 2023/09/29 3:52:10 ET
Table 'Periphas III' 6-max Seat #5 is the button
Seat 1: stevo420ca ($10.65 in chips) 
Seat 2: guap44 ($5.77 in chips) 
Seat 4: Zorba1978 ($7.96 in chips) 
Seat 5: CashMatteo ($12.01 in chips) 
Seat 6: TheDoctor7778 ($6.77 in chips) 
TheDoctor7778: posts small blind $0.05
stevo420ca: posts big blind $0.10
*** HOLE CARDS ***
Dealt to CashMatteo [3d 5s]
guap44: folds 
Zorba1978: folds 
CashMatteo: folds 
TheDoctor7778: calls $0.05
stevo420ca: raises $0.22 to $0.32
TheDoctor7778: calls $0.22
*** FLOP *** [Td Qc Jd]
TheDoctor7778: checks 
stevo420ca: bets $0.40
TheDoctor7778: raises $0.40 to $0.80
stevo420ca: calls $0.40
*** TURN *** [Td Qc Jd] [3c]
TheDoctor7778: bets $1.07
stevo420ca: calls $1.07
*** RIVER *** [Td Qc Jd 3c] [As]
TheDoctor7778: checks 
stevo420ca: bets $8.46 and is all-in
TheDoctor7778 said, "gay "
TheDoctor7778: folds 
Uncalled bet ($8.46) returned to stevo420ca
stevo420ca collected $4.18 from pot
stevo420ca: doesn't show hand 
*** SUMMARY ***
Total pot $4.38 | Rake $0.20 
Board [Td Qc Jd 3c As]
Seat 1: stevo420ca (big blind) collected ($4.18)
Seat 2: guap44 folded before Flop (didn't bet)
Seat 4: Zorba1978 folded before Flop (didn't bet)
Seat 5: CashMatteo (button) folded before Flop (didn't bet)
Seat 6: TheDoctor7778 (small blind) folded on the River

Hand #533: 

PokerStars Hand #246242884166:  Hold'em No Limit ($0.05/$0.10 CAD) - 2023/09/29 3:53:27 ET
Table 'Periphas III' 6-max Seat #6 is the button
Seat 1: stevo420ca ($12.64 in chips) 
Seat 2: guap44 ($5.77 in chips) 
Seat 4: Zorba1978 ($7.96 in chips) 
Seat 5: CashMatteo ($12.01 in chips) 
Seat 6: TheDoctor7778 ($4.58 in chips) 
stevo420ca: posts small blind $0.05
guap44: posts big blind $0.10
*** HOLE CARDS ***
Dealt to CashMatteo [2s 7s]
Zorba1978: folds 
CashMatteo: calls $0.10
stevo420ca said, "kiss me"
TheDoctor7778: raises $0.15 to $0.25
stevo420ca: folds 
TheDoctor7778 said, "zero though "
guap44: folds 
CashMatteo: folds 
Uncalled bet ($0.15) returned to TheDoctor7778
TheDoctor7778 collected $0.35 from pot
*** SUMMARY ***
Total pot $0.35 | Rake $0 
Seat 1: stevo420ca (small blind) folded before Flop
Seat 2: guap44 (big blind) folded before Flop
Seat 4: Zorba1978 folded before Flop (didn't bet)
Seat 5: CashMatteo folded before Flop
Seat 6: TheDoctor7778 (button) collected ($0.35)

Hand #534: 

PokerStars Hand #246242886807:  Hold'em No Limit ($0.05/$0.10 CAD) - 2023/09/29 3:53:52 ET
Table 'Periphas III' 6-max Seat #1 is the button
Seat 1: stevo420ca ($12.59 in chips) 
Seat 2: guap44 ($5.67 in chips) 
Seat 4: Zorba1978 ($7.96 in chips) 
Seat 5: CashMatteo ($11.91 in chips) 
Seat 6: TheDoctor7778 ($4.83 in chips) 
guap44: posts small blind $0.05
Zorba1978: posts big blind $0.10
*** HOLE CARDS ***
Dealt to CashMatteo [Ts 5c]
CashMatteo: folds 
TheDoctor7778 said, "what's the point "
stevo420ca said, "top pair open end"
TheDoctor7778 said, "NPC play "
TheDoctor7778: folds 
stevo420ca: folds 
guap44: calls $0.05
Zorba1978: checks 
*** FLOP *** [Jh 5h 5s]
guap44: bets $5.57 and is all-in
Zorba1978: folds 
Uncalled bet ($5.57) returned to guap44
guap44 collected $0.19 from pot
*** SUMMARY ***
Total pot $0.20 | Rake $0.01 
Board [Jh 5h 5s]
Seat 1: stevo420ca (button) folded before Flop (didn't bet)
Seat 2: guap44 (small blind) collected ($0.19)
Seat 4: Zorba1978 (big blind) folded on the Flop
Seat 5: CashMatteo folded before Flop (didn't bet)
Seat 6: TheDoctor7778 folded before Flop (didn't bet)

Hand #535: 

PokerStars Hand #246242889894:  Hold'em No Limit ($0.05/$0.10 CAD) - 2023/09/29 3:54:21 ET
Table 'Periphas III' 6-max Seat #2 is the button
Seat 1: stevo420ca ($12.59 in chips) 
Seat 2: guap44 ($5.76 in chips) 
Seat 4: Zorba1978 ($7.86 in chips) 
Seat 5: CashMatteo ($11.91 in chips) 
Seat 6: TheDoctor7778 ($4.83 in chips) 
Zorba1978: posts small blind $0.05
CashMatteo: posts big blind $0.10
*** HOLE CARDS ***
Dealt to CashMatteo [Ac 6s]
TheDoctor7778: folds 
stevo420ca: folds 
guap44: calls $0.10
Zorba1978: calls $0.05
CashMatteo: checks 
*** FLOP *** [Kc 8h 5c]
Zorba1978: bets $0.20
CashMatteo: folds 
guap44: folds 
Uncalled bet ($0.20) returned to Zorba1978
Zorba1978 collected $0.29 from pot
*** SUMMARY ***
Total pot $0.30 | Rake $0.01 
Board [Kc 8h 5c]
Seat 1: stevo420ca folded before Flop (didn't bet)
Seat 2: guap44 (button) folded on the Flop
Seat 4: Zorba1978 (small blind) collected ($0.29)
Seat 5: CashMatteo (big blind) folded on the Flop
Seat 6: TheDoctor7778 folded before Flop (didn't bet)

Hand #536: 

PokerStars Hand #246242891755:  Hold'em No Limit ($0.05/$0.10 CAD) - 2023/09/29 3:54:39 ET
Table 'Periphas III' 6-max Seat #4 is the button
Seat 1: stevo420ca ($12.59 in chips) 
Seat 2: guap44 ($5.66 in chips) 
Seat 4: Zorba1978 ($8.05 in chips) 
Seat 5: CashMatteo ($11.81 in chips) 
Seat 6: TheDoctor7778 ($4.83 in chips) 
CashMatteo: posts small blind $0.05
TheDoctor7778: posts big blind $0.10
*** HOLE CARDS ***
Dealt to CashMatteo [Qc Qh]
stevo420ca: calls $0.10
guap44: raises $0.10 to $0.20
Zorba1978: calls $0.20
stevo420ca said, "i prolly had u whole way"
CashMatteo: raises $0.50 to $0.70
TheDoctor7778: folds 
stevo420ca: folds 
guap44: calls $0.50
Zorba1978: folds 
*** FLOP *** [2s Qd 3c]
CashMatteo: bets $0.86
guap44: raises $4.10 to $4.96 and is all-in
CashMatteo: calls $4.10
*** TURN *** [2s Qd 3c] [5d]
*** RIVER *** [2s Qd 3c 5d] [6s]
*** SHOW DOWN ***
CashMatteo: shows [Qc Qh] (three of a kind, Queens)
guap44: shows [Js 4s] (a straight, Deuce to Six)
guap44 collected $11.19 from pot
*** SUMMARY ***
Total pot $11.72 | Rake $0.53 
Board [2s Qd 3c 5d 6s]
Seat 1: stevo420ca folded before Flop
Seat 2: guap44 showed [Js 4s] and won ($11.19) with a straight, Deuce to Six
Seat 4: Zorba1978 (button) folded before Flop
Seat 5: CashMatteo (small blind) showed [Qc Qh] and lost with three of a kind, Queens
Seat 6: TheDoctor7778 (big blind) folded before Flop

Hand #537: 

PokerStars Hand #246242897056:  Hold'em No Limit ($0.05/$0.10 CAD) - 2023/09/29 3:55:32 ET
Table 'Periphas III' 6-max Seat #5 is the button
Seat 1: stevo420ca ($12.49 in chips) 
Seat 2: guap44 ($11.19 in chips) 
Seat 4: Zorba1978 ($7.85 in chips) 
Seat 5: CashMatteo ($6.15 in chips) 
Seat 6: TheDoctor7778 ($4.73 in chips) 
TheDoctor7778: posts small blind $0.05
stevo420ca: posts big blind $0.10
*** HOLE CARDS ***
Dealt to CashMatteo [Kd Th]
guap44: folds 
stevo420ca said, "and if u had anything better than KQ, then u just played bad preflop"
CashMatteo said, "wtf was that"
Zorba1978 has timed out
Zorba1978: folds 
CashMatteo: calls $0.10
TheDoctor7778: folds 
CashMatteo said, "this game sucks"
stevo420ca: raises $0.12 to $0.22
CashMatteo: calls $0.12
*** FLOP *** [6c 2h 3s]
TheDoctor7778 said, "fr"
stevo420ca: checks 
CashMatteo said, "fuck this bull"
CashMatteo: checks 
*** TURN *** [6c 2h 3s] [7h]
stevo420ca: bets $0.31
CashMatteo: folds 
Uncalled bet ($0.31) returned to stevo420ca
stevo420ca collected $0.47 from pot
stevo420ca: doesn't show hand 
*** SUMMARY ***
Total pot $0.49 | Rake $0.02 
Board [6c 2h 3s 7h]
Seat 1: stevo420ca (big blind) collected ($0.47)
Seat 2: guap44 folded before Flop (didn't bet)
Seat 4: Zorba1978 folded before Flop (didn't bet)
Seat 5: CashMatteo (button) folded on the Turn
Seat 6: TheDoctor7778 (small blind) folded before Flop

Hand #538: 

PokerStars Hand #246242900686:  Hold'em No Limit ($0.05/$0.10 CAD) - 2023/09/29 3:56:11 ET
Table 'Periphas III' 6-max Seat #6 is the button
Seat 1: stevo420ca ($12.74 in chips) 
Seat 2: guap44 ($11.19 in chips) 
Seat 5: CashMatteo ($5.93 in chips) 
Seat 6: TheDoctor7778 ($4.68 in chips) 
stevo420ca: posts small blind $0.05
guap44: posts big blind $0.10
*** HOLE CARDS ***
Dealt to CashMatteo [4s Jh]
CashMatteo said, "terrable play btw"
TheDoctor7778 said, "it's crap, seriously "
CashMatteo: folds 
TheDoctor7778 said, "no fun for anyone "
TheDoctor7778: raises $0.25 to $0.35
stevo420ca said, "u gonna say what u had that hand doctor or just btch"
stevo420ca: folds 
guap44: calls $0.25
*** FLOP *** [8s 2d 2c]
TheDoctor7778 said, "why bother to come here "
guap44: bets $0.36
CashMatteo said, "real"
TheDoctor7778: calls $0.36
*** TURN *** [8s 2d 2c] [4h]
guap44: bets $0.70
TheDoctor7778: raises $0.70 to $1.40
guap44: calls $0.70
*** RIVER *** [8s 2d 2c 4h] [7c]
guap44: bets $2.04
stevo420ca said, "come on tell me what u had that hand"
TheDoctor7778: calls $2.04
*** SHOW DOWN ***
guap44: shows [3h 3s] (two pair, Threes and Deuces)
TheDoctor7778: shows [2s As] (three of a kind, Deuces)
TheDoctor7778 collected $7.97 from pot
*** SUMMARY ***
Total pot $8.35 | Rake $0.38 
Board [8s 2d 2c 4h 7c]
Seat 1: stevo420ca (small blind) folded before Flop
Seat 2: guap44 (big blind) showed [3h 3s] and lost with two pair, Threes and Deuces
Seat 5: CashMatteo folded before Flop (didn't bet)
Seat 6: TheDoctor7778 (button) showed [2s As] and won ($7.97) with three of a kind, Deuces

Hand #539: 

PokerStars Hand #246242905679:  Hold'em No Limit ($0.05/$0.10 CAD) - 2023/09/29 3:57:03 ET
Table 'Periphas III' 6-max Seat #1 is the button
Seat 1: stevo420ca ($12.69 in chips) 
Seat 2: guap44 ($7.04 in chips) 
Seat 4: Zorba1978 ($7.85 in chips) 
Seat 5: CashMatteo ($5.93 in chips) 
Seat 6: TheDoctor7778 ($8.50 in chips) 
guap44: posts small blind $0.05
Zorba1978: posts big blind $0.10
*** HOLE CARDS ***
Dealt to CashMatteo [8d Ks]
CashMatteo: calls $0.10
TheDoctor7778: raises $0.25 to $0.35
stevo420ca: calls $0.35
guap44: calls $0.30
Zorba1978: folds 
CashMatteo: calls $0.25
*** FLOP *** [3c 9s 7s]
guap44: bets $1.43
CashMatteo: folds 
TheDoctor7778: folds 
stevo420ca: folds 
Uncalled bet ($1.43) returned to guap44
guap44 collected $1.43 from pot
guap44: shows [3s Ad] (a pair of Threes)
*** SUMMARY ***
Total pot $1.50 | Rake $0.07 
Board [3c 9s 7s]
Seat 1: stevo420ca (button) folded on the Flop
Seat 2: guap44 (small blind) collected ($1.43)
Seat 4: Zorba1978 (big blind) folded before Flop
Seat 5: CashMatteo folded on the Flop
Seat 6: TheDoctor7778 folded on the Flop

Hand #540: 

PokerStars Hand #246242909296:  Hold'em No Limit ($0.05/$0.10 CAD) - 2023/09/29 3:57:41 ET
Table 'Periphas III' 6-max Seat #2 is the button
Seat 1: stevo420ca ($12.34 in chips) 
Seat 2: guap44 ($8.12 in chips) 
Seat 4: Zorba1978 ($7.75 in chips) 
Seat 5: CashMatteo ($5.58 in chips) 
Seat 6: TheDoctor7778 ($8.15 in chips) 
Zorba1978: posts small blind $0.05
CashMatteo: posts big blind $0.10
*** HOLE CARDS ***
Dealt to CashMatteo [Kd 8s]
TheDoctor7778 said, "i don't understand 1/2 these moves "
TheDoctor7778: folds 
stevo420ca said, "that's what i thought Doc i had u the whole way. keep crying for being bad"
stevo420ca: folds 
guap44: calls $0.10
Zorba1978: raises $0.30 to $0.40
CashMatteo: calls $0.30
TheDoctor7778 said, "what are you talking about "
guap44: calls $0.30
*** FLOP *** [Qc 3d 3c]
Zorba1978: checks 
CashMatteo: checks 
guap44: bets $0.58
stevo420ca said, "tell me what u had the hand i beat u"
stevo420ca said, "and u cried"
Zorba1978: folds 
CashMatteo: folds 
Uncalled bet ($0.58) returned to guap44
guap44 collected $1.15 from pot
guap44: shows [9s Jh] (a pair of Threes)
*** SUMMARY ***
Total pot $1.20 | Rake $0.05 
Board [Qc 3d 3c]
Seat 1: stevo420ca folded before Flop (didn't bet)
Seat 2: guap44 (button) collected ($1.15)
Seat 4: Zorba1978 (small blind) folded on the Flop
Seat 5: CashMatteo (big blind) folded on the Flop
Seat 6: TheDoctor7778 folded before Flop (didn't bet)

Hand #541: 

PokerStars Hand #246242913074:  Hold'em No Limit ($0.05/$0.10 CAD) - 2023/09/29 3:58:21 ET
Table 'Periphas III' 6-max Seat #4 is the button
Seat 1: stevo420ca ($12.34 in chips) 
Seat 2: guap44 ($8.87 in chips) 
Seat 4: Zorba1978 ($7.35 in chips) 
Seat 5: CashMatteo ($5.18 in chips) 
Seat 6: TheDoctor7778 ($8.15 in chips) 
CashMatteo: posts small blind $0.05
TheDoctor7778: posts big blind $0.10
*** HOLE CARDS ***
Dealt to CashMatteo [Kc 9d]
stevo420ca: folds 
guap44: folds 
Zorba1978: folds 
CashMatteo: calls $0.05
TheDoctor7778 said, "i stopped paying attention to you at the of the hand, Idk what you're still going on about "
TheDoctor7778: checks 
*** FLOP *** [Kh 3d 3s]
guap44 said, "never seen people type so much in 5 cent 10 cent before"
TheDoctor7778 said, "lulz "
TheDoctor7778 said, "what "
CashMatteo: bets $0.10
TheDoctor7778 said, "bruh this chat makes you laugh "
TheDoctor7778: calls $0.10
*** TURN *** [Kh 3d 3s] [Kd]
CashMatteo: bets $0.19
stevo420ca said, "i just find it funny when fish tell me "no thought""
TheDoctor7778: folds 
Uncalled bet ($0.19) returned to CashMatteo
CashMatteo collected $0.38 from pot
CashMatteo: doesn't show hand 
*** SUMMARY ***
Total pot $0.40 | Rake $0.02 
Board [Kh 3d 3s Kd]
Seat 1: stevo420ca folded before Flop (didn't bet)
Seat 2: guap44 folded before Flop (didn't bet)
Seat 4: Zorba1978 (button) folded before Flop (didn't bet)
Seat 5: CashMatteo (small blind) collected ($0.38)
Seat 6: TheDoctor7778 (big blind) folded on the Turn

Hand #542: 

PokerStars Hand #246242917912:  Hold'em No Limit ($0.05/$0.10 CAD) - 2023/09/29 3:59:11 ET
Table 'Periphas III' 6-max Seat #5 is the button
Seat 1: stevo420ca ($12.34 in chips) 
Seat 2: guap44 ($8.87 in chips) 
Seat 4: Zorba1978 ($7.35 in chips) 
Seat 5: CashMatteo ($5.36 in chips) 
Seat 6: TheDoctor7778 ($7.95 in chips) 
TheDoctor7778: posts small blind $0.05
stevo420ca: posts big blind $0.10
*** HOLE CARDS ***
Dealt to CashMatteo [8c Qh]
guap44: folds 
Zorba1978: folds 
CashMatteo: calls $0.10
TheDoctor7778: calls $0.05
stevo420ca: checks 
*** FLOP *** [Ks 7s Td]
TheDoctor7778 said, "he can't let it go "
TheDoctor7778: checks 
TheDoctor7778 said, "I already forgot what it was "
stevo420ca said, "i won the hand my guy. there's nothing to let go lol"
stevo420ca: checks 
CashMatteo: checks 
*** TURN *** [Ks 7s Td] [9s]
Derrrr6 was removed from the table for failing to post
Derrrr6 leaves the table
TheDoctor7778: bets $0.15
GFBJEH joins the table at seat #3 
stevo420ca said, "u didnt forget"
stevo420ca: folds 
CashMatteo: calls $0.15
*** RIVER *** [Ks 7s Td 9s] [5c]
TheDoctor7778 said, "no, i really did "
TheDoctor7778: bets $0.33
CashMatteo: folds 
Uncalled bet ($0.33) returned to TheDoctor7778
TheDoctor7778 collected $0.57 from pot
*** SUMMARY ***
Total pot $0.60 | Rake $0.03 
Board [Ks 7s Td 9s 5c]
Seat 1: stevo420ca (big blind) folded on the Turn
Seat 2: guap44 folded before Flop (didn't bet)
Seat 4: Zorba1978 folded before Flop (didn't bet)
Seat 5: CashMatteo (button) folded on the River
Seat 6: TheDoctor7778 (small blind) collected ($0.57)

Hand #543: 

PokerStars Hand #246242926179:  Hold'em No Limit ($0.05/$0.10 CAD) - 2023/09/29 4:00:36 ET
Table 'Periphas III' 6-max Seat #6 is the button
Seat 1: stevo420ca ($12.24 in chips) 
Seat 2: guap44 ($8.87 in chips) 
Seat 4: Zorba1978 ($7.35 in chips) 
Seat 5: CashMatteo ($5.11 in chips) 
Seat 6: TheDoctor7778 ($8.27 in chips) 
stevo420ca: posts small blind $0.05
guap44: posts big blind $0.10
GFBJEH: sits out 
*** HOLE CARDS ***
Dealt to CashMatteo [8d 6d]
TheDoctor7778 said, "i was busy playing chess "
Zorba1978: folds 
CashMatteo: calls $0.10
stevo420ca said, "uh huh"
TheDoctor7778 said, "idk what happened after "
TheDoctor7778: folds 
stevo420ca: calls $0.05
guap44: checks 
*** FLOP *** [3c Qc Qs]
stevo420ca: checks 
TheDoctor7778 said, "i zoned out "
guap44: checks 
CashMatteo: checks 
*** TURN *** [3c Qc Qs] [2d]
stevo420ca: bets $0.19
guap44: folds 
CashMatteo: folds 
Uncalled bet ($0.19) returned to stevo420ca
stevo420ca collected $0.29 from pot
stevo420ca: doesn't show hand 
*** SUMMARY ***
Total pot $0.30 | Rake $0.01 
Board [3c Qc Qs 2d]
Seat 1: stevo420ca (small blind) collected ($0.29)
Seat 2: guap44 (big blind) folded on the Turn
Seat 4: Zorba1978 folded before Flop (didn't bet)
Seat 5: CashMatteo folded on the Turn
Seat 6: TheDoctor7778 (button) folded before Flop (didn't bet)

Hand #544: 

PokerStars Hand #246242929805:  Hold'em No Limit ($0.05/$0.10 CAD) - 2023/09/29 4:01:09 ET
Table 'Periphas III' 6-max Seat #1 is the button
Seat 1: stevo420ca ($12.43 in chips) 
Seat 2: guap44 ($8.77 in chips) 
Seat 3: GFBJEH ($8.60 in chips) 
Seat 4: Zorba1978 ($7.35 in chips) 
Seat 5: CashMatteo ($5.01 in chips) 
Seat 6: TheDoctor7778 ($8.27 in chips) 
guap44: posts small blind $0.05
GFBJEH: posts big blind $0.10
*** HOLE CARDS ***
Dealt to CashMatteo [Ah 7s]
Zorba1978: folds 
CashMatteo: calls $0.10
TheDoctor7778: raises $0.25 to $0.35
stevo420ca: folds 
guap44: folds 
GFBJEH: calls $0.25
CashMatteo: calls $0.25
*** FLOP *** [2h 4s Ks]
GFBJEH: checks 
CashMatteo: checks 
TheDoctor7778 said, "whatever you're mad about, i'm sure it's worth it "
TheDoctor7778: bets $0.50
GFBJEH: folds 
CashMatteo: folds 
Uncalled bet ($0.50) returned to TheDoctor7778
TheDoctor7778 collected $1.05 from pot
TheDoctor7778: doesn't show hand 
*** SUMMARY ***
Total pot $1.10 | Rake $0.05 
Board [2h 4s Ks]
Seat 1: stevo420ca (button) folded before Flop (didn't bet)
Seat 2: guap44 (small blind) folded before Flop
Seat 3: GFBJEH (big blind) folded on the Flop
Seat 4: Zorba1978 folded before Flop (didn't bet)
Seat 5: CashMatteo folded on the Flop
Seat 6: TheDoctor7778 collected ($1.05)

Hand #545: 

PokerStars Hand #246242934485:  Hold'em No Limit ($0.05/$0.10 CAD) - 2023/09/29 4:01:54 ET
Table 'Periphas III' 6-max Seat #2 is the button
Seat 1: stevo420ca ($12.43 in chips) 
Seat 2: guap44 ($8.72 in chips) 
Seat 3: GFBJEH ($8.25 in chips) 
Seat 4: Zorba1978 ($7.35 in chips) 
Seat 5: CashMatteo ($4.66 in chips) 
Seat 6: TheDoctor7778 ($8.97 in chips) 
GFBJEH: posts small blind $0.05
Zorba1978: posts big blind $0.10
*** HOLE CARDS ***
Dealt to CashMatteo [Ad 7s]
stevo420ca said, "self-project much?"
CashMatteo: folds 
TheDoctor7778: calls $0.10
stevo420ca: folds 
guap44: raises $0.10 to $0.20
TheDoctor7778 said, "what "
GFBJEH: raises $0.80 to $1
Zorba1978: folds 
stevo420ca said, "figured that would go over ur head"
TheDoctor7778 said, "are you just talking to yourself at this point or "
TheDoctor7778: folds 
guap44: calls $0.80
*** FLOP *** [8s 7h Th]
GFBJEH: bets $7.25 and is all-in
TheDoctor7778 said, "rambling "
guap44: folds 
Uncalled bet ($7.25) returned to GFBJEH
GFBJEH collected $2.10 from pot
*** SUMMARY ***
Total pot $2.20 | Rake $0.10 
Board [8s 7h Th]
Seat 1: stevo420ca folded before Flop (didn't bet)
Seat 2: guap44 (button) folded on the Flop
Seat 3: GFBJEH (small blind) collected ($2.10)
Seat 4: Zorba1978 (big blind) folded before Flop
Seat 5: CashMatteo folded before Flop (didn't bet)
Seat 6: TheDoctor7778 folded before Flop

Hand #546: 

PokerStars Hand #246242938952:  Hold'em No Limit ($0.05/$0.10 CAD) - 2023/09/29 4:02:35 ET
Table 'Periphas III' 6-max Seat #3 is the button
Seat 1: stevo420ca ($12.43 in chips) 
Seat 2: guap44 ($7.72 in chips) 
Seat 3: GFBJEH ($9.35 in chips) 
Seat 4: Zorba1978 ($7.25 in chips) 
Seat 5: CashMatteo ($4.66 in chips) 
Seat 6: TheDoctor7778 ($8.87 in chips) 
Zorba1978: posts small blind $0.05
CashMatteo: posts big blind $0.10
*** HOLE CARDS ***
Dealt to CashMatteo [5s 7h]
TheDoctor7778: raises $0.15 to $0.25
stevo420ca: folds 
guap44: raises $0.65 to $0.90
GFBJEH: calls $0.90
Zorba1978: folds 
CashMatteo: folds 
TheDoctor7778: folds 
*** FLOP *** [Kc 2d 2c]
guap44: bets $6.82 and is all-in
GFBJEH: calls $6.82
*** TURN *** [Kc 2d 2c] [5d]
*** RIVER *** [Kc 2d 2c 5d] [Jh]
*** SHOW DOWN ***
guap44: shows [Th Kh] (two pair, Kings and Deuces)
GFBJEH: shows [Js 2s] (a full house, Deuces full of Jacks)
GFBJEH collected $15.13 from pot
*** SUMMARY ***
Total pot $15.84 | Rake $0.71 
Board [Kc 2d 2c 5d Jh]
Seat 1: stevo420ca folded before Flop (didn't bet)
Seat 2: guap44 showed [Th Kh] and lost with two pair, Kings and Deuces
Seat 3: GFBJEH (button) showed [Js 2s] and won ($15.13) with a full house, Deuces full of Jacks
Seat 4: Zorba1978 (small blind) folded before Flop
Seat 5: CashMatteo (big blind) folded before Flop
Seat 6: TheDoctor7778 folded before Flop

Hand #547: 

PokerStars Hand #246242942369:  Hold'em No Limit ($0.05/$0.10 CAD) - 2023/09/29 4:03:07 ET
Table 'Periphas III' 6-max Seat #4 is the button
Seat 1: stevo420ca ($12.43 in chips) 
Seat 3: GFBJEH ($16.76 in chips) 
Seat 4: Zorba1978 ($7.20 in chips) 
Seat 5: CashMatteo ($4.56 in chips) 
Seat 6: TheDoctor7778 ($8.62 in chips) 
CashMatteo: posts small blind $0.05
TheDoctor7778: posts big blind $0.10
*** HOLE CARDS ***
Dealt to CashMatteo [7c Th]
stevo420ca: folds 
TheDoctor7778 said, "you guys are crazy "
GFBJEH: raises $0.10 to $0.20
Zorba1978: folds 
CashMatteo: calls $0.15
TheDoctor7778 said, "idk how you make these plays "
guap44 said, "j2 all in"
guap44 said, "xd"
guap44 leaves the table
TheDoctor7778: calls $0.10
*** FLOP *** [4c 6s 3d]
CashMatteo: checks 
TheDoctor7778: bets $0.33
loder2 joins the table at seat #2 
GFBJEH: calls $0.33
CashMatteo: folds 
*** TURN *** [4c 6s 3d] [Ad]
TheDoctor7778 said, "last sane man alive "
TheDoctor7778: bets $0.60
TheDoctor7778 said, "me against the world, bb "
GFBJEH: folds 
Uncalled bet ($0.60) returned to TheDoctor7778
TheDoctor7778 collected $1.20 from pot
TheDoctor7778: doesn't show hand 
*** SUMMARY ***
Total pot $1.26 | Rake $0.06 
Board [4c 6s 3d Ad]
Seat 1: stevo420ca folded before Flop (didn't bet)
Seat 3: GFBJEH folded on the Turn
Seat 4: Zorba1978 (button) folded before Flop (didn't bet)
Seat 5: CashMatteo (small blind) folded on the Flop
Seat 6: TheDoctor7778 (big blind) collected ($1.20)

Hand #548: 

PokerStars Hand #246242948996:  Hold'em No Limit ($0.05/$0.10 CAD) - 2023/09/29 4:04:08 ET
Table 'Periphas III' 6-max Seat #5 is the button
Seat 1: stevo420ca ($12.43 in chips) 
Seat 2: loder2 ($4.61 in chips) 
Seat 3: GFBJEH ($16.23 in chips) 
Seat 4: Zorba1978 ($7.20 in chips) 
Seat 5: CashMatteo ($4.36 in chips) 
Seat 6: TheDoctor7778 ($9.29 in chips) 
TheDoctor7778: posts small blind $0.05
stevo420ca: posts big blind $0.10
loder2: posts big blind $0.10
*** HOLE CARDS ***
Dealt to CashMatteo [Th 9s]
loder2: checks 
GFBJEH: calls $0.10
Zorba1978: folds 
CashMatteo: calls $0.10
TheDoctor7778 said, "crazy world out there "
TheDoctor7778: calls $0.05
stevo420ca: checks 
*** FLOP *** [Kd Tc Jd]
TheDoctor7778: checks 
stevo420ca: checks 
loder2: checks 
GFBJEH: checks 
CashMatteo: checks 
*** TURN *** [Kd Tc Jd] [Jh]
TheDoctor7778: checks 
stevo420ca: checks 
loder2: checks 
GFBJEH: checks 
CashMatteo: checks 
*** RIVER *** [Kd Tc Jd Jh] [Ah]
TheDoctor7778: checks 
stevo420ca: bets $0.10
loder2: calls $0.10
GFBJEH: calls $0.10
CashMatteo: folds 
TheDoctor7778: folds 
*** SHOW DOWN ***
stevo420ca: shows [As 7c] (two pair, Aces and Jacks)
loder2: shows [Ac 6c] (two pair, Aces and Jacks)
GFBJEH: shows [Qh 6h] (a straight, Ten to Ace)
GFBJEH collected $0.76 from pot
*** SUMMARY ***
Total pot $0.80 | Rake $0.04 
Board [Kd Tc Jd Jh Ah]
Seat 1: stevo420ca (big blind) showed [As 7c] and lost with two pair, Aces and Jacks
Seat 2: loder2 showed [Ac 6c] and lost with two pair, Aces and Jacks
Seat 3: GFBJEH showed [Qh 6h] and won ($0.76) with a straight, Ten to Ace
Seat 4: Zorba1978 folded before Flop (didn't bet)
Seat 5: CashMatteo (button) folded on the River
Seat 6: TheDoctor7778 (small blind) folded on the River

Hand #549: 

PokerStars Hand #246242954011:  Hold'em No Limit ($0.05/$0.10 CAD) - 2023/09/29 4:04:55 ET
Table 'Periphas III' 6-max Seat #6 is the button
Seat 1: stevo420ca ($12.23 in chips) 
Seat 2: loder2 ($4.41 in chips) 
Seat 3: GFBJEH ($16.79 in chips) 
Seat 4: Zorba1978 ($7.20 in chips) 
Seat 5: CashMatteo ($4.26 in chips) 
Seat 6: TheDoctor7778 ($9.19 in chips) 
stevo420ca: posts small blind $0.05
loder2: posts big blind $0.10
*** HOLE CARDS ***
Dealt to CashMatteo [4c 2s]
GFBJEH: calls $0.10
Zorba1978: folds 
CashMatteo: folds 
TheDoctor7778: raises $0.20 to $0.30
stevo420ca: calls $0.25
loder2: calls $0.20
GFBJEH: calls $0.20
*** FLOP *** [9d Qd Kd]
stevo420ca: checks 
loder2: checks 
GFBJEH: checks 
TheDoctor7778: bets $0.40
stevo420ca: folds 
loder2: folds 
GFBJEH: calls $0.40
*** TURN *** [9d Qd Kd] [Tc]
GFBJEH: checks 
TheDoctor7778: bets $0.90
GFBJEH: calls $0.90
*** RIVER *** [9d Qd Kd Tc] [Ts]
GFBJEH: checks 
TheDoctor7778: bets $2.91
GFBJEH: folds 
Uncalled bet ($2.91) returned to TheDoctor7778
TheDoctor7778 collected $3.63 from pot
TheDoctor7778: doesn't show hand 
*** SUMMARY ***
Total pot $3.80 | Rake $0.17 
Board [9d Qd Kd Tc Ts]
Seat 1: stevo420ca (small blind) folded on the Flop
Seat 2: loder2 (big blind) folded on the Flop
Seat 3: GFBJEH folded on the River
Seat 4: Zorba1978 folded before Flop (didn't bet)
Seat 5: CashMatteo folded before Flop (didn't bet)
Seat 6: TheDoctor7778 (button) collected ($3.63)

Hand #550: 

PokerStars Hand #246242963264:  Hold'em No Limit ($0.05/$0.10 CAD) - 2023/09/29 4:06:19 ET
Table 'Periphas III' 6-max Seat #1 is the button
Seat 1: stevo420ca ($11.93 in chips) 
Seat 2: loder2 ($4.11 in chips) 
Seat 3: GFBJEH ($15.19 in chips) 
Seat 4: Zorba1978 ($7.20 in chips) 
Seat 5: CashMatteo ($4.26 in chips) 
Seat 6: TheDoctor7778 ($11.22 in chips) 
loder2: posts small blind $0.05
GFBJEH: posts big blind $0.10
*** HOLE CARDS ***
Dealt to CashMatteo [3s Js]
Zorba1978: folds 
CashMatteo: calls $0.10
TheDoctor7778: folds 
stevo420ca: folds 
loder2: calls $0.05
GFBJEH: raises $0.30 to $0.40
CashMatteo: calls $0.30
loder2: calls $0.30
*** FLOP *** [7c Kh 2c]
loder2: checks 
GFBJEH: bets $1.15
CashMatteo: folds 
loder2: folds 
Uncalled bet ($1.15) returned to GFBJEH
GFBJEH collected $1.15 from pot
*** SUMMARY ***
Total pot $1.20 | Rake $0.05 
Board [7c Kh 2c]
Seat 1: stevo420ca (button) folded before Flop (didn't bet)
Seat 2: loder2 (small blind) folded on the Flop
Seat 3: GFBJEH (big blind) collected ($1.15)
Seat 4: Zorba1978 folded before Flop (didn't bet)
Seat 5: CashMatteo folded on the Flop
Seat 6: TheDoctor7778 folded before Flop (didn't bet)

Hand #551: 

PokerStars Hand #246242966649:  Hold'em No Limit ($0.05/$0.10 CAD) - 2023/09/29 4:06:50 ET
Table 'Periphas III' 6-max Seat #2 is the button
Seat 1: stevo420ca ($11.93 in chips) 
Seat 2: loder2 ($3.71 in chips) 
Seat 3: GFBJEH ($15.94 in chips) 
Seat 4: Zorba1978 ($7.20 in chips) 
Seat 5: CashMatteo ($3.86 in chips) 
Seat 6: TheDoctor7778 ($11.22 in chips) 
GFBJEH: posts small blind $0.05
Zorba1978: posts big blind $0.10
*** HOLE CARDS ***
Dealt to CashMatteo [9c 3c]
CashMatteo: folds 
TheDoctor7778: raises $0.10 to $0.20
stevo420ca: folds 
loder2: folds 
GFBJEH: calls $0.15
Zorba1978: folds 
*** FLOP *** [Qh 3h 7s]
GFBJEH: checks 
TheDoctor7778: bets $0.24
GFBJEH: raises $0.24 to $0.48
TheDoctor7778: folds 
Uncalled bet ($0.24) returned to GFBJEH
GFBJEH collected $0.94 from pot
*** SUMMARY ***
Total pot $0.98 | Rake $0.04 
Board [Qh 3h 7s]
Seat 1: stevo420ca folded before Flop (didn't bet)
Seat 2: loder2 (button) folded before Flop (didn't bet)
Seat 3: GFBJEH (small blind) collected ($0.94)
Seat 4: Zorba1978 (big blind) folded before Flop
Seat 5: CashMatteo folded before Flop (didn't bet)
Seat 6: TheDoctor7778 folded on the Flop

Hand #552: 

PokerStars Hand #246242970205:  Hold'em No Limit ($0.05/$0.10 CAD) - 2023/09/29 4:07:22 ET
Table 'Periphas III' 6-max Seat #3 is the button
Seat 1: stevo420ca ($11.93 in chips) 
Seat 2: loder2 ($3.71 in chips) 
Seat 3: GFBJEH ($16.44 in chips) 
Seat 4: Zorba1978 ($7.10 in chips) 
Seat 5: CashMatteo ($3.86 in chips) 
Seat 6: TheDoctor7778 ($10.78 in chips) 
Zorba1978: posts small blind $0.05
CashMatteo: posts big blind $0.10
*** HOLE CARDS ***
Dealt to CashMatteo [7d 9s]
TheDoctor7778: raises $0.30 to $0.40
stevo420ca: folds 
loder2: calls $0.40
GFBJEH: folds 
Zorba1978: calls $0.35
CashMatteo: folds 
*** FLOP *** [Th 3c 5d]
Zorba1978: checks 
TheDoctor7778: bets $0.64
loder2: calls $0.64
Zorba1978: folds 
*** TURN *** [Th 3c 5d] [Js]
TheDoctor7778: bets $1.26
loder2: folds 
Uncalled bet ($1.26) returned to TheDoctor7778
TheDoctor7778 collected $2.46 from pot
TheDoctor7778: doesn't show hand 
*** SUMMARY ***
Total pot $2.58 | Rake $0.12 
Board [Th 3c 5d Js]
Seat 1: stevo420ca folded before Flop (didn't bet)
Seat 2: loder2 folded on the Turn
Seat 3: GFBJEH (button) folded before Flop (didn't bet)
Seat 4: Zorba1978 (small blind) folded on the Flop
Seat 5: CashMatteo (big blind) folded before Flop
Seat 6: TheDoctor7778 collected ($2.46)

Hand #553: 

PokerStars Hand #246242975383:  Hold'em No Limit ($0.05/$0.10 CAD) - 2023/09/29 4:08:09 ET
Table 'Periphas III' 6-max Seat #4 is the button
Seat 1: stevo420ca ($11.93 in chips) 
Seat 2: loder2 ($2.67 in chips) 
Seat 3: GFBJEH ($16.44 in chips) 
Seat 4: Zorba1978 ($6.70 in chips) 
Seat 5: CashMatteo ($3.76 in chips) 
Seat 6: TheDoctor7778 ($12.20 in chips) 
CashMatteo: posts small blind $0.05
TheDoctor7778: posts big blind $0.10
*** HOLE CARDS ***
Dealt to CashMatteo [8c 9c]
stevo420ca: folds 
loder2: calls $0.10
GFBJEH: calls $0.10
Zorba1978: calls $0.10
CashMatteo: calls $0.05
TheDoctor7778: raises $0.20 to $0.30
loder2: raises $2.37 to $2.67 and is all-in
GFBJEH: folds 
Zorba1978: folds 
CashMatteo: folds 
TheDoctor7778: folds 
Uncalled bet ($2.37) returned to loder2
loder2 collected $0.90 from pot
loder2: doesn't show hand 
*** SUMMARY ***
Total pot $0.90 | Rake $0 
Seat 1: stevo420ca folded before Flop (didn't bet)
Seat 2: loder2 collected ($0.90)
Seat 3: GFBJEH folded before Flop
Seat 4: Zorba1978 (button) folded before Flop
Seat 5: CashMatteo (small blind) folded before Flop
Seat 6: TheDoctor7778 (big blind) folded before Flop

Hand #554: 

PokerStars Hand #246242979804:  Hold'em No Limit ($0.05/$0.10 CAD) - 2023/09/29 4:08:48 ET
Table 'Periphas III' 6-max Seat #5 is the button
Seat 1: stevo420ca ($11.93 in chips) 
Seat 2: loder2 ($3.27 in chips) 
Seat 3: GFBJEH ($16.34 in chips) 
Seat 4: Zorba1978 ($6.60 in chips) 
Seat 5: CashMatteo ($3.66 in chips) 
Seat 6: TheDoctor7778 ($11.90 in chips) 
TheDoctor7778: posts small blind $0.05
stevo420ca: posts big blind $0.10
*** HOLE CARDS ***
Dealt to CashMatteo [8c Th]
loder2: calls $0.10
GFBJEH: calls $0.10
TheDoctor7778 said, "he's the one who went all in "
Zorba1978: raises $0.10 to $0.20
CashMatteo: folds 
TheDoctor7778: raises $0.15 to $0.35
stevo420ca: folds 
loder2: folds 
GFBJEH: calls $0.25
Zorba1978: calls $0.15
*** FLOP *** [3s 8s 2s]
TheDoctor7778: bets $0.20
GFBJEH: calls $0.20
Zorba1978: folds 
*** TURN *** [3s 8s 2s] [7h]
TheDoctor7778: bets $0.40
GFBJEH: raises $0.70 to $1.10
TheDoctor7778: calls $0.70
*** RIVER *** [3s 8s 2s 7h] [Ah]
TheDoctor7778: checks 
GFBJEH: checks 
*** SHOW DOWN ***
TheDoctor7778: shows [Ad Kh] (a pair of Aces)
GFBJEH: mucks hand 
TheDoctor7778 collected $3.68 from pot
*** SUMMARY ***
Total pot $3.85 | Rake $0.17 
Board [3s 8s 2s 7h Ah]
Seat 1: stevo420ca (big blind) folded before Flop
Seat 2: loder2 folded before Flop
Seat 3: GFBJEH mucked [Ts 7c]
Seat 4: Zorba1978 folded on the Flop
Seat 5: CashMatteo (button) folded before Flop (didn't bet)
Seat 6: TheDoctor7778 (small blind) showed [Ad Kh] and won ($3.68) with a pair of Aces

Hand #555: 

PokerStars Hand #246242987376:  Hold'em No Limit ($0.05/$0.10 CAD) - 2023/09/29 4:09:56 ET
Table 'Periphas III' 6-max Seat #6 is the button
Seat 1: stevo420ca ($11.83 in chips) 
Seat 2: loder2 ($3.17 in chips) 
Seat 3: GFBJEH ($14.69 in chips) 
Seat 4: Zorba1978 ($6.25 in chips) 
Seat 5: CashMatteo ($3.66 in chips) 
Seat 6: TheDoctor7778 ($13.93 in chips) 
stevo420ca: posts small blind $0.05
loder2: posts big blind $0.10
*** HOLE CARDS ***
Dealt to CashMatteo [Th Qs]
GFBJEH: folds 
Zorba1978: folds 
CashMatteo: raises $0.20 to $0.30
TheDoctor7778: calls $0.30
stevo420ca: folds 
loder2: calls $0.20
*** FLOP *** [5d 7h Qd]
loder2: checks 
CashMatteo: bets $0.91
TheDoctor7778: folds 
loder2: folds 
Uncalled bet ($0.91) returned to CashMatteo
CashMatteo collected $0.91 from pot
CashMatteo: doesn't show hand 
*** SUMMARY ***
Total pot $0.95 | Rake $0.04 
Board [5d 7h Qd]
Seat 1: stevo420ca (small blind) folded before Flop
Seat 2: loder2 (big blind) folded on the Flop
Seat 3: GFBJEH folded before Flop (didn't bet)
Seat 4: Zorba1978 folded before Flop (didn't bet)
Seat 5: CashMatteo collected ($0.91)
Seat 6: TheDoctor7778 (button) folded on the Flop

Hand #556: 

PokerStars Hand #246242989897:  Hold'em No Limit ($0.05/$0.10 CAD) - 2023/09/29 4:10:18 ET
Table 'Periphas III' 6-max Seat #1 is the button
Seat 1: stevo420ca ($11.78 in chips) 
Seat 2: loder2 ($2.87 in chips) 
Seat 3: GFBJEH ($14.69 in chips) 
Seat 4: Zorba1978 ($6.25 in chips) 
Seat 5: CashMatteo ($4.27 in chips) 
Seat 6: TheDoctor7778 ($13.63 in chips) 
loder2: posts small blind $0.05
GFBJEH: posts big blind $0.10
*** HOLE CARDS ***
Dealt to CashMatteo [9c 3h]
Zorba1978: folds 
CashMatteo: folds 
TheDoctor7778: raises $0.15 to $0.25
stevo420ca: folds 
loder2: folds 
GFBJEH: folds 
Uncalled bet ($0.15) returned to TheDoctor7778
TheDoctor7778 collected $0.25 from pot
TheDoctor7778: doesn't show hand 
*** SUMMARY ***
Total pot $0.25 | Rake $0 
Seat 1: stevo420ca (button) folded before Flop (didn't bet)
Seat 2: loder2 (small blind) folded before Flop
Seat 3: GFBJEH (big blind) folded before Flop
Seat 4: Zorba1978 folded before Flop (didn't bet)
Seat 5: CashMatteo folded before Flop (didn't bet)
Seat 6: TheDoctor7778 collected ($0.25)

Hand #557: 

PokerStars Hand #246242991929:  Hold'em No Limit ($0.05/$0.10 CAD) - 2023/09/29 4:10:36 ET
Table 'Periphas III' 6-max Seat #2 is the button
Seat 1: stevo420ca ($11.78 in chips) 
Seat 2: loder2 ($2.82 in chips) 
Seat 3: GFBJEH ($14.59 in chips) 
Seat 4: Zorba1978 ($6.25 in chips) 
Seat 5: CashMatteo ($4.27 in chips) 
Seat 6: TheDoctor7778 ($13.78 in chips) 
GFBJEH: posts small blind $0.05
Zorba1978: posts big blind $0.10
*** HOLE CARDS ***
Dealt to CashMatteo [5s Th]
CashMatteo: calls $0.10
TheDoctor7778 is disconnected 
TheDoctor7778 has timed out
TheDoctor7778: folds 
stevo420ca: raises $0.10 to $0.20
loder2: folds 
GFBJEH: calls $0.15
Zorba1978: folds 
CashMatteo: folds 
*** FLOP *** [Ac Ks Jc]
GFBJEH: checks 
stevo420ca: bets $0.38
GFBJEH: folds 
Uncalled bet ($0.38) returned to stevo420ca
stevo420ca collected $0.57 from pot
stevo420ca: doesn't show hand 
*** SUMMARY ***
Total pot $0.60 | Rake $0.03 
Board [Ac Ks Jc]
Seat 1: stevo420ca collected ($0.57)
Seat 2: loder2 (button) folded before Flop (didn't bet)
Seat 3: GFBJEH (small blind) folded on the Flop
Seat 4: Zorba1978 (big blind) folded before Flop
Seat 5: CashMatteo folded before Flop
Seat 6: TheDoctor7778 folded before Flop (didn't bet)

Hand #558: 

PokerStars Hand #246242996808:  Hold'em No Limit ($0.05/$0.10 CAD) - 2023/09/29 4:11:19 ET
Table 'Periphas III' 6-max Seat #3 is the button
Seat 1: stevo420ca ($12.15 in chips) 
Seat 2: loder2 ($2.82 in chips) 
Seat 3: GFBJEH ($14.39 in chips) 
Seat 4: Zorba1978 ($6.15 in chips) 
Seat 5: CashMatteo ($4.17 in chips) 
Seat 6: TheDoctor7778 ($13.78 in chips) 
Zorba1978: posts small blind $0.05
CashMatteo: posts big blind $0.10
*** HOLE CARDS ***
Dealt to CashMatteo [6h Th]
TheDoctor7778: raises $0.10 to $0.20
stevo420ca: folds 
loder2: calls $0.20
GFBJEH: folds 
Zorba1978: folds 
CashMatteo: folds 
*** FLOP *** [3s Td Tc]
TheDoctor7778: checks 
loder2: checks 
*** TURN *** [3s Td Tc] [2s]
TheDoctor7778: bets $0.15
loder2: calls $0.15
*** RIVER *** [3s Td Tc 2s] [5d]
TheDoctor7778: bets $0.40
loder2: calls $0.40
*** SHOW DOWN ***
TheDoctor7778: shows [Jh 9c] (a pair of Tens)
loder2: shows [5s 4d] (two pair, Tens and Fives)
loder2 collected $1.58 from pot
*** SUMMARY ***
Total pot $1.65 | Rake $0.07 
Board [3s Td Tc 2s 5d]
Seat 1: stevo420ca folded before Flop (didn't bet)
Seat 2: loder2 showed [5s 4d] and won ($1.58) with two pair, Tens and Fives
Seat 3: GFBJEH (button) folded before Flop (didn't bet)
Seat 4: Zorba1978 (small blind) folded before Flop
Seat 5: CashMatteo (big blind) folded before Flop
Seat 6: TheDoctor7778 showed [Jh 9c] and lost with a pair of Tens

Hand #559: 

PokerStars Hand #246243002837:  Hold'em No Limit ($0.05/$0.10 CAD) - 2023/09/29 4:12:12 ET
Table 'Periphas III' 6-max Seat #4 is the button
Seat 1: stevo420ca ($12.15 in chips) 
Seat 2: loder2 ($3.65 in chips) 
Seat 3: GFBJEH ($14.39 in chips) 
Seat 4: Zorba1978 ($6.10 in chips) 
Seat 5: CashMatteo ($4.07 in chips) 
Seat 6: TheDoctor7778 ($13.03 in chips) 
CashMatteo: posts small blind $0.05
TheDoctor7778: posts big blind $0.10
*** HOLE CARDS ***
Dealt to CashMatteo [As Qd]
stevo420ca: folds 
loder2: folds 
GFBJEH: folds 
Zorba1978: calls $0.10
CashMatteo: raises $0.20 to $0.30
TheDoctor7778: folds 
Zorba1978: calls $0.20
*** FLOP *** [3c Jd 8c]
CashMatteo: bets $0.34
Zorba1978: folds 
Uncalled bet ($0.34) returned to CashMatteo
CashMatteo collected $0.67 from pot
CashMatteo: doesn't show hand 
*** SUMMARY ***
Total pot $0.70 | Rake $0.03 
Board [3c Jd 8c]
Seat 1: stevo420ca folded before Flop (didn't bet)
Seat 2: loder2 folded before Flop (didn't bet)
Seat 3: GFBJEH folded before Flop (didn't bet)
Seat 4: Zorba1978 (button) folded on the Flop
Seat 5: CashMatteo (small blind) collected ($0.67)
Seat 6: TheDoctor7778 (big blind) folded before Flop

Hand #560: 

PokerStars Hand #246243004961:  Hold'em No Limit ($0.05/$0.10 CAD) - 2023/09/29 4:12:32 ET
Table 'Periphas III' 6-max Seat #5 is the button
Seat 1: stevo420ca ($12.15 in chips) 
Seat 2: loder2 ($3.65 in chips) 
Seat 3: GFBJEH ($14.39 in chips) 
Seat 4: Zorba1978 ($5.80 in chips) 
Seat 5: CashMatteo ($4.44 in chips) 
Seat 6: TheDoctor7778 ($12.93 in chips) 
TheDoctor7778: posts small blind $0.05
stevo420ca: posts big blind $0.10
*** HOLE CARDS ***
Dealt to CashMatteo [Tc Th]
loder2: folds 
GFBJEH: raises $0.25 to $0.35
Zorba1978: folds 
CashMatteo: raises $0.85 to $1.20
TheDoctor7778: folds 
stevo420ca: folds 
GFBJEH: calls $0.85
*** FLOP *** [Js 8d 2c]
GFBJEH: checks 
CashMatteo: bets $1.22
GFBJEH: calls $1.22
*** TURN *** [Js 8d 2c] [8c]
GFBJEH: checks 
TheDoctor7778 said, "wonder what stevo's thinking "
CashMatteo: bets $2.02 and is all-in
GFBJEH: folds 
Uncalled bet ($2.02) returned to CashMatteo
CashMatteo collected $4.77 from pot
CashMatteo: doesn't show hand 
*** SUMMARY ***
Total pot $4.99 | Rake $0.22 
Board [Js 8d 2c 8c]
Seat 1: stevo420ca (big blind) folded before Flop
Seat 2: loder2 folded before Flop (didn't bet)
Seat 3: GFBJEH folded on the Turn
Seat 4: Zorba1978 folded before Flop (didn't bet)
Seat 5: CashMatteo (button) collected ($4.77)
Seat 6: TheDoctor7778 (small blind) folded before Flop

Hand #561: 

PokerStars Hand #246243009278:  Hold'em No Limit ($0.05/$0.10 CAD) - 2023/09/29 4:13:10 ET
Table 'Periphas III' 6-max Seat #6 is the button
Seat 1: stevo420ca ($12.05 in chips) 
Seat 2: loder2 ($3.65 in chips) 
Seat 3: GFBJEH ($11.97 in chips) 
Seat 4: Zorba1978 ($5.80 in chips) 
Seat 5: CashMatteo ($6.79 in chips) 
Seat 6: TheDoctor7778 ($12.88 in chips) 
stevo420ca: posts small blind $0.05
loder2: posts big blind $0.10
*** HOLE CARDS ***
Dealt to CashMatteo [3c 9s]
GFBJEH: calls $0.10
Zorba1978: folds 
CashMatteo: folds 
TheDoctor7778: raises $0.25 to $0.35
stevo420ca: calls $0.30
loder2: calls $0.25
GFBJEH: calls $0.25
*** FLOP *** [5h Qh 8h]
stevo420ca: checks 
loder2: checks 
GFBJEH: bets $1.34
TheDoctor7778: calls $1.34
stevo420ca: folds 
loder2: folds 
*** TURN *** [5h Qh 8h] [7d]
GFBJEH: bets $1.95
TheDoctor7778: raises $2.30 to $4.25
GFBJEH: calls $2.30
*** RIVER *** [5h Qh 8h 7d] [Qc]
GFBJEH: bets $6.03 and is all-in
TheDoctor7778 said, "he has it "
TheDoctor7778 said, "god damn "
CashMatteo said, "yea maybe"
TheDoctor7778 said, "i have a flush "
TheDoctor7778 said, "but it's crap "
CashMatteo said, "or maybe not"
TheDoctor7778 said, "it's low "
TheDoctor7778: folds 
Uncalled bet ($6.03) returned to GFBJEH
GFBJEH collected $12.01 from pot
*** SUMMARY ***
Total pot $12.58 | Rake $0.57 
Board [5h Qh 8h 7d Qc]
Seat 1: stevo420ca (small blind) folded on the Flop
Seat 2: loder2 (big blind) folded on the Flop
Seat 3: GFBJEH collected ($12.01)
Seat 4: Zorba1978 folded before Flop (didn't bet)
Seat 5: CashMatteo folded before Flop (didn't bet)
Seat 6: TheDoctor7778 (button) folded on the River

Hand #562: 

PokerStars Hand #246243020753:  Hold'em No Limit ($0.05/$0.10 CAD) - 2023/09/29 4:14:55 ET
Table 'Periphas III' 6-max Seat #1 is the button
Seat 1: stevo420ca ($11.70 in chips) 
Seat 2: loder2 ($3.30 in chips) 
Seat 3: GFBJEH ($18.04 in chips) 
Seat 4: Zorba1978 ($5.80 in chips) 
Seat 5: CashMatteo ($6.79 in chips) 
Seat 6: TheDoctor7778 ($6.94 in chips) 
loder2: posts small blind $0.05
GFBJEH: posts big blind $0.10
*** HOLE CARDS ***
Dealt to CashMatteo [7d Qc]
Zorba1978: folds 
CashMatteo: calls $0.10
TheDoctor7778: raises $0.20 to $0.30
stevo420ca: folds 
loder2: calls $0.25
GFBJEH: calls $0.20
CashMatteo: calls $0.20
*** FLOP *** [9d Qs Kc]
loder2: checks 
GFBJEH: checks 
CashMatteo: checks 
TheDoctor7778: bets $0.60
loder2: calls $0.60
GFBJEH: folds 
CashMatteo: folds 
*** TURN *** [9d Qs Kc] [Kd]
loder2: checks 
GFBJEH said, "Flush was good"
TheDoctor7778: checks 
*** RIVER *** [9d Qs Kc Kd] [8h]
loder2: checks 
TheDoctor7778 said, "i wouldn't believe you unless I saw it so whatever "
TheDoctor7778: bets $3.50
loder2: folds 
Uncalled bet ($3.50) returned to TheDoctor7778
TheDoctor7778 collected $2.29 from pot
TheDoctor7778: doesn't show hand 
*** SUMMARY ***
Total pot $2.40 | Rake $0.11 
Board [9d Qs Kc Kd 8h]
Seat 1: stevo420ca (button) folded before Flop (didn't bet)
Seat 2: loder2 (small blind) folded on the River
Seat 3: GFBJEH (big blind) folded on the Flop
Seat 4: Zorba1978 folded before Flop (didn't bet)
Seat 5: CashMatteo folded on the Flop
Seat 6: TheDoctor7778 collected ($2.29)

Hand #563: 

PokerStars Hand #246243029437:  Hold'em No Limit ($0.05/$0.10 CAD) - 2023/09/29 4:16:13 ET
Table 'Periphas III' 6-max Seat #2 is the button
Seat 1: stevo420ca ($11.70 in chips) 
Seat 2: loder2 ($2.40 in chips) 
Seat 3: GFBJEH ($17.74 in chips) 
Seat 4: Zorba1978 ($5.80 in chips) 
Seat 5: CashMatteo ($6.49 in chips) 
Seat 6: TheDoctor7778 ($8.33 in chips) 
GFBJEH: posts small blind $0.05
Zorba1978: posts big blind $0.10
*** HOLE CARDS ***
Dealt to CashMatteo [6d 4d]
CashMatteo: folds 
TheDoctor7778: folds 
stevo420ca: folds 
loder2: calls $0.10
CashMatteo leaves the table
GFBJEH: calls $0.05
Zorba1978: raises $0.10 to $0.20
loder2: calls $0.10
GFBJEH: calls $0.10
*** FLOP *** [8s Ts 5d]
GFBJEH: checks 
Zorba1978: bets $0.29
loder2: folds 
GFBJEH: calls $0.29
*** TURN *** [8s Ts 5d] [9s]
GFBJEH: checks 
Zorba1978: checks 
*** RIVER *** [8s Ts 5d 9s] [Qc]
GFBJEH: checks 
Zorba1978: checks 
*** SHOW DOWN ***
GFBJEH: shows [Kh 5c] (a pair of Fives)
Zorba1978: shows [9h As] (a pair of Nines)
Zorba1978 collected $1.13 from pot
Hulk201 joins the table at seat #5 
*** SUMMARY ***
Total pot $1.18 | Rake $0.05 
Board [8s Ts 5d 9s Qc]
Seat 1: stevo420ca folded before Flop (didn't bet)
Seat 2: loder2 (button) folded on the Flop
Seat 3: GFBJEH (small blind) showed [Kh 5c] and lost with a pair of Fives
Seat 4: Zorba1978 (big blind) showed [9h As] and won ($1.13) with a pair of Nines
Seat 5: CashMatteo folded before Flop (didn't bet)
Seat 6: TheDoctor7778 folded before Flop (didn't bet)

Hand #564: 

PokerStars Hand #246249453840:  Hold'em No Limit ($0.01/$0.02 CAD) - 2023/09/29 13:28:34 ET
Table 'Daedalus' 6-max Seat #2 is the button
Seat 2: CashMatteo ($1.60 in chips) 
Seat 6: Alpinist17 ($2 in chips) 
CashMatteo: posts small blind $0.01
Alpinist17: posts big blind $0.02
*** HOLE CARDS ***
Dealt to CashMatteo [5h 6c]
CashMatteo: calls $0.01
Alpinist17: checks 
*** FLOP *** [6d Ah Th]
Alpinist17: bets $0.02
CashMatteo: calls $0.02
*** TURN *** [6d Ah Th] [3s]
Alpinist17: checks 
CashMatteo: checks 
*** RIVER *** [6d Ah Th 3s] [3c]
Alpinist17: checks 
CashMatteo: bets $0.04
Alpinist17: folds 
Uncalled bet ($0.04) returned to CashMatteo
CashMatteo collected $0.08 from pot
CashMatteo: doesn't show hand 
*** SUMMARY ***
Total pot $0.08 | Rake $0 
Board [6d Ah Th 3s 3c]
Seat 2: CashMatteo (button) (small blind) collected ($0.08)
Seat 6: Alpinist17 (big blind) folded on the River

Hand #565: 

PokerStars Hand #246249462037:  Hold'em No Limit ($0.01/$0.02 CAD) - 2023/09/29 13:29:01 ET
Table 'Daedalus' 6-max Seat #6 is the button
Seat 2: CashMatteo ($1.64 in chips) 
Seat 6: Alpinist17 ($2 in chips) 
Alpinist17: posts small blind $0.01
CashMatteo: posts big blind $0.02
*** HOLE CARDS ***
Dealt to CashMatteo [4h Ts]
Alpinist17: raises $0.02 to $0.04
CashMatteo: folds 
Uncalled bet ($0.02) returned to Alpinist17
Alpinist17 collected $0.04 from pot
*** SUMMARY ***
Total pot $0.04 | Rake $0 
Seat 2: CashMatteo (big blind) folded before Flop
Seat 6: Alpinist17 (button) (small blind) collected ($0.04)

Hand #566: 

PokerStars Hand #246249464665:  Hold'em No Limit ($0.01/$0.02 CAD) - 2023/09/29 13:29:09 ET
Table 'Daedalus' 6-max Seat #2 is the button
Seat 2: CashMatteo ($1.62 in chips) 
Seat 6: Alpinist17 ($2.02 in chips) 
CashMatteo: posts small blind $0.01
Alpinist17: posts big blind $0.02
*** HOLE CARDS ***
Dealt to CashMatteo [8s 5d]
CashMatteo: calls $0.01
Alpinist17: raises $0.04 to $0.06
CashMatteo: calls $0.04
*** FLOP *** [9c Jd 8h]
Alpinist17: bets $0.06
CashMatteo: calls $0.06
*** TURN *** [9c Jd 8h] [4h]
Alpinist17: bets $0.14
CashMatteo: folds 
Uncalled bet ($0.14) returned to Alpinist17
Alpinist17 collected $0.23 from pot
*** SUMMARY ***
Total pot $0.24 | Rake $0.01 
Board [9c Jd 8h 4h]
Seat 2: CashMatteo (button) (small blind) folded on the Turn
Seat 6: Alpinist17 (big blind) collected ($0.23)

Hand #567: 

PokerStars Hand #246249473398:  Hold'em No Limit ($0.01/$0.02 CAD) - 2023/09/29 13:29:37 ET
Table 'Daedalus' 6-max Seat #6 is the button
Seat 2: CashMatteo ($1.50 in chips) 
Seat 6: Alpinist17 ($2.13 in chips) 
Alpinist17: posts small blind $0.01
CashMatteo: posts big blind $0.02
*** HOLE CARDS ***
Dealt to CashMatteo [8s Jd]
Alpinist17: raises $0.04 to $0.06
CashMatteo: calls $0.04
*** FLOP *** [Tc 9s 3h]
CashMatteo: bets $0.12
Alpinist17: calls $0.12
*** TURN *** [Tc 9s 3h] [5d]
CashMatteo: checks 
Alpinist17: checks 
*** RIVER *** [Tc 9s 3h 5d] [5h]
CashMatteo: checks 
Alpinist17: bets $0.30
CashMatteo: folds 
Uncalled bet ($0.30) returned to Alpinist17
Alpinist17 collected $0.35 from pot
*** SUMMARY ***
Total pot $0.36 | Rake $0.01 
Board [Tc 9s 3h 5d 5h]
Seat 2: CashMatteo (big blind) folded on the River
Seat 6: Alpinist17 (button) (small blind) collected ($0.35)

Hand #568: 

PokerStars Hand #246249485159:  Hold'em No Limit ($0.01/$0.02 CAD) - 2023/09/29 13:30:15 ET
Table 'Daedalus' 6-max Seat #2 is the button
Seat 2: CashMatteo ($1.32 in chips) 
Seat 6: Alpinist17 ($2.30 in chips) 
CashMatteo: posts small blind $0.01
Alpinist17: posts big blind $0.02
*** HOLE CARDS ***
Dealt to CashMatteo [3d Th]
CashMatteo: folds 
Uncalled bet ($0.01) returned to Alpinist17
Alpinist17 collected $0.02 from pot
*** SUMMARY ***
Total pot $0.02 | Rake $0 
Seat 2: CashMatteo (button) (small blind) folded before Flop
Seat 6: Alpinist17 (big blind) collected ($0.02)

Hand #569: 

PokerStars Hand #246249487403:  Hold'em No Limit ($0.01/$0.02 CAD) - 2023/09/29 13:30:22 ET
Table 'Daedalus' 6-max Seat #6 is the button
Seat 2: CashMatteo ($1.31 in chips) 
Seat 6: Alpinist17 ($2.31 in chips) 
Alpinist17: posts small blind $0.01
CashMatteo: posts big blind $0.02
*** HOLE CARDS ***
Dealt to CashMatteo [3d Ah]
Alpinist17: folds 
Uncalled bet ($0.01) returned to CashMatteo
CashMatteo collected $0.02 from pot
CashMatteo: doesn't show hand 
*** SUMMARY ***
Total pot $0.02 | Rake $0 
Seat 2: CashMatteo (big blind) collected ($0.02)
Seat 6: Alpinist17 (button) (small blind) folded before Flop

Hand #570: 

PokerStars Hand #246249490441:  Hold'em No Limit ($0.01/$0.02 CAD) - 2023/09/29 13:30:32 ET
Table 'Daedalus' 6-max Seat #2 is the button
Seat 2: CashMatteo ($1.32 in chips) 
Seat 6: Alpinist17 ($2.30 in chips) 
CashMatteo: posts small blind $0.01
Alpinist17: posts big blind $0.02
*** HOLE CARDS ***
Dealt to CashMatteo [Jd 9d]
CashMatteo: raises $0.04 to $0.06
Alpinist17: calls $0.04
*** FLOP *** [8d 6d Js]
Alpinist17: checks 
CashMatteo: bets $0.06
Alpinist17: calls $0.06
*** TURN *** [8d 6d Js] [6c]
Alpinist17: checks 
CashMatteo: bets $0.12
Alpinist17: calls $0.12
*** RIVER *** [8d 6d Js 6c] [7s]
Alpinist17: bets $0.10
CashMatteo: calls $0.10
*** SHOW DOWN ***
Alpinist17: shows [Kh 8h] (two pair, Eights and Sixes)
CashMatteo: shows [Jd 9d] (two pair, Jacks and Sixes)
CashMatteo collected $0.66 from pot
*** SUMMARY ***
Total pot $0.68 | Rake $0.02 
Board [8d 6d Js 6c 7s]
Seat 2: CashMatteo (button) (small blind) showed [Jd 9d] and won ($0.66) with two pair, Jacks and Sixes
Seat 6: Alpinist17 (big blind) showed [Kh 8h] and lost with two pair, Eights and Sixes

Hand #571: 

PokerStars Hand #246249502942:  Hold'em No Limit ($0.01/$0.02 CAD) - 2023/09/29 13:31:13 ET
Table 'Daedalus' 6-max Seat #6 is the button
Seat 2: CashMatteo ($1.64 in chips) 
Seat 6: Alpinist17 ($2 in chips) 
Alpinist17: posts small blind $0.01
CashMatteo: posts big blind $0.02
*** HOLE CARDS ***
Dealt to CashMatteo [6s 3h]
Alpinist17: folds 
Uncalled bet ($0.01) returned to CashMatteo
Alpinist17 leaves the table
CashMatteo collected $0.02 from pot
CashMatteo: doesn't show hand 
*** SUMMARY ***
Total pot $0.02 | Rake $0 
Seat 2: CashMatteo (big blind) collected ($0.02)
Seat 6: Alpinist17 (button) (small blind) folded before Flop

Hand #572: 

PokerStars Hand #246249559427:  Hold'em No Limit ($0.01/$0.02 CAD) - 2023/09/29 13:34:16 ET
Table 'Figneria II' 6-max Seat #3 is the button
Seat 1: picajew93 ($4.46 in chips) 
Seat 2: Nash328 ($1.11 in chips) 
Seat 3: quicklyFolding ($0.59 in chips) 
Seat 4: Cungvui ($0.86 in chips) 
Seat 5: CashMatteo ($1.60 in chips) 
Seat 6: liverpool946 ($1.81 in chips) 
Cungvui: posts small blind $0.01
CashMatteo: posts big blind $0.02
*** HOLE CARDS ***
Dealt to CashMatteo [4h 4d]
liverpool946: calls $0.02
picajew93: folds 
Nash328: calls $0.02
quicklyFolding: folds 
Cungvui: calls $0.01
CashMatteo: raises $0.04 to $0.06
liverpool946: calls $0.04
Nash328: calls $0.04
Cungvui: calls $0.04
*** FLOP *** [Ac Js 6s]
Cungvui: checks 
CashMatteo: checks 
liverpool946: bets $0.04
Nash328: calls $0.04
Cungvui: raises $0.35 to $0.39
CashMatteo: folds 
liverpool946: calls $0.35
Nash328: raises $0.66 to $1.05 and is all-in
Cungvui: calls $0.41 and is all-in
liverpool946: folds 
Uncalled bet ($0.25) returned to Nash328
*** TURN *** [Ac Js 6s] [Td]
*** RIVER *** [Ac Js 6s Td] [4s]
*** SHOW DOWN ***
Cungvui: shows [Jd Ad] (two pair, Aces and Jacks)
Nash328: shows [Jc Jh] (three of a kind, Jacks)
Nash328 collected $2.15 from pot
*** SUMMARY ***
Total pot $2.23 | Rake $0.08 
Board [Ac Js 6s Td 4s]
Seat 1: picajew93 folded before Flop (didn't bet)
Seat 2: Nash328 showed [Jc Jh] and won ($2.15) with three of a kind, Jacks
Seat 3: quicklyFolding (button) folded before Flop (didn't bet)
Seat 4: Cungvui (small blind) showed [Jd Ad] and lost with two pair, Aces and Jacks
Seat 5: CashMatteo (big blind) folded on the Flop
Seat 6: liverpool946 folded on the Flop

Hand #573: 

PokerStars Hand #246249577369:  Hold'em No Limit ($0.01/$0.02 CAD) - 2023/09/29 13:35:15 ET
Table 'Figneria II' 6-max Seat #5 is the button
Seat 1: picajew93 ($4.46 in chips) 
Seat 2: Nash328 ($2.40 in chips) 
Seat 3: quicklyFolding ($0.59 in chips) 
Seat 5: CashMatteo ($1.54 in chips) 
Seat 6: liverpool946 ($1.36 in chips) 
liverpool946: posts small blind $0.01
picajew93: posts big blind $0.02
*** HOLE CARDS ***
Dealt to CashMatteo [4d Ah]
Cungvui leaves the table
Nash328: folds 
quicklyFolding: folds 
CashMatteo: raises $0.04 to $0.06
liverpool946: folds 
picajew93: folds 
Uncalled bet ($0.04) returned to CashMatteo
CashMatteo collected $0.05 from pot
CashMatteo: doesn't show hand 
*** SUMMARY ***
Total pot $0.05 | Rake $0 
Seat 1: picajew93 (big blind) folded before Flop
Seat 2: Nash328 folded before Flop (didn't bet)
Seat 3: quicklyFolding folded before Flop (didn't bet)
Seat 5: CashMatteo (button) collected ($0.05)
Seat 6: liverpool946 (small blind) folded before Flop

Hand #574: 

PokerStars Hand #246249582304:  Hold'em No Limit ($0.01/$0.02 CAD) - 2023/09/29 13:35:31 ET
Table 'Figneria II' 6-max Seat #6 is the button
Seat 1: picajew93 ($4.44 in chips) 
Seat 2: Nash328 ($2.40 in chips) 
Seat 3: quicklyFolding ($0.59 in chips) 
Seat 5: CashMatteo ($1.57 in chips) 
Seat 6: liverpool946 ($1.35 in chips) 
picajew93: posts small blind $0.01
Nash328: posts big blind $0.02
*** HOLE CARDS ***
Dealt to CashMatteo [9h 6s]
momonnez joins the table at seat #4 
quicklyFolding: folds 
CashMatteo: raises $0.04 to $0.06
liverpool946: folds 
picajew93: folds 
Nash328: calls $0.04
*** FLOP *** [Ah 2h Js]
Nash328: checks 
CashMatteo: checks 
*** TURN *** [Ah 2h Js] [Qc]
Nash328: checks 
CashMatteo: checks 
*** RIVER *** [Ah 2h Js Qc] [7h]
Nash328: checks 
CashMatteo: bets $0.07
Nash328: folds 
Uncalled bet ($0.07) returned to CashMatteo
CashMatteo collected $0.13 from pot
CashMatteo: doesn't show hand 
*** SUMMARY ***
Total pot $0.13 | Rake $0 
Board [Ah 2h Js Qc 7h]
Seat 1: picajew93 (small blind) folded before Flop
Seat 2: Nash328 (big blind) folded on the River
Seat 3: quicklyFolding folded before Flop (didn't bet)
Seat 5: CashMatteo collected ($0.13)
Seat 6: liverpool946 (button) folded before Flop (didn't bet)

Hand #575: 

PokerStars Hand #246249593089:  Hold'em No Limit ($0.01/$0.02 CAD) - 2023/09/29 13:36:06 ET
Table 'Figneria II' 6-max Seat #1 is the button
Seat 1: picajew93 ($4.43 in chips) 
Seat 2: Nash328 ($2.34 in chips) 
Seat 3: quicklyFolding ($0.59 in chips) 
Seat 4: momonnez ($2 in chips) 
Seat 5: CashMatteo ($1.64 in chips) 
Seat 6: liverpool946 ($1.35 in chips) 
Nash328: posts small blind $0.01
quicklyFolding: posts big blind $0.02
momonnez: posts big blind $0.02
*** HOLE CARDS ***
Dealt to CashMatteo [5c 3d]
momonnez: checks 
CashMatteo: folds 
liverpool946: calls $0.02
picajew93: calls $0.02
Nash328: folds 
quicklyFolding: checks 
*** FLOP *** [4d 3c Ts]
quicklyFolding: checks 
momonnez: checks 
liverpool946: checks 
picajew93: checks 
*** TURN *** [4d 3c Ts] [8d]
quicklyFolding: bets $0.04
momonnez: folds 
liverpool946: calls $0.04
picajew93: folds 
*** RIVER *** [4d 3c Ts 8d] [7h]
quicklyFolding: bets $0.08
liverpool946: calls $0.08
*** SHOW DOWN ***
quicklyFolding: shows [Jh 9h] (a straight, Seven to Jack)
liverpool946: mucks hand 
quicklyFolding collected $0.32 from pot
*** SUMMARY ***
Total pot $0.33 | Rake $0.01 
Board [4d 3c Ts 8d 7h]
Seat 1: picajew93 (button) folded on the Turn
Seat 2: Nash328 (small blind) folded before Flop
Seat 3: quicklyFolding (big blind) showed [Jh 9h] and won ($0.32) with a straight, Seven to Jack
Seat 4: momonnez folded on the Turn (didn't bet)
Seat 5: CashMatteo folded before Flop (didn't bet)
Seat 6: liverpool946 mucked [Ah 8h]

Hand #576: 

PokerStars Hand #246249612145:  Hold'em No Limit ($0.01/$0.02 CAD) - 2023/09/29 13:37:07 ET
Table 'Figneria II' 6-max Seat #2 is the button
Seat 1: picajew93 ($4.41 in chips) 
Seat 2: Nash328 ($2.33 in chips) 
Seat 3: quicklyFolding ($0.77 in chips) 
Seat 4: momonnez ($1.98 in chips) 
Seat 5: CashMatteo ($1.64 in chips) 
Seat 6: liverpool946 ($1.21 in chips) 
quicklyFolding: posts small blind $0.01
momonnez: posts big blind $0.02
*** HOLE CARDS ***
Dealt to CashMatteo [4c Qc]
CashMatteo: calls $0.02
liverpool946: folds 
picajew93: calls $0.02
Nash328: calls $0.02
quicklyFolding: calls $0.01
momonnez: checks 
*** FLOP *** [Jc 3s 9c]
quicklyFolding: checks 
momonnez: bets $0.02
CashMatteo: raises $0.14 to $0.16
picajew93: calls $0.16
Nash328: folds 
quicklyFolding: calls $0.16
momonnez: calls $0.14
*** TURN *** [Jc 3s 9c] [2h]
quicklyFolding: checks 
momonnez: checks 
CashMatteo: checks 
picajew93: bets $0.50
quicklyFolding: calls $0.50
momonnez: calls $0.50
CashMatteo: calls $0.50
*** RIVER *** [Jc 3s 9c 2h] [7c]
quicklyFolding: checks 
momonnez: checks 
CashMatteo: checks 
picajew93: bets $3.73 and is all-in
quicklyFolding: calls $0.09 and is all-in
momonnez: calls $1.30 and is all-in
CashMatteo: calls $0.96 and is all-in
Uncalled bet ($2.43) returned to picajew93
*** SHOW DOWN ***
picajew93: shows [9h 8c] (a pair of Nines)
momonnez: shows [3d Jh] (two pair, Jacks and Threes)
momonnez collected $0.66 from side pot-2 
CashMatteo: shows [4c Qc] (a flush, Queen high)
CashMatteo collected $2.52 from side pot-1 
quicklyFolding: shows [Js Th] (a pair of Jacks)
CashMatteo collected $2.99 from main pot
*** SUMMARY ***
Total pot $6.39 Main pot $2.99. Side pot-1 $2.52. Side pot-2 $0.66. | Rake $0.22 
Board [Jc 3s 9c 2h 7c]
Seat 1: picajew93 showed [9h 8c] and lost with a pair of Nines
Seat 2: Nash328 (button) folded on the Flop
Seat 3: quicklyFolding (small blind) showed [Js Th] and lost with a pair of Jacks
Seat 4: momonnez (big blind) showed [3d Jh] and won ($0.66) with two pair, Jacks and Threes
Seat 5: CashMatteo showed [4c Qc] and won ($5.51) with a flush, Queen high
Seat 6: liverpool946 folded before Flop (didn't bet)

Hand #577: 

PokerStars Hand #246249641449:  Hold'em No Limit ($0.01/$0.02 CAD) - 2023/09/29 13:38:42 ET
Table 'Figneria II' 6-max Seat #4 is the button
Seat 1: picajew93 ($2.43 in chips) 
Seat 2: Nash328 ($2.31 in chips) 
Seat 4: momonnez ($0.66 in chips) 
Seat 5: CashMatteo ($5.51 in chips) 
Seat 6: liverpool946 ($1.21 in chips) 
CashMatteo: posts small blind $0.01
liverpool946: posts big blind $0.02
*** HOLE CARDS ***
Dealt to CashMatteo [Qs 8s]
picajew93: calls $0.02
quicklyFolding leaves the table
Nash328: folds 
momonnez: raises $0.02 to $0.04
CashMatteo: calls $0.03
liverpool946: folds 
picajew93: calls $0.02
*** FLOP *** [Js Kd Td]
CashMatteo: checks 
picajew93: checks 
momonnez: bets $0.02
CashMatteo: calls $0.02
picajew93: calls $0.02
*** TURN *** [Js Kd Td] [9c]
CashMatteo: checks 
picajew93: bets $0.20
momonnez: calls $0.20
CashMatteo: raises $0.79 to $0.99
picajew93: folds 
momonnez: calls $0.40 and is all-in
Uncalled bet ($0.39) returned to CashMatteo
*** RIVER *** [Js Kd Td 9c] [6c]
*** SHOW DOWN ***
CashMatteo: shows [Qs 8s] (a straight, Nine to King)
momonnez: shows [Tc Th] (three of a kind, Tens)
CashMatteo collected $1.54 from pot
*** SUMMARY ***
Total pot $1.60 | Rake $0.06 
Board [Js Kd Td 9c 6c]
Seat 1: picajew93 folded on the Turn
Seat 2: Nash328 folded before Flop (didn't bet)
Seat 4: momonnez (button) showed [Tc Th] and lost with three of a kind, Tens
Seat 5: CashMatteo (small blind) showed [Qs 8s] and won ($1.54) with a straight, Nine to King
Seat 6: liverpool946 (big blind) folded before Flop

Hand #578: 

PokerStars Hand #246249664482:  Hold'em No Limit ($0.01/$0.02 CAD) - 2023/09/29 13:39:56 ET
Table 'Figneria II' 6-max Seat #5 is the button
Seat 1: picajew93 ($2.17 in chips) 
Seat 2: Nash328 ($2.31 in chips) 
Seat 5: CashMatteo ($6.39 in chips) 
Seat 6: liverpool946 ($1.19 in chips) 
liverpool946: posts small blind $0.01
picajew93: posts big blind $0.02
*** HOLE CARDS ***
Dealt to CashMatteo [Ks 8h]
Nash328: calls $0.02
CashMatteo: calls $0.02
liverpool946: calls $0.01
picajew93: checks 
*** FLOP *** [Ts 9d 2s]
liverpool946: checks 
picajew93: checks 
Nash328: checks 
CashMatteo: checks 
*** TURN *** [Ts 9d 2s] [8d]
liverpool946: checks 
picajew93: bets $0.08
GMJames joins the table at seat #3 
Nash328: folds 
CashMatteo: calls $0.08
liverpool946: calls $0.08
*** RIVER *** [Ts 9d 2s 8d] [2h]
liverpool946: bets $0.04
picajew93: folds 
CashMatteo: calls $0.04
*** SHOW DOWN ***
liverpool946: shows [9s 3c] (two pair, Nines and Deuces)
CashMatteo: mucks hand 
liverpool946 collected $0.39 from pot
*** SUMMARY ***
Total pot $0.40 | Rake $0.01 
Board [Ts 9d 2s 8d 2h]
Seat 1: picajew93 (big blind) folded on the River
Seat 2: Nash328 folded on the Turn
Seat 5: CashMatteo (button) mucked [Ks 8h]
Seat 6: liverpool946 (small blind) showed [9s 3c] and won ($0.39) with two pair, Nines and Deuces

Hand #579: 

PokerStars Hand #246249675470:  Hold'em No Limit ($0.01/$0.02 CAD) - 2023/09/29 13:40:31 ET
Table 'Figneria II' 6-max Seat #6 is the button
Seat 1: picajew93 ($2.07 in chips) 
Seat 2: Nash328 ($2.29 in chips) 
Seat 3: GMJames ($0.80 in chips) 
Seat 5: CashMatteo ($6.25 in chips) 
Seat 6: liverpool946 ($1.44 in chips) 
picajew93: posts small blind $0.01
Nash328: posts big blind $0.02
GMJames: posts big blind $0.02
*** HOLE CARDS ***
Dealt to CashMatteo [5s Tc]
GMJames: checks 
CashMatteo: folds 
liverpool946: folds 
picajew93: raises $0.18 to $0.20
Nash328: folds 
momonnez is disconnected 
GMJames: folds 
Uncalled bet ($0.18) returned to picajew93
picajew93 collected $0.06 from pot
picajew93: doesn't show hand 
*** SUMMARY ***
Total pot $0.06 | Rake $0 
Seat 1: picajew93 (small blind) collected ($0.06)
Seat 2: Nash328 (big blind) folded before Flop
Seat 3: GMJames folded before Flop (didn't bet)
Seat 5: CashMatteo folded before Flop (didn't bet)
Seat 6: liverpool946 (button) folded before Flop (didn't bet)

Hand #580: 

PokerStars Hand #246249681673:  Hold'em No Limit ($0.01/$0.02 CAD) - 2023/09/29 13:40:52 ET
Table 'Figneria II' 6-max Seat #1 is the button
Seat 1: picajew93 ($2.11 in chips) 
Seat 2: Nash328 ($2.27 in chips) 
Seat 3: GMJames ($0.78 in chips) 
Seat 5: CashMatteo ($6.25 in chips) 
Seat 6: liverpool946 ($1.44 in chips) 
Nash328: posts small blind $0.01
GMJames: posts big blind $0.02
*** HOLE CARDS ***
Dealt to CashMatteo [6c 5d]
CashMatteo: calls $0.02
liverpool946: calls $0.02
picajew93: raises $0.08 to $0.10
Nash328: folds 
GMJames: calls $0.08
CashMatteo: folds 
liverpool946: calls $0.08
*** FLOP *** [5h Th Jd]
GMJames: checks 
liverpool946: checks 
picajew93: bets $0.20
GMJames: calls $0.20
liverpool946: folds 
*** TURN *** [5h Th Jd] [Kd]
GMJames: checks 
picajew93: bets $0.48
GMJames: calls $0.48 and is all-in
*** RIVER *** [5h Th Jd Kd] [Qd]
*** SHOW DOWN ***
GMJames: shows [3h Kh] (a pair of Kings)
picajew93: shows [Ac 5s] (a straight, Ten to Ace)
picajew93 collected $1.63 from pot
*** SUMMARY ***
Total pot $1.69 | Rake $0.06 
Board [5h Th Jd Kd Qd]
Seat 1: picajew93 (button) showed [Ac 5s] and won ($1.63) with a straight, Ten to Ace
Seat 2: Nash328 (small blind) folded before Flop
Seat 3: GMJames (big blind) showed [3h Kh] and lost with a pair of Kings
Seat 5: CashMatteo folded before Flop
Seat 6: liverpool946 folded on the Flop

Hand #581: 

PokerStars Hand #246249698086:  Hold'em No Limit ($0.01/$0.02 CAD) - 2023/09/29 13:41:45 ET
Table 'Figneria II' 6-max Seat #2 is the button
Seat 1: picajew93 ($2.96 in chips) 
Seat 2: Nash328 ($2.26 in chips) 
Seat 5: CashMatteo ($6.23 in chips) 
Seat 6: liverpool946 ($1.34 in chips) 
CashMatteo: posts small blind $0.01
liverpool946: posts big blind $0.02
*** HOLE CARDS ***
Dealt to CashMatteo [Jc 7s]
picajew93: folds 
Nash328: calls $0.02
CashMatteo: calls $0.01
liverpool946: raises $0.02 to $0.04
Nash328: calls $0.02
CashMatteo: calls $0.02
*** FLOP *** [2s 3c Kd]
GMJames leaves the table
CashMatteo: checks 
liverpool946: checks 
Nash328: bets $0.06
CashMatteo: folds 
liverpool946: calls $0.06
*** TURN *** [2s 3c Kd] [Js]
liverpool946: bets $0.02
Nash328: raises $0.14 to $0.16
liverpool946: folds 
Uncalled bet ($0.14) returned to Nash328
Nash328 collected $0.27 from pot
*** SUMMARY ***
Total pot $0.28 | Rake $0.01 
Board [2s 3c Kd Js]
Seat 1: picajew93 folded before Flop (didn't bet)
Seat 2: Nash328 (button) collected ($0.27)
Seat 5: CashMatteo (small blind) folded on the Flop
Seat 6: liverpool946 (big blind) folded on the Turn

Hand #582: 

PokerStars Hand #246249708701:  Hold'em No Limit ($0.01/$0.02 CAD) - 2023/09/29 13:42:20 ET
Table 'Figneria II' 6-max Seat #5 is the button
Seat 1: picajew93 ($2.96 in chips) 
Seat 2: Nash328 ($2.41 in chips) 
Seat 5: CashMatteo ($6.19 in chips) 
Seat 6: liverpool946 ($1.22 in chips) 
liverpool946: posts small blind $0.01
picajew93: posts big blind $0.02
*** HOLE CARDS ***
Dealt to CashMatteo [Kh As]
Nash328: folds 
CashMatteo: raises $0.04 to $0.06
liverpool946: folds 
picajew93: calls $0.04
*** FLOP *** [4h 2s 9d]
picajew93: checks 
CashMatteo: checks 
*** TURN *** [4h 2s 9d] [9c]
picajew93: bets $0.08
CashMatteo: calls $0.08
*** RIVER *** [4h 2s 9d 9c] [Ac]
picajew93: checks 
CashMatteo: bets $0.14
picajew93: calls $0.14
*** SHOW DOWN ***
CashMatteo: shows [Kh As] (two pair, Aces and Nines)
picajew93: mucks hand 
CashMatteo collected $0.55 from pot
*** SUMMARY ***
Total pot $0.57 | Rake $0.02 
Board [4h 2s 9d 9c Ac]
Seat 1: picajew93 (big blind) mucked [Jh 4s]
Seat 2: Nash328 folded before Flop (didn't bet)
Seat 5: CashMatteo (button) showed [Kh As] and won ($0.55) with two pair, Aces and Nines
Seat 6: liverpool946 (small blind) folded before Flop

Hand #583: 

PokerStars Hand #246249721336:  Hold'em No Limit ($0.01/$0.02 CAD) - 2023/09/29 13:43:01 ET
Table 'Figneria II' 6-max Seat #6 is the button
Seat 1: picajew93 ($2.68 in chips) 
Seat 2: Nash328 ($2.41 in chips) 
Seat 5: CashMatteo ($6.46 in chips) 
Seat 6: liverpool946 ($1.21 in chips) 
picajew93: posts small blind $0.01
Nash328: posts big blind $0.02
*** HOLE CARDS ***
Dealt to CashMatteo [2c 8h]
bubbarl joins the table at seat #3 
CashMatteo: folds 
liverpool946: calls $0.02
picajew93: calls $0.01
Nash328: checks 
*** FLOP *** [4h Ac 9s]
picajew93: checks 
Nash328: checks 
liverpool946: checks 
*** TURN *** [4h Ac 9s] [Th]
picajew93: checks 
Nash328: checks 
liverpool946: checks 
*** RIVER *** [4h Ac 9s Th] [Kc]
picajew93: checks 
Nash328: checks 
liverpool946: bets $0.06
picajew93: folds 
Nash328: folds 
Uncalled bet ($0.06) returned to liverpool946
liverpool946 collected $0.06 from pot
*** SUMMARY ***
Total pot $0.06 | Rake $0 
Board [4h Ac 9s Th Kc]
Seat 1: picajew93 (small blind) folded on the River
Seat 2: Nash328 (big blind) folded on the River
Seat 5: CashMatteo folded before Flop (didn't bet)
Seat 6: liverpool946 (button) collected ($0.06)

Hand #584: 

PokerStars Hand #246249734595:  Hold'em No Limit ($0.01/$0.02 CAD) - 2023/09/29 13:43:44 ET
Table 'Figneria II' 6-max Seat #1 is the button
Seat 1: picajew93 ($2.66 in chips) 
Seat 2: Nash328 ($2.39 in chips) 
Seat 3: bubbarl ($2 in chips) 
Seat 5: CashMatteo ($6.46 in chips) 
Seat 6: liverpool946 ($1.25 in chips) 
Nash328: posts small blind $0.01
bubbarl: posts big blind $0.02
*** HOLE CARDS ***
Dealt to CashMatteo [Qh 6d]
CashMatteo: calls $0.02
liverpool946: folds 
picajew93: calls $0.02
Nash328: raises $0.02 to $0.04
bubbarl: folds 
CashMatteo: calls $0.02
picajew93: calls $0.02
*** FLOP *** [2s Jd Ts]
Nash328: checks 
CashMatteo: checks 
picajew93: bets $0.10
Nash328: calls $0.10
CashMatteo: folds 
*** TURN *** [2s Jd Ts] [8h]
Nash328: checks 
picajew93: checks 
*** RIVER *** [2s Jd Ts 8h] [8s]
Nash328: bets $0.17
picajew93: folds 
Uncalled bet ($0.17) returned to Nash328
Nash328 collected $0.33 from pot
*** SUMMARY ***
Total pot $0.34 | Rake $0.01 
Board [2s Jd Ts 8h 8s]
Seat 1: picajew93 (button) folded on the River
Seat 2: Nash328 (small blind) collected ($0.33)
Seat 3: bubbarl (big blind) folded before Flop
Seat 5: CashMatteo folded on the Flop
Seat 6: liverpool946 folded before Flop (didn't bet)

Hand #585: 

PokerStars Hand #246249749326:  Hold'em No Limit ($0.01/$0.02 CAD) - 2023/09/29 13:44:31 ET
Table 'Figneria II' 6-max Seat #2 is the button
Seat 1: picajew93 ($2.52 in chips) 
Seat 2: Nash328 ($2.58 in chips) 
Seat 3: bubbarl ($1.98 in chips) 
Seat 5: CashMatteo ($6.42 in chips) 
Seat 6: liverpool946 ($1.25 in chips) 
bubbarl: posts small blind $0.01
CashMatteo: posts big blind $0.02
*** HOLE CARDS ***
Dealt to CashMatteo [2c Qc]
liverpool946: folds 
picajew93: calls $0.02
Nash328: calls $0.02
bubbarl: folds 
CashMatteo: checks 
*** FLOP *** [Kh 8h 9s]
CashMatteo: checks 
picajew93: bets $0.10
Nash328: calls $0.10
CashMatteo: folds 
*** TURN *** [Kh 8h 9s] [Jh]
picajew93: checks 
Nash328: checks 
*** RIVER *** [Kh 8h 9s Jh] [6s]
picajew93: checks 
Nash328: checks 
*** SHOW DOWN ***
picajew93: shows [7c Ah] (high card Ace)
Nash328: shows [9c 8s] (two pair, Nines and Eights)
Nash328 collected $0.26 from pot
*** SUMMARY ***
Total pot $0.27 | Rake $0.01 
Board [Kh 8h 9s Jh 6s]
Seat 1: picajew93 showed [7c Ah] and lost with high card Ace
Seat 2: Nash328 (button) showed [9c 8s] and won ($0.26) with two pair, Nines and Eights
Seat 3: bubbarl (small blind) folded before Flop
Seat 5: CashMatteo (big blind) folded on the Flop
Seat 6: liverpool946 folded before Flop (didn't bet)

Hand #586: 

PokerStars Hand #246249764935:  Hold'em No Limit ($0.01/$0.02 CAD) - 2023/09/29 13:45:21 ET
Table 'Figneria II' 6-max Seat #3 is the button
Seat 1: picajew93 ($2.40 in chips) 
Seat 2: Nash328 ($2.72 in chips) 
Seat 3: bubbarl ($1.97 in chips) 
Seat 5: CashMatteo ($6.40 in chips) 
Seat 6: liverpool946 ($1.25 in chips) 
CashMatteo: posts small blind $0.01
liverpool946: posts big blind $0.02
*** HOLE CARDS ***
Dealt to CashMatteo [Ac 8s]
picajew93: calls $0.02
Nash328: folds 
bubbarl: folds 
CashMatteo: raises $0.04 to $0.06
momonnez is disconnected 
liverpool946: calls $0.04
picajew93: calls $0.04
*** FLOP *** [4h 6d 6c]
CashMatteo: bets $0.09
liverpool946: folds 
picajew93: calls $0.09
*** TURN *** [4h 6d 6c] [Kd]
CashMatteo: checks 
picajew93: checks 
*** RIVER *** [4h 6d 6c Kd] [5c]
CashMatteo: checks 
picajew93: bets $0.50
CashMatteo: folds 
Uncalled bet ($0.50) returned to picajew93
picajew93 collected $0.35 from pot
picajew93: doesn't show hand 
*** SUMMARY ***
Total pot $0.36 | Rake $0.01 
Board [4h 6d 6c Kd 5c]
Seat 1: picajew93 collected ($0.35)
Seat 2: Nash328 folded before Flop (didn't bet)
Seat 3: bubbarl (button) folded before Flop (didn't bet)
Seat 5: CashMatteo (small blind) folded on the River
Seat 6: liverpool946 (big blind) folded on the Flop

Hand #587: 

PokerStars Hand #246249782422:  Hold'em No Limit ($0.01/$0.02 CAD) - 2023/09/29 13:46:18 ET
Table 'Figneria II' 6-max Seat #5 is the button
Seat 1: picajew93 ($2.60 in chips) 
Seat 2: Nash328 ($2.72 in chips) 
Seat 3: bubbarl ($1.97 in chips) 
Seat 5: CashMatteo ($6.25 in chips) 
Seat 6: liverpool946 ($1.19 in chips) 
liverpool946: posts small blind $0.01
picajew93: posts big blind $0.02
*** HOLE CARDS ***
Dealt to CashMatteo [Qd Kh]
Nash328: calls $0.02
bubbarl: folds 
CashMatteo: raises $0.04 to $0.06
liverpool946: folds 
picajew93: folds 
Nash328: calls $0.04
*** FLOP *** [Js Jd 9d]
Nash328: checks 
CashMatteo: checks 
*** TURN *** [Js Jd 9d] [6c]
Nash328: bets $0.07
CashMatteo: calls $0.07
*** RIVER *** [Js Jd 9d 6c] [Ks]
Nash328: bets $0.02
CashMatteo: raises $0.16 to $0.18
Nash328: calls $0.16
*** SHOW DOWN ***
CashMatteo: shows [Qd Kh] (two pair, Kings and Jacks)
Nash328: mucks hand 
CashMatteo collected $0.63 from pot
*** SUMMARY ***
Total pot $0.65 | Rake $0.02 
Board [Js Jd 9d 6c Ks]
Seat 1: picajew93 (big blind) folded before Flop
Seat 2: Nash328 mucked [Ac 9s]
Seat 3: bubbarl folded before Flop (didn't bet)
Seat 5: CashMatteo (button) showed [Qd Kh] and won ($0.63) with two pair, Kings and Jacks
Seat 6: liverpool946 (small blind) folded before Flop

Hand #588: 

PokerStars Hand #246249800763:  Hold'em No Limit ($0.01/$0.02 CAD) - 2023/09/29 13:47:17 ET
Table 'Figneria II' 6-max Seat #6 is the button
Seat 1: picajew93 ($2.58 in chips) 
Seat 2: Nash328 ($2.41 in chips) 
Seat 3: bubbarl ($1.97 in chips) 
Seat 5: CashMatteo ($6.57 in chips) 
Seat 6: liverpool946 ($1.18 in chips) 
picajew93: posts small blind $0.01
Nash328: posts big blind $0.02
*** HOLE CARDS ***
Dealt to CashMatteo [3h Ad]
bubbarl: folds 
CashMatteo: raises $0.04 to $0.06
liverpool946: calls $0.06
picajew93: folds 
Nash328: folds 
*** FLOP *** [Qd 6c 5d]
CashMatteo: checks 
liverpool946: checks 
*** TURN *** [Qd 6c 5d] [2c]
Nash328 leaves the table
CashMatteo: checks 
liverpool946: checks 
*** RIVER *** [Qd 6c 5d 2c] [9s]
CashMatteo: bets $0.07
liverpool946: folds 
Uncalled bet ($0.07) returned to CashMatteo
CashMatteo collected $0.14 from pot
CashMatteo: doesn't show hand 
*** SUMMARY ***
Total pot $0.15 | Rake $0.01 
Board [Qd 6c 5d 2c 9s]
Seat 1: picajew93 (small blind) folded before Flop
Seat 2: Nash328 (big blind) folded before Flop
Seat 3: bubbarl folded before Flop (didn't bet)
Seat 5: CashMatteo collected ($0.14)
Seat 6: liverpool946 (button) folded on the River

Hand #589: 

PokerStars Hand #246249810691:  Hold'em No Limit ($0.01/$0.02 CAD) - 2023/09/29 13:47:49 ET
Table 'Figneria II' 6-max Seat #1 is the button
Seat 1: picajew93 ($2.57 in chips) 
Seat 3: bubbarl ($1.97 in chips) 
Seat 5: CashMatteo ($6.65 in chips) 
Seat 6: liverpool946 ($1.12 in chips) 
bubbarl: posts small blind $0.01
CashMatteo: posts big blind $0.02
*** HOLE CARDS ***
Dealt to CashMatteo [5d 7d]
liverpool946: folds 
picajew93: calls $0.02
bubbarl: calls $0.01
CashMatteo: checks 
*** FLOP *** [4c 4s Kd]
bubbarl: checks 
CashMatteo: checks 
picajew93: checks 
*** TURN *** [4c 4s Kd] [5c]
bubbarl: bets $0.02
CashMatteo: calls $0.02
picajew93: folds 
*** RIVER *** [4c 4s Kd 5c] [2c]
zViveXz joins the table at seat #2 
bubbarl: bets $0.10
CashMatteo: folds 
Uncalled bet ($0.10) returned to bubbarl
bubbarl collected $0.10 from pot
bubbarl: doesn't show hand 
*** SUMMARY ***
Total pot $0.10 | Rake $0 
Board [4c 4s Kd 5c 2c]
Seat 1: picajew93 (button) folded on the Turn
Seat 3: bubbarl (small blind) collected ($0.10)
Seat 5: CashMatteo (big blind) folded on the River
Seat 6: liverpool946 folded before Flop (didn't bet)

Hand #590: 

PokerStars Hand #246249822914:  Hold'em No Limit ($0.01/$0.02 CAD) - 2023/09/29 13:48:29 ET
Table 'Figneria II' 6-max Seat #3 is the button
Seat 1: picajew93 ($2.55 in chips) 
Seat 2: zViveXz ($2 in chips) 
Seat 3: bubbarl ($2.03 in chips) 
Seat 5: CashMatteo ($6.61 in chips) 
Seat 6: liverpool946 ($1.12 in chips) 
CashMatteo: posts small blind $0.01
liverpool946: posts big blind $0.02
zViveXz: posts big blind $0.02
*** HOLE CARDS ***
Dealt to CashMatteo [4d 2s]
picajew93: calls $0.02
zViveXz: checks 
bubbarl: folds 
CashMatteo: folds 
liverpool946: checks 
*** FLOP *** [7s Qd Kc]
liverpool946: checks 
picajew93: checks 
zViveXz: checks 
*** TURN *** [7s Qd Kc] [2h]
liverpool946: checks 
picajew93: checks 
zViveXz: bets $0.04
liverpool946: folds 
picajew93: folds 
Uncalled bet ($0.04) returned to zViveXz
zViveXz collected $0.07 from pot
*** SUMMARY ***
Total pot $0.07 | Rake $0 
Board [7s Qd Kc 2h]
Seat 1: picajew93 folded on the Turn
Seat 2: zViveXz collected ($0.07)
Seat 3: bubbarl (button) folded before Flop (didn't bet)
Seat 5: CashMatteo (small blind) folded before Flop
Seat 6: liverpool946 (big blind) folded on the Turn

Hand #591: 

PokerStars Hand #246249840782:  Hold'em No Limit ($0.01/$0.02 CAD) - 2023/09/29 13:49:27 ET
Table 'Figneria II' 6-max Seat #5 is the button
Seat 1: picajew93 ($2.53 in chips) 
Seat 2: zViveXz ($2.05 in chips) 
Seat 3: bubbarl ($2.03 in chips) 
Seat 5: CashMatteo ($6.60 in chips) 
Seat 6: liverpool946 ($1.10 in chips) 
liverpool946: posts small blind $0.01
picajew93: posts big blind $0.02
*** HOLE CARDS ***
Dealt to CashMatteo [7c Jh]
zViveXz: raises $0.04 to $0.06
bubbarl: folds 
CashMatteo: calls $0.06
liverpool946: folds 
picajew93: calls $0.04
*** FLOP *** [3h 3d 4s]
picajew93: bets $0.06
zViveXz: calls $0.06
CashMatteo: folds 
*** TURN *** [3h 3d 4s] [6s]
picajew93: checks 
zViveXz: checks 
*** RIVER *** [3h 3d 4s 6s] [4h]
picajew93: checks 
zViveXz: checks 
*** SHOW DOWN ***
picajew93: shows [4c 3c] (a full house, Fours full of Threes)
zViveXz: mucks hand 
picajew93 collected $0.30 from pot
*** SUMMARY ***
Total pot $0.31 | Rake $0.01 
Board [3h 3d 4s 6s 4h]
Seat 1: picajew93 (big blind) showed [4c 3c] and won ($0.30) with a full house, Fours full of Threes
Seat 2: zViveXz mucked [Ac Js]
Seat 3: bubbarl folded before Flop (didn't bet)
Seat 5: CashMatteo (button) folded on the Flop
Seat 6: liverpool946 (small blind) folded before Flop

Hand #592: 

PokerStars Hand #246249856547:  Hold'em No Limit ($0.01/$0.02 CAD) - 2023/09/29 13:50:18 ET
Table 'Figneria II' 6-max Seat #6 is the button
Seat 1: picajew93 ($2.71 in chips) 
Seat 2: zViveXz ($1.93 in chips) 
Seat 3: bubbarl ($2.03 in chips) 
Seat 5: CashMatteo ($6.54 in chips) 
Seat 6: liverpool946 ($1.09 in chips) 
picajew93: posts small blind $0.01
zViveXz: posts big blind $0.02
*** HOLE CARDS ***
Dealt to CashMatteo [As 2c]
bubbarl: calls $0.02
CashMatteo: calls $0.02
liverpool946: calls $0.02
picajew93: calls $0.01
zViveXz: checks 
*** FLOP *** [Ks 3d 8s]
picajew93: checks 
zViveXz: checks 
bubbarl: checks 
CashMatteo: checks 
liverpool946: checks 
*** TURN *** [Ks 3d 8s] [6c]
picajew93: checks 
zViveXz: checks 
bubbarl: bets $0.10
CashMatteo: folds 
liverpool946: folds 
picajew93: folds 
zViveXz: folds 
Uncalled bet ($0.10) returned to bubbarl
bubbarl collected $0.10 from pot
bubbarl: doesn't show hand 
*** SUMMARY ***
Total pot $0.10 | Rake $0 
Board [Ks 3d 8s 6c]
Seat 1: picajew93 (small blind) folded on the Turn
Seat 2: zViveXz (big blind) folded on the Turn
Seat 3: bubbarl collected ($0.10)
Seat 5: CashMatteo folded on the Turn
Seat 6: liverpool946 (button) folded on the Turn

Hand #593: 

PokerStars Hand #246249871048:  Hold'em No Limit ($0.01/$0.02 CAD) - 2023/09/29 13:51:05 ET
Table 'Figneria II' 6-max Seat #1 is the button
Seat 1: picajew93 ($2.69 in chips) 
Seat 2: zViveXz ($1.91 in chips) 
Seat 3: bubbarl ($2.11 in chips) 
Seat 5: CashMatteo ($6.52 in chips) 
Seat 6: liverpool946 ($1.07 in chips) 
zViveXz: posts small blind $0.01
bubbarl: posts big blind $0.02
*** HOLE CARDS ***
Dealt to CashMatteo [3c 6c]
CashMatteo: folds 
liverpool946: folds 
picajew93: calls $0.02
zViveXz: calls $0.01
bubbarl: checks 
*** FLOP *** [9s Jc 9c]
zViveXz: checks 
bubbarl: checks 
picajew93: checks 
*** TURN *** [9s Jc 9c] [Th]
zViveXz: checks 
bubbarl: bets $0.10
picajew93: folds 
zViveXz: folds 
Uncalled bet ($0.10) returned to bubbarl
bubbarl collected $0.06 from pot
bubbarl: doesn't show hand 
*** SUMMARY ***
Total pot $0.06 | Rake $0 
Board [9s Jc 9c Th]
Seat 1: picajew93 (button) folded on the Turn
Seat 2: zViveXz (small blind) folded on the Turn
Seat 3: bubbarl (big blind) collected ($0.06)
Seat 5: CashMatteo folded before Flop (didn't bet)
Seat 6: liverpool946 folded before Flop (didn't bet)

Hand #594: 

PokerStars Hand #246249882802:  Hold'em No Limit ($0.01/$0.02 CAD) - 2023/09/29 13:51:43 ET
Table 'Figneria II' 6-max Seat #2 is the button
Seat 2: zViveXz ($1.89 in chips) 
Seat 3: bubbarl ($2.15 in chips) 
Seat 5: CashMatteo ($6.52 in chips) 
Seat 6: liverpool946 ($1.07 in chips) 
bubbarl: posts small blind $0.01
CashMatteo: posts big blind $0.02
*** HOLE CARDS ***
Dealt to CashMatteo [5d 8h]
liverpool946: calls $0.02
zViveXz: folds 
bubbarl: calls $0.01
CashMatteo: checks 
*** FLOP *** [6s 2s 9d]
bubbarl: checks 
CashMatteo: checks 
liverpool946: bets $0.06
bubbarl: calls $0.06
CashMatteo: calls $0.06
*** TURN *** [6s 2s 9d] [7d]
bubbarl: checks 
CashMatteo: bets $0.23
liverpool946: calls $0.23
bubbarl: folds 
*** RIVER *** [6s 2s 9d 7d] [5h]
bubbarl leaves the table
CashMatteo: bets $0.12
liverpool946: calls $0.12
*** SHOW DOWN ***
CashMatteo: shows [5d 8h] (a straight, Five to Nine)
liverpool946: mucks hand 
CashMatteo collected $0.91 from pot
momonnez was removed from the table for failing to post
momonnez leaves the table
*** SUMMARY ***
Total pot $0.94 | Rake $0.03 
Board [6s 2s 9d 7d 5h]
Seat 2: zViveXz (button) folded before Flop (didn't bet)
Seat 3: bubbarl (small blind) folded on the Turn
Seat 5: CashMatteo (big blind) showed [5d 8h] and won ($0.91) with a straight, Five to Nine
Seat 6: liverpool946 mucked [Tc Th]

Hand #595: 

PokerStars Hand #246249904315:  Hold'em No Limit ($0.01/$0.02 CAD) - 2023/09/29 13:52:53 ET
Table 'Figneria II' 6-max Seat #5 is the button
Seat 1: picajew93 ($2.67 in chips) 
Seat 2: zViveXz ($1.89 in chips) 
Seat 5: CashMatteo ($7 in chips) 
Seat 6: liverpool946 ($0.64 in chips) 
liverpool946: posts small blind $0.01
picajew93: posts big blind $0.02
*** HOLE CARDS ***
Dealt to CashMatteo [6h 3c]
zViveXz: raises $0.04 to $0.06
CashMatteo: folds 
liverpool946: folds 
picajew93: folds 
Uncalled bet ($0.04) returned to zViveXz
zViveXz collected $0.05 from pot
*** SUMMARY ***
Total pot $0.05 | Rake $0 
Seat 1: picajew93 (big blind) folded before Flop
Seat 2: zViveXz collected ($0.05)
Seat 5: CashMatteo (button) folded before Flop (didn't bet)
Seat 6: liverpool946 (small blind) folded before Flop

Hand #596: 

PokerStars Hand #246249907448:  Hold'em No Limit ($0.01/$0.02 CAD) - 2023/09/29 13:53:03 ET
Table 'Figneria II' 6-max Seat #6 is the button
Seat 1: picajew93 ($2.65 in chips) 
Seat 2: zViveXz ($1.92 in chips) 
Seat 5: CashMatteo ($7 in chips) 
Seat 6: liverpool946 ($0.63 in chips) 
picajew93: posts small blind $0.01
zViveXz: posts big blind $0.02
*** HOLE CARDS ***
Dealt to CashMatteo [9s Kd]
CashMatteo: raises $0.04 to $0.06
liverpool946: folds 
picajew93: folds 
zViveXz: calls $0.04
*** FLOP *** [6s Ts 5s]
zViveXz: checks 
CashMatteo: checks 
*** TURN *** [6s Ts 5s] [8c]
freejjmom joins the table at seat #3 
zViveXz: bets $0.13
CashMatteo: calls $0.13
*** RIVER *** [6s Ts 5s 8c] [3h]
zViveXz: bets $0.38
CashMatteo: folds 
Uncalled bet ($0.38) returned to zViveXz
zViveXz collected $0.38 from pot
*** SUMMARY ***
Total pot $0.39 | Rake $0.01 
Board [6s Ts 5s 8c 3h]
Seat 1: picajew93 (small blind) folded before Flop
Seat 2: zViveXz (big blind) collected ($0.38)
Seat 5: CashMatteo folded on the River
Seat 6: liverpool946 (button) folded before Flop (didn't bet)

Hand #597: 

PokerStars Hand #246249919553:  Hold'em No Limit ($0.01/$0.02 CAD) - 2023/09/29 13:53:43 ET
Table 'Figneria II' 6-max Seat #1 is the button
Seat 1: picajew93 ($2.64 in chips) 
Seat 2: zViveXz ($2.11 in chips) 
Seat 3: freejjmom ($1.60 in chips) 
Seat 5: CashMatteo ($6.81 in chips) 
Seat 6: liverpool946 ($0.63 in chips) 
zViveXz: posts small blind $0.01
freejjmom: posts big blind $0.02
*** HOLE CARDS ***
Dealt to CashMatteo [Tc Jc]
CashMatteo: raises $0.04 to $0.06
liverpool946: folds 
picajew93: folds 
zViveXz: calls $0.05
freejjmom: folds 
*** FLOP *** [Qc 3d 2s]
zViveXz: checks 
CashMatteo: bets $0.07
zViveXz: calls $0.07
*** TURN *** [Qc 3d 2s] [3s]
zViveXz: checks 
CashMatteo: checks 
*** RIVER *** [Qc 3d 2s 3s] [6d]
zViveXz: bets $0.27
CashMatteo: folds 
Uncalled bet ($0.27) returned to zViveXz
zViveXz collected $0.27 from pot
*** SUMMARY ***
Total pot $0.28 | Rake $0.01 
Board [Qc 3d 2s 3s 6d]
Seat 1: picajew93 (button) folded before Flop (didn't bet)
Seat 2: zViveXz (small blind) collected ($0.27)
Seat 3: freejjmom (big blind) folded before Flop
Seat 5: CashMatteo folded on the River
Seat 6: liverpool946 folded before Flop (didn't bet)

Hand #598: 

PokerStars Hand #246249929200:  Hold'em No Limit ($0.01/$0.02 CAD) - 2023/09/29 13:54:14 ET
Table 'Figneria II' 6-max Seat #2 is the button
Seat 1: picajew93 ($2.64 in chips) 
Seat 2: zViveXz ($2.25 in chips) 
Seat 3: freejjmom ($1.58 in chips) 
Seat 5: CashMatteo ($6.68 in chips) 
Seat 6: liverpool946 ($0.63 in chips) 
freejjmom: posts small blind $0.01
CashMatteo: posts big blind $0.02
*** HOLE CARDS ***
Dealt to CashMatteo [Jc 4h]
liverpool946: folds 
picajew93: calls $0.02
zViveXz: folds 
liverpool946 leaves the table
freejjmom: calls $0.01
CashMatteo: checks 
*** FLOP *** [Jd 3c 4c]
freejjmom: checks 
CashMatteo: bets $0.06
picajew93: folds 
freejjmom: calls $0.06
*** TURN *** [Jd 3c 4c] [8s]
freejjmom: checks 
CashMatteo: bets $0.09
freejjmom: calls $0.09
*** RIVER *** [Jd 3c 4c 8s] [Kd]
freejjmom: checks 
Durco joins the table at seat #6 
CashMatteo: bets $0.18
freejjmom: folds 
Uncalled bet ($0.18) returned to CashMatteo
CashMatteo collected $0.35 from pot
CashMatteo: doesn't show hand 
*** SUMMARY ***
Total pot $0.36 | Rake $0.01 
Board [Jd 3c 4c 8s Kd]
Seat 1: picajew93 folded on the Flop
Seat 2: zViveXz (button) folded before Flop (didn't bet)
Seat 3: freejjmom (small blind) folded on the River
Seat 5: CashMatteo (big blind) collected ($0.35)
Seat 6: liverpool946 folded before Flop (didn't bet)

Hand #599: 

PokerStars Hand #246249940443:  Hold'em No Limit ($0.01/$0.02 CAD) - 2023/09/29 13:54:51 ET
Table 'Figneria II' 6-max Seat #3 is the button
Seat 1: picajew93 ($2.62 in chips) 
Seat 2: zViveXz ($2.25 in chips) 
Seat 3: freejjmom ($1.41 in chips) 
Seat 5: CashMatteo ($6.86 in chips) 
Seat 6: Durco ($1.02 in chips) 
CashMatteo: posts small blind $0.01
Durco: posts big blind $0.02
*** HOLE CARDS ***
Dealt to CashMatteo [6d Tc]
picajew93: calls $0.02
zViveXz: calls $0.02
freejjmom: folds 
CashMatteo: folds 
Durco: checks 
*** FLOP *** [6c Ah As]
Durco: checks 
picajew93: checks 
zViveXz: checks 
*** TURN *** [6c Ah As] [9s]
Durco: bets $0.04
picajew93: folds 
zViveXz: calls $0.04
*** RIVER *** [6c Ah As 9s] [3s]
Sno11ygoster joins the table at seat #4 
Durco: checks 
zViveXz: checks 
*** SHOW DOWN ***
Durco: shows [Qh 4c] (a pair of Aces)
zViveXz: shows [Th 6h] (two pair, Aces and Sixes)
zViveXz collected $0.14 from pot
*** SUMMARY ***
Total pot $0.15 | Rake $0.01 
Board [6c Ah As 9s 3s]
Seat 1: picajew93 folded on the Turn
Seat 2: zViveXz showed [Th 6h] and won ($0.14) with two pair, Aces and Sixes
Seat 3: freejjmom (button) folded before Flop (didn't bet)
Seat 5: CashMatteo (small blind) folded before Flop
Seat 6: Durco (big blind) showed [Qh 4c] and lost with a pair of Aces

Hand #600: 

PokerStars Hand #246249949359:  Hold'em No Limit ($0.01/$0.02 CAD) - 2023/09/29 13:55:28 ET
Table 'Figneria II' 6-max Seat #5 is the button
Seat 1: picajew93 ($2.60 in chips) 
Seat 2: zViveXz ($2.33 in chips) 
Seat 3: freejjmom ($1.41 in chips) 
Seat 4: Sno11ygoster ($0.82 in chips) 
Seat 5: CashMatteo ($6.85 in chips) 
Seat 6: Durco ($0.96 in chips) 
Durco: posts small blind $0.01
picajew93: posts big blind $0.02
Sno11ygoster: posts big blind $0.02
*** HOLE CARDS ***
Dealt to CashMatteo [8c 2h]
zViveXz: raises $0.04 to $0.06
freejjmom: folds 
Sno11ygoster: raises $0.04 to $0.10
CashMatteo: folds 
Durco: folds 
picajew93: folds 
zViveXz: calls $0.04
*** FLOP *** [9s 4c 7h]
zViveXz: checks 
Sno11ygoster: checks 
*** TURN *** [9s 4c 7h] [4d]
zViveXz: checks 
Sno11ygoster: bets $0.06
zViveXz: folds 
Uncalled bet ($0.06) returned to Sno11ygoster
Sno11ygoster collected $0.22 from pot
Sno11ygoster: doesn't show hand 
*** SUMMARY ***
Total pot $0.23 | Rake $0.01 
Board [9s 4c 7h 4d]
Seat 1: picajew93 (big blind) folded before Flop
Seat 2: zViveXz folded on the Turn
Seat 3: freejjmom folded before Flop (didn't bet)
Seat 4: Sno11ygoster collected ($0.22)
Seat 5: CashMatteo (button) folded before Flop (didn't bet)
Seat 6: Durco (small blind) folded before Flop

Hand #601: 

PokerStars Hand #246249954270:  Hold'em No Limit ($0.01/$0.02 CAD) - 2023/09/29 13:55:51 ET
Table 'Figneria II' 6-max Seat #6 is the button
Seat 1: picajew93 ($2.58 in chips) 
Seat 2: zViveXz ($2.23 in chips) 
Seat 3: freejjmom ($1.41 in chips) 
Seat 4: Sno11ygoster ($0.94 in chips) 
Seat 5: CashMatteo ($6.85 in chips) 
Seat 6: Durco ($0.95 in chips) 
picajew93: posts small blind $0.01
zViveXz: posts big blind $0.02
*** HOLE CARDS ***
Dealt to CashMatteo [6h 5h]
freejjmom: folds 
Sno11ygoster: calls $0.02
CashMatteo: calls $0.02
Durco: calls $0.02
picajew93: calls $0.01
zViveXz: checks 
*** FLOP *** [7d 4h Kh]
picajew93: checks 
zViveXz: checks 
Sno11ygoster: checks 
CashMatteo: bets $0.10
Durco: folds 
picajew93: folds 
zViveXz: folds 
Sno11ygoster: folds 
Uncalled bet ($0.10) returned to CashMatteo
CashMatteo collected $0.10 from pot
CashMatteo: doesn't show hand 
*** SUMMARY ***
Total pot $0.10 | Rake $0 
Board [7d 4h Kh]
Seat 1: picajew93 (small blind) folded on the Flop
Seat 2: zViveXz (big blind) folded on the Flop
Seat 3: freejjmom folded before Flop (didn't bet)
Seat 4: Sno11ygoster folded on the Flop
Seat 5: CashMatteo collected ($0.10)
Seat 6: Durco (button) folded on the Flop

Hand #602: 

PokerStars Hand #246249961469:  Hold'em No Limit ($0.01/$0.02 CAD) - 2023/09/29 13:56:25 ET
Table 'Figneria II' 6-max Seat #1 is the button
Seat 1: picajew93 ($2.56 in chips) 
Seat 2: zViveXz ($2.21 in chips) 
Seat 3: freejjmom ($1.41 in chips) 
Seat 4: Sno11ygoster ($0.92 in chips) 
Seat 5: CashMatteo ($6.93 in chips) 
Seat 6: Durco ($0.93 in chips) 
zViveXz: posts small blind $0.01
freejjmom: posts big blind $0.02
*** HOLE CARDS ***
Dealt to CashMatteo [Jd Qh]
Sno11ygoster: calls $0.02
CashMatteo: raises $0.07 to $0.09
Durco: folds 
picajew93: folds 
zViveXz: folds 
freejjmom: folds 
Sno11ygoster: folds 
Uncalled bet ($0.07) returned to CashMatteo
CashMatteo collected $0.07 from pot
CashMatteo: doesn't show hand 
*** SUMMARY ***
Total pot $0.07 | Rake $0 
Seat 1: picajew93 (button) folded before Flop (didn't bet)
Seat 2: zViveXz (small blind) folded before Flop
Seat 3: freejjmom (big blind) folded before Flop
Seat 4: Sno11ygoster folded before Flop
Seat 5: CashMatteo collected ($0.07)
Seat 6: Durco folded before Flop (didn't bet)

Hand #603: 

PokerStars Hand #246249966201:  Hold'em No Limit ($0.01/$0.02 CAD) - 2023/09/29 13:56:47 ET
Table 'Figneria II' 6-max Seat #2 is the button
Seat 1: picajew93 ($2.56 in chips) 
Seat 2: zViveXz ($2.20 in chips) 
Seat 3: freejjmom ($1.39 in chips) 
Seat 4: Sno11ygoster ($0.90 in chips) 
Seat 5: CashMatteo ($6.98 in chips) 
Seat 6: Durco ($0.93 in chips) 
freejjmom: posts small blind $0.01
Sno11ygoster: posts big blind $0.02
*** HOLE CARDS ***
Dealt to CashMatteo [6s Qd]
CashMatteo: calls $0.02
Durco: calls $0.02
picajew93: folds 
zViveXz: calls $0.02
freejjmom: folds 
Sno11ygoster: checks 
*** FLOP *** [6d Qc Jd]
Sno11ygoster: checks 
CashMatteo: bets $0.09
Durco: raises $0.27 to $0.36
zViveXz: folds 
Sno11ygoster: folds 
CashMatteo: calls $0.27
*** TURN *** [6d Qc Jd] [Ad]
CashMatteo: bets $0.39
Durco: raises $0.16 to $0.55 and is all-in
CashMatteo: calls $0.16
*** RIVER *** [6d Qc Jd Ad] [4s]
*** SHOW DOWN ***
CashMatteo: shows [6s Qd] (two pair, Queens and Sixes)
Durco: shows [Qs Js] (two pair, Queens and Jacks)
Durco collected $1.84 from pot
*** SUMMARY ***
Total pot $1.91 | Rake $0.07 
Board [6d Qc Jd Ad 4s]
Seat 1: picajew93 folded before Flop (didn't bet)
Seat 2: zViveXz (button) folded on the Flop
Seat 3: freejjmom (small blind) folded before Flop
Seat 4: Sno11ygoster (big blind) folded on the Flop
Seat 5: CashMatteo showed [6s Qd] and lost with two pair, Queens and Sixes
Seat 6: Durco showed [Qs Js] and won ($1.84) with two pair, Queens and Jacks

Hand #604: 

PokerStars Hand #246249978346:  Hold'em No Limit ($0.01/$0.02 CAD) - 2023/09/29 13:57:44 ET
Table 'Figneria II' 6-max Seat #3 is the button
Seat 1: picajew93 ($2.56 in chips) 
Seat 2: zViveXz ($2.18 in chips) 
Seat 3: freejjmom ($1.38 in chips) 
Seat 4: Sno11ygoster ($0.88 in chips) 
Seat 5: CashMatteo ($6.05 in chips) 
Seat 6: Durco ($1.84 in chips) 
Sno11ygoster: posts small blind $0.01
CashMatteo: posts big blind $0.02
*** HOLE CARDS ***
Dealt to CashMatteo [Qs 6h]
Durco: folds 
picajew93: folds 
zViveXz: calls $0.02
freejjmom: calls $0.02
Sno11ygoster: raises $0.04 to $0.06
CashMatteo: calls $0.04
zViveXz: calls $0.04
freejjmom: calls $0.04
*** FLOP *** [Ks 4h Jh]
Sno11ygoster: checks 
CashMatteo: checks 
zViveXz: checks 
freejjmom: checks 
*** TURN *** [Ks 4h Jh] [4d]
Sno11ygoster: checks 
CashMatteo: checks 
zViveXz: checks 
freejjmom: checks 
*** RIVER *** [Ks 4h Jh 4d] [Qh]
Sno11ygoster: checks 
CashMatteo: checks 
zViveXz: bets $0.23
freejjmom: folds 
Sno11ygoster: folds 
CashMatteo: folds 
Uncalled bet ($0.23) returned to zViveXz
zViveXz collected $0.23 from pot
*** SUMMARY ***
Total pot $0.24 | Rake $0.01 
Board [Ks 4h Jh 4d Qh]
Seat 1: picajew93 folded before Flop (didn't bet)
Seat 2: zViveXz collected ($0.23)
Seat 3: freejjmom (button) folded on the River
Seat 4: Sno11ygoster (small blind) folded on the River
Seat 5: CashMatteo (big blind) folded on the River
Seat 6: Durco folded before Flop (didn't bet)

Hand #605: 

PokerStars Hand #246249996159:  Hold'em No Limit ($0.01/$0.02 CAD) - 2023/09/29 13:59:05 ET
Table 'Figneria II' 6-max Seat #4 is the button
Seat 1: picajew93 ($2.56 in chips) 
Seat 2: zViveXz ($2.35 in chips) 
Seat 3: freejjmom ($1.32 in chips) 
Seat 4: Sno11ygoster ($0.82 in chips) 
Seat 5: CashMatteo ($5.99 in chips) 
Seat 6: Durco ($1.84 in chips) 
CashMatteo: posts small blind $0.01
Durco: posts big blind $0.02
*** HOLE CARDS ***
Dealt to CashMatteo [5d 3d]
picajew93: calls $0.02
zViveXz: raises $0.04 to $0.06
freejjmom: folds 
Sno11ygoster: raises $0.04 to $0.10
CashMatteo: folds 
Durco: calls $0.08
picajew93: calls $0.08
zViveXz: calls $0.04
*** FLOP *** [Kd 9d 2h]
Durco: checks 
picajew93: checks 
zViveXz: checks 
Sno11ygoster: bets $0.14
Durco: folds 
picajew93: calls $0.14
zViveXz: folds 
*** TURN *** [Kd 9d 2h] [4d]
picajew93: checks 
Sno11ygoster: checks 
*** RIVER *** [Kd 9d 2h 4d] [Qd]
picajew93: checks 
Sno11ygoster: bets $0.26
picajew93: folds 
Uncalled bet ($0.26) returned to Sno11ygoster
Sno11ygoster collected $0.67 from pot
Sno11ygoster: doesn't show hand 
*** SUMMARY ***
Total pot $0.69 | Rake $0.02 
Board [Kd 9d 2h 4d Qd]
Seat 1: picajew93 folded on the River
Seat 2: zViveXz folded on the Flop
Seat 3: freejjmom folded before Flop (didn't bet)
Seat 4: Sno11ygoster (button) collected ($0.67)
Seat 5: CashMatteo (small blind) folded before Flop
Seat 6: Durco (big blind) folded on the Flop

Hand #606: 

PokerStars Hand #246250007421:  Hold'em No Limit ($0.01/$0.02 CAD) - 2023/09/29 13:59:57 ET
Table 'Figneria II' 6-max Seat #5 is the button
Seat 1: picajew93 ($2.32 in chips) 
Seat 2: zViveXz ($2.25 in chips) 
Seat 3: freejjmom ($1.32 in chips) 
Seat 4: Sno11ygoster ($1.25 in chips) 
Seat 5: CashMatteo ($5.98 in chips) 
Seat 6: Durco ($1.74 in chips) 
Durco: posts small blind $0.01
picajew93: posts big blind $0.02
*** HOLE CARDS ***
Dealt to CashMatteo [Kc 3d]
zViveXz: raises $0.04 to $0.06
freejjmom: folds 
Sno11ygoster: folds 
CashMatteo: calls $0.06
Durco: calls $0.05
picajew93: folds 
*** FLOP *** [2h 9s 4d]
Durco: checks 
zViveXz: checks 
CashMatteo: checks 
*** TURN *** [2h 9s 4d] [2d]
Durco: checks 
picajew93 leaves the table
Runway26 joins the table at seat #1 
zViveXz: checks 
CashMatteo: checks 
*** RIVER *** [2h 9s 4d 2d] [5d]
Durco: checks 
zViveXz: bets $0.10
CashMatteo: folds 
Durco: folds 
Uncalled bet ($0.10) returned to zViveXz
zViveXz collected $0.19 from pot
*** SUMMARY ***
Total pot $0.20 | Rake $0.01 
Board [2h 9s 4d 2d 5d]
Seat 1: picajew93 (big blind) folded before Flop
Seat 2: zViveXz collected ($0.19)
Seat 3: freejjmom folded before Flop (didn't bet)
Seat 4: Sno11ygoster folded before Flop (didn't bet)
Seat 5: CashMatteo (button) folded on the River
Seat 6: Durco (small blind) folded on the River

Hand #607: 

PokerStars Hand #246250018925:  Hold'em No Limit ($0.01/$0.02 CAD) - 2023/09/29 14:00:46 ET
Table 'Figneria II' 6-max Seat #6 is the button
Seat 2: zViveXz ($2.38 in chips) 
Seat 3: freejjmom ($1.32 in chips) 
Seat 4: Sno11ygoster ($1.25 in chips) 
Seat 5: CashMatteo ($5.92 in chips) 
Seat 6: Durco ($1.68 in chips) 
Runway26 will be allowed to play after the button
zViveXz: posts small blind $0.01
freejjmom: posts big blind $0.02
*** HOLE CARDS ***
Dealt to CashMatteo [3c Ah]
Sno11ygoster: folds 
CashMatteo: calls $0.02
Durco: calls $0.02
zViveXz: folds 
freejjmom: checks 
*** FLOP *** [2h 8s 7h]
freejjmom: checks 
CashMatteo: checks 
Durco: checks 
*** TURN *** [2h 8s 7h] [Qs]
freejjmom: checks 
CashMatteo: checks 
Durco: checks 
*** RIVER *** [2h 8s 7h Qs] [Qc]
freejjmom: checks 
CashMatteo: checks 
Durco: bets $0.07
freejjmom: folds 
CashMatteo: folds 
Uncalled bet ($0.07) returned to Durco
Durco collected $0.07 from pot
Durco: doesn't show hand 
*** SUMMARY ***
Total pot $0.07 | Rake $0 
Board [2h 8s 7h Qs Qc]
Seat 2: zViveXz (small blind) folded before Flop
Seat 3: freejjmom (big blind) folded on the River
Seat 4: Sno11ygoster folded before Flop (didn't bet)
Seat 5: CashMatteo folded on the River
Seat 6: Durco (button) collected ($0.07)

Hand #608: 

PokerStars Hand #246250035038:  Hold'em No Limit ($0.01/$0.02 CAD) - 2023/09/29 14:01:47 ET
Table 'Figneria II' 6-max Seat #2 is the button
Seat 2: zViveXz ($2.37 in chips) 
Seat 3: freejjmom ($1.30 in chips) 
Seat 4: Sno11ygoster ($1.25 in chips) 
Seat 5: CashMatteo ($5.90 in chips) 
Seat 6: Durco ($1.73 in chips) 
freejjmom: posts small blind $0.01
Sno11ygoster: posts big blind $0.02
Runway26: sits out 
*** HOLE CARDS ***
Dealt to CashMatteo [9d Qs]
CashMatteo: raises $0.04 to $0.06
Durco: folds 
zViveXz: folds 
freejjmom: raises $0.14 to $0.20
Sno11ygoster: folds 
CashMatteo: calls $0.14
*** FLOP *** [8h 6s 5s]
freejjmom: bets $0.41
CashMatteo: calls $0.41
*** TURN *** [8h 6s 5s] [Qc]
freejjmom: bets $0.69 and is all-in
CashMatteo: calls $0.69
*** RIVER *** [8h 6s 5s Qc] [4d]
*** SHOW DOWN ***
freejjmom: shows [Kh Ks] (a pair of Kings)
CashMatteo: shows [9d Qs] (a pair of Queens)
freejjmom collected $2.53 from pot
*** SUMMARY ***
Total pot $2.62 | Rake $0.09 
Board [8h 6s 5s Qc 4d]
Seat 2: zViveXz (button) folded before Flop (didn't bet)
Seat 3: freejjmom (small blind) showed [Kh Ks] and won ($2.53) with a pair of Kings
Seat 4: Sno11ygoster (big blind) folded before Flop
Seat 5: CashMatteo showed [9d Qs] and lost with a pair of Queens
Seat 6: Durco folded before Flop (didn't bet)

Hand #609: 

PokerStars Hand #246250050172:  Hold'em No Limit ($0.01/$0.02 CAD) - 2023/09/29 14:02:35 ET
Table 'Figneria II' 6-max Seat #3 is the button
Seat 2: zViveXz ($2.37 in chips) 
Seat 3: freejjmom ($2.53 in chips) 
Seat 4: Sno11ygoster ($1.23 in chips) 
Seat 5: CashMatteo ($4.60 in chips) 
Seat 6: Durco ($1.73 in chips) 
Sno11ygoster: posts small blind $0.01
CashMatteo: posts big blind $0.02
Runway26: sits out 
*** HOLE CARDS ***
Dealt to CashMatteo [7h Th]
Durco: calls $0.02
zViveXz: folds 
freejjmom: folds 
Sno11ygoster: raises $0.04 to $0.06
CashMatteo: calls $0.04
Durco: calls $0.04
*** FLOP *** [Qs 6d 6s]
Sno11ygoster: checks 
CashMatteo: checks 
Durco: checks 
*** TURN *** [Qs 6d 6s] [Qc]
Sno11ygoster: checks 
CashMatteo: checks 
Durco: bets $0.09
Sno11ygoster: calls $0.09
CashMatteo: folds 
*** RIVER *** [Qs 6d 6s Qc] [8d]
Sno11ygoster: checks 
Durco: bets $0.18
Sno11ygoster: calls $0.18
*** SHOW DOWN ***
Durco: shows [4c 6c] (a full house, Sixes full of Queens)
Sno11ygoster: mucks hand 
Durco collected $0.69 from pot
*** SUMMARY ***
Total pot $0.72 | Rake $0.03 
Board [Qs 6d 6s Qc 8d]
Seat 2: zViveXz folded before Flop (didn't bet)
Seat 3: freejjmom (button) folded before Flop (didn't bet)
Seat 4: Sno11ygoster (small blind) mucked [3h Ad]
Seat 5: CashMatteo (big blind) folded on the Turn
Seat 6: Durco showed [4c 6c] and won ($0.69) with a full house, Sixes full of Queens

Hand #610: 

PokerStars Hand #246250068285:  Hold'em No Limit ($0.01/$0.02 CAD) - 2023/09/29 14:03:34 ET
Table 'Figneria II' 6-max Seat #4 is the button
Seat 2: zViveXz ($2.37 in chips) 
Seat 3: freejjmom ($2.53 in chips) 
Seat 4: Sno11ygoster ($0.90 in chips) 
Seat 5: CashMatteo ($4.54 in chips) 
Seat 6: Durco ($2.09 in chips) 
CashMatteo: posts small blind $0.01
Durco: posts big blind $0.02
Runway26: sits out 
*** HOLE CARDS ***
Dealt to CashMatteo [5h 4h]
zViveXz: folds 
freejjmom: folds 
Sno11ygoster: raises $0.04 to $0.06
CashMatteo: folds 
Durco: calls $0.04
*** FLOP *** [3d 7h 6c]
Durco: checks 
Sno11ygoster: checks 
*** TURN *** [3d 7h 6c] [5s]
Durco: bets $0.07
Sno11ygoster: calls $0.07
*** RIVER *** [3d 7h 6c 5s] [5d]
Durco: bets $0.26
Sno11ygoster: raises $0.34 to $0.60
Durco: raises $1.36 to $1.96 and is all-in
Sno11ygoster: calls $0.17 and is all-in
Uncalled bet ($1.19) returned to Durco
*** SHOW DOWN ***
Durco: shows [5c 3h] (a full house, Fives full of Threes)
Sno11ygoster: shows [As 4c] (a straight, Three to Seven)
Durco collected $1.75 from pot
*** SUMMARY ***
Total pot $1.81 | Rake $0.06 
Board [3d 7h 6c 5s 5d]
Seat 2: zViveXz folded before Flop (didn't bet)
Seat 3: freejjmom folded before Flop (didn't bet)
Seat 4: Sno11ygoster (button) showed [As 4c] and lost with a straight, Three to Seven
Seat 5: CashMatteo (small blind) folded before Flop
Seat 6: Durco (big blind) showed [5c 3h] and won ($1.75) with a full house, Fives full of Threes

Hand #611: 

PokerStars Hand #246250081953:  Hold'em No Limit ($0.01/$0.02 CAD) - 2023/09/29 14:04:17 ET
Table 'Figneria II' 6-max Seat #5 is the button
Seat 2: zViveXz ($2.37 in chips) 
Seat 3: freejjmom ($2.53 in chips) 
Seat 5: CashMatteo ($4.53 in chips) 
Runway26 will be allowed to play after the button
zViveXz: posts small blind $0.01
freejjmom: posts big blind $0.02
*** HOLE CARDS ***
Dealt to CashMatteo [2s Kc]
Durco leaves the table
CashMatteo: calls $0.02
Sno11ygoster leaves the table
zViveXz: folds 
Runway26 leaves the table
freejjmom: checks 
*** FLOP *** [7d 8h Tc]
freejjmom: checks 
CashMatteo: checks 
*** TURN *** [7d 8h Tc] [Jd]
freejjmom: checks 
CashMatteo: checks 
*** RIVER *** [7d 8h Tc Jd] [4d]
freejjmom: checks 
CashMatteo: checks 
*** SHOW DOWN ***
freejjmom: shows [Ac 6s] (high card Ace)
CashMatteo: mucks hand 
freejjmom collected $0.05 from pot
*** SUMMARY ***
Total pot $0.05 | Rake $0 
Board [7d 8h Tc Jd 4d]
Seat 2: zViveXz (small blind) folded before Flop
Seat 3: freejjmom (big blind) showed [Ac 6s] and won ($0.05) with high card Ace
Seat 5: CashMatteo (button) mucked [2s Kc]

Hand #612: 

PokerStars Hand #246250090755:  Hold'em No Limit ($0.01/$0.02 CAD) - 2023/09/29 14:04:45 ET
Table 'Figneria II' 6-max Seat #2 is the button
Seat 2: zViveXz ($2.36 in chips) 
Seat 3: freejjmom ($2.56 in chips) 
Seat 5: CashMatteo ($4.51 in chips) 
freejjmom: posts small blind $0.01
CashMatteo: posts big blind $0.02
*** HOLE CARDS ***
Dealt to CashMatteo [5h 7h]
zViveXz: folds 
freejjmom: folds 
Uncalled bet ($0.01) returned to CashMatteo
CashMatteo collected $0.02 from pot
CashMatteo: doesn't show hand 
*** SUMMARY ***
Total pot $0.02 | Rake $0 
Seat 2: zViveXz (button) folded before Flop (didn't bet)
Seat 3: freejjmom (small blind) folded before Flop
Seat 5: CashMatteo (big blind) collected ($0.02)

Hand #613: 

PokerStars Hand #246250094104:  Hold'em No Limit ($0.01/$0.02 CAD) - 2023/09/29 14:04:56 ET
Table 'Figneria II' 6-max Seat #3 is the button
Seat 2: zViveXz ($2.36 in chips) 
Seat 3: freejjmom ($2.55 in chips) 
Seat 5: CashMatteo ($4.52 in chips) 
CashMatteo: posts small blind $0.01
zViveXz: posts big blind $0.02
*** HOLE CARDS ***
Dealt to CashMatteo [3d 7d]
freejjmom: folds 
CashMatteo: calls $0.01
zViveXz: checks 
*** FLOP *** [Qd Kh 7c]
CashMatteo: bets $0.02
zViveXz: calls $0.02
*** TURN *** [Qd Kh 7c] [4d]
CashMatteo: bets $0.08
zViveXz: folds 
Uncalled bet ($0.08) returned to CashMatteo
CashMatteo collected $0.08 from pot
CashMatteo: doesn't show hand 
*** SUMMARY ***
Total pot $0.08 | Rake $0 
Board [Qd Kh 7c 4d]
Seat 2: zViveXz (big blind) folded on the Turn
Seat 3: freejjmom (button) folded before Flop (didn't bet)
Seat 5: CashMatteo (small blind) collected ($0.08)

Hand #614: 

PokerStars Hand #246250103536:  Hold'em No Limit ($0.01/$0.02 CAD) - 2023/09/29 14:05:25 ET
Table 'Figneria II' 6-max Seat #5 is the button
Seat 2: zViveXz ($2.32 in chips) 
Seat 3: freejjmom ($2.55 in chips) 
Seat 5: CashMatteo ($4.56 in chips) 
zViveXz: posts small blind $0.01
freejjmom: posts big blind $0.02
*** HOLE CARDS ***
Dealt to CashMatteo [3d 2h]
CashMatteo: folds 
zViveXz: raises $0.04 to $0.06
freejjmom: calls $0.04
*** FLOP *** [8c 4h Jh]
zViveXz: bets $0.06
Amigobambino joins the table at seat #4 
freejjmom: folds 
Uncalled bet ($0.06) returned to zViveXz
zViveXz collected $0.12 from pot
*** SUMMARY ***
Total pot $0.12 | Rake $0 
Board [8c 4h Jh]
Seat 2: zViveXz (small blind) collected ($0.12)
Seat 3: freejjmom (big blind) folded on the Flop
Seat 5: CashMatteo (button) folded before Flop (didn't bet)

Hand #615: 

PokerStars Hand #246250111671:  Hold'em No Limit ($0.01/$0.02 CAD) - 2023/09/29 14:05:51 ET
Table 'Figneria II' 6-max Seat #2 is the button
Seat 2: zViveXz ($2.38 in chips) 
Seat 3: freejjmom ($2.49 in chips) 
Seat 4: Amigobambino ($2 in chips) 
Seat 5: CashMatteo ($4.56 in chips) 
freejjmom: posts small blind $0.01
Amigobambino: posts big blind $0.02
*** HOLE CARDS ***
Dealt to CashMatteo [Jc Kc]
CashMatteo: raises $0.04 to $0.06
zViveXz: folds 
freejjmom: calls $0.05
Amigobambino: calls $0.04
*** FLOP *** [8s 2c 7d]
freejjmom: checks 
Amigobambino: bets $0.11
CashMatteo: calls $0.11
freejjmom: folds 
*** TURN *** [8s 2c 7d] [3c]
Amigobambino: bets $0.22
CashMatteo: calls $0.22
*** RIVER *** [8s 2c 7d 3c] [9c]
Amigobambino: bets $0.43
CashMatteo: raises $0.96 to $1.39
Amigobambino: raises $0.22 to $1.61 and is all-in
CashMatteo: calls $0.22
*** SHOW DOWN ***
Amigobambino: shows [6c 7c] (a flush, Nine high)
CashMatteo: shows [Jc Kc] (a flush, King high)
CashMatteo collected $3.92 from pot
*** SUMMARY ***
Total pot $4.06 | Rake $0.14 
Board [8s 2c 7d 3c 9c]
Seat 2: zViveXz (button) folded before Flop (didn't bet)
Seat 3: freejjmom (small blind) folded on the Flop
Seat 4: Amigobambino (big blind) showed [6c 7c] and lost with a flush, Nine high
Seat 5: CashMatteo showed [Jc Kc] and won ($3.92) with a flush, King high

Hand #616: 

PokerStars Hand #246250134854:  Hold'em No Limit ($0.01/$0.02 CAD) - 2023/09/29 14:07:04 ET
Table 'Figneria II' 6-max Seat #3 is the button
Seat 2: zViveXz ($2.38 in chips) 
Seat 3: freejjmom ($2.43 in chips) 
Seat 5: CashMatteo ($6.48 in chips) 
CashMatteo: posts small blind $0.01
zViveXz: posts big blind $0.02
*** HOLE CARDS ***
Dealt to CashMatteo [6d Ac]
freejjmom: folds 
CashMatteo: calls $0.01
Amigobambino is disconnected 
HABFAN13 joins the table at seat #6 
zViveXz: raises $0.04 to $0.06
CashMatteo: calls $0.04
*** FLOP *** [9c Ad 7d]
CashMatteo: bets $0.06
zViveXz: calls $0.06
*** TURN *** [9c Ad 7d] [As]
CashMatteo: checks 
zViveXz: checks 
*** RIVER *** [9c Ad 7d As] [Ks]
CashMatteo: bets $0.23
zViveXz: calls $0.23
*** SHOW DOWN ***
CashMatteo: shows [6d Ac] (three of a kind, Aces)
zViveXz: mucks hand 
CashMatteo collected $0.68 from pot
*** SUMMARY ***
Total pot $0.70 | Rake $0.02 
Board [9c Ad 7d As Ks]
Seat 2: zViveXz (big blind) mucked [Kc Th]
Seat 3: freejjmom (button) folded before Flop (didn't bet)
Seat 5: CashMatteo (small blind) showed [6d Ac] and won ($0.68) with three of a kind, Aces

Hand #617: 

PokerStars Hand #246250148005:  Hold'em No Limit ($0.01/$0.02 CAD) - 2023/09/29 14:07:45 ET
Table 'Figneria II' 6-max Seat #5 is the button
Seat 2: zViveXz ($2.03 in chips) 
Seat 3: freejjmom ($2.43 in chips) 
Seat 5: CashMatteo ($6.81 in chips) 
HABFAN13 will be allowed to play after the button
zViveXz: posts small blind $0.01
freejjmom: posts big blind $0.02
*** HOLE CARDS ***
Dealt to CashMatteo [9c 4h]
CashMatteo: folds 
CashMatteo leaves the table
zViveXz: calls $0.01
freejjmom: checks 
*** FLOP *** [Kh Td As]
zViveXz: checks 
freejjmom: checks 
*** TURN *** [Kh Td As] [Th]
zViveXz: checks 
freejjmom: checks 
*** RIVER *** [Kh Td As Th] [2d]
zViveXz: checks 
freejjmom: checks 
*** SHOW DOWN ***
zViveXz: shows [8s 6s] (a pair of Tens)
freejjmom: shows [Qs 3s] (a pair of Tens - Ace+King+Queen kicker)
verobasque joins the table at seat #5 
freejjmom collected $0.04 from pot
*** SUMMARY ***
Total pot $0.04 | Rake $0 
Board [Kh Td As Th 2d]
Seat 2: zViveXz (small blind) showed [8s 6s] and lost with a pair of Tens
Seat 3: freejjmom (big blind) showed [Qs 3s] and won ($0.04) with a pair of Tens
Seat 5: CashMatteo (button) folded before Flop (didn't bet)

Hand #618: 

PokerStars Hand #246252196687:  Hold'em No Limit ($0.02/$0.05 CAD) - 2023/09/29 15:44:56 ET
Table 'Hadar III' 6-max Seat #1 is the button
Seat 1: edovale493 ($4.55 in chips) 
Seat 2: tcaz99 ($4.85 in chips) 
Seat 3: CashMatteo ($3.50 in chips) 
Seat 5: DSilver ($5.16 in chips) 
Seat 6: CraigNesh ($2.99 in chips) 
tcaz99: posts small blind $0.02
CashMatteo: posts big blind $0.05
I3inky: sits out 
*** HOLE CARDS ***
Dealt to CashMatteo [3d Kh]
DSilver: folds 
CraigNesh: calls $0.05
edovale493: raises $0.10 to $0.15
tcaz99: raises $0.60 to $0.75
CashMatteo: folds 
CraigNesh: folds 
edovale493: folds 
Uncalled bet ($0.60) returned to tcaz99
tcaz99 collected $0.40 from pot
*** SUMMARY ***
Total pot $0.40 | Rake $0 
Seat 1: edovale493 (button) folded before Flop
Seat 2: tcaz99 (small blind) collected ($0.40)
Seat 3: CashMatteo (big blind) folded before Flop
Seat 5: DSilver folded before Flop (didn't bet)
Seat 6: CraigNesh folded before Flop

Hand #619: 

PokerStars Hand #246252209681:  Hold'em No Limit ($0.02/$0.05 CAD) - 2023/09/29 15:45:29 ET
Table 'Hadar III' 6-max Seat #2 is the button
Seat 1: edovale493 ($4.40 in chips) 
Seat 2: tcaz99 ($5.10 in chips) 
Seat 3: CashMatteo ($3.45 in chips) 
Seat 4: I3inky ($5 in chips) 
Seat 5: DSilver ($5.16 in chips) 
Seat 6: CraigNesh ($2.94 in chips) 
CashMatteo: posts small blind $0.02
I3inky: posts big blind $0.05
*** HOLE CARDS ***
Dealt to CashMatteo [Kd 6c]
DSilver: raises $0.10 to $0.15
CraigNesh: calls $0.15
edovale493: folds 
tcaz99: folds 
CashMatteo: folds 
I3inky: raises $0.47 to $0.62
DSilver: folds 
CraigNesh: calls $0.47
*** FLOP *** [3c 4h Kh]
I3inky: bets $0.73
CraigNesh: calls $0.73
*** TURN *** [3c 4h Kh] [4d]
I3inky: checks 
CraigNesh: checks 
*** RIVER *** [3c 4h Kh 4d] [Th]
I3inky: bets $1.38
CraigNesh: calls $1.38
*** SHOW DOWN ***
I3inky: shows [Ad Ac] (two pair, Aces and Fours)
CraigNesh: mucks hand 
I3inky collected $5.40 from pot
*** SUMMARY ***
Total pot $5.63 | Rake $0.23 
Board [3c 4h Kh 4d Th]
Seat 1: edovale493 folded before Flop (didn't bet)
Seat 2: tcaz99 (button) folded before Flop (didn't bet)
Seat 3: CashMatteo (small blind) folded before Flop
Seat 4: I3inky (big blind) showed [Ad Ac] and won ($5.40) with two pair, Aces and Fours
Seat 5: DSilver folded before Flop
Seat 6: CraigNesh mucked [Jh Jd]

Hand #620: 

PokerStars Hand #246252240396:  Hold'em No Limit ($0.02/$0.05 CAD) - 2023/09/29 15:46:45 ET
Table 'Hadar III' 6-max Seat #3 is the button
Seat 1: edovale493 ($4.40 in chips) 
Seat 2: tcaz99 ($5.10 in chips) 
Seat 3: CashMatteo ($3.43 in chips) 
Seat 4: I3inky ($7.67 in chips) 
Seat 5: DSilver ($5.01 in chips) 
Seat 6: CraigNesh ($0.21 in chips) 
I3inky: posts small blind $0.02
DSilver: posts big blind $0.05
*** HOLE CARDS ***
Dealt to CashMatteo [Ts 7d]
CraigNesh: folds 
edovale493: folds 
CraigNesh leaves the table
tcaz99: raises $0.05 to $0.10
CashMatteo: folds 
I3inky: folds 
Nimbus_Meeseeks joins the table at seat #6 
DSilver: folds 
Uncalled bet ($0.05) returned to tcaz99
tcaz99 collected $0.12 from pot
*** SUMMARY ***
Total pot $0.12 | Rake $0 
Seat 1: edovale493 folded before Flop (didn't bet)
Seat 2: tcaz99 collected ($0.12)
Seat 3: CashMatteo (button) folded before Flop (didn't bet)
Seat 4: I3inky (small blind) folded before Flop
Seat 5: DSilver (big blind) folded before Flop
Seat 6: CraigNesh folded before Flop (didn't bet)

Hand #621: 

PokerStars Hand #246252250377:  Hold'em No Limit ($0.02/$0.05 CAD) - 2023/09/29 15:47:10 ET
Table 'Hadar III' 6-max Seat #4 is the button
Seat 1: edovale493 ($4.40 in chips) 
Seat 2: tcaz99 ($5.17 in chips) 
Seat 3: CashMatteo ($3.43 in chips) 
Seat 4: I3inky ($7.65 in chips) 
Seat 5: DSilver ($5 in chips) 
Seat 6: Nimbus_Meeseeks ($5 in chips) 
DSilver: posts small blind $0.02
Nimbus_Meeseeks: posts big blind $0.05
*** HOLE CARDS ***
Dealt to CashMatteo [3d As]
edovale493: folds 
tcaz99: calls $0.05
CashMatteo: calls $0.05
I3inky: folds 
DSilver: calls $0.03
Nimbus_Meeseeks: checks 
*** FLOP *** [3h Kc 9s]
DSilver: checks 
Nimbus_Meeseeks: checks 
tcaz99: checks 
CashMatteo: checks 
*** TURN *** [3h Kc 9s] [9h]
DSilver: bets $0.10
Nimbus_Meeseeks: folds 
tcaz99: folds 
CashMatteo: calls $0.10
*** RIVER *** [3h Kc 9s 9h] [Jd]
DSilver: checks 
CashMatteo: checks 
*** SHOW DOWN ***
DSilver: shows [Tc Ks] (two pair, Kings and Nines)
CashMatteo: mucks hand 
DSilver collected $0.38 from pot
*** SUMMARY ***
Total pot $0.40 | Rake $0.02 
Board [3h Kc 9s 9h Jd]
Seat 1: edovale493 folded before Flop (didn't bet)
Seat 2: tcaz99 folded on the Turn
Seat 3: CashMatteo mucked [3d As]
Seat 4: I3inky (button) folded before Flop (didn't bet)
Seat 5: DSilver (small blind) showed [Tc Ks] and won ($0.38) with two pair, Kings and Nines
Seat 6: Nimbus_Meeseeks (big blind) folded on the Turn

Hand #622: 

PokerStars Hand #246252275370:  Hold'em No Limit ($0.02/$0.05 CAD) - 2023/09/29 15:48:12 ET
Table 'Hadar III' 6-max Seat #5 is the button
Seat 1: edovale493 ($4.40 in chips) 
Seat 2: tcaz99 ($5.12 in chips) 
Seat 3: CashMatteo ($3.28 in chips) 
Seat 4: I3inky ($7.65 in chips) 
Seat 5: DSilver ($5.23 in chips) 
Seat 6: Nimbus_Meeseeks ($4.95 in chips) 
Nimbus_Meeseeks: posts small blind $0.02
edovale493: posts big blind $0.05
*** HOLE CARDS ***
Dealt to CashMatteo [8s Qd]
tcaz99: raises $0.05 to $0.10
CashMatteo: calls $0.10
I3inky: raises $0.20 to $0.30
DSilver: folds 
Nimbus_Meeseeks: folds 
edovale493: calls $0.25
tcaz99: calls $0.20
CashMatteo: calls $0.20
*** FLOP *** [Th Qc Ad]
edovale493: checks 
tcaz99: checks 
CashMatteo: checks 
I3inky: checks 
*** TURN *** [Th Qc Ad] [Jh]
edovale493: checks 
tcaz99: checks 
CashMatteo: checks 
I3inky: bets $0.25
edovale493: folds 
tcaz99: folds 
CashMatteo: folds 
Uncalled bet ($0.25) returned to I3inky
I3inky collected $1.17 from pot
*** SUMMARY ***
Total pot $1.22 | Rake $0.05 
Board [Th Qc Ad Jh]
Seat 1: edovale493 (big blind) folded on the Turn
Seat 2: tcaz99 folded on the Turn
Seat 3: CashMatteo folded on the Turn
Seat 4: I3inky collected ($1.17)
Seat 5: DSilver (button) folded before Flop (didn't bet)
Seat 6: Nimbus_Meeseeks (small blind) folded before Flop

Hand #623: 

PokerStars Hand #246252302932:  Hold'em No Limit ($0.02/$0.05 CAD) - 2023/09/29 15:49:22 ET
Table 'Hadar III' 6-max Seat #6 is the button
Seat 1: edovale493 ($4.10 in chips) 
Seat 2: tcaz99 ($4.82 in chips) 
Seat 3: CashMatteo ($2.98 in chips) 
Seat 4: I3inky ($8.52 in chips) 
Seat 5: DSilver ($5.23 in chips) 
Seat 6: Nimbus_Meeseeks ($4.93 in chips) 
edovale493: posts small blind $0.02
tcaz99: posts big blind $0.05
*** HOLE CARDS ***
Dealt to CashMatteo [3s 2d]
CashMatteo: folds 
I3inky: calls $0.05
DSilver: folds 
Nimbus_Meeseeks: folds 
edovale493: raises $0.15 to $0.20
tcaz99: folds 
I3inky: folds 
Uncalled bet ($0.15) returned to edovale493
edovale493 collected $0.15 from pot
edovale493: doesn't show hand 
*** SUMMARY ***
Total pot $0.15 | Rake $0 
Seat 1: edovale493 (small blind) collected ($0.15)
Seat 2: tcaz99 (big blind) folded before Flop
Seat 3: CashMatteo folded before Flop (didn't bet)
Seat 4: I3inky folded before Flop
Seat 5: DSilver folded before Flop (didn't bet)
Seat 6: Nimbus_Meeseeks (button) folded before Flop (didn't bet)

Hand #624: 

PokerStars Hand #246252309182:  Hold'em No Limit ($0.02/$0.05 CAD) - 2023/09/29 15:49:38 ET
Table 'Hadar III' 6-max Seat #1 is the button
Seat 1: edovale493 ($4.20 in chips) 
Seat 2: tcaz99 ($4.77 in chips) 
Seat 3: CashMatteo ($2.98 in chips) 
Seat 4: I3inky ($8.47 in chips) 
Seat 5: DSilver ($5.23 in chips) 
Seat 6: Nimbus_Meeseeks ($4.93 in chips) 
tcaz99: posts small blind $0.02
CashMatteo: posts big blind $0.05
*** HOLE CARDS ***
Dealt to CashMatteo [Jh 9d]
I3inky: folds 
DSilver: folds 
Nimbus_Meeseeks: folds 
edovale493: calls $0.05
tcaz99: calls $0.03
CashMatteo: checks 
*** FLOP *** [As Kd 3c]
tcaz99: checks 
CashMatteo: checks 
edovale493: checks 
*** TURN *** [As Kd 3c] [Qc]
tcaz99: checks 
CashMatteo: checks 
edovale493: checks 
*** RIVER *** [As Kd 3c Qc] [6c]
tcaz99: bets $0.14
CashMatteo: folds 
edovale493: folds 
Uncalled bet ($0.14) returned to tcaz99
tcaz99 collected $0.14 from pot
DSilver was removed from the table for failing to post
DSilver leaves the table
*** SUMMARY ***
Total pot $0.15 | Rake $0.01 
Board [As Kd 3c Qc 6c]
Seat 1: edovale493 (button) folded on the River
Seat 2: tcaz99 (small blind) collected ($0.14)
Seat 3: CashMatteo (big blind) folded on the River
Seat 4: I3inky folded before Flop (didn't bet)
Seat 5: DSilver folded before Flop (didn't bet)
Seat 6: Nimbus_Meeseeks folded before Flop (didn't bet)

Hand #625: 

PokerStars Hand #246252323711:  Hold'em No Limit ($0.02/$0.05 CAD) - 2023/09/29 15:50:15 ET
Table 'Hadar III' 6-max Seat #2 is the button
Seat 1: edovale493 ($4.15 in chips) 
Seat 2: tcaz99 ($4.86 in chips) 
Seat 3: CashMatteo ($2.93 in chips) 
Seat 4: I3inky ($8.47 in chips) 
Seat 6: Nimbus_Meeseeks ($4.93 in chips) 
CashMatteo: posts small blind $0.02
I3inky: posts big blind $0.05
*** HOLE CARDS ***
Dealt to CashMatteo [7s Th]
covid19ad joins the table at seat #5 
Nimbus_Meeseeks: raises $0.10 to $0.15
edovale493: raises $0.37 to $0.52
tcaz99: folds 
CashMatteo: folds 
I3inky: folds 
Nimbus_Meeseeks: folds 
Uncalled bet ($0.37) returned to edovale493
edovale493 collected $0.37 from pot
edovale493: doesn't show hand 
*** SUMMARY ***
Total pot $0.37 | Rake $0 
Seat 1: edovale493 collected ($0.37)
Seat 2: tcaz99 (button) folded before Flop (didn't bet)
Seat 3: CashMatteo (small blind) folded before Flop
Seat 4: I3inky (big blind) folded before Flop
Seat 6: Nimbus_Meeseeks folded before Flop

Hand #626: 

PokerStars Hand #246252335475:  Hold'em No Limit ($0.02/$0.05 CAD) - 2023/09/29 15:50:44 ET
Table 'Hadar III' 6-max Seat #3 is the button
Seat 1: edovale493 ($4.37 in chips) 
Seat 2: tcaz99 ($4.86 in chips) 
Seat 3: CashMatteo ($2.91 in chips) 
Seat 4: I3inky ($8.42 in chips) 
Seat 5: covid19ad ($5 in chips) 
Seat 6: Nimbus_Meeseeks ($4.78 in chips) 
I3inky: posts small blind $0.02
covid19ad: posts big blind $0.05
*** HOLE CARDS ***
Dealt to CashMatteo [Td 6s]
Nimbus_Meeseeks: folds 
edovale493: raises $0.10 to $0.15
tcaz99: folds 
CashMatteo: folds 
I3inky: folds 
covid19ad: calls $0.10
*** FLOP *** [7s Kd 6d]
covid19ad: checks 
edovale493: bets $0.16
covid19ad: folds 
Uncalled bet ($0.16) returned to edovale493
edovale493 collected $0.31 from pot
edovale493: doesn't show hand 
*** SUMMARY ***
Total pot $0.32 | Rake $0.01 
Board [7s Kd 6d]
Seat 1: edovale493 collected ($0.31)
Seat 2: tcaz99 folded before Flop (didn't bet)
Seat 3: CashMatteo (button) folded before Flop (didn't bet)
Seat 4: I3inky (small blind) folded before Flop
Seat 5: covid19ad (big blind) folded on the Flop
Seat 6: Nimbus_Meeseeks folded before Flop (didn't bet)

Hand #627: 

PokerStars Hand #246252348549:  Hold'em No Limit ($0.02/$0.05 CAD) - 2023/09/29 15:51:17 ET
Table 'Hadar III' 6-max Seat #4 is the button
Seat 1: edovale493 ($4.53 in chips) 
Seat 2: tcaz99 ($4.86 in chips) 
Seat 3: CashMatteo ($2.91 in chips) 
Seat 4: I3inky ($8.40 in chips) 
Seat 5: covid19ad ($4.85 in chips) 
Seat 6: Nimbus_Meeseeks ($4.78 in chips) 
covid19ad: posts small blind $0.02
Nimbus_Meeseeks: posts big blind $0.05
*** HOLE CARDS ***
Dealt to CashMatteo [4d Qh]
edovale493: calls $0.05
tcaz99: folds 
CashMatteo: folds 
I3inky: folds 
covid19ad: folds 
Nimbus_Meeseeks: checks 
*** FLOP *** [3d Th Js]
Nimbus_Meeseeks: checks 
edovale493: checks 
*** TURN *** [3d Th Js] [6h]
Nimbus_Meeseeks: checks 
edovale493: bets $0.06
Nimbus_Meeseeks: calls $0.06
*** RIVER *** [3d Th Js 6h] [4s]
Nimbus_Meeseeks: checks 
edovale493: bets $0.23
Nimbus_Meeseeks: calls $0.23
*** SHOW DOWN ***
edovale493: shows [9c Qs] (high card Queen)
Nimbus_Meeseeks: shows [6s 5h] (a pair of Sixes)
Nimbus_Meeseeks collected $0.67 from pot
*** SUMMARY ***
Total pot $0.70 | Rake $0.03 
Board [3d Th Js 6h 4s]
Seat 1: edovale493 showed [9c Qs] and lost with high card Queen
Seat 2: tcaz99 folded before Flop (didn't bet)
Seat 3: CashMatteo folded before Flop (didn't bet)
Seat 4: I3inky (button) folded before Flop (didn't bet)
Seat 5: covid19ad (small blind) folded before Flop
Seat 6: Nimbus_Meeseeks (big blind) showed [6s 5h] and won ($0.67) with a pair of Sixes

Hand #628: 

PokerStars Hand #246252372980:  Hold'em No Limit ($0.02/$0.05 CAD) - 2023/09/29 15:52:18 ET
Table 'Hadar III' 6-max Seat #5 is the button
Seat 1: edovale493 ($4.19 in chips) 
Seat 2: tcaz99 ($4.86 in chips) 
Seat 3: CashMatteo ($2.91 in chips) 
Seat 4: I3inky ($8.40 in chips) 
Seat 5: covid19ad ($4.83 in chips) 
Seat 6: Nimbus_Meeseeks ($5.11 in chips) 
Nimbus_Meeseeks: posts small blind $0.02
edovale493: posts big blind $0.05
*** HOLE CARDS ***
Dealt to CashMatteo [4s Ah]
tcaz99: folds 
CashMatteo: calls $0.05
I3inky: folds 
covid19ad: calls $0.05
Nimbus_Meeseeks: folds 
edovale493: checks 
*** FLOP *** [4h 2h 4c]
edovale493: checks 
CashMatteo: checks 
covid19ad: checks 
*** TURN *** [4h 2h 4c] [7d]
edovale493: bets $0.08
CashMatteo: calls $0.08
covid19ad: raises $0.08 to $0.16
edovale493: calls $0.08
CashMatteo: raises $0.32 to $0.48
covid19ad: folds 
edovale493: calls $0.32
*** RIVER *** [4h 2h 4c 7d] [3s]
edovale493: checks 
CashMatteo: bets $0.52
edovale493: calls $0.52
*** SHOW DOWN ***
CashMatteo: shows [4s Ah] (three of a kind, Fours)
edovale493: shows [5s 6s] (a straight, Three to Seven)
edovale493 collected $2.23 from pot
*** SUMMARY ***
Total pot $2.33 | Rake $0.10 
Board [4h 2h 4c 7d 3s]
Seat 1: edovale493 (big blind) showed [5s 6s] and won ($2.23) with a straight, Three to Seven
Seat 2: tcaz99 folded before Flop (didn't bet)
Seat 3: CashMatteo showed [4s Ah] and lost with three of a kind, Fours
Seat 4: I3inky folded before Flop (didn't bet)
Seat 5: covid19ad (button) folded on the Turn
Seat 6: Nimbus_Meeseeks (small blind) folded before Flop

Hand #629: 

PokerStars Hand #246252406344:  Hold'em No Limit ($0.02/$0.05 CAD) - 2023/09/29 15:53:43 ET
Table 'Hadar III' 6-max Seat #6 is the button
Seat 1: edovale493 ($5.37 in chips) 
Seat 2: tcaz99 ($4.86 in chips) 
Seat 3: CashMatteo ($1.86 in chips) 
Seat 4: I3inky ($8.40 in chips) 
Seat 5: covid19ad ($4.62 in chips) 
Seat 6: Nimbus_Meeseeks ($5.09 in chips) 
edovale493: posts small blind $0.02
tcaz99: posts big blind $0.05
*** HOLE CARDS ***
Dealt to CashMatteo [4h 7d]
CashMatteo: folds 
I3inky: folds 
covid19ad: calls $0.05
Nimbus_Meeseeks: folds 
edovale493: calls $0.03
tcaz99: checks 
*** FLOP *** [Ad Ah 4c]
edovale493: checks 
tcaz99: checks 
covid19ad: checks 
*** TURN *** [Ad Ah 4c] [Td]
edovale493: checks 
tcaz99: checks 
covid19ad: checks 
*** RIVER *** [Ad Ah 4c Td] [6h]
edovale493: checks 
tcaz99: bets $0.14
covid19ad: folds 
edovale493: folds 
Uncalled bet ($0.14) returned to tcaz99
tcaz99 collected $0.14 from pot
*** SUMMARY ***
Total pot $0.15 | Rake $0.01 
Board [Ad Ah 4c Td 6h]
Seat 1: edovale493 (small blind) folded on the River
Seat 2: tcaz99 (big blind) collected ($0.14)
Seat 3: CashMatteo folded before Flop (didn't bet)
Seat 4: I3inky folded before Flop (didn't bet)
Seat 5: covid19ad folded on the River
Seat 6: Nimbus_Meeseeks (button) folded before Flop (didn't bet)

Hand #630: 

PokerStars Hand #246252431803:  Hold'em No Limit ($0.02/$0.05 CAD) - 2023/09/29 15:54:46 ET
Table 'Hadar III' 6-max Seat #1 is the button
Seat 1: edovale493 ($5.32 in chips) 
Seat 2: tcaz99 ($4.95 in chips) 
Seat 3: CashMatteo ($1.86 in chips) 
Seat 4: I3inky ($8.40 in chips) 
Seat 5: covid19ad ($4.57 in chips) 
Seat 6: Nimbus_Meeseeks ($5.09 in chips) 
tcaz99: posts small blind $0.02
CashMatteo: posts big blind $0.05
*** HOLE CARDS ***
Dealt to CashMatteo [3c 2d]
I3inky: folds 
covid19ad: raises $0.12 to $0.17
Nimbus_Meeseeks: folds 
edovale493: folds 
tcaz99: folds 
CashMatteo: folds 
Uncalled bet ($0.12) returned to covid19ad
covid19ad collected $0.12 from pot
*** SUMMARY ***
Total pot $0.12 | Rake $0 
Seat 1: edovale493 (button) folded before Flop (didn't bet)
Seat 2: tcaz99 (small blind) folded before Flop
Seat 3: CashMatteo (big blind) folded before Flop
Seat 4: I3inky folded before Flop (didn't bet)
Seat 5: covid19ad collected ($0.12)
Seat 6: Nimbus_Meeseeks folded before Flop (didn't bet)

Hand #631: 

PokerStars Hand #246252441887:  Hold'em No Limit ($0.02/$0.05 CAD) - 2023/09/29 15:55:17 ET
Table 'Hadar III' 6-max Seat #2 is the button
Seat 1: edovale493 ($5.32 in chips) 
Seat 2: tcaz99 ($4.93 in chips) 
Seat 3: CashMatteo ($1.81 in chips) 
Seat 4: I3inky ($8.40 in chips) 
Seat 5: covid19ad ($4.64 in chips) 
Seat 6: Nimbus_Meeseeks ($5.09 in chips) 
CashMatteo: posts small blind $0.02
I3inky: posts big blind $0.05
*** HOLE CARDS ***
Dealt to CashMatteo [6d 8h]
covid19ad: raises $0.12 to $0.17
Nimbus_Meeseeks: folds 
edovale493: folds 
tcaz99: folds 
CashMatteo: folds 
I3inky: folds 
Uncalled bet ($0.12) returned to covid19ad
covid19ad collected $0.12 from pot
*** SUMMARY ***
Total pot $0.12 | Rake $0 
Seat 1: edovale493 folded before Flop (didn't bet)
Seat 2: tcaz99 (button) folded before Flop (didn't bet)
Seat 3: CashMatteo (small blind) folded before Flop
Seat 4: I3inky (big blind) folded before Flop
Seat 5: covid19ad collected ($0.12)
Seat 6: Nimbus_Meeseeks folded before Flop (didn't bet)

Hand #632: 

PokerStars Hand #246252445447:  Hold'em No Limit ($0.02/$0.05 CAD) - 2023/09/29 15:55:32 ET
Table 'Hadar III' 6-max Seat #3 is the button
Seat 1: edovale493 ($5.32 in chips) 
Seat 2: tcaz99 ($4.93 in chips) 
Seat 3: CashMatteo ($1.79 in chips) 
Seat 4: I3inky ($8.35 in chips) 
Seat 5: covid19ad ($4.71 in chips) 
Seat 6: Nimbus_Meeseeks ($5.09 in chips) 
I3inky: posts small blind $0.02
covid19ad: posts big blind $0.05
*** HOLE CARDS ***
Dealt to CashMatteo [8c 9c]
Nimbus_Meeseeks: folds 
edovale493: raises $0.10 to $0.15
tcaz99: folds 
CashMatteo: calls $0.15
I3inky: folds 
covid19ad: folds 
*** FLOP *** [3h 3s 8d]
edovale493: bets $0.10
CashMatteo: calls $0.10
*** TURN *** [3h 3s 8d] [Jc]
edovale493: checks 
CashMatteo: checks 
*** RIVER *** [3h 3s 8d Jc] [4s]
edovale493: bets $0.28
CashMatteo: calls $0.28
*** SHOW DOWN ***
edovale493: shows [Th Tc] (two pair, Tens and Threes)
CashMatteo: mucks hand 
edovale493 collected $1.08 from pot
*** SUMMARY ***
Total pot $1.13 | Rake $0.05 
Board [3h 3s 8d Jc 4s]
Seat 1: edovale493 showed [Th Tc] and won ($1.08) with two pair, Tens and Threes
Seat 2: tcaz99 folded before Flop (didn't bet)
Seat 3: CashMatteo (button) mucked [8c 9c]
Seat 4: I3inky (small blind) folded before Flop
Seat 5: covid19ad (big blind) folded before Flop
Seat 6: Nimbus_Meeseeks folded before Flop (didn't bet)

Hand #633: 

PokerStars Hand #246252457931:  Hold'em No Limit ($0.02/$0.05 CAD) - 2023/09/29 15:56:24 ET
Table 'Hadar III' 6-max Seat #4 is the button
Seat 1: edovale493 ($5.87 in chips) 
Seat 2: tcaz99 ($4.93 in chips) 
Seat 3: CashMatteo ($1.26 in chips) 
Seat 4: I3inky ($8.33 in chips) 
Seat 5: covid19ad ($4.66 in chips) 
Seat 6: Nimbus_Meeseeks ($5.09 in chips) 
covid19ad: posts small blind $0.02
Nimbus_Meeseeks: posts big blind $0.05
*** HOLE CARDS ***
Dealt to CashMatteo [Kc 4c]
edovale493: calls $0.05
tcaz99: folds 
CashMatteo: calls $0.05
I3inky: folds 
covid19ad: calls $0.03
Nimbus_Meeseeks: checks 
*** FLOP *** [3s Kd 4h]
covid19ad: checks 
Nimbus_Meeseeks: checks 
edovale493: checks 
CashMatteo: bets $0.19
covid19ad: folds 
Nimbus_Meeseeks: folds 
edovale493: calls $0.19
*** TURN *** [3s Kd 4h] [9h]
edovale493: checks 
CashMatteo: bets $0.28
edovale493: folds 
Uncalled bet ($0.28) returned to CashMatteo
CashMatteo collected $0.56 from pot
CashMatteo: doesn't show hand 
*** SUMMARY ***
Total pot $0.58 | Rake $0.02 
Board [3s Kd 4h 9h]
Seat 1: edovale493 folded on the Turn
Seat 2: tcaz99 folded before Flop (didn't bet)
Seat 3: CashMatteo collected ($0.56)
Seat 4: I3inky (button) folded before Flop (didn't bet)
Seat 5: covid19ad (small blind) folded on the Flop
Seat 6: Nimbus_Meeseeks (big blind) folded on the Flop

Hand #634: 

PokerStars Hand #246252470961:  Hold'em No Limit ($0.02/$0.05 CAD) - 2023/09/29 15:57:16 ET
Table 'Hadar III' 6-max Seat #5 is the button
Seat 1: edovale493 ($5.63 in chips) 
Seat 2: tcaz99 ($4.93 in chips) 
Seat 3: CashMatteo ($1.58 in chips) 
Seat 4: I3inky ($8.33 in chips) 
Seat 5: covid19ad ($4.61 in chips) 
Seat 6: Nimbus_Meeseeks ($5.04 in chips) 
Nimbus_Meeseeks: posts small blind $0.02
edovale493: posts big blind $0.05
*** HOLE CARDS ***
Dealt to CashMatteo [4h 9h]
tcaz99: folds 
CashMatteo: folds 
I3inky: folds 
covid19ad: folds 
Nimbus_Meeseeks: folds 
Uncalled bet ($0.03) returned to edovale493
edovale493 collected $0.04 from pot
edovale493: doesn't show hand 
*** SUMMARY ***
Total pot $0.04 | Rake $0 
Seat 1: edovale493 (big blind) collected ($0.04)
Seat 2: tcaz99 folded before Flop (didn't bet)
Seat 3: CashMatteo folded before Flop (didn't bet)
Seat 4: I3inky folded before Flop (didn't bet)
Seat 5: covid19ad (button) folded before Flop (didn't bet)
Seat 6: Nimbus_Meeseeks (small blind) folded before Flop

Hand #635: 

PokerStars Hand #246252478344:  Hold'em No Limit ($0.02/$0.05 CAD) - 2023/09/29 15:57:46 ET
Table 'Hadar III' 6-max Seat #6 is the button
Seat 1: edovale493 ($5.65 in chips) 
Seat 2: tcaz99 ($4.93 in chips) 
Seat 3: CashMatteo ($1.58 in chips) 
Seat 4: I3inky ($8.33 in chips) 
Seat 5: covid19ad ($4.61 in chips) 
Seat 6: Nimbus_Meeseeks ($5.02 in chips) 
edovale493: posts small blind $0.02
tcaz99: posts big blind $0.05
*** HOLE CARDS ***
Dealt to CashMatteo [3d Js]
CashMatteo: folds 
I3inky: folds 
covid19ad: folds 
Nimbus_Meeseeks: folds 
edovale493: calls $0.03
tcaz99: checks 
*** FLOP *** [7d Td Ac]
edovale493: checks 
tcaz99: checks 
*** TURN *** [7d Td Ac] [7c]
edovale493: checks 
tcaz99: checks 
*** RIVER *** [7d Td Ac 7c] [Qs]
edovale493: checks 
tcaz99: checks 
*** SHOW DOWN ***
edovale493: shows [5s 9s] (a pair of Sevens)
tcaz99: shows [6s 9c] (a pair of Sevens)
edovale493 collected $0.05 from pot
tcaz99 collected $0.05 from pot
*** SUMMARY ***
Total pot $0.10 | Rake $0 
Board [7d Td Ac 7c Qs]
Seat 1: edovale493 (small blind) showed [5s 9s] and won ($0.05) with a pair of Sevens
Seat 2: tcaz99 (big blind) showed [6s 9c] and won ($0.05) with a pair of Sevens
Seat 3: CashMatteo folded before Flop (didn't bet)
Seat 4: I3inky folded before Flop (didn't bet)
Seat 5: covid19ad folded before Flop (didn't bet)
Seat 6: Nimbus_Meeseeks (button) folded before Flop (didn't bet)

Hand #636: 

PokerStars Hand #246252484752:  Hold'em No Limit ($0.02/$0.05 CAD) - 2023/09/29 15:58:12 ET
Table 'Hadar III' 6-max Seat #1 is the button
Seat 1: edovale493 ($5.65 in chips) 
Seat 2: tcaz99 ($4.93 in chips) 
Seat 3: CashMatteo ($1.58 in chips) 
Seat 4: I3inky ($8.33 in chips) 
Seat 5: covid19ad ($4.61 in chips) 
Seat 6: Nimbus_Meeseeks ($5.02 in chips) 
tcaz99: posts small blind $0.02
CashMatteo: posts big blind $0.05
*** HOLE CARDS ***
Dealt to CashMatteo [As Kh]
I3inky: folds 
I3inky is disconnected 
covid19ad: calls $0.05
Nimbus_Meeseeks: folds 
edovale493: raises $0.17 to $0.22
tcaz99: folds 
CashMatteo: raises $0.51 to $0.73
covid19ad: folds 
edovale493: calls $0.51
*** FLOP *** [8c 6c Kd]
CashMatteo: checks 
edovale493: checks 
*** TURN *** [8c 6c Kd] [7d]
CashMatteo: bets $0.85 and is all-in
edovale493: calls $0.85
*** RIVER *** [8c 6c Kd 7d] [Ks]
*** SHOW DOWN ***
CashMatteo: shows [As Kh] (three of a kind, Kings)
edovale493: shows [4d Ad] (a pair of Kings)
CashMatteo collected $3.10 from pot
*** SUMMARY ***
Total pot $3.23 | Rake $0.13 
Board [8c 6c Kd 7d Ks]
Seat 1: edovale493 (button) showed [4d Ad] and lost with a pair of Kings
Seat 2: tcaz99 (small blind) folded before Flop
Seat 3: CashMatteo (big blind) showed [As Kh] and won ($3.10) with three of a kind, Kings
Seat 4: I3inky folded before Flop (didn't bet)
Seat 5: covid19ad folded before Flop
Seat 6: Nimbus_Meeseeks folded before Flop (didn't bet)

Hand #637: 

PokerStars Hand #246252497822:  Hold'em No Limit ($0.02/$0.05 CAD) - 2023/09/29 15:59:05 ET
Table 'Hadar III' 6-max Seat #2 is the button
Seat 1: edovale493 ($4.07 in chips) 
Seat 2: tcaz99 ($4.91 in chips) 
Seat 3: CashMatteo ($3.10 in chips) 
Seat 5: covid19ad ($4.56 in chips) 
Seat 6: Nimbus_Meeseeks ($5.02 in chips) 
CashMatteo: posts small blind $0.02
covid19ad: posts big blind $0.05
*** HOLE CARDS ***
Dealt to CashMatteo [9c 9s]
Nimbus_Meeseeks: folds 
edovale493: raises $0.12 to $0.17
tcaz99: raises $4.74 to $4.91 and is all-in
CashMatteo: calls $3.08 and is all-in
covid19ad: folds 
edovale493: folds [Qd Kd]
Uncalled bet ($1.81) returned to tcaz99
*** FLOP *** [7c 3h 7h]
*** TURN *** [7c 3h 7h] [5c]
*** RIVER *** [7c 3h 7h 5c] [8d]
*** SHOW DOWN ***
CashMatteo: shows [9c 9s] (two pair, Nines and Sevens)
tcaz99: shows [Ah Ac] (two pair, Aces and Sevens)
tcaz99 collected $6.15 from pot
*** SUMMARY ***
Total pot $6.42 | Rake $0.27 
Board [7c 3h 7h 5c 8d]
Seat 1: edovale493 folded before Flop
Seat 2: tcaz99 (button) showed [Ah Ac] and won ($6.15) with two pair, Aces and Sevens
Seat 3: CashMatteo (small blind) showed [9c 9s] and lost with two pair, Nines and Sevens
Seat 5: covid19ad (big blind) folded before Flop
Seat 6: Nimbus_Meeseeks folded before Flop (didn't bet)

Hand #638: 

PokerStars Hand #246280155694:  Hold'em No Limit ($0.02/$0.05 CAD) - 2023/10/01 0:15:51 ET
Table 'Minelava' 6-max Seat #2 is the button
Seat 1: 3D ICEMAN ($1.61 in chips) 
Seat 2: stugatz1948 ($7.85 in chips) 
Seat 3: Indie993 ($7.06 in chips) 
Seat 5: CashMatteo ($4 in chips) 
Indie993: posts small blind $0.02
CashMatteo: posts big blind $0.05
led6ela: sits out 
*** HOLE CARDS ***
Dealt to CashMatteo [8h 6c]
3D ICEMAN: calls $0.05
stugatz1948: folds 
Indie993: folds 
CashMatteo: checks 
*** FLOP *** [Ts As Kc]
CashMatteo: checks 
3D ICEMAN: bets $0.10
CashMatteo: folds 
Uncalled bet ($0.10) returned to 3D ICEMAN
3D ICEMAN collected $0.12 from pot
sLiCkfLiPs was removed from the table for failing to post
sLiCkfLiPs leaves the table
3D ICEMAN: doesn't show hand 
*** SUMMARY ***
Total pot $0.12 | Rake $0 
Board [Ts As Kc]
Seat 1: 3D ICEMAN collected ($0.12)
Seat 2: stugatz1948 (button) folded before Flop (didn't bet)
Seat 3: Indie993 (small blind) folded before Flop
Seat 5: CashMatteo (big blind) folded on the Flop

Hand #639: 

PokerStars Hand #246280158336:  Hold'em No Limit ($0.02/$0.05 CAD) - 2023/10/01 0:16:13 ET
Table 'Minelava' 6-max Seat #3 is the button
Seat 1: 3D ICEMAN ($1.68 in chips) 
Seat 2: stugatz1948 ($7.85 in chips) 
Seat 3: Indie993 ($7.04 in chips) 
Seat 5: CashMatteo ($3.95 in chips) 
Seat 6: led6ela ($5 in chips) 
CashMatteo: posts small blind $0.02
led6ela: posts big blind $0.05
*** HOLE CARDS ***
Dealt to CashMatteo [4d 3h]
3D ICEMAN: calls $0.05
stugatz1948: folds 
sLiCkfLiPs joins the table at seat #4 
Indie993: folds 
CashMatteo: folds 
led6ela: checks 
*** FLOP *** [Kd 4c 7c]
led6ela: checks 
3D ICEMAN: checks 
*** TURN *** [Kd 4c 7c] [Jc]
led6ela: checks 
3D ICEMAN: bets $0.10
led6ela: folds 
Uncalled bet ($0.10) returned to 3D ICEMAN
3D ICEMAN collected $0.12 from pot
3D ICEMAN: doesn't show hand 
*** SUMMARY ***
Total pot $0.12 | Rake $0 
Board [Kd 4c 7c Jc]
Seat 1: 3D ICEMAN collected ($0.12)
Seat 2: stugatz1948 folded before Flop (didn't bet)
Seat 3: Indie993 (button) folded before Flop (didn't bet)
Seat 5: CashMatteo (small blind) folded before Flop
Seat 6: led6ela (big blind) folded on the Turn

Hand #640: 

PokerStars Hand #246280162865:  Hold'em No Limit ($0.02/$0.05 CAD) - 2023/10/01 0:16:51 ET
Table 'Minelava' 6-max Seat #5 is the button
Seat 1: 3D ICEMAN ($1.75 in chips) 
Seat 2: stugatz1948 ($7.85 in chips) 
Seat 3: Indie993 ($7.04 in chips) 
Seat 4: sLiCkfLiPs ($10.54 in chips) 
Seat 5: CashMatteo ($3.93 in chips) 
Seat 6: led6ela ($4.95 in chips) 
led6ela: posts small blind $0.02
3D ICEMAN: posts big blind $0.05
sLiCkfLiPs: posts big blind $0.05
*** HOLE CARDS ***
Dealt to CashMatteo [6h 2h]
stugatz1948: folds 
Indie993: folds 
sLiCkfLiPs: checks 
CashMatteo: folds 
led6ela: folds 
3D ICEMAN: checks 
*** FLOP *** [Jh Qd 7h]
3D ICEMAN: checks 
sLiCkfLiPs: checks 
*** TURN *** [Jh Qd 7h] [Jd]
3D ICEMAN: checks 
sLiCkfLiPs: checks 
*** RIVER *** [Jh Qd 7h Jd] [6s]
3D ICEMAN: checks 
sLiCkfLiPs: checks 
*** SHOW DOWN ***
3D ICEMAN: shows [6d 4h] (two pair, Jacks and Sixes)
sLiCkfLiPs: mucks hand 
3D ICEMAN collected $0.12 from pot
*** SUMMARY ***
Total pot $0.12 | Rake $0 
Board [Jh Qd 7h Jd 6s]
Seat 1: 3D ICEMAN (big blind) showed [6d 4h] and won ($0.12) with two pair, Jacks and Sixes
Seat 2: stugatz1948 folded before Flop (didn't bet)
Seat 3: Indie993 folded before Flop (didn't bet)
Seat 4: sLiCkfLiPs mucked [8c Kh]
Seat 5: CashMatteo (button) folded before Flop (didn't bet)
Seat 6: led6ela (small blind) folded before Flop

Hand #641: 

PokerStars Hand #246280167967:  Hold'em No Limit ($0.02/$0.05 CAD) - 2023/10/01 0:17:33 ET
Table 'Minelava' 6-max Seat #6 is the button
Seat 1: 3D ICEMAN ($1.82 in chips) 
Seat 2: stugatz1948 ($7.85 in chips) 
Seat 3: Indie993 ($7.04 in chips) 
Seat 4: sLiCkfLiPs ($10.49 in chips) 
Seat 5: CashMatteo ($3.93 in chips) 
Seat 6: led6ela ($4.93 in chips) 
3D ICEMAN: posts small blind $0.02
stugatz1948: posts big blind $0.05
*** HOLE CARDS ***
Dealt to CashMatteo [Ks 5c]
Indie993: folds 
sLiCkfLiPs: folds 
CashMatteo: folds 
led6ela: folds 
3D ICEMAN: calls $0.03
stugatz1948: raises $7.80 to $7.85 and is all-in
3D ICEMAN: folds 
Uncalled bet ($7.80) returned to stugatz1948
stugatz1948 collected $0.10 from pot
stugatz1948: doesn't show hand 
*** SUMMARY ***
Total pot $0.10 | Rake $0 
Seat 1: 3D ICEMAN (small blind) folded before Flop
Seat 2: stugatz1948 (big blind) collected ($0.10)
Seat 3: Indie993 folded before Flop (didn't bet)
Seat 4: sLiCkfLiPs folded before Flop (didn't bet)
Seat 5: CashMatteo folded before Flop (didn't bet)
Seat 6: led6ela (button) folded before Flop (didn't bet)

Hand #642: 

PokerStars Hand #246280171847:  Hold'em No Limit ($0.02/$0.05 CAD) - 2023/10/01 0:18:06 ET
Table 'Minelava' 6-max Seat #1 is the button
Seat 1: 3D ICEMAN ($1.77 in chips) 
Seat 2: stugatz1948 ($7.90 in chips) 
Seat 3: Indie993 ($7.04 in chips) 
Seat 4: sLiCkfLiPs ($10.49 in chips) 
Seat 5: CashMatteo ($3.93 in chips) 
Seat 6: led6ela ($4.93 in chips) 
stugatz1948: posts small blind $0.02
Indie993: posts big blind $0.05
*** HOLE CARDS ***
Dealt to CashMatteo [Ad 6d]
sLiCkfLiPs: raises $0.07 to $0.12
CashMatteo: calls $0.12
led6ela: folds 
3D ICEMAN: folds 
stugatz1948: folds 
Indie993: calls $0.07
*** FLOP *** [2c 7c 4c]
Indie993: checks 
sLiCkfLiPs: checks 
CashMatteo: checks 
*** TURN *** [2c 7c 4c] [4s]
Indie993: checks 
sLiCkfLiPs: bets $0.21
CashMatteo: folds 
Indie993: folds 
Uncalled bet ($0.21) returned to sLiCkfLiPs
sLiCkfLiPs collected $0.36 from pot
sLiCkfLiPs: doesn't show hand 
*** SUMMARY ***
Total pot $0.38 | Rake $0.02 
Board [2c 7c 4c 4s]
Seat 1: 3D ICEMAN (button) folded before Flop (didn't bet)
Seat 2: stugatz1948 (small blind) folded before Flop
Seat 3: Indie993 (big blind) folded on the Turn
Seat 4: sLiCkfLiPs collected ($0.36)
Seat 5: CashMatteo folded on the Turn
Seat 6: led6ela folded before Flop (didn't bet)

Hand #643: 

PokerStars Hand #246280179476:  Hold'em No Limit ($0.02/$0.05 CAD) - 2023/10/01 0:19:10 ET
Table 'Minelava' 6-max Seat #2 is the button
Seat 1: 3D ICEMAN ($1.77 in chips) 
Seat 2: stugatz1948 ($7.88 in chips) 
Seat 3: Indie993 ($6.92 in chips) 
Seat 4: sLiCkfLiPs ($10.73 in chips) 
Seat 5: CashMatteo ($3.81 in chips) 
Seat 6: led6ela ($4.93 in chips) 
Indie993: posts small blind $0.02
sLiCkfLiPs: posts big blind $0.05
*** HOLE CARDS ***
Dealt to CashMatteo [Jh 5c]
CashMatteo: folds 
led6ela: folds 
3D ICEMAN: folds 
stugatz1948: folds 
Indie993: raises $0.10 to $0.15
sLiCkfLiPs: calls $0.10
*** FLOP *** [Ac 9c Qs]
Indie993: bets $0.29
sLiCkfLiPs: calls $0.29
*** TURN *** [Ac 9c Qs] [8c]
Indie993: bets $0.42
sLiCkfLiPs: calls $0.42
*** RIVER *** [Ac 9c Qs 8c] [Qd]
Indie993: bets $0.83
sLiCkfLiPs: calls $0.83
*** SHOW DOWN ***
Indie993: shows [Kc Ah] (two pair, Aces and Queens)
sLiCkfLiPs: mucks hand 
Indie993 collected $3.24 from pot
*** SUMMARY ***
Total pot $3.38 | Rake $0.14 
Board [Ac 9c Qs 8c Qd]
Seat 1: 3D ICEMAN folded before Flop (didn't bet)
Seat 2: stugatz1948 (button) folded before Flop (didn't bet)
Seat 3: Indie993 (small blind) showed [Kc Ah] and won ($3.24) with two pair, Aces and Queens
Seat 4: sLiCkfLiPs (big blind) mucked [8d Ad]
Seat 5: CashMatteo folded before Flop (didn't bet)
Seat 6: led6ela folded before Flop (didn't bet)

Hand #644: 

PokerStars Hand #246280183788:  Hold'em No Limit ($0.02/$0.05 CAD) - 2023/10/01 0:19:46 ET
Table 'Minelava' 6-max Seat #3 is the button
Seat 1: 3D ICEMAN ($1.77 in chips) 
Seat 2: stugatz1948 ($7.88 in chips) 
Seat 3: Indie993 ($8.47 in chips) 
Seat 4: sLiCkfLiPs ($9.04 in chips) 
Seat 5: CashMatteo ($3.81 in chips) 
Seat 6: led6ela ($4.93 in chips) 
sLiCkfLiPs: posts small blind $0.02
CashMatteo: posts big blind $0.05
*** HOLE CARDS ***
Dealt to CashMatteo [7c 3d]
led6ela: folds 
3D ICEMAN: folds 
stugatz1948: folds 
Indie993: folds 
sLiCkfLiPs: calls $0.03
CashMatteo: checks 
*** FLOP *** [Jd 4s Ah]
sLiCkfLiPs: checks 
CashMatteo: checks 
*** TURN *** [Jd 4s Ah] [2c]
sLiCkfLiPs: bets $0.10
CashMatteo: folds 
Uncalled bet ($0.10) returned to sLiCkfLiPs
sLiCkfLiPs collected $0.10 from pot
sLiCkfLiPs: doesn't show hand 
*** SUMMARY ***
Total pot $0.10 | Rake $0 
Board [Jd 4s Ah 2c]
Seat 1: 3D ICEMAN folded before Flop (didn't bet)
Seat 2: stugatz1948 folded before Flop (didn't bet)
Seat 3: Indie993 (button) folded before Flop (didn't bet)
Seat 4: sLiCkfLiPs (small blind) collected ($0.10)
Seat 5: CashMatteo (big blind) folded on the Turn
Seat 6: led6ela folded before Flop (didn't bet)

Hand #645: 

PokerStars Hand #246280187419:  Hold'em No Limit ($0.02/$0.05 CAD) - 2023/10/01 0:20:17 ET
Table 'Minelava' 6-max Seat #4 is the button
Seat 1: 3D ICEMAN ($1.77 in chips) 
Seat 2: stugatz1948 ($7.88 in chips) 
Seat 3: Indie993 ($8.47 in chips) 
Seat 4: sLiCkfLiPs ($9.09 in chips) 
Seat 5: CashMatteo ($3.76 in chips) 
Seat 6: led6ela ($4.93 in chips) 
CashMatteo: posts small blind $0.02
led6ela: posts big blind $0.05
*** HOLE CARDS ***
Dealt to CashMatteo [5s 6d]
3D ICEMAN: folds 
stugatz1948: raises $0.10 to $0.15
Indie993: folds 
sLiCkfLiPs: folds 
sLiCkfLiPs leaves the table
CashMatteo: folds 
led6ela: folds 
Uncalled bet ($0.10) returned to stugatz1948
stugatz1948 collected $0.12 from pot
stugatz1948: doesn't show hand 
*** SUMMARY ***
Total pot $0.12 | Rake $0 
Seat 1: 3D ICEMAN folded before Flop (didn't bet)
Seat 2: stugatz1948 collected ($0.12)
Seat 3: Indie993 folded before Flop (didn't bet)
Seat 4: sLiCkfLiPs (button) folded before Flop (didn't bet)
Seat 5: CashMatteo (small blind) folded before Flop
Seat 6: led6ela (big blind) folded before Flop

Hand #646: 

PokerStars Hand #246280190286:  Hold'em No Limit ($0.02/$0.05 CAD) - 2023/10/01 0:20:40 ET
Table 'Minelava' 6-max Seat #5 is the button
Seat 1: 3D ICEMAN ($1.77 in chips) 
Seat 2: stugatz1948 ($7.95 in chips) 
Seat 3: Indie993 ($8.47 in chips) 
Seat 5: CashMatteo ($3.74 in chips) 
Seat 6: led6ela ($4.88 in chips) 
led6ela: posts small blind $0.02
3D ICEMAN: posts big blind $0.05
*** HOLE CARDS ***
Dealt to CashMatteo [6s Tc]
stugatz1948: folds 
Indie993: raises $0.17 to $0.22
CashMatteo: folds 
led6ela: folds 
3D ICEMAN: folds 
Uncalled bet ($0.17) returned to Indie993
Indie993 collected $0.12 from pot
*** SUMMARY ***
Total pot $0.12 | Rake $0 
Seat 1: 3D ICEMAN (big blind) folded before Flop
Seat 2: stugatz1948 folded before Flop (didn't bet)
Seat 3: Indie993 collected ($0.12)
Seat 5: CashMatteo (button) folded before Flop (didn't bet)
Seat 6: led6ela (small blind) folded before Flop

Hand #647: 

PokerStars Hand #246280193724:  Hold'em No Limit ($0.02/$0.05 CAD) - 2023/10/01 0:21:09 ET
Table 'Minelava' 6-max Seat #6 is the button
Seat 1: 3D ICEMAN ($1.72 in chips) 
Seat 2: stugatz1948 ($7.95 in chips) 
Seat 3: Indie993 ($8.54 in chips) 
Seat 5: CashMatteo ($3.74 in chips) 
Seat 6: led6ela ($4.86 in chips) 
3D ICEMAN: posts small blind $0.02
stugatz1948: posts big blind $0.05
*** HOLE CARDS ***
Dealt to CashMatteo [4c Qs]
Indie993: calls $0.05
CashMatteo: folds 
led6ela: folds 
3D ICEMAN: folds 
stugatz1948: raises $0.20 to $0.25
Indie993: folds 
Uncalled bet ($0.20) returned to stugatz1948
stugatz1948 collected $0.12 from pot
stugatz1948: doesn't show hand 
*** SUMMARY ***
Total pot $0.12 | Rake $0 
Seat 1: 3D ICEMAN (small blind) folded before Flop
Seat 2: stugatz1948 (big blind) collected ($0.12)
Seat 3: Indie993 folded before Flop
Seat 5: CashMatteo folded before Flop (didn't bet)
Seat 6: led6ela (button) folded before Flop (didn't bet)

Hand #648: 

PokerStars Hand #246280196526:  Hold'em No Limit ($0.02/$0.05 CAD) - 2023/10/01 0:21:33 ET
Table 'Minelava' 6-max Seat #1 is the button
Seat 1: 3D ICEMAN ($1.70 in chips) 
Seat 2: stugatz1948 ($8.02 in chips) 
Seat 3: Indie993 ($8.49 in chips) 
Seat 5: CashMatteo ($3.74 in chips) 
Seat 6: led6ela ($4.86 in chips) 
stugatz1948: posts small blind $0.02
Indie993: posts big blind $0.05
*** HOLE CARDS ***
Dealt to CashMatteo [9d Tc]
anthony10112 joins the table at seat #4 
CashMatteo: calls $0.05
led6ela: folds 
3D ICEMAN: calls $0.05
stugatz1948: folds 
Indie993: checks 
*** FLOP *** [Ks 2s Qh]
Indie993: checks 
CashMatteo: checks 
3D ICEMAN: checks 
*** TURN *** [Ks 2s Qh] [2d]
Indie993: checks 
CashMatteo: checks 
3D ICEMAN: checks 
*** RIVER *** [Ks 2s Qh 2d] [Qs]
Indie993: checks 
CashMatteo: checks 
3D ICEMAN: checks 
*** SHOW DOWN ***
Indie993: shows [Th 8s] (two pair, Queens and Deuces)
CashMatteo: shows [9d Tc] (two pair, Queens and Deuces)
3D ICEMAN: shows [Jh As] (two pair, Queens and Deuces - Ace kicker)
3D ICEMAN collected $0.16 from pot
*** SUMMARY ***
Total pot $0.17 | Rake $0.01 
Board [Ks 2s Qh 2d Qs]
Seat 1: 3D ICEMAN (button) showed [Jh As] and won ($0.16) with two pair, Queens and Deuces
Seat 2: stugatz1948 (small blind) folded before Flop
Seat 3: Indie993 (big blind) showed [Th 8s] and lost with two pair, Queens and Deuces
Seat 5: CashMatteo showed [9d Tc] and lost with two pair, Queens and Deuces
Seat 6: led6ela folded before Flop (didn't bet)

Hand #649: 

PokerStars Hand #246280200144:  Hold'em No Limit ($0.02/$0.05 CAD) - 2023/10/01 0:22:03 ET
Table 'Minelava' 6-max Seat #2 is the button
Seat 1: 3D ICEMAN ($1.81 in chips) 
Seat 2: stugatz1948 ($8 in chips) 
Seat 3: Indie993 ($8.44 in chips) 
Seat 4: anthony10112 ($2.34 in chips) 
Seat 5: CashMatteo ($3.69 in chips) 
Seat 6: led6ela ($4.86 in chips) 
Indie993: posts small blind $0.02
anthony10112: posts big blind $0.05
*** HOLE CARDS ***
Dealt to CashMatteo [Qd 4s]
CashMatteo: calls $0.05
led6ela: calls $0.05
3D ICEMAN: calls $0.05
stugatz1948: calls $0.05
Indie993: calls $0.03
anthony10112: checks 
*** FLOP *** [Ks 3c 2d]
Indie993: bets $0.15
anthony10112: calls $0.15
CashMatteo: folds 
led6ela: calls $0.15
3D ICEMAN: folds 
stugatz1948: calls $0.15
*** TURN *** [Ks 3c 2d] [Ad]
Indie993: checks 
anthony10112: checks 
led6ela: bets $0.43
stugatz1948: calls $0.43
Indie993: folds 
anthony10112: calls $0.43
*** RIVER *** [Ks 3c 2d Ad] [5d]
anthony10112: checks 
led6ela: checks 
stugatz1948: bets $2.10
anthony10112: folds 
led6ela: folds 
Uncalled bet ($2.10) returned to stugatz1948
stugatz1948 collected $2.10 from pot
stugatz1948: doesn't show hand 
*** SUMMARY ***
Total pot $2.19 | Rake $0.09 
Board [Ks 3c 2d Ad 5d]
Seat 1: 3D ICEMAN folded on the Flop
Seat 2: stugatz1948 (button) collected ($2.10)
Seat 3: Indie993 (small blind) folded on the Turn
Seat 4: anthony10112 (big blind) folded on the River
Seat 5: CashMatteo folded on the Flop
Seat 6: led6ela folded on the River

Hand #650: 

PokerStars Hand #246280210794:  Hold'em No Limit ($0.02/$0.05 CAD) - 2023/10/01 0:23:33 ET
Table 'Minelava' 6-max Seat #3 is the button
Seat 1: 3D ICEMAN ($1.76 in chips) 
Seat 2: stugatz1948 ($9.47 in chips) 
Seat 3: Indie993 ($8.24 in chips) 
Seat 4: anthony10112 ($1.71 in chips) 
Seat 5: CashMatteo ($3.64 in chips) 
Seat 6: led6ela ($5 in chips) 
anthony10112: posts small blind $0.02
CashMatteo: posts big blind $0.05
*** HOLE CARDS ***
Dealt to CashMatteo [5c 9c]
led6ela: raises $0.10 to $0.15
3D ICEMAN: folds 
stugatz1948: folds 
Indie993: folds 
anthony10112: calls $0.13
CashMatteo: calls $0.10
*** FLOP *** [7h Kh Qs]
anthony10112: checks 
CashMatteo: checks 
led6ela: bets $0.22
anthony10112: folds 
CashMatteo: folds 
Uncalled bet ($0.22) returned to led6ela
led6ela collected $0.43 from pot
led6ela: doesn't show hand 
*** SUMMARY ***
Total pot $0.45 | Rake $0.02 
Board [7h Kh Qs]
Seat 1: 3D ICEMAN folded before Flop (didn't bet)
Seat 2: stugatz1948 folded before Flop (didn't bet)
Seat 3: Indie993 (button) folded before Flop (didn't bet)
Seat 4: anthony10112 (small blind) folded on the Flop
Seat 5: CashMatteo (big blind) folded on the Flop
Seat 6: led6ela collected ($0.43)

Hand #651: 

PokerStars Hand #246280214288:  Hold'em No Limit ($0.02/$0.05 CAD) - 2023/10/01 0:24:03 ET
Table 'Minelava' 6-max Seat #4 is the button
Seat 1: 3D ICEMAN ($1.76 in chips) 
Seat 2: stugatz1948 ($9.47 in chips) 
Seat 3: Indie993 ($8.24 in chips) 
Seat 4: anthony10112 ($1.56 in chips) 
Seat 5: CashMatteo ($3.49 in chips) 
Seat 6: led6ela ($5.28 in chips) 
CashMatteo: posts small blind $0.02
led6ela: posts big blind $0.05
*** HOLE CARDS ***
Dealt to CashMatteo [3d 8h]
3D ICEMAN: calls $0.05
stugatz1948: folds 
Indie993: calls $0.05
anthony10112: calls $0.05
CashMatteo: folds 
led6ela: checks 
*** FLOP *** [Kh Jc 3c]
led6ela: checks 
3D ICEMAN: checks 
Indie993: bets $0.11
anthony10112: calls $0.11
led6ela: folds 
3D ICEMAN: folds 
*** TURN *** [Kh Jc 3c] [2c]
Indie993: checks 
anthony10112: bets $0.42
Indie993: folds 
Uncalled bet ($0.42) returned to anthony10112
anthony10112 collected $0.42 from pot
*** SUMMARY ***
Total pot $0.44 | Rake $0.02 
Board [Kh Jc 3c 2c]
Seat 1: 3D ICEMAN folded on the Flop
Seat 2: stugatz1948 folded before Flop (didn't bet)
Seat 3: Indie993 folded on the Turn
Seat 4: anthony10112 (button) collected ($0.42)
Seat 5: CashMatteo (small blind) folded before Flop
Seat 6: led6ela (big blind) folded on the Flop

Hand #652: 

PokerStars Hand #246280220506:  Hold'em No Limit ($0.02/$0.05 CAD) - 2023/10/01 0:24:56 ET
Table 'Minelava' 6-max Seat #5 is the button
Seat 1: 3D ICEMAN ($1.71 in chips) 
Seat 2: stugatz1948 ($9.47 in chips) 
Seat 3: Indie993 ($8.08 in chips) 
Seat 4: anthony10112 ($1.82 in chips) 
Seat 5: CashMatteo ($3.47 in chips) 
Seat 6: led6ela ($5.23 in chips) 
led6ela: posts small blind $0.02
3D ICEMAN: posts big blind $0.05
*** HOLE CARDS ***
Dealt to CashMatteo [8c Qc]
stugatz1948: folds 
Indie993: folds 
anthony10112: folds 
CashMatteo: calls $0.05
led6ela: folds 
3D ICEMAN: checks 
*** FLOP *** [7h 4c Jc]
3D ICEMAN: checks 
CashMatteo: bets $0.12
3D ICEMAN: calls $0.12
*** TURN *** [7h 4c Jc] [Td]
3D ICEMAN: checks 
CashMatteo: bets $0.18
3D ICEMAN: calls $0.18
*** RIVER *** [7h 4c Jc Td] [As]
3D ICEMAN: checks 
CashMatteo: checks 
*** SHOW DOWN ***
3D ICEMAN: shows [Js 3d] (a pair of Jacks)
CashMatteo: mucks hand 
3D ICEMAN collected $0.69 from pot
*** SUMMARY ***
Total pot $0.72 | Rake $0.03 
Board [7h 4c Jc Td As]
Seat 1: 3D ICEMAN (big blind) showed [Js 3d] and won ($0.69) with a pair of Jacks
Seat 2: stugatz1948 folded before Flop (didn't bet)
Seat 3: Indie993 folded before Flop (didn't bet)
Seat 4: anthony10112 folded before Flop (didn't bet)
Seat 5: CashMatteo (button) mucked [8c Qc]
Seat 6: led6ela (small blind) folded before Flop

Hand #653: 

PokerStars Hand #246280224529:  Hold'em No Limit ($0.02/$0.05 CAD) - 2023/10/01 0:25:30 ET
Table 'Minelava' 6-max Seat #6 is the button
Seat 1: 3D ICEMAN ($2.05 in chips) 
Seat 2: stugatz1948 ($9.47 in chips) 
Seat 3: Indie993 ($8.08 in chips) 
Seat 4: anthony10112 ($1.82 in chips) 
Seat 5: CashMatteo ($3.12 in chips) 
Seat 6: led6ela ($5.21 in chips) 
3D ICEMAN: posts small blind $0.02
stugatz1948: posts big blind $0.05
*** HOLE CARDS ***
Dealt to CashMatteo [7c Ts]
Indie993: folds 
anthony10112: calls $0.05
CashMatteo: folds 
led6ela: folds 
3D ICEMAN: folds 
stugatz1948: checks 
*** FLOP *** [5c Th Jc]
stugatz1948: checks 
anthony10112: bets $0.05
stugatz1948: folds 
Uncalled bet ($0.05) returned to anthony10112
anthony10112 collected $0.12 from pot
*** SUMMARY ***
Total pot $0.12 | Rake $0 
Board [5c Th Jc]
Seat 1: 3D ICEMAN (small blind) folded before Flop
Seat 2: stugatz1948 (big blind) folded on the Flop
Seat 3: Indie993 folded before Flop (didn't bet)
Seat 4: anthony10112 collected ($0.12)
Seat 5: CashMatteo folded before Flop (didn't bet)
Seat 6: led6ela (button) folded before Flop (didn't bet)

Hand #654: 

PokerStars Hand #246280227758:  Hold'em No Limit ($0.02/$0.05 CAD) - 2023/10/01 0:25:58 ET
Table 'Minelava' 6-max Seat #1 is the button
Seat 1: 3D ICEMAN ($2.03 in chips) 
Seat 2: stugatz1948 ($9.42 in chips) 
Seat 3: Indie993 ($8.08 in chips) 
Seat 4: anthony10112 ($1.89 in chips) 
Seat 5: CashMatteo ($3.12 in chips) 
Seat 6: led6ela ($5.21 in chips) 
stugatz1948: posts small blind $0.02
Indie993: posts big blind $0.05
*** HOLE CARDS ***
Dealt to CashMatteo [5h 2s]
anthony10112: calls $0.05
CashMatteo: folds 
led6ela: folds 
3D ICEMAN: folds 
stugatz1948: folds 
Indie993: checks 
*** FLOP *** [3s Td 4s]
Indie993: bets $0.05
anthony10112: folds 
Uncalled bet ($0.05) returned to Indie993
Indie993 collected $0.12 from pot
*** SUMMARY ***
Total pot $0.12 | Rake $0 
Board [3s Td 4s]
Seat 1: 3D ICEMAN (button) folded before Flop (didn't bet)
Seat 2: stugatz1948 (small blind) folded before Flop
Seat 3: Indie993 (big blind) collected ($0.12)
Seat 4: anthony10112 folded on the Flop
Seat 5: CashMatteo folded before Flop (didn't bet)
Seat 6: led6ela folded before Flop (didn't bet)

Hand #655: 

PokerStars Hand #246280232264:  Hold'em No Limit ($0.02/$0.05 CAD) - 2023/10/01 0:26:37 ET
Table 'Minelava' 6-max Seat #2 is the button
Seat 1: 3D ICEMAN ($2.03 in chips) 
Seat 2: stugatz1948 ($9.40 in chips) 
Seat 3: Indie993 ($8.15 in chips) 
Seat 4: anthony10112 ($1.84 in chips) 
Seat 5: CashMatteo ($3.12 in chips) 
Seat 6: led6ela ($5.21 in chips) 
Indie993: posts small blind $0.02
anthony10112: posts big blind $0.05
*** HOLE CARDS ***
Dealt to CashMatteo [5d Jh]
CashMatteo: folds 
led6ela: folds 
3D ICEMAN: folds 
stugatz1948: raises $0.10 to $0.15
Indie993: folds 
anthony10112: calls $0.10
*** FLOP *** [7h 3c Kd]
anthony10112: checks 
stugatz1948: checks 
*** TURN *** [7h 3c Kd] [Td]
anthony10112: bets $0.05
stugatz1948: calls $0.05
*** RIVER *** [7h 3c Kd Td] [3d]
anthony10112: bets $0.40
stugatz1948: folds 
Uncalled bet ($0.40) returned to anthony10112
anthony10112 collected $0.40 from pot
*** SUMMARY ***
Total pot $0.42 | Rake $0.02 
Board [7h 3c Kd Td 3d]
Seat 1: 3D ICEMAN folded before Flop (didn't bet)
Seat 2: stugatz1948 (button) folded on the River
Seat 3: Indie993 (small blind) folded before Flop
Seat 4: anthony10112 (big blind) collected ($0.40)
Seat 5: CashMatteo folded before Flop (didn't bet)
Seat 6: led6ela folded before Flop (didn't bet)

Hand #656: 

PokerStars Hand #246280237476:  Hold'em No Limit ($0.02/$0.05 CAD) - 2023/10/01 0:27:21 ET
Table 'Minelava' 6-max Seat #3 is the button
Seat 1: 3D ICEMAN ($2.03 in chips) 
Seat 2: stugatz1948 ($9.20 in chips) 
Seat 3: Indie993 ($8.13 in chips) 
Seat 4: anthony10112 ($2.04 in chips) 
Seat 5: CashMatteo ($3.12 in chips) 
Seat 6: led6ela ($5.21 in chips) 
anthony10112: posts small blind $0.02
CashMatteo: posts big blind $0.05
*** HOLE CARDS ***
Dealt to CashMatteo [2c Jd]
led6ela: folds 
3D ICEMAN: folds 
stugatz1948: raises $0.12 to $0.17
Indie993: folds 
anthony10112: folds 
CashMatteo: folds 
Uncalled bet ($0.12) returned to stugatz1948
stugatz1948 collected $0.12 from pot
stugatz1948: doesn't show hand 
*** SUMMARY ***
Total pot $0.12 | Rake $0 
Seat 1: 3D ICEMAN folded before Flop (didn't bet)
Seat 2: stugatz1948 collected ($0.12)
Seat 3: Indie993 (button) folded before Flop (didn't bet)
Seat 4: anthony10112 (small blind) folded before Flop
Seat 5: CashMatteo (big blind) folded before Flop
Seat 6: led6ela folded before Flop (didn't bet)

Hand #657: 

PokerStars Hand #246280241925:  Hold'em No Limit ($0.02/$0.05 CAD) - 2023/10/01 0:27:59 ET
Table 'Minelava' 6-max Seat #4 is the button
Seat 1: 3D ICEMAN ($2.03 in chips) 
Seat 2: stugatz1948 ($9.27 in chips) 
Seat 3: Indie993 ($8.13 in chips) 
Seat 4: anthony10112 ($2.02 in chips) 
Seat 5: CashMatteo ($3.07 in chips) 
Seat 6: led6ela ($5.21 in chips) 
CashMatteo: posts small blind $0.02
led6ela: posts big blind $0.05
*** HOLE CARDS ***
Dealt to CashMatteo [6s Ah]
3D ICEMAN: folds 
stugatz1948: raises $0.05 to $0.10
Indie993: folds 
anthony10112: calls $0.10
CashMatteo: calls $0.08
led6ela: calls $0.05
*** FLOP *** [4s 2c 8h]
CashMatteo: checks 
led6ela: checks 
stugatz1948: bets $0.38
anthony10112: folds 
CashMatteo: folds 
led6ela: folds 
Uncalled bet ($0.38) returned to stugatz1948
stugatz1948 collected $0.38 from pot
stugatz1948: doesn't show hand 
*** SUMMARY ***
Total pot $0.40 | Rake $0.02 
Board [4s 2c 8h]
Seat 1: 3D ICEMAN folded before Flop (didn't bet)
Seat 2: stugatz1948 collected ($0.38)
Seat 3: Indie993 folded before Flop (didn't bet)
Seat 4: anthony10112 (button) folded on the Flop
Seat 5: CashMatteo (small blind) folded on the Flop
Seat 6: led6ela (big blind) folded on the Flop

Hand #658: 

PokerStars Hand #246280246046:  Hold'em No Limit ($0.02/$0.05 CAD) - 2023/10/01 0:28:34 ET
Table 'Minelava' 6-max Seat #5 is the button
Seat 1: 3D ICEMAN ($2.03 in chips) 
Seat 2: stugatz1948 ($9.55 in chips) 
Seat 3: Indie993 ($8.13 in chips) 
Seat 4: anthony10112 ($1.92 in chips) 
Seat 5: CashMatteo ($2.97 in chips) 
Seat 6: led6ela ($5.11 in chips) 
led6ela: posts small blind $0.02
3D ICEMAN: posts big blind $0.05
*** HOLE CARDS ***
Dealt to CashMatteo [Ks 9c]
stugatz1948: raises $0.10 to $0.15
Indie993: folds 
anthony10112: folds 
CashMatteo: calls $0.15
led6ela: folds 
3D ICEMAN: folds 
*** FLOP *** [4d 7d 5d]
stugatz1948: checks 
CashMatteo: checks 
*** TURN *** [4d 7d 5d] [Tc]
stugatz1948: checks 
CashMatteo: checks 
*** RIVER *** [4d 7d 5d Tc] [Kd]
stugatz1948: checks 
CashMatteo: checks 
*** SHOW DOWN ***
stugatz1948: shows [7c Ac] (a pair of Sevens)
CashMatteo: shows [Ks 9c] (a pair of Kings)
CashMatteo collected $0.35 from pot
*** SUMMARY ***
Total pot $0.37 | Rake $0.02 
Board [4d 7d 5d Tc Kd]
Seat 1: 3D ICEMAN (big blind) folded before Flop
Seat 2: stugatz1948 showed [7c Ac] and lost with a pair of Sevens
Seat 3: Indie993 folded before Flop (didn't bet)
Seat 4: anthony10112 folded before Flop (didn't bet)
Seat 5: CashMatteo (button) showed [Ks 9c] and won ($0.35) with a pair of Kings
Seat 6: led6ela (small blind) folded before Flop

Hand #659: 

PokerStars Hand #246280249432:  Hold'em No Limit ($0.02/$0.05 CAD) - 2023/10/01 0:29:02 ET
Table 'Minelava' 6-max Seat #6 is the button
Seat 1: 3D ICEMAN ($1.98 in chips) 
Seat 2: stugatz1948 ($9.40 in chips) 
Seat 3: Indie993 ($8.13 in chips) 
Seat 4: anthony10112 ($1.92 in chips) 
Seat 5: CashMatteo ($3.17 in chips) 
Seat 6: led6ela ($5.09 in chips) 
3D ICEMAN: posts small blind $0.02
stugatz1948: posts big blind $0.05
*** HOLE CARDS ***
Dealt to CashMatteo [7c Kh]
Indie993: folds 
anthony10112: folds 
CashMatteo: raises $0.10 to $0.15
led6ela: folds 
3D ICEMAN: folds 
stugatz1948: folds 
Uncalled bet ($0.10) returned to CashMatteo
CashMatteo collected $0.12 from pot
CashMatteo: doesn't show hand 
*** SUMMARY ***
Total pot $0.12 | Rake $0 
Seat 1: 3D ICEMAN (small blind) folded before Flop
Seat 2: stugatz1948 (big blind) folded before Flop
Seat 3: Indie993 folded before Flop (didn't bet)
Seat 4: anthony10112 folded before Flop (didn't bet)
Seat 5: CashMatteo collected ($0.12)
Seat 6: led6ela (button) folded before Flop (didn't bet)

Hand #660: 

PokerStars Hand #246280252284:  Hold'em No Limit ($0.02/$0.05 CAD) - 2023/10/01 0:29:27 ET
Table 'Minelava' 6-max Seat #1 is the button
Seat 1: 3D ICEMAN ($1.96 in chips) 
Seat 2: stugatz1948 ($9.35 in chips) 
Seat 3: Indie993 ($8.13 in chips) 
Seat 4: anthony10112 ($1.92 in chips) 
Seat 5: CashMatteo ($3.24 in chips) 
Seat 6: led6ela ($5.09 in chips) 
stugatz1948: posts small blind $0.02
Indie993: posts big blind $0.05
*** HOLE CARDS ***
Dealt to CashMatteo [2s 6s]
anthony10112: calls $0.05
CashMatteo: folds 
led6ela: folds 
3D ICEMAN: folds 
stugatz1948: folds 
Indie993: checks 
*** FLOP *** [As 6h 8h]
Indie993: checks 
anthony10112: checks 
*** TURN *** [As 6h 8h] [5c]
Indie993: checks 
anthony10112: bets $0.12
Indie993: folds 
Uncalled bet ($0.12) returned to anthony10112
anthony10112 collected $0.12 from pot
*** SUMMARY ***
Total pot $0.12 | Rake $0 
Board [As 6h 8h 5c]
Seat 1: 3D ICEMAN (button) folded before Flop (didn't bet)
Seat 2: stugatz1948 (small blind) folded before Flop
Seat 3: Indie993 (big blind) folded on the Turn
Seat 4: anthony10112 collected ($0.12)
Seat 5: CashMatteo folded before Flop (didn't bet)
Seat 6: led6ela folded before Flop (didn't bet)

Hand #661: 

PokerStars Hand #246280258636:  Hold'em No Limit ($0.02/$0.05 CAD) - 2023/10/01 0:30:22 ET
Table 'Minelava' 6-max Seat #2 is the button
Seat 1: 3D ICEMAN ($1.96 in chips) 
Seat 2: stugatz1948 ($9.33 in chips) 
Seat 3: Indie993 ($8.08 in chips) 
Seat 4: anthony10112 ($1.99 in chips) 
Seat 5: CashMatteo ($3.24 in chips) 
Seat 6: led6ela ($5.09 in chips) 
Indie993: posts small blind $0.02
anthony10112: posts big blind $0.05
*** HOLE CARDS ***
Dealt to CashMatteo [Qh Ac]
CashMatteo: raises $0.10 to $0.15
led6ela: folds 
3D ICEMAN: folds 
stugatz1948: folds 
Indie993: folds 
anthony10112: calls $0.10
*** FLOP *** [Ts 5s 5d]
anthony10112: checks 
CashMatteo: checks 
*** TURN *** [Ts 5s 5d] [Tc]
anthony10112: bets $0.05
CashMatteo: calls $0.05
*** RIVER *** [Ts 5s 5d Tc] [Ah]
anthony10112: bets $0.55
CashMatteo: calls $0.55
*** SHOW DOWN ***
anthony10112: shows [Ad 5c] (a full house, Fives full of Aces)
CashMatteo: mucks hand 
anthony10112 collected $1.46 from pot
*** SUMMARY ***
Total pot $1.52 | Rake $0.06 
Board [Ts 5s 5d Tc Ah]
Seat 1: 3D ICEMAN folded before Flop (didn't bet)
Seat 2: stugatz1948 (button) folded before Flop (didn't bet)
Seat 3: Indie993 (small blind) folded before Flop
Seat 4: anthony10112 (big blind) showed [Ad 5c] and won ($1.46) with a full house, Fives full of Aces
Seat 5: CashMatteo mucked [Qh Ac]
Seat 6: led6ela folded before Flop (didn't bet)

Hand #662: 

PokerStars Hand #246280263786:  Hold'em No Limit ($0.02/$0.05 CAD) - 2023/10/01 0:31:07 ET
Table 'Minelava' 6-max Seat #3 is the button
Seat 1: 3D ICEMAN ($1.96 in chips) 
Seat 2: stugatz1948 ($9.33 in chips) 
Seat 3: Indie993 ($8.06 in chips) 
Seat 4: anthony10112 ($2.70 in chips) 
Seat 5: CashMatteo ($2.49 in chips) 
Seat 6: led6ela ($5.09 in chips) 
anthony10112: posts small blind $0.02
CashMatteo: posts big blind $0.05
*** HOLE CARDS ***
Dealt to CashMatteo [2h Kc]
led6ela: raises $0.10 to $0.15
3D ICEMAN: folds 
stugatz1948: folds 
Indie993: calls $0.15
anthony10112: calls $0.13
CashMatteo: calls $0.10
*** FLOP *** [5d Jd 9c]
anthony10112: checks 
CashMatteo: checks 
led6ela: checks 
Indie993: checks 
*** TURN *** [5d Jd 9c] [2d]
anthony10112: checks 
CashMatteo: checks 
led6ela: checks 
Indie993: checks 
*** RIVER *** [5d Jd 9c 2d] [6h]
anthony10112: checks 
CashMatteo: checks 
led6ela: checks 
Indie993: checks 
*** SHOW DOWN ***
anthony10112: shows [3d 5s] (a pair of Fives)
CashMatteo: mucks hand 
led6ela: mucks hand 
Indie993: mucks hand 
anthony10112 collected $0.58 from pot
*** SUMMARY ***
Total pot $0.60 | Rake $0.02 
Board [5d Jd 9c 2d 6h]
Seat 1: 3D ICEMAN folded before Flop (didn't bet)
Seat 2: stugatz1948 folded before Flop (didn't bet)
Seat 3: Indie993 (button) mucked [Ks Ts]
Seat 4: anthony10112 (small blind) showed [3d 5s] and won ($0.58) with a pair of Fives
Seat 5: CashMatteo (big blind) mucked [2h Kc]
Seat 6: led6ela mucked [Ah 7h]

Hand #663: 

PokerStars Hand #246280271394:  Hold'em No Limit ($0.02/$0.05 CAD) - 2023/10/01 0:32:13 ET
Table 'Minelava' 6-max Seat #4 is the button
Seat 1: 3D ICEMAN ($1.96 in chips) 
Seat 2: stugatz1948 ($9.33 in chips) 
Seat 3: Indie993 ($7.91 in chips) 
Seat 4: anthony10112 ($3.13 in chips) 
Seat 5: CashMatteo ($2.34 in chips) 
Seat 6: led6ela ($4.94 in chips) 
CashMatteo: posts small blind $0.02
led6ela: posts big blind $0.05
*** HOLE CARDS ***
Dealt to CashMatteo [Tc 2s]
3D ICEMAN: folds 
stugatz1948: raises $0.10 to $0.15
Indie993: folds 
anthony10112: folds 
CashMatteo: folds 
led6ela: calls $0.10
*** FLOP *** [Ac As 6d]
led6ela: checks 
stugatz1948: checks 
*** TURN *** [Ac As 6d] [8c]
led6ela: checks 
stugatz1948: bets $0.31
led6ela: folds 
Uncalled bet ($0.31) returned to stugatz1948
stugatz1948 collected $0.31 from pot
stugatz1948: doesn't show hand 
*** SUMMARY ***
Total pot $0.32 | Rake $0.01 
Board [Ac As 6d 8c]
Seat 1: 3D ICEMAN folded before Flop (didn't bet)
Seat 2: stugatz1948 collected ($0.31)
Seat 3: Indie993 folded before Flop (didn't bet)
Seat 4: anthony10112 (button) folded before Flop (didn't bet)
Seat 5: CashMatteo (small blind) folded before Flop
Seat 6: led6ela (big blind) folded on the Turn

Hand #664: 

PokerStars Hand #246280275331:  Hold'em No Limit ($0.02/$0.05 CAD) - 2023/10/01 0:32:47 ET
Table 'Minelava' 6-max Seat #5 is the button
Seat 1: 3D ICEMAN ($1.96 in chips) 
Seat 2: stugatz1948 ($9.49 in chips) 
Seat 3: Indie993 ($7.91 in chips) 
Seat 4: anthony10112 ($3.13 in chips) 
Seat 5: CashMatteo ($2.32 in chips) 
Seat 6: led6ela ($4.79 in chips) 
led6ela: posts small blind $0.02
3D ICEMAN: posts big blind $0.05
*** HOLE CARDS ***
Dealt to CashMatteo [6s Ts]
stugatz1948: folds 
Indie993: folds 
anthony10112: calls $0.05
CashMatteo: calls $0.05
led6ela: raises $0.15 to $0.20
3D ICEMAN: folds 
anthony10112: calls $0.15
CashMatteo: calls $0.15
*** FLOP *** [2d Qc 8h]
led6ela: bets $0.31
anthony10112: folds 
CashMatteo: folds 
Uncalled bet ($0.31) returned to led6ela
led6ela collected $0.62 from pot
led6ela: doesn't show hand 
*** SUMMARY ***
Total pot $0.65 | Rake $0.03 
Board [2d Qc 8h]
Seat 1: 3D ICEMAN (big blind) folded before Flop
Seat 2: stugatz1948 folded before Flop (didn't bet)
Seat 3: Indie993 folded before Flop (didn't bet)
Seat 4: anthony10112 folded on the Flop
Seat 5: CashMatteo (button) folded on the Flop
Seat 6: led6ela (small blind) collected ($0.62)

Hand #665: 

PokerStars Hand #246280280280:  Hold'em No Limit ($0.02/$0.05 CAD) - 2023/10/01 0:33:31 ET
Table 'Minelava' 6-max Seat #6 is the button
Seat 1: 3D ICEMAN ($1.91 in chips) 
Seat 2: stugatz1948 ($9.49 in chips) 
Seat 3: Indie993 ($7.91 in chips) 
Seat 4: anthony10112 ($2.93 in chips) 
Seat 5: CashMatteo ($2.12 in chips) 
Seat 6: led6ela ($5.21 in chips) 
3D ICEMAN: posts small blind $0.02
stugatz1948: posts big blind $0.05
*** HOLE CARDS ***
Dealt to CashMatteo [3c Qc]
Indie993: folds 
anthony10112: folds 
CashMatteo: calls $0.05
led6ela: folds 
3D ICEMAN: folds 
stugatz1948: checks 
*** FLOP *** [8h 4h Kh]
stugatz1948: checks 
CashMatteo: checks 
*** TURN *** [8h 4h Kh] [Qd]
stugatz1948: checks 
CashMatteo: checks 
*** RIVER *** [8h 4h Kh Qd] [Tc]
stugatz1948: checks 
CashMatteo: bets $0.06
stugatz1948: calls $0.06
*** SHOW DOWN ***
CashMatteo: shows [3c Qc] (a pair of Queens)
stugatz1948: shows [4c 8s] (two pair, Eights and Fours)
stugatz1948 collected $0.23 from pot
*** SUMMARY ***
Total pot $0.24 | Rake $0.01 
Board [8h 4h Kh Qd Tc]
Seat 1: 3D ICEMAN (small blind) folded before Flop
Seat 2: stugatz1948 (big blind) showed [4c 8s] and won ($0.23) with two pair, Eights and Fours
Seat 3: Indie993 folded before Flop (didn't bet)
Seat 4: anthony10112 folded before Flop (didn't bet)
Seat 5: CashMatteo showed [3c Qc] and lost with a pair of Queens
Seat 6: led6ela (button) folded before Flop (didn't bet)

Hand #666: 

PokerStars Hand #246280285104:  Hold'em No Limit ($0.02/$0.05 CAD) - 2023/10/01 0:34:13 ET
Table 'Minelava' 6-max Seat #1 is the button
Seat 1: 3D ICEMAN ($1.89 in chips) 
Seat 2: stugatz1948 ($9.61 in chips) 
Seat 3: Indie993 ($7.91 in chips) 
Seat 4: anthony10112 ($2.93 in chips) 
Seat 5: CashMatteo ($2.01 in chips) 
Seat 6: led6ela ($5.21 in chips) 
stugatz1948: posts small blind $0.02
Indie993: posts big blind $0.05
*** HOLE CARDS ***
Dealt to CashMatteo [8c Qc]
anthony10112: calls $0.05
CashMatteo: raises $0.10 to $0.15
led6ela: folds 
3D ICEMAN: folds 
stugatz1948: folds 
Indie993: folds 
anthony10112: calls $0.10
*** FLOP *** [Tc 4c As]
anthony10112: checks 
CashMatteo: bets $0.35
anthony10112: folds 
Uncalled bet ($0.35) returned to CashMatteo
CashMatteo collected $0.35 from pot
CashMatteo: doesn't show hand 
*** SUMMARY ***
Total pot $0.37 | Rake $0.02 
Board [Tc 4c As]
Seat 1: 3D ICEMAN (button) folded before Flop (didn't bet)
Seat 2: stugatz1948 (small blind) folded before Flop
Seat 3: Indie993 (big blind) folded before Flop
Seat 4: anthony10112 folded on the Flop
Seat 5: CashMatteo collected ($0.35)
Seat 6: led6ela folded before Flop (didn't bet)

Hand #667: 

PokerStars Hand #246280289171:  Hold'em No Limit ($0.02/$0.05 CAD) - 2023/10/01 0:34:48 ET
Table 'Minelava' 6-max Seat #2 is the button
Seat 1: 3D ICEMAN ($1.89 in chips) 
Seat 2: stugatz1948 ($9.59 in chips) 
Seat 3: Indie993 ($7.86 in chips) 
Seat 4: anthony10112 ($2.78 in chips) 
Seat 5: CashMatteo ($2.21 in chips) 
Seat 6: led6ela ($5.21 in chips) 
Indie993: posts small blind $0.02
anthony10112: posts big blind $0.05
*** HOLE CARDS ***
Dealt to CashMatteo [Qs 2c]
CashMatteo: folds 
led6ela: calls $0.05
3D ICEMAN: folds 
stugatz1948: folds 
Indie993: calls $0.03
anthony10112: checks 
*** FLOP *** [Kd Ac 3d]
Indie993: checks 
anthony10112: checks 
led6ela: bets $0.07
Indie993: folds 
anthony10112: calls $0.07
*** TURN *** [Kd Ac 3d] [7h]
anthony10112: checks 
led6ela: bets $0.28
anthony10112: calls $0.28
*** RIVER *** [Kd Ac 3d 7h] [4h]
anthony10112: bets $0.81
led6ela: raises $1.22 to $2.03
anthony10112: raises $0.35 to $2.38 and is all-in
led6ela: calls $0.35
*** SHOW DOWN ***
anthony10112: shows [2h 5d] (a straight, Ace to Five)
led6ela: shows [3s 3c] (three of a kind, Threes)
anthony10112 collected $5.38 from pot
*** SUMMARY ***
Total pot $5.61 | Rake $0.23 
Board [Kd Ac 3d 7h 4h]
Seat 1: 3D ICEMAN folded before Flop (didn't bet)
Seat 2: stugatz1948 (button) folded before Flop (didn't bet)
Seat 3: Indie993 (small blind) folded on the Flop
Seat 4: anthony10112 (big blind) showed [2h 5d] and won ($5.38) with a straight, Ace to Five
Seat 5: CashMatteo folded before Flop (didn't bet)
Seat 6: led6ela showed [3s 3c] and lost with three of a kind, Threes

Hand #668: 

PokerStars Hand #246280299955:  Hold'em No Limit ($0.02/$0.05 CAD) - 2023/10/01 0:36:22 ET
Table 'Minelava' 6-max Seat #3 is the button
Seat 1: 3D ICEMAN ($1.89 in chips) 
Seat 2: stugatz1948 ($9.59 in chips) 
Seat 3: Indie993 ($7.81 in chips) 
Seat 4: anthony10112 ($5.38 in chips) 
Seat 5: CashMatteo ($2.21 in chips) 
Seat 6: led6ela ($5 in chips) 
anthony10112: posts small blind $0.02
CashMatteo: posts big blind $0.05
*** HOLE CARDS ***
Dealt to CashMatteo [Qd 6d]
led6ela: raises $0.10 to $0.15
3D ICEMAN: folds 
stugatz1948: calls $0.15
Indie993: folds 
anthony10112: calls $0.13
CashMatteo: calls $0.10
*** FLOP *** [7c 6c 2c]
anthony10112: checks 
CashMatteo: checks 
led6ela: checks 
stugatz1948: bets $0.58
anthony10112: raises $0.58 to $1.16
CashMatteo: folds 
led6ela: calls $1.16
stugatz1948: calls $0.58
*** TURN *** [7c 6c 2c] [Jc]
anthony10112: checks 
led6ela: checks 
stugatz1948: bets $0.30
anthony10112: calls $0.30
led6ela: calls $0.30
*** RIVER *** [7c 6c 2c Jc] [Jd]
anthony10112: bets $3.77 and is all-in
led6ela: calls $3.39 and is all-in
stugatz1948: folds 
Uncalled bet ($0.38) returned to anthony10112
*** SHOW DOWN ***
anthony10112: shows [7d 7s] (a full house, Sevens full of Jacks)
led6ela: shows [Js Jh] (four of a kind, Jacks)
led6ela collected $11.27 from pot
*** SUMMARY ***
Total pot $11.76 | Rake $0.49 
Board [7c 6c 2c Jc Jd]
Seat 1: 3D ICEMAN folded before Flop (didn't bet)
Seat 2: stugatz1948 folded on the River
Seat 3: Indie993 (button) folded before Flop (didn't bet)
Seat 4: anthony10112 (small blind) showed [7d 7s] and lost with a full house, Sevens full of Jacks
Seat 5: CashMatteo (big blind) folded on the Flop
Seat 6: led6ela showed [Js Jh] and won ($11.27) with four of a kind, Jacks

Hand #669: 

PokerStars Hand #246280312948:  Hold'em No Limit ($0.02/$0.05 CAD) - 2023/10/01 0:38:16 ET
Table 'Minelava' 6-max Seat #4 is the button
Seat 1: 3D ICEMAN ($1.89 in chips) 
Seat 2: stugatz1948 ($7.98 in chips) 
Seat 3: Indie993 ($7.81 in chips) 
Seat 4: anthony10112 ($0.38 in chips) 
Seat 5: CashMatteo ($2.06 in chips) 
Seat 6: led6ela ($11.27 in chips) 
CashMatteo: posts small blind $0.02
led6ela: posts big blind $0.05
*** HOLE CARDS ***
Dealt to CashMatteo [Ac Qs]
3D ICEMAN: folds 
stugatz1948: folds 
Indie993: folds 
anthony10112: raises $0.33 to $0.38 and is all-in
CashMatteo: calls $0.36
led6ela: folds 
*** FLOP *** [Ad 3s 6d]
*** TURN *** [Ad 3s 6d] [6s]
*** RIVER *** [Ad 3s 6d 6s] [7d]
*** SHOW DOWN ***
CashMatteo: shows [Ac Qs] (two pair, Aces and Sixes)
anthony10112: shows [Kh 4d] (a pair of Sixes)
CashMatteo collected $0.78 from pot
*** SUMMARY ***
Total pot $0.81 | Rake $0.03 
Board [Ad 3s 6d 6s 7d]
Seat 1: 3D ICEMAN folded before Flop (didn't bet)
Seat 2: stugatz1948 folded before Flop (didn't bet)
Seat 3: Indie993 folded before Flop (didn't bet)
Seat 4: anthony10112 (button) showed [Kh 4d] and lost with a pair of Sixes
Seat 5: CashMatteo (small blind) showed [Ac Qs] and won ($0.78) with two pair, Aces and Sixes
Seat 6: led6ela (big blind) folded before Flop

Hand #670: 

PokerStars Hand #246280316459:  Hold'em No Limit ($0.02/$0.05 CAD) - 2023/10/01 0:38:46 ET
Table 'Minelava' 6-max Seat #5 is the button
Seat 1: 3D ICEMAN ($1.89 in chips) 
Seat 2: stugatz1948 ($7.98 in chips) 
Seat 3: Indie993 ($7.81 in chips) 
Seat 5: CashMatteo ($2.46 in chips) 
Seat 6: led6ela ($11.22 in chips) 
led6ela: posts small blind $0.02
3D ICEMAN: posts big blind $0.05
*** HOLE CARDS ***
Dealt to CashMatteo [7s 2s]
stugatz1948: folds 
Indie993: folds 
CashMatteo: calls $0.05
led6ela: folds 
3D ICEMAN: checks 
*** FLOP *** [Jh Qc 5h]
3D ICEMAN: checks 
CashMatteo: checks 
*** TURN *** [Jh Qc 5h] [Ks]
anthony10112 is disconnected 
3D ICEMAN: checks 
CashMatteo: checks 
*** RIVER *** [Jh Qc 5h Ks] [3h]
3D ICEMAN: checks 
CashMatteo: checks 
*** SHOW DOWN ***
3D ICEMAN: shows [Ts 7d] (high card King)
CashMatteo: mucks hand 
3D ICEMAN collected $0.12 from pot
*** SUMMARY ***
Total pot $0.12 | Rake $0 
Board [Jh Qc 5h Ks 3h]
Seat 1: 3D ICEMAN (big blind) showed [Ts 7d] and won ($0.12) with high card King
Seat 2: stugatz1948 folded before Flop (didn't bet)
Seat 3: Indie993 folded before Flop (didn't bet)
Seat 5: CashMatteo (button) mucked [7s 2s]
Seat 6: led6ela (small blind) folded before Flop

Hand #671: 

PokerStars Hand #246280322031:  Hold'em No Limit ($0.02/$0.05 CAD) - 2023/10/01 0:39:35 ET
Table 'Minelava' 6-max Seat #6 is the button
Seat 1: 3D ICEMAN ($1.96 in chips) 
Seat 2: stugatz1948 ($7.98 in chips) 
Seat 3: Indie993 ($7.81 in chips) 
Seat 5: CashMatteo ($2.41 in chips) 
Seat 6: led6ela ($11.20 in chips) 
3D ICEMAN: posts small blind $0.02
stugatz1948: posts big blind $0.05
*** HOLE CARDS ***
Dealt to CashMatteo [6c 5d]
Indie993 has timed out
Indie993: folds 
CashMatteo: folds 
led6ela: folds 
3D ICEMAN: calls $0.03
stugatz1948: checks 
*** FLOP *** [4d Th Jd]
3D ICEMAN: checks 
stugatz1948: checks 
*** TURN *** [4d Th Jd] [8s]
3D ICEMAN: checks 
stugatz1948: checks 
*** RIVER *** [4d Th Jd 8s] [4c]
3D ICEMAN: checks 
stugatz1948: checks 
*** SHOW DOWN ***
3D ICEMAN: shows [5h Ah] (a pair of Fours)
stugatz1948: shows [7d Ac] (a pair of Fours)
3D ICEMAN collected $0.05 from pot
stugatz1948 collected $0.05 from pot
*** SUMMARY ***
Total pot $0.10 | Rake $0 
Board [4d Th Jd 8s 4c]
Seat 1: 3D ICEMAN (small blind) showed [5h Ah] and won ($0.05) with a pair of Fours
Seat 2: stugatz1948 (big blind) showed [7d Ac] and won ($0.05) with a pair of Fours
Seat 3: Indie993 folded before Flop (didn't bet)
Seat 5: CashMatteo folded before Flop (didn't bet)
Seat 6: led6ela (button) folded before Flop (didn't bet)

Hand #672: 

PokerStars Hand #246280332083:  Hold'em No Limit ($0.02/$0.05 CAD) - 2023/10/01 0:41:04 ET
Table 'Minelava' 6-max Seat #1 is the button
Seat 1: 3D ICEMAN ($1.96 in chips) 
Seat 2: stugatz1948 ($7.98 in chips) 
Seat 3: Indie993 ($7.81 in chips) 
Seat 5: CashMatteo ($2.41 in chips) 
Seat 6: led6ela ($11.20 in chips) 
stugatz1948: posts small blind $0.02
Indie993: posts big blind $0.05
*** HOLE CARDS ***
Dealt to CashMatteo [2s Qh]
CashMatteo: folds 
led6ela: folds 
3D ICEMAN: calls $0.05
stugatz1948: folds 
Indie993: checks 
*** FLOP *** [Jd 3h 9s]
Indie993: bets $0.12
3D ICEMAN: raises $0.12 to $0.24
Indie993: calls $0.12
*** TURN *** [Jd 3h 9s] [5h]
Indie993: checks 
3D ICEMAN: bets $0.30
Indie993: calls $0.30
*** RIVER *** [Jd 3h 9s 5h] [Js]
Indie993: checks 
3D ICEMAN: bets $0.35
Indie993: folds 
Uncalled bet ($0.35) returned to 3D ICEMAN
3D ICEMAN collected $1.15 from pot
3D ICEMAN: doesn't show hand 
*** SUMMARY ***
Total pot $1.20 | Rake $0.05 
Board [Jd 3h 9s 5h Js]
Seat 1: 3D ICEMAN (button) collected ($1.15)
Seat 2: stugatz1948 (small blind) folded before Flop
Seat 3: Indie993 (big blind) folded on the River
Seat 5: CashMatteo folded before Flop (didn't bet)
Seat 6: led6ela folded before Flop (didn't bet)

Hand #673: 

PokerStars Hand #246280340505:  Hold'em No Limit ($0.02/$0.05 CAD) - 2023/10/01 0:42:19 ET
Table 'Minelava' 6-max Seat #2 is the button
Seat 1: 3D ICEMAN ($2.52 in chips) 
Seat 2: stugatz1948 ($7.96 in chips) 
Seat 3: Indie993 ($7.22 in chips) 
Seat 5: CashMatteo ($2.41 in chips) 
Seat 6: led6ela ($11.20 in chips) 
Indie993: posts small blind $0.02
CashMatteo: posts big blind $0.05
*** HOLE CARDS ***
Dealt to CashMatteo [Jd 9h]
led6ela: folds 
3D ICEMAN: folds 
stugatz1948: folds 
Indie993: calls $0.03
CashMatteo: checks 
*** FLOP *** [8s Qh 4c]
Indie993: checks 
CashMatteo: bets $0.10
Indie993: calls $0.10
*** TURN *** [8s Qh 4c] [4d]
Indie993: checks 
CashMatteo: checks 
*** RIVER *** [8s Qh 4c 4d] [8h]
Indie993: checks 
CashMatteo: bets $0.15
Indie993: folds 
Uncalled bet ($0.15) returned to CashMatteo
CashMatteo collected $0.29 from pot
CashMatteo: doesn't show hand 
*** SUMMARY ***
Total pot $0.30 | Rake $0.01 
Board [8s Qh 4c 4d 8h]
Seat 1: 3D ICEMAN folded before Flop (didn't bet)
Seat 2: stugatz1948 (button) folded before Flop (didn't bet)
Seat 3: Indie993 (small blind) folded on the River
Seat 5: CashMatteo (big blind) collected ($0.29)
Seat 6: led6ela folded before Flop (didn't bet)

Hand #674: 

PokerStars Hand #246280346904:  Hold'em No Limit ($0.02/$0.05 CAD) - 2023/10/01 0:43:17 ET
Table 'Minelava' 6-max Seat #3 is the button
Seat 1: 3D ICEMAN ($2.52 in chips) 
Seat 2: stugatz1948 ($7.96 in chips) 
Seat 3: Indie993 ($7.07 in chips) 
Seat 5: CashMatteo ($2.55 in chips) 
Seat 6: led6ela ($11.20 in chips) 
CashMatteo: posts small blind $0.02
led6ela: posts big blind $0.05
*** HOLE CARDS ***
Dealt to CashMatteo [Qc 5d]
3D ICEMAN: calls $0.05
stugatz1948: folds 
Indie993: folds 
CashMatteo: folds 
led6ela: raises $0.10 to $0.15
3D ICEMAN: calls $0.10
*** FLOP *** [Qh 8c Td]
led6ela: bets $0.16
3D ICEMAN: calls $0.16
*** TURN *** [Qh 8c Td] [8s]
led6ela: checks 
3D ICEMAN: checks 
*** RIVER *** [Qh 8c Td 8s] [2h]
led6ela: checks 
3D ICEMAN: checks 
*** SHOW DOWN ***
led6ela: shows [Jd Ad] (a pair of Eights)
3D ICEMAN: shows [Jc Js] (two pair, Jacks and Eights)
3D ICEMAN collected $0.61 from pot
*** SUMMARY ***
Total pot $0.64 | Rake $0.03 
Board [Qh 8c Td 8s 2h]
Seat 1: 3D ICEMAN showed [Jc Js] and won ($0.61) with two pair, Jacks and Eights
Seat 2: stugatz1948 folded before Flop (didn't bet)
Seat 3: Indie993 (button) folded before Flop (didn't bet)
Seat 5: CashMatteo (small blind) folded before Flop
Seat 6: led6ela (big blind) showed [Jd Ad] and lost with a pair of Eights

Hand #675: 

PokerStars Hand #246280354105:  Hold'em No Limit ($0.02/$0.05 CAD) - 2023/10/01 0:44:22 ET
Table 'Minelava' 6-max Seat #5 is the button
Seat 1: 3D ICEMAN ($2.82 in chips) 
Seat 2: stugatz1948 ($7.96 in chips) 
Seat 3: Indie993 ($7.07 in chips) 
Seat 5: CashMatteo ($2.53 in chips) 
Seat 6: led6ela ($10.89 in chips) 
led6ela: posts small blind $0.02
3D ICEMAN: posts big blind $0.05
*** HOLE CARDS ***
Dealt to CashMatteo [9s 5s]
stugatz1948: raises $0.12 to $0.17
Indie993: folds 
CashMatteo: folds 
led6ela: calls $0.15
3D ICEMAN: folds 
*** FLOP *** [Qc Td 4c]
led6ela: checks 
stugatz1948: bets $0.37
led6ela: folds 
Uncalled bet ($0.37) returned to stugatz1948
stugatz1948 collected $0.37 from pot
stugatz1948: doesn't show hand 
*** SUMMARY ***
Total pot $0.39 | Rake $0.02 
Board [Qc Td 4c]
Seat 1: 3D ICEMAN (big blind) folded before Flop
Seat 2: stugatz1948 collected ($0.37)
Seat 3: Indie993 folded before Flop (didn't bet)
Seat 5: CashMatteo (button) folded before Flop (didn't bet)
Seat 6: led6ela (small blind) folded on the Flop

Hand #676: 

PokerStars Hand #246280358183:  Hold'em No Limit ($0.02/$0.05 CAD) - 2023/10/01 0:44:58 ET
Table 'Minelava' 6-max Seat #6 is the button
Seat 1: 3D ICEMAN ($2.77 in chips) 
Seat 2: stugatz1948 ($8.16 in chips) 
Seat 3: Indie993 ($7.07 in chips) 
Seat 5: CashMatteo ($2.53 in chips) 
Seat 6: led6ela ($10.72 in chips) 
3D ICEMAN: posts small blind $0.02
stugatz1948: posts big blind $0.05
*** HOLE CARDS ***
Dealt to CashMatteo [6h 9c]
Indie993: folds 
CashMatteo: folds 
led6ela: folds 
3D ICEMAN: folds 
Uncalled bet ($0.03) returned to stugatz1948
stugatz1948 collected $0.04 from pot
stugatz1948: doesn't show hand 
*** SUMMARY ***
Total pot $0.04 | Rake $0 
Seat 1: 3D ICEMAN (small blind) folded before Flop
Seat 2: stugatz1948 (big blind) collected ($0.04)
Seat 3: Indie993 folded before Flop (didn't bet)
Seat 5: CashMatteo folded before Flop (didn't bet)
Seat 6: led6ela (button) folded before Flop (didn't bet)

Hand #677: 

PokerStars Hand #246280360376:  Hold'em No Limit ($0.02/$0.05 CAD) - 2023/10/01 0:45:18 ET
Table 'Minelava' 6-max Seat #1 is the button
Seat 1: 3D ICEMAN ($2.75 in chips) 
Seat 2: stugatz1948 ($8.18 in chips) 
Seat 3: Indie993 ($7.07 in chips) 
Seat 5: CashMatteo ($2.53 in chips) 
Seat 6: led6ela ($10.72 in chips) 
stugatz1948: posts small blind $0.02
Indie993: posts big blind $0.05
*** HOLE CARDS ***
Dealt to CashMatteo [Qd Qs]
CashMatteo: raises $0.10 to $0.15
led6ela: folds 
3D ICEMAN: folds 
stugatz1948: raises $0.35 to $0.50
Indie993: folds 
CashMatteo: calls $0.35
*** FLOP *** [2c 6s Ac]
stugatz1948: bets $1.01
CashMatteo: folds 
Uncalled bet ($1.01) returned to stugatz1948
stugatz1948 collected $1.01 from pot
stugatz1948: doesn't show hand 
*** SUMMARY ***
Total pot $1.05 | Rake $0.04 
Board [2c 6s Ac]
Seat 1: 3D ICEMAN (button) folded before Flop (didn't bet)
Seat 2: stugatz1948 (small blind) collected ($1.01)
Seat 3: Indie993 (big blind) folded before Flop
Seat 5: CashMatteo folded on the Flop
Seat 6: led6ela folded before Flop (didn't bet)

Hand #678: 

PokerStars Hand #246280368400:  Hold'em No Limit ($0.02/$0.05 CAD) - 2023/10/01 0:46:30 ET
Table 'Minelava' 6-max Seat #2 is the button
Seat 1: 3D ICEMAN ($2.75 in chips) 
Seat 2: stugatz1948 ($8.69 in chips) 
Seat 3: Indie993 ($7.02 in chips) 
Seat 5: CashMatteo ($2.03 in chips) 
Seat 6: led6ela ($10.72 in chips) 
Indie993: posts small blind $0.02
CashMatteo: posts big blind $0.05
*** HOLE CARDS ***
Dealt to CashMatteo [3h Ac]
led6ela: folds 
3D ICEMAN: folds 
stugatz1948: folds 
Indie993: calls $0.03
CashMatteo: checks 
*** FLOP *** [5h 7d Jc]
Indie993: bets $0.10
CashMatteo: folds 
Uncalled bet ($0.10) returned to Indie993
Indie993 collected $0.10 from pot
*** SUMMARY ***
Total pot $0.10 | Rake $0 
Board [5h 7d Jc]
Seat 1: 3D ICEMAN folded before Flop (didn't bet)
Seat 2: stugatz1948 (button) folded before Flop (didn't bet)
Seat 3: Indie993 (small blind) collected ($0.10)
Seat 5: CashMatteo (big blind) folded on the Flop
Seat 6: led6ela folded before Flop (didn't bet)

Hand #679: 

PokerStars Hand #246280371253:  Hold'em No Limit ($0.02/$0.05 CAD) - 2023/10/01 0:46:56 ET
Table 'Minelava' 6-max Seat #3 is the button
Seat 1: 3D ICEMAN ($2.75 in chips) 
Seat 2: stugatz1948 ($8.69 in chips) 
Seat 3: Indie993 ($7.07 in chips) 
Seat 5: CashMatteo ($1.98 in chips) 
Seat 6: led6ela ($10.72 in chips) 
CashMatteo: posts small blind $0.02
led6ela: posts big blind $0.05
*** HOLE CARDS ***
Dealt to CashMatteo [3c 5s]
3D ICEMAN: folds 
stugatz1948: folds 
Indie993: folds 
Indie993 leaves the table
CashMatteo: folds 
Uncalled bet ($0.03) returned to led6ela
led6ela collected $0.04 from pot
led6ela: doesn't show hand 
*** SUMMARY ***
Total pot $0.04 | Rake $0 
Seat 1: 3D ICEMAN folded before Flop (didn't bet)
Seat 2: stugatz1948 folded before Flop (didn't bet)
Seat 3: Indie993 (button) folded before Flop (didn't bet)
Seat 5: CashMatteo (small blind) folded before Flop
Seat 6: led6ela (big blind) collected ($0.04)

Hand #680: 

PokerStars Hand #246280373416:  Hold'em No Limit ($0.02/$0.05 CAD) - 2023/10/01 0:47:15 ET
Table 'Minelava' 6-max Seat #5 is the button
Seat 1: 3D ICEMAN ($2.75 in chips) 
Seat 2: stugatz1948 ($8.69 in chips) 
Seat 5: CashMatteo ($1.96 in chips) 
Seat 6: led6ela ($10.74 in chips) 
led6ela: posts small blind $0.02
3D ICEMAN: posts big blind $0.05
*** HOLE CARDS ***
Dealt to CashMatteo [6d 2d]
DSilver joins the table at seat #3 
stugatz1948: folds 
CashMatteo: folds 
led6ela: calls $0.03
3D ICEMAN: checks 
*** FLOP *** [5c Kd 4h]
led6ela: bets $0.10
3D ICEMAN: folds 
Uncalled bet ($0.10) returned to led6ela
led6ela collected $0.10 from pot
led6ela: doesn't show hand 
*** SUMMARY ***
Total pot $0.10 | Rake $0 
Board [5c Kd 4h]
Seat 1: 3D ICEMAN (big blind) folded on the Flop
Seat 2: stugatz1948 folded before Flop (didn't bet)
Seat 5: CashMatteo (button) folded before Flop (didn't bet)
Seat 6: led6ela (small blind) collected ($0.10)

Hand #681: 

PokerStars Hand #246280376389:  Hold'em No Limit ($0.02/$0.05 CAD) - 2023/10/01 0:47:42 ET
Table 'Minelava' 6-max Seat #6 is the button
Seat 1: 3D ICEMAN ($2.70 in chips) 
Seat 2: stugatz1948 ($8.69 in chips) 
Seat 5: CashMatteo ($1.96 in chips) 
Seat 6: led6ela ($10.79 in chips) 
3D ICEMAN: posts small blind $0.02
stugatz1948: posts big blind $0.05
DSilver: sits out 
*** HOLE CARDS ***
Dealt to CashMatteo [6d 4s]
CashMatteo: folds 
led6ela: calls $0.05
3D ICEMAN: folds 
stugatz1948: checks 
*** FLOP *** [2h 6s Ks]
stugatz1948: checks 
led6ela: checks 
*** TURN *** [2h 6s Ks] [3c]
stugatz1948: checks 
led6ela: checks 
*** RIVER *** [2h 6s Ks 3c] [7d]
stugatz1948: bets $0.06
led6ela: folds 
Uncalled bet ($0.06) returned to stugatz1948
stugatz1948 collected $0.12 from pot
stugatz1948: doesn't show hand 
*** SUMMARY ***
Total pot $0.12 | Rake $0 
Board [2h 6s Ks 3c 7d]
Seat 1: 3D ICEMAN (small blind) folded before Flop
Seat 2: stugatz1948 (big blind) collected ($0.12)
Seat 5: CashMatteo folded before Flop (didn't bet)
Seat 6: led6ela (button) folded on the River

Hand #682: 

PokerStars Hand #246280381518:  Hold'em No Limit ($0.02/$0.05 CAD) - 2023/10/01 0:48:29 ET
Table 'Minelava' 6-max Seat #1 is the button
Seat 1: 3D ICEMAN ($2.68 in chips) 
Seat 2: stugatz1948 ($8.76 in chips) 
Seat 3: DSilver ($5 in chips) 
Seat 5: CashMatteo ($1.96 in chips) 
Seat 6: led6ela ($10.74 in chips) 
stugatz1948: posts small blind $0.02
DSilver: posts big blind $0.05
*** HOLE CARDS ***
Dealt to CashMatteo [Qc 3d]
CashMatteo: calls $0.05
led6ela: folds 
3D ICEMAN: folds 
stugatz1948: calls $0.03
DSilver: checks 
*** FLOP *** [8s 7h 7c]
stugatz1948: bets $0.05
DSilver: folds 
CashMatteo: folds 
Uncalled bet ($0.05) returned to stugatz1948
stugatz1948 collected $0.14 from pot
stugatz1948: doesn't show hand 
*** SUMMARY ***
Total pot $0.15 | Rake $0.01 
Board [8s 7h 7c]
Seat 1: 3D ICEMAN (button) folded before Flop (didn't bet)
Seat 2: stugatz1948 (small blind) collected ($0.14)
Seat 3: DSilver (big blind) folded on the Flop
Seat 5: CashMatteo folded on the Flop
Seat 6: led6ela folded before Flop (didn't bet)

Hand #683: 

PokerStars Hand #246280386108:  Hold'em No Limit ($0.02/$0.05 CAD) - 2023/10/01 0:49:10 ET
Table 'Minelava' 6-max Seat #2 is the button
Seat 1: 3D ICEMAN ($2.68 in chips) 
Seat 2: stugatz1948 ($8.85 in chips) 
Seat 3: DSilver ($5 in chips) 
Seat 5: CashMatteo ($1.91 in chips) 
Seat 6: led6ela ($10.74 in chips) 
DSilver: posts small blind $0.02
CashMatteo: posts big blind $0.05
*** HOLE CARDS ***
Dealt to CashMatteo [Qs Ac]
led6ela: calls $0.05
3D ICEMAN: folds 
stugatz1948: folds 
DSilver: folds 
CashMatteo: raises $0.12 to $0.17
anthony10112 was removed from the table for failing to post
anthony10112 leaves the table
led6ela: calls $0.12
*** FLOP *** [6d Js 3h]
CashMatteo: bets $0.18
led6ela: folds 
Uncalled bet ($0.18) returned to CashMatteo
CashMatteo collected $0.35 from pot
CashMatteo: doesn't show hand 
*** SUMMARY ***
Total pot $0.36 | Rake $0.01 
Board [6d Js 3h]
Seat 1: 3D ICEMAN folded before Flop (didn't bet)
Seat 2: stugatz1948 (button) folded before Flop (didn't bet)
Seat 3: DSilver (small blind) folded before Flop
Seat 5: CashMatteo (big blind) collected ($0.35)
Seat 6: led6ela folded on the Flop

Hand #684: 

PokerStars Hand #246280388803:  Hold'em No Limit ($0.02/$0.05 CAD) - 2023/10/01 0:49:34 ET
Table 'Minelava' 6-max Seat #3 is the button
Seat 1: 3D ICEMAN ($2.68 in chips) 
Seat 2: stugatz1948 ($8.85 in chips) 
Seat 3: DSilver ($5 in chips) 
Seat 5: CashMatteo ($2.09 in chips) 
Seat 6: led6ela ($10.57 in chips) 
CashMatteo: posts small blind $0.02
led6ela: posts big blind $0.05
*** HOLE CARDS ***
Dealt to CashMatteo [7s 9d]
3D ICEMAN: folds 
stugatz1948: folds 
DSilver: raises $0.10 to $0.15
CashMatteo: folds 
Anardom joins the table at seat #4 
led6ela: folds 
Uncalled bet ($0.10) returned to DSilver
DSilver collected $0.12 from pot
DSilver: doesn't show hand 
*** SUMMARY ***
Total pot $0.12 | Rake $0 
Seat 1: 3D ICEMAN folded before Flop (didn't bet)
Seat 2: stugatz1948 folded before Flop (didn't bet)
Seat 3: DSilver (button) collected ($0.12)
Seat 5: CashMatteo (small blind) folded before Flop
Seat 6: led6ela (big blind) folded before Flop

Hand #685: 

PokerStars Hand #246280391887:  Hold'em No Limit ($0.02/$0.05 CAD) - 2023/10/01 0:50:02 ET
Table 'Minelava' 6-max Seat #5 is the button
Seat 1: 3D ICEMAN ($2.68 in chips) 
Seat 2: stugatz1948 ($8.85 in chips) 
Seat 3: DSilver ($5.07 in chips) 
Seat 5: CashMatteo ($2.07 in chips) 
Seat 6: led6ela ($10.52 in chips) 
led6ela: posts small blind $0.02
3D ICEMAN: posts big blind $0.05
Anardom: sits out 
*** HOLE CARDS ***
Dealt to CashMatteo [8c 4c]
stugatz1948: folds 
DSilver: folds 
CashMatteo: folds 
led6ela: raises $0.05 to $0.10
3D ICEMAN: calls $0.05
*** FLOP *** [2s 2h Jc]
led6ela: bets $0.19
3D ICEMAN: folds 
Uncalled bet ($0.19) returned to led6ela
led6ela collected $0.19 from pot
led6ela: doesn't show hand 
*** SUMMARY ***
Total pot $0.20 | Rake $0.01 
Board [2s 2h Jc]
Seat 1: 3D ICEMAN (big blind) folded on the Flop
Seat 2: stugatz1948 folded before Flop (didn't bet)
Seat 3: DSilver folded before Flop (didn't bet)
Seat 5: CashMatteo (button) folded before Flop (didn't bet)
Seat 6: led6ela (small blind) collected ($0.19)

Hand #686: 

PokerStars Hand #246280395988:  Hold'em No Limit ($0.02/$0.05 CAD) - 2023/10/01 0:50:38 ET
Table 'Minelava' 6-max Seat #6 is the button
Seat 1: 3D ICEMAN ($2.58 in chips) 
Seat 2: stugatz1948 ($8.85 in chips) 
Seat 3: DSilver ($5.07 in chips) 
Seat 5: CashMatteo ($2.07 in chips) 
Seat 6: led6ela ($10.61 in chips) 
3D ICEMAN: posts small blind $0.02
stugatz1948: posts big blind $0.05
Anardom: sits out 
*** HOLE CARDS ***
Dealt to CashMatteo [6h 5d]
DSilver: folds 
CashMatteo: folds 
led6ela: folds 
3D ICEMAN: calls $0.03
stugatz1948: checks 
*** FLOP *** [2h 8c 5c]
3D ICEMAN: checks 
stugatz1948: checks 
*** TURN *** [2h 8c 5c] [Ac]
3D ICEMAN: checks 
stugatz1948: checks 
*** RIVER *** [2h 8c 5c Ac] [Kd]
3D ICEMAN: checks 
stugatz1948: bets $0.10
3D ICEMAN: folds 
Uncalled bet ($0.10) returned to stugatz1948
stugatz1948 collected $0.10 from pot
stugatz1948: doesn't show hand 
*** SUMMARY ***
Total pot $0.10 | Rake $0 
Board [2h 8c 5c Ac Kd]
Seat 1: 3D ICEMAN (small blind) folded on the River
Seat 2: stugatz1948 (big blind) collected ($0.10)
Seat 3: DSilver folded before Flop (didn't bet)
Seat 5: CashMatteo folded before Flop (didn't bet)
Seat 6: led6ela (button) folded before Flop (didn't bet)

Hand #687: 

PokerStars Hand #246280401745:  Hold'em No Limit ($0.02/$0.05 CAD) - 2023/10/01 0:51:32 ET
Table 'Minelava' 6-max Seat #1 is the button
Seat 1: 3D ICEMAN ($2.53 in chips) 
Seat 2: stugatz1948 ($8.90 in chips) 
Seat 3: DSilver ($5.07 in chips) 
Seat 5: CashMatteo ($2.07 in chips) 
Seat 6: led6ela ($10.61 in chips) 
stugatz1948: posts small blind $0.02
DSilver: posts big blind $0.05
Anardom: sits out 
*** HOLE CARDS ***
Dealt to CashMatteo [5c Kc]
CashMatteo: calls $0.05
led6ela: raises $0.10 to $0.15
3D ICEMAN: folds 
stugatz1948: folds 
DSilver: calls $0.10
CashMatteo: calls $0.10
*** FLOP *** [8h Ah 9h]
DSilver: checks 
CashMatteo: checks 
led6ela: bets $0.23
DSilver: calls $0.23
CashMatteo: folds 
*** TURN *** [8h Ah 9h] [2d]
DSilver: checks 
led6ela: bets $0.45
DSilver: calls $0.45
*** RIVER *** [8h Ah 9h 2d] [Jd]
DSilver: checks 
led6ela: checks 
*** SHOW DOWN ***
DSilver: shows [As Jc] (two pair, Aces and Jacks)
led6ela: mucks hand 
DSilver collected $1.75 from pot
*** SUMMARY ***
Total pot $1.83 | Rake $0.08 
Board [8h Ah 9h 2d Jd]
Seat 1: 3D ICEMAN (button) folded before Flop (didn't bet)
Seat 2: stugatz1948 (small blind) folded before Flop
Seat 3: DSilver (big blind) showed [As Jc] and won ($1.75) with two pair, Aces and Jacks
Seat 5: CashMatteo folded on the Flop
Seat 6: led6ela mucked [Th Ac]

Hand #688: 

PokerStars Hand #246280409217:  Hold'em No Limit ($0.02/$0.05 CAD) - 2023/10/01 0:52:39 ET
Table 'Minelava' 6-max Seat #2 is the button
Seat 1: 3D ICEMAN ($2.53 in chips) 
Seat 2: stugatz1948 ($8.88 in chips) 
Seat 3: DSilver ($5.99 in chips) 
Seat 4: Anardom ($5 in chips) 
Seat 5: CashMatteo ($1.92 in chips) 
Seat 6: led6ela ($9.78 in chips) 
DSilver: posts small blind $0.02
Anardom: posts big blind $0.05
*** HOLE CARDS ***
Dealt to CashMatteo [Td 8c]
CashMatteo: folds 
led6ela: calls $0.05
3D ICEMAN: folds 
stugatz1948: raises $0.17 to $0.22
DSilver: calls $0.20
Anardom: calls $0.17
led6ela: calls $0.17
*** FLOP *** [Qs 5h 4h]
DSilver: checks 
Anardom: checks 
led6ela: checks 
stugatz1948: bets $0.84
DSilver: folds 
Anardom: folds 
led6ela: calls $0.84
*** TURN *** [Qs 5h 4h] [4c]
led6ela: bets $1.23
stugatz1948: calls $1.23
*** RIVER *** [Qs 5h 4h 4c] [9d]
led6ela: checks 
stugatz1948: checks 
*** SHOW DOWN ***
led6ela: shows [3h Kh] (a pair of Fours)
stugatz1948: shows [As Qc] (two pair, Queens and Fours)
stugatz1948 collected $4.81 from pot
*** SUMMARY ***
Total pot $5.02 | Rake $0.21 
Board [Qs 5h 4h 4c 9d]
Seat 1: 3D ICEMAN folded before Flop (didn't bet)
Seat 2: stugatz1948 (button) showed [As Qc] and won ($4.81) with two pair, Queens and Fours
Seat 3: DSilver (small blind) folded on the Flop
Seat 4: Anardom (big blind) folded on the Flop
Seat 5: CashMatteo folded before Flop (didn't bet)
Seat 6: led6ela showed [3h Kh] and lost with a pair of Fours

Hand #689: 

PokerStars Hand #246280416752:  Hold'em No Limit ($0.02/$0.05 CAD) - 2023/10/01 0:53:48 ET
Table 'Minelava' 6-max Seat #3 is the button
Seat 1: 3D ICEMAN ($2.53 in chips) 
Seat 2: stugatz1948 ($11.40 in chips) 
Seat 3: DSilver ($5.77 in chips) 
Seat 4: Anardom ($4.78 in chips) 
Seat 5: CashMatteo ($1.92 in chips) 
Seat 6: led6ela ($7.49 in chips) 
Anardom: posts small blind $0.02
CashMatteo: posts big blind $0.05
*** HOLE CARDS ***
Dealt to CashMatteo [4h 3c]
led6ela: folds 
3D ICEMAN: folds 
stugatz1948: folds 
DSilver: raises $0.10 to $0.15
Anardom: calls $0.13
led6ela leaves the table
CashMatteo: folds 
*** FLOP *** [Qh 8c Ks]
Anardom: checks 
DSilver: bets $0.20
Anardom: raises $0.25 to $0.45
DSilver: folds 
Uncalled bet ($0.25) returned to Anardom
Anardom collected $0.72 from pot
Anardom: doesn't show hand 
*** SUMMARY ***
Total pot $0.75 | Rake $0.03 
Board [Qh 8c Ks]
Seat 1: 3D ICEMAN folded before Flop (didn't bet)
Seat 2: stugatz1948 folded before Flop (didn't bet)
Seat 3: DSilver (button) folded on the Flop
Seat 4: Anardom (small blind) collected ($0.72)
Seat 5: CashMatteo (big blind) folded before Flop
Seat 6: led6ela folded before Flop (didn't bet)

Hand #690: 

PokerStars Hand #246280420988:  Hold'em No Limit ($0.02/$0.05 CAD) - 2023/10/01 0:54:26 ET
Table 'Minelava' 6-max Seat #4 is the button
Seat 1: 3D ICEMAN ($2.53 in chips) 
Seat 2: stugatz1948 ($11.40 in chips) 
Seat 3: DSilver ($5.42 in chips) 
Seat 4: Anardom ($5.15 in chips) 
Seat 5: CashMatteo ($1.87 in chips) 
CashMatteo: posts small blind $0.02
3D ICEMAN: posts big blind $0.05
*** HOLE CARDS ***
Dealt to CashMatteo [6h Ks]
stugatz1948: folds 
DSilver: raises $0.10 to $0.15
Anardom: folds 
CashMatteo: calls $0.13
3D ICEMAN: folds 
*** FLOP *** [4h Js Th]
CashMatteo: checks 
DSilver: checks 
*** TURN *** [4h Js Th] [Ac]
CashMatteo: bets $0.17
DSilver: folds 
Uncalled bet ($0.17) returned to CashMatteo
CashMatteo collected $0.34 from pot
CashMatteo: doesn't show hand 
*** SUMMARY ***
Total pot $0.35 | Rake $0.01 
Board [4h Js Th Ac]
Seat 1: 3D ICEMAN (big blind) folded before Flop
Seat 2: stugatz1948 folded before Flop (didn't bet)
Seat 3: DSilver folded on the Turn
Seat 4: Anardom (button) folded before Flop (didn't bet)
Seat 5: CashMatteo (small blind) collected ($0.34)

Hand #691: 

PokerStars Hand #246280424876:  Hold'em No Limit ($0.02/$0.05 CAD) - 2023/10/01 0:55:02 ET
Table 'Minelava' 6-max Seat #5 is the button
Seat 1: 3D ICEMAN ($2.48 in chips) 
Seat 2: stugatz1948 ($11.40 in chips) 
Seat 3: DSilver ($5.27 in chips) 
Seat 4: Anardom ($5.15 in chips) 
Seat 5: CashMatteo ($2.06 in chips) 
3D ICEMAN: posts small blind $0.02
stugatz1948: posts big blind $0.05
*** HOLE CARDS ***
Dealt to CashMatteo [Ad 5c]
DSilver: folds 
Anardom: folds 
CashMatteo: calls $0.05
3D ICEMAN: calls $0.03
stugatz1948: checks 
*** FLOP *** [7c 2d 4d]
3D ICEMAN: checks 
stugatz1948: checks 
CashMatteo: checks 
*** TURN *** [7c 2d 4d] [8s]
3D ICEMAN: checks 
stugatz1948: checks 
CashMatteo: checks 
*** RIVER *** [7c 2d 4d 8s] [Ts]
3D ICEMAN: checks 
stugatz1948: checks 
CashMatteo: checks 
*** SHOW DOWN ***
3D ICEMAN: shows [3d 3c] (a pair of Threes)
stugatz1948: mucks hand 
CashMatteo: mucks hand 
3D ICEMAN collected $0.14 from pot
*** SUMMARY ***
Total pot $0.15 | Rake $0.01 
Board [7c 2d 4d 8s Ts]
Seat 1: 3D ICEMAN (small blind) showed [3d 3c] and won ($0.14) with a pair of Threes
Seat 2: stugatz1948 (big blind) mucked [Qd 2s]
Seat 3: DSilver folded before Flop (didn't bet)
Seat 4: Anardom folded before Flop (didn't bet)
Seat 5: CashMatteo (button) mucked [Ad 5c]

Hand #692: 

PokerStars Hand #246280427781:  Hold'em No Limit ($0.02/$0.05 CAD) - 2023/10/01 0:55:33 ET
Table 'Minelava' 6-max Seat #1 is the button
Seat 1: 3D ICEMAN ($2.57 in chips) 
Seat 2: stugatz1948 ($11.35 in chips) 
Seat 3: DSilver ($5.27 in chips) 
Seat 4: Anardom ($5.15 in chips) 
Seat 5: CashMatteo ($2.01 in chips) 
stugatz1948: posts small blind $0.02
DSilver: posts big blind $0.05
*** HOLE CARDS ***
Dealt to CashMatteo [Jd Qc]
Anardom: folds 
CashMatteo: raises $0.10 to $0.15
3D ICEMAN: folds 
stugatz1948: folds 
DSilver: folds 
Uncalled bet ($0.10) returned to CashMatteo
CashMatteo collected $0.12 from pot
CashMatteo: doesn't show hand 
*** SUMMARY ***
Total pot $0.12 | Rake $0 
Seat 1: 3D ICEMAN (button) folded before Flop (didn't bet)
Seat 2: stugatz1948 (small blind) folded before Flop
Seat 3: DSilver (big blind) folded before Flop
Seat 4: Anardom folded before Flop (didn't bet)
Seat 5: CashMatteo collected ($0.12)

Hand #693: 

PokerStars Hand #246280429307:  Hold'em No Limit ($0.02/$0.05 CAD) - 2023/10/01 0:55:49 ET
Table 'Minelava' 6-max Seat #2 is the button
Seat 1: 3D ICEMAN ($2.57 in chips) 
Seat 2: stugatz1948 ($11.33 in chips) 
Seat 3: DSilver ($5.22 in chips) 
Seat 5: CashMatteo ($2.08 in chips) 
DSilver: posts small blind $0.02
CashMatteo: posts big blind $0.05
*** HOLE CARDS ***
Dealt to CashMatteo [Kc 3h]
3D ICEMAN: folds 
stugatz1948: folds 
DSilver: folds 
Uncalled bet ($0.03) returned to CashMatteo
CashMatteo collected $0.04 from pot
CashMatteo: doesn't show hand 
*** SUMMARY ***
Total pot $0.04 | Rake $0 
Seat 1: 3D ICEMAN folded before Flop (didn't bet)
Seat 2: stugatz1948 (button) folded before Flop (didn't bet)
Seat 3: DSilver (small blind) folded before Flop
Seat 5: CashMatteo (big blind) collected ($0.04)

Hand #694: 

PokerStars Hand #246280430457:  Hold'em No Limit ($0.02/$0.05 CAD) - 2023/10/01 0:56:02 ET
Table 'Minelava' 6-max Seat #3 is the button
Seat 1: 3D ICEMAN ($2.57 in chips) 
Seat 2: stugatz1948 ($11.33 in chips) 
Seat 3: DSilver ($5.20 in chips) 
Seat 5: CashMatteo ($2.10 in chips) 
CashMatteo: posts small blind $0.02
3D ICEMAN: posts big blind $0.05
*** HOLE CARDS ***
Dealt to CashMatteo [6h 6s]
stugatz1948: raises $0.10 to $0.15
DSilver: raises $0.37 to $0.52
CashMatteo: calls $0.50
3D ICEMAN: folds 
stugatz1948: calls $0.37
*** FLOP *** [9c Kd 9s]
CashMatteo: checks 
stugatz1948: checks 
DSilver: bets $1.03
CashMatteo: calls $1.03
stugatz1948: folds 
*** TURN *** [9c Kd 9s] [Ah]
CashMatteo: checks 
DSilver: bets $1.06
CashMatteo: calls $0.55 and is all-in
Uncalled bet ($0.51) returned to DSilver
*** RIVER *** [9c Kd 9s Ah] [2s]
*** SHOW DOWN ***
CashMatteo: shows [6h 6s] (two pair, Nines and Sixes)
DSilver: shows [Jc As] (two pair, Aces and Nines)
DSilver collected $4.57 from pot
*** SUMMARY ***
Total pot $4.77 | Rake $0.20 
Board [9c Kd 9s Ah 2s]
Seat 1: 3D ICEMAN (big blind) folded before Flop
Seat 2: stugatz1948 folded on the Flop
Seat 3: DSilver (button) showed [Jc As] and won ($4.57) with two pair, Aces and Nines
Seat 5: CashMatteo (small blind) showed [6h 6s] and lost with two pair, Nines and Sixes

Hand #695: 

PokerStars Hand #246289999816: Tournament #3652619479, $4.65+$0.35 CAD Hold'em No Limit - Level I (10/20) - 2023/10/01 13:47:36 ET
Table '3652619479 1' 3-max Seat #1 is the button
Seat 1: brenda1972 (500 in chips) 
Seat 2: Kora Fett (500 in chips) 
Seat 3: CashMatteo (500 in chips) 
Kora Fett: posts small blind 10
CashMatteo: posts big blind 20
*** HOLE CARDS ***
Dealt to CashMatteo [As 5d]
brenda1972: calls 20
Kora Fett: folds 
CashMatteo: raises 40 to 60
brenda1972: calls 40
*** FLOP *** [9h Tc 3c]
CashMatteo: checks 
brenda1972: checks 
*** TURN *** [9h Tc 3c] [7c]
CashMatteo: checks 
brenda1972: checks 
*** RIVER *** [9h Tc 3c 7c] [Kh]
CashMatteo: bets 65
brenda1972: calls 65
*** SHOW DOWN ***
CashMatteo: shows [As 5d] (high card Ace)
brenda1972: shows [8d 8c] (a pair of Eights)
brenda1972 collected 260 from pot
*** SUMMARY ***
Total pot 260 | Rake 0 
Board [9h Tc 3c 7c Kh]
Seat 1: brenda1972 (button) showed [8d 8c] and won (260) with a pair of Eights
Seat 2: Kora Fett (small blind) folded before Flop
Seat 3: CashMatteo (big blind) showed [As 5d] and lost with high card Ace

Hand #696: 

PokerStars Hand #246290014184: Tournament #3652619479, $4.65+$0.35 CAD Hold'em No Limit - Level I (10/20) - 2023/10/01 13:48:11 ET
Table '3652619479 1' 3-max Seat #2 is the button
Seat 1: brenda1972 (635 in chips) 
Seat 2: Kora Fett (490 in chips) 
Seat 3: CashMatteo (375 in chips) 
CashMatteo: posts small blind 10
brenda1972: posts big blind 20
*** HOLE CARDS ***
Dealt to CashMatteo [Ad Ts]
Kora Fett: folds 
CashMatteo: raises 40 to 60
brenda1972: folds 
Uncalled bet (40) returned to CashMatteo
CashMatteo collected 40 from pot
CashMatteo: doesn't show hand 
*** SUMMARY ***
Total pot 40 | Rake 0 
Seat 1: brenda1972 (big blind) folded before Flop
Seat 2: Kora Fett (button) folded before Flop (didn't bet)
Seat 3: CashMatteo (small blind) collected (40)

Hand #697: 

PokerStars Hand #246290017559: Tournament #3652619479, $4.65+$0.35 CAD Hold'em No Limit - Level I (10/20) - 2023/10/01 13:48:19 ET
Table '3652619479 1' 3-max Seat #3 is the button
Seat 1: brenda1972 (615 in chips) 
Seat 2: Kora Fett (490 in chips) 
Seat 3: CashMatteo (395 in chips) 
brenda1972: posts small blind 10
Kora Fett: posts big blind 20
*** HOLE CARDS ***
Dealt to CashMatteo [8c Kd]
CashMatteo: calls 20
brenda1972: raises 40 to 60
Kora Fett: folds 
CashMatteo: calls 40
*** FLOP *** [2c 3c 6s]
brenda1972: bets 140
CashMatteo: folds 
Uncalled bet (140) returned to brenda1972
brenda1972 collected 140 from pot
*** SUMMARY ***
Total pot 140 | Rake 0 
Board [2c 3c 6s]
Seat 1: brenda1972 (small blind) collected (140)
Seat 2: Kora Fett (big blind) folded before Flop
Seat 3: CashMatteo (button) folded on the Flop

Hand #698: 

PokerStars Hand #246290023594: Tournament #3652619479, $4.65+$0.35 CAD Hold'em No Limit - Level I (10/20) - 2023/10/01 13:48:34 ET
Table '3652619479 1' 3-max Seat #1 is the button
Seat 1: brenda1972 (695 in chips) 
Seat 2: Kora Fett (470 in chips) 
Seat 3: CashMatteo (335 in chips) 
Kora Fett: posts small blind 10
CashMatteo: posts big blind 20
*** HOLE CARDS ***
Dealt to CashMatteo [Qd Jh]
brenda1972: folds 
Kora Fett: folds 
Uncalled bet (10) returned to CashMatteo
CashMatteo collected 20 from pot
CashMatteo: doesn't show hand 
*** SUMMARY ***
Total pot 20 | Rake 0 
Seat 1: brenda1972 (button) folded before Flop (didn't bet)
Seat 2: Kora Fett (small blind) folded before Flop
Seat 3: CashMatteo (big blind) collected (20)

Hand #699: 

PokerStars Hand #246290025920: Tournament #3652619479, $4.65+$0.35 CAD Hold'em No Limit - Level I (10/20) - 2023/10/01 13:48:39 ET
Table '3652619479 1' 3-max Seat #2 is the button
Seat 1: brenda1972 (695 in chips) 
Seat 2: Kora Fett (460 in chips) 
Seat 3: CashMatteo (345 in chips) 
CashMatteo: posts small blind 10
brenda1972: posts big blind 20
*** HOLE CARDS ***
Dealt to CashMatteo [8h Jd]
Kora Fett: folds 
CashMatteo: calls 10
brenda1972: raises 40 to 60
CashMatteo: folds 
Uncalled bet (40) returned to brenda1972
brenda1972 collected 40 from pot
*** SUMMARY ***
Total pot 40 | Rake 0 
Seat 1: brenda1972 (big blind) collected (40)
Seat 2: Kora Fett (button) folded before Flop (didn't bet)
Seat 3: CashMatteo (small blind) folded before Flop

Hand #700: 

PokerStars Hand #246290030622: Tournament #3652619479, $4.65+$0.35 CAD Hold'em No Limit - Level I (10/20) - 2023/10/01 13:48:51 ET
Table '3652619479 1' 3-max Seat #3 is the button
Seat 1: brenda1972 (715 in chips) 
Seat 2: Kora Fett (460 in chips) 
Seat 3: CashMatteo (325 in chips) 
brenda1972: posts small blind 10
Kora Fett: posts big blind 20
*** HOLE CARDS ***
Dealt to CashMatteo [2d Ac]
CashMatteo: calls 20
brenda1972: calls 10
Kora Fett: checks 
*** FLOP *** [2s 8h 5c]
brenda1972: bets 60
Kora Fett: folds 
CashMatteo: calls 60
*** TURN *** [2s 8h 5c] [9s]
brenda1972: bets 90
CashMatteo: folds 
Uncalled bet (90) returned to brenda1972
brenda1972 collected 180 from pot
*** SUMMARY ***
Total pot 180 | Rake 0 
Board [2s 8h 5c 9s]
Seat 1: brenda1972 (small blind) collected (180)
Seat 2: Kora Fett (big blind) folded on the Flop
Seat 3: CashMatteo (button) folded on the Turn

Hand #701: 

PokerStars Hand #246290038291: Tournament #3652619479, $4.65+$0.35 CAD Hold'em No Limit - Level I (10/20) - 2023/10/01 13:49:09 ET
Table '3652619479 1' 3-max Seat #1 is the button
Seat 1: brenda1972 (815 in chips) 
Seat 2: Kora Fett (440 in chips) 
Seat 3: CashMatteo (245 in chips) 
Kora Fett: posts small blind 10
CashMatteo: posts big blind 20
*** HOLE CARDS ***
Dealt to CashMatteo [6c 3c]
brenda1972: folds 
Kora Fett: calls 10
CashMatteo: checks 
*** FLOP *** [As 5s 6s]
Kora Fett: checks 
CashMatteo: bets 40
Kora Fett: calls 40
*** TURN *** [As 5s 6s] [4h]
Kora Fett: checks 
CashMatteo: checks 
*** RIVER *** [As 5s 6s 4h] [Jh]
Kora Fett: checks 
CashMatteo: bets 120
Kora Fett: calls 120
*** SHOW DOWN ***
CashMatteo: shows [6c 3c] (a pair of Sixes)
Kora Fett: shows [Ts Jd] (a pair of Jacks)
Kora Fett collected 360 from pot
*** SUMMARY ***
Total pot 360 | Rake 0 
Board [As 5s 6s 4h Jh]
Seat 1: brenda1972 (button) folded before Flop (didn't bet)
Seat 2: Kora Fett (small blind) showed [Ts Jd] and won (360) with a pair of Jacks
Seat 3: CashMatteo (big blind) showed [6c 3c] and lost with a pair of Sixes

Hand #702: 

PokerStars Hand #246290049305: Tournament #3652619479, $4.65+$0.35 CAD Hold'em No Limit - Level I (10/20) - 2023/10/01 13:49:36 ET
Table '3652619479 1' 3-max Seat #2 is the button
Seat 1: brenda1972 (815 in chips) 
Seat 2: Kora Fett (620 in chips) 
Seat 3: CashMatteo (65 in chips) 
CashMatteo: posts small blind 10
brenda1972: posts big blind 20
*** HOLE CARDS ***
Dealt to CashMatteo [2h As]
Kora Fett: folds 
CashMatteo: calls 10
brenda1972: checks 
*** FLOP *** [2d Ks Ad]
CashMatteo: bets 45 and is all-in
brenda1972: folds 
Uncalled bet (45) returned to CashMatteo
CashMatteo collected 40 from pot
CashMatteo: doesn't show hand 
*** SUMMARY ***
Total pot 40 | Rake 0 
Board [2d Ks Ad]
Seat 1: brenda1972 (big blind) folded on the Flop
Seat 2: Kora Fett (button) folded before Flop (didn't bet)
Seat 3: CashMatteo (small blind) collected (40)

Hand #703: 

PokerStars Hand #246290055986: Tournament #3652619479, $4.65+$0.35 CAD Hold'em No Limit - Level II (15/30) - 2023/10/01 13:49:53 ET
Table '3652619479 1' 3-max Seat #3 is the button
Seat 1: brenda1972 (795 in chips) 
Seat 2: Kora Fett (620 in chips) 
Seat 3: CashMatteo (85 in chips) 
brenda1972: posts small blind 15
Kora Fett: posts big blind 30
*** HOLE CARDS ***
Dealt to CashMatteo [Jc 5c]
CashMatteo: folds 
brenda1972: calls 15
Kora Fett: checks 
*** FLOP *** [2d 9s 4h]
brenda1972: checks 
Kora Fett: checks 
*** TURN *** [2d 9s 4h] [7s]
brenda1972: checks 
Kora Fett: checks 
*** RIVER *** [2d 9s 4h 7s] [7c]
brenda1972: checks 
Kora Fett: checks 
*** SHOW DOWN ***
brenda1972: shows [Kh 8d] (a pair of Sevens)
Kora Fett: mucks hand 
brenda1972 collected 60 from pot
*** SUMMARY ***
Total pot 60 | Rake 0 
Board [2d 9s 4h 7s 7c]
Seat 1: brenda1972 (small blind) showed [Kh 8d] and won (60) with a pair of Sevens
Seat 2: Kora Fett (big blind) mucked [5h 6c]
Seat 3: CashMatteo (button) folded before Flop (didn't bet)

Hand #704: 

PokerStars Hand #246290063715: Tournament #3652619479, $4.65+$0.35 CAD Hold'em No Limit - Level II (15/30) - 2023/10/01 13:50:11 ET
Table '3652619479 1' 3-max Seat #1 is the button
Seat 1: brenda1972 (825 in chips) 
Seat 2: Kora Fett (590 in chips) 
Seat 3: CashMatteo (85 in chips) 
Kora Fett: posts small blind 15
CashMatteo: posts big blind 30
*** HOLE CARDS ***
Dealt to CashMatteo [2s Kd]
brenda1972: raises 75 to 105
Kora Fett: calls 90
CashMatteo: calls 55 and is all-in
*** FLOP *** [6h Qc Jd]
Kora Fett: checks 
brenda1972: bets 295
Kora Fett: folds 
Uncalled bet (295) returned to brenda1972
*** TURN *** [6h Qc Jd] [8s]
*** RIVER *** [6h Qc Jd 8s] [Ac]
*** SHOW DOWN ***
brenda1972: shows [Kh Kc] (a pair of Kings)
brenda1972 collected 40 from side pot
CashMatteo: shows [2s Kd] (high card Ace)
brenda1972 collected 255 from main pot
CashMatteo finished the tournament in 3rd place
*** SUMMARY ***
Total pot 295 Main pot 255. Side pot 40. | Rake 0 
Board [6h Qc Jd 8s Ac]
Seat 1: brenda1972 (button) showed [Kh Kc] and won (295) with a pair of Kings
Seat 2: Kora Fett (small blind) folded on the Flop
Seat 3: CashMatteo (big blind) showed [2s Kd] and lost with high card Ace

Hand #705: 

PokerStars Hand #246290190972: Tournament #3652621625, $4.65+$0.35 CAD Hold'em No Limit - Level I (10/20) - 2023/10/01 13:55:37 ET
Table '3652621625 1' 3-max Seat #1 is the button
Seat 1: Yawnbo85 (500 in chips) 
Seat 2: CashMatteo (500 in chips) 
Seat 3: LuckyLad69 (500 in chips) 
CashMatteo: posts small blind 10
LuckyLad69: posts big blind 20
*** HOLE CARDS ***
Dealt to CashMatteo [Qs Kd]
Yawnbo85: calls 20
CashMatteo: raises 40 to 60
LuckyLad69: calls 40
Yawnbo85: calls 40
*** FLOP *** [Ac 5h Jd]
CashMatteo: bets 90
LuckyLad69: folds 
Yawnbo85: folds 
Uncalled bet (90) returned to CashMatteo
CashMatteo collected 180 from pot
CashMatteo: doesn't show hand 
*** SUMMARY ***
Total pot 180 | Rake 0 
Board [Ac 5h Jd]
Seat 1: Yawnbo85 (button) folded on the Flop
Seat 2: CashMatteo (small blind) collected (180)
Seat 3: LuckyLad69 (big blind) folded on the Flop

Hand #706: 

PokerStars Hand #246290196543: Tournament #3652621625, $4.65+$0.35 CAD Hold'em No Limit - Level I (10/20) - 2023/10/01 13:56:01 ET
Table '3652621625 1' 3-max Seat #2 is the button
Seat 1: Yawnbo85 (440 in chips) 
Seat 2: CashMatteo (620 in chips) 
Seat 3: LuckyLad69 (440 in chips) 
LuckyLad69: posts small blind 10
Yawnbo85: posts big blind 20
*** HOLE CARDS ***
Dealt to CashMatteo [2h 7d]
CashMatteo: folds 
LuckyLad69: raises 20 to 40
Yawnbo85: calls 20
*** FLOP *** [8h 5h 3d]
LuckyLad69: bets 40
Yawnbo85: folds 
Uncalled bet (40) returned to LuckyLad69
LuckyLad69 collected 80 from pot
*** SUMMARY ***
Total pot 80 | Rake 0 
Board [8h 5h 3d]
Seat 1: Yawnbo85 (big blind) folded on the Flop
Seat 2: CashMatteo (button) folded before Flop (didn't bet)
Seat 3: LuckyLad69 (small blind) collected (80)

Hand #707: 

PokerStars Hand #246290200903: Tournament #3652621625, $4.65+$0.35 CAD Hold'em No Limit - Level I (10/20) - 2023/10/01 13:56:20 ET
Table '3652621625 1' 3-max Seat #3 is the button
Seat 1: Yawnbo85 (400 in chips) 
Seat 2: CashMatteo (620 in chips) 
Seat 3: LuckyLad69 (480 in chips) 
Yawnbo85: posts small blind 10
CashMatteo: posts big blind 20
*** HOLE CARDS ***
Dealt to CashMatteo [8h 9c]
LuckyLad69: folds 
Yawnbo85: calls 10
CashMatteo: checks 
*** FLOP *** [8c Ks 9s]
Yawnbo85: bets 20
CashMatteo: calls 20
*** TURN *** [8c Ks 9s] [As]
Yawnbo85: checks 
CashMatteo: checks 
*** RIVER *** [8c Ks 9s As] [5s]
Yawnbo85: bets 20
CashMatteo: calls 20
*** SHOW DOWN ***
Yawnbo85: shows [7s 9h] (a flush, Ace high)
CashMatteo: mucks hand 
Yawnbo85 collected 120 from pot
*** SUMMARY ***
Total pot 120 | Rake 0 
Board [8c Ks 9s As 5s]
Seat 1: Yawnbo85 (small blind) showed [7s 9h] and won (120) with a flush, Ace high
Seat 2: CashMatteo (big blind) mucked [8h 9c]
Seat 3: LuckyLad69 (button) folded before Flop (didn't bet)

Hand #708: 

PokerStars Hand #246290210745: Tournament #3652621625, $4.65+$0.35 CAD Hold'em No Limit - Level I (10/20) - 2023/10/01 13:57:03 ET
Table '3652621625 1' 3-max Seat #1 is the button
Seat 1: Yawnbo85 (460 in chips) 
Seat 2: CashMatteo (560 in chips) 
Seat 3: LuckyLad69 (480 in chips) 
CashMatteo: posts small blind 10
LuckyLad69: posts big blind 20
*** HOLE CARDS ***
Dealt to CashMatteo [2s 4d]
Yawnbo85: calls 20
CashMatteo: folds 
LuckyLad69: raises 20 to 40
Yawnbo85: calls 20
*** FLOP *** [Jh 6c 7c]
LuckyLad69: checks 
Yawnbo85: checks 
*** TURN *** [Jh 6c 7c] [7h]
LuckyLad69: checks 
Yawnbo85: checks 
*** RIVER *** [Jh 6c 7c 7h] [6s]
LuckyLad69: checks 
Yawnbo85: bets 20
LuckyLad69: calls 20
*** SHOW DOWN ***
Yawnbo85: shows [6d Ks] (a full house, Sixes full of Sevens)
LuckyLad69: mucks hand 
Yawnbo85 collected 130 from pot
*** SUMMARY ***
Total pot 130 | Rake 0 
Board [Jh 6c 7c 7h 6s]
Seat 1: Yawnbo85 (button) showed [6d Ks] and won (130) with a full house, Sixes full of Sevens
Seat 2: CashMatteo (small blind) folded before Flop
Seat 3: LuckyLad69 (big blind) mucked [Kd 5c]

Hand #709: 

PokerStars Hand #246290223860: Tournament #3652621625, $4.65+$0.35 CAD Hold'em No Limit - Level II (15/30) - 2023/10/01 13:57:59 ET
Table '3652621625 1' 3-max Seat #2 is the button
Seat 1: Yawnbo85 (530 in chips) 
Seat 2: CashMatteo (550 in chips) 
Seat 3: LuckyLad69 (420 in chips) 
LuckyLad69: posts small blind 15
Yawnbo85: posts big blind 30
*** HOLE CARDS ***
Dealt to CashMatteo [4s 3c]
CashMatteo: folds 
LuckyLad69: folds 
Uncalled bet (15) returned to Yawnbo85
Yawnbo85 collected 30 from pot
*** SUMMARY ***
Total pot 30 | Rake 0 
Seat 1: Yawnbo85 (big blind) collected (30)
Seat 2: CashMatteo (button) folded before Flop (didn't bet)
Seat 3: LuckyLad69 (small blind) folded before Flop

Hand #710: 

PokerStars Hand #246290225503: Tournament #3652621625, $4.65+$0.35 CAD Hold'em No Limit - Level II (15/30) - 2023/10/01 13:58:06 ET
Table '3652621625 1' 3-max Seat #3 is the button
Seat 1: Yawnbo85 (545 in chips) 
Seat 2: CashMatteo (550 in chips) 
Seat 3: LuckyLad69 (405 in chips) 
Yawnbo85: posts small blind 15
CashMatteo: posts big blind 30
*** HOLE CARDS ***
Dealt to CashMatteo [4d 8d]
LuckyLad69: raises 60 to 90
Yawnbo85: folds 
CashMatteo: folds 
Uncalled bet (60) returned to LuckyLad69
LuckyLad69 collected 75 from pot
*** SUMMARY ***
Total pot 75 | Rake 0 
Seat 1: Yawnbo85 (small blind) folded before Flop
Seat 2: CashMatteo (big blind) folded before Flop
Seat 3: LuckyLad69 (button) collected (75)

Hand #711: 

PokerStars Hand #246290228573: Tournament #3652621625, $4.65+$0.35 CAD Hold'em No Limit - Level II (15/30) - 2023/10/01 13:58:19 ET
Table '3652621625 1' 3-max Seat #1 is the button
Seat 1: Yawnbo85 (530 in chips) 
Seat 2: CashMatteo (520 in chips) 
Seat 3: LuckyLad69 (450 in chips) 
CashMatteo: posts small blind 15
LuckyLad69: posts big blind 30
*** HOLE CARDS ***
Dealt to CashMatteo [Qd Ah]
Yawnbo85: folds 
CashMatteo: raises 60 to 90
LuckyLad69: calls 60
*** FLOP *** [Js Ad 9c]
CashMatteo: bets 90
LuckyLad69: folds 
Uncalled bet (90) returned to CashMatteo
CashMatteo collected 180 from pot
CashMatteo: doesn't show hand 
*** SUMMARY ***
Total pot 180 | Rake 0 
Board [Js Ad 9c]
Seat 1: Yawnbo85 (button) folded before Flop (didn't bet)
Seat 2: CashMatteo (small blind) collected (180)
Seat 3: LuckyLad69 (big blind) folded on the Flop

Hand #712: 

PokerStars Hand #246290233454: Tournament #3652621625, $4.65+$0.35 CAD Hold'em No Limit - Level II (15/30) - 2023/10/01 13:58:40 ET
Table '3652621625 1' 3-max Seat #2 is the button
Seat 1: Yawnbo85 (530 in chips) 
Seat 2: CashMatteo (610 in chips) 
Seat 3: LuckyLad69 (360 in chips) 
LuckyLad69: posts small blind 15
Yawnbo85: posts big blind 30
*** HOLE CARDS ***
Dealt to CashMatteo [Jh 6d]
CashMatteo: raises 30 to 60
LuckyLad69: folds 
Yawnbo85: raises 30 to 90
CashMatteo: calls 30
*** FLOP *** [6c 5d 8h]
Yawnbo85: bets 60
CashMatteo: calls 60
*** TURN *** [6c 5d 8h] [5h]
Yawnbo85: bets 30
CashMatteo: calls 30
*** RIVER *** [6c 5d 8h 5h] [8c]
Yawnbo85: bets 30
CashMatteo: raises 68 to 98
Yawnbo85: folds 
Uncalled bet (68) returned to CashMatteo
CashMatteo collected 435 from pot
CashMatteo: doesn't show hand 
*** SUMMARY ***
Total pot 435 | Rake 0 
Board [6c 5d 8h 5h 8c]
Seat 1: Yawnbo85 (big blind) folded on the River
Seat 2: CashMatteo (button) collected (435)
Seat 3: LuckyLad69 (small blind) folded before Flop

Hand #713: 

PokerStars Hand #246290251585: Tournament #3652621625, $4.65+$0.35 CAD Hold'em No Limit - Level III (20/40) - 2023/10/01 13:59:58 ET
Table '3652621625 1' 3-max Seat #3 is the button
Seat 1: Yawnbo85 (320 in chips) 
Seat 2: CashMatteo (835 in chips) 
Seat 3: LuckyLad69 (345 in chips) 
Yawnbo85: posts small blind 20
CashMatteo: posts big blind 40
*** HOLE CARDS ***
Dealt to CashMatteo [Qs 9d]
LuckyLad69: raises 40 to 80
Yawnbo85: calls 60
CashMatteo: calls 40
*** FLOP *** [6d 6c 4s]
Yawnbo85: checks 
CashMatteo: checks 
LuckyLad69: bets 120
Yawnbo85: folds 
CashMatteo: folds 
Uncalled bet (120) returned to LuckyLad69
LuckyLad69 collected 240 from pot
*** SUMMARY ***
Total pot 240 | Rake 0 
Board [6d 6c 4s]
Seat 1: Yawnbo85 (small blind) folded on the Flop
Seat 2: CashMatteo (big blind) folded on the Flop
Seat 3: LuckyLad69 (button) collected (240)

Hand #714: 

PokerStars Hand #246290260954: Tournament #3652621625, $4.65+$0.35 CAD Hold'em No Limit - Level III (20/40) - 2023/10/01 14:00:31 ET
Table '3652621625 1' 3-max Seat #1 is the button
Seat 1: Yawnbo85 (240 in chips) 
Seat 2: CashMatteo (755 in chips) 
Seat 3: LuckyLad69 (505 in chips) 
CashMatteo: posts small blind 20
LuckyLad69: posts big blind 40
*** HOLE CARDS ***
Dealt to CashMatteo [8c 5c]
Yawnbo85: folds 
CashMatteo: folds 
Uncalled bet (20) returned to LuckyLad69
LuckyLad69 collected 40 from pot
*** SUMMARY ***
Total pot 40 | Rake 0 
Seat 1: Yawnbo85 (button) folded before Flop (didn't bet)
Seat 2: CashMatteo (small blind) folded before Flop
Seat 3: LuckyLad69 (big blind) collected (40)

Hand #715: 

PokerStars Hand #246290263394: Tournament #3652621625, $4.65+$0.35 CAD Hold'em No Limit - Level III (20/40) - 2023/10/01 14:00:40 ET
Table '3652621625 1' 3-max Seat #2 is the button
Seat 1: Yawnbo85 (240 in chips) 
Seat 2: CashMatteo (735 in chips) 
Seat 3: LuckyLad69 (525 in chips) 
LuckyLad69: posts small blind 20
Yawnbo85: posts big blind 40
*** HOLE CARDS ***
Dealt to CashMatteo [7c 5d]
CashMatteo: folds 
LuckyLad69: calls 20
Yawnbo85: raises 40 to 80
LuckyLad69: calls 40
*** FLOP *** [4h 6h Js]
LuckyLad69: checks 
Yawnbo85: bets 80
LuckyLad69: calls 80
*** TURN *** [4h 6h Js] [7s]
LuckyLad69: checks 
Yawnbo85: bets 80 and is all-in
LuckyLad69: calls 80
*** RIVER *** [4h 6h Js 7s] [7d]
*** SHOW DOWN ***
LuckyLad69: shows [3h 5c] (a straight, Three to Seven)
Yawnbo85: shows [Kh Qh] (a pair of Sevens)
LuckyLad69 collected 480 from pot
Yawnbo85 finished the tournament in 3rd place
*** SUMMARY ***
Total pot 480 | Rake 0 
Board [4h 6h Js 7s 7d]
Seat 1: Yawnbo85 (big blind) showed [Kh Qh] and lost with a pair of Sevens
Seat 2: CashMatteo (button) folded before Flop (didn't bet)
Seat 3: LuckyLad69 (small blind) showed [3h 5c] and won (480) with a straight, Three to Seven

Hand #716: 

PokerStars Hand #246290275084: Tournament #3652621625, $4.65+$0.35 CAD Hold'em No Limit - Level III (20/40) - 2023/10/01 14:01:19 ET
Table '3652621625 1' 3-max Seat #3 is the button
Seat 2: CashMatteo (735 in chips) 
Seat 3: LuckyLad69 (765 in chips) 
LuckyLad69: posts small blind 20
CashMatteo: posts big blind 40
*** HOLE CARDS ***
Dealt to CashMatteo [Qh 7s]
LuckyLad69: folds 
Uncalled bet (20) returned to CashMatteo
CashMatteo collected 40 from pot
CashMatteo: doesn't show hand 
*** SUMMARY ***
Total pot 40 | Rake 0 
Seat 2: CashMatteo (big blind) collected (40)
Seat 3: LuckyLad69 (button) (small blind) folded before Flop

Hand #717: 

PokerStars Hand #246290276464: Tournament #3652621625, $4.65+$0.35 CAD Hold'em No Limit - Level III (20/40) - 2023/10/01 14:01:24 ET
Table '3652621625 1' 3-max Seat #2 is the button
Seat 2: CashMatteo (755 in chips) 
Seat 3: LuckyLad69 (745 in chips) 
CashMatteo: posts small blind 20
LuckyLad69: posts big blind 40
*** HOLE CARDS ***
Dealt to CashMatteo [Qd 6c]
CashMatteo: raises 80 to 120
LuckyLad69: calls 80
*** FLOP *** [Qs 9s Ts]
LuckyLad69: checks 
CashMatteo: bets 120
LuckyLad69: folds 
Uncalled bet (120) returned to CashMatteo
CashMatteo collected 240 from pot
CashMatteo: doesn't show hand 
*** SUMMARY ***
Total pot 240 | Rake 0 
Board [Qs 9s Ts]
Seat 2: CashMatteo (button) (small blind) collected (240)
Seat 3: LuckyLad69 (big blind) folded on the Flop

Hand #718: 

PokerStars Hand #246290282476: Tournament #3652621625, $4.65+$0.35 CAD Hold'em No Limit - Level IV (30/60) - 2023/10/01 14:01:41 ET
Table '3652621625 1' 3-max Seat #3 is the button
Seat 2: CashMatteo (875 in chips) 
Seat 3: LuckyLad69 (625 in chips) 
LuckyLad69: posts small blind 30
CashMatteo: posts big blind 60
*** HOLE CARDS ***
Dealt to CashMatteo [2c 2h]
LuckyLad69: calls 30
CashMatteo: raises 120 to 180
LuckyLad69: folds 
Uncalled bet (120) returned to CashMatteo
CashMatteo collected 120 from pot
CashMatteo: doesn't show hand 
*** SUMMARY ***
Total pot 120 | Rake 0 
Seat 2: CashMatteo (big blind) collected (120)
Seat 3: LuckyLad69 (button) (small blind) folded before Flop

Hand #719: 

PokerStars Hand #246290285569: Tournament #3652621625, $4.65+$0.35 CAD Hold'em No Limit - Level IV (30/60) - 2023/10/01 14:01:50 ET
Table '3652621625 1' 3-max Seat #2 is the button
Seat 2: CashMatteo (935 in chips) 
Seat 3: LuckyLad69 (565 in chips) 
CashMatteo: posts small blind 30
LuckyLad69: posts big blind 60
*** HOLE CARDS ***
Dealt to CashMatteo [Jh 4s]
CashMatteo: calls 30
LuckyLad69: checks 
*** FLOP *** [6d 7s Kd]
LuckyLad69: checks 
CashMatteo: checks 
*** TURN *** [6d 7s Kd] [5h]
LuckyLad69: bets 120
CashMatteo: folds 
Uncalled bet (120) returned to LuckyLad69
LuckyLad69 collected 120 from pot
*** SUMMARY ***
Total pot 120 | Rake 0 
Board [6d 7s Kd 5h]
Seat 2: CashMatteo (button) (small blind) folded on the Turn
Seat 3: LuckyLad69 (big blind) collected (120)

Hand #720: 

PokerStars Hand #246290292084: Tournament #3652621625, $4.65+$0.35 CAD Hold'em No Limit - Level IV (30/60) - 2023/10/01 14:02:07 ET
Table '3652621625 1' 3-max Seat #3 is the button
Seat 2: CashMatteo (875 in chips) 
Seat 3: LuckyLad69 (625 in chips) 
LuckyLad69: posts small blind 30
CashMatteo: posts big blind 60
*** HOLE CARDS ***
Dealt to CashMatteo [3c Jd]
LuckyLad69: calls 30
CashMatteo: checks 
*** FLOP *** [3d Qs Th]
CashMatteo: bets 120
LuckyLad69: calls 120
*** TURN *** [3d Qs Th] [As]
CashMatteo: bets 60
LuckyLad69: calls 60
*** RIVER *** [3d Qs Th As] [8s]
CashMatteo: checks 
LuckyLad69: checks 
*** SHOW DOWN ***
CashMatteo: shows [3c Jd] (a pair of Threes)
LuckyLad69: shows [4d Qh] (a pair of Queens)
LuckyLad69 collected 480 from pot
*** SUMMARY ***
Total pot 480 | Rake 0 
Board [3d Qs Th As 8s]
Seat 2: CashMatteo (big blind) showed [3c Jd] and lost with a pair of Threes
Seat 3: LuckyLad69 (button) (small blind) showed [4d Qh] and won (480) with a pair of Queens

Hand #721: 

PokerStars Hand #246290304924: Tournament #3652621625, $4.65+$0.35 CAD Hold'em No Limit - Level IV (30/60) - 2023/10/01 14:02:39 ET
Table '3652621625 1' 3-max Seat #2 is the button
Seat 2: CashMatteo (635 in chips) 
Seat 3: LuckyLad69 (865 in chips) 
CashMatteo: posts small blind 30
LuckyLad69: posts big blind 60
*** HOLE CARDS ***
Dealt to CashMatteo [7c 3d]
CashMatteo: folds 
Uncalled bet (30) returned to LuckyLad69
LuckyLad69 collected 60 from pot
*** SUMMARY ***
Total pot 60 | Rake 0 
Seat 2: CashMatteo (button) (small blind) folded before Flop
Seat 3: LuckyLad69 (big blind) collected (60)

Hand #722: 

PokerStars Hand #246290307079: Tournament #3652621625, $4.65+$0.35 CAD Hold'em No Limit - Level IV (30/60) - 2023/10/01 14:02:45 ET
Table '3652621625 1' 3-max Seat #3 is the button
Seat 2: CashMatteo (605 in chips) 
Seat 3: LuckyLad69 (895 in chips) 
LuckyLad69: posts small blind 30
CashMatteo: posts big blind 60
*** HOLE CARDS ***
Dealt to CashMatteo [Jh 8c]
LuckyLad69: raises 120 to 180
CashMatteo: calls 120
*** FLOP *** [7s 3d Ks]
CashMatteo: checks 
LuckyLad69: bets 180
CashMatteo: folds 
Uncalled bet (180) returned to LuckyLad69
LuckyLad69 collected 360 from pot
*** SUMMARY ***
Total pot 360 | Rake 0 
Board [7s 3d Ks]
Seat 2: CashMatteo (big blind) folded on the Flop
Seat 3: LuckyLad69 (button) (small blind) collected (360)

Hand #723: 

PokerStars Hand #246290312337: Tournament #3652621625, $4.65+$0.35 CAD Hold'em No Limit - Level IV (30/60) - 2023/10/01 14:02:59 ET
Table '3652621625 1' 3-max Seat #2 is the button
Seat 2: CashMatteo (425 in chips) 
Seat 3: LuckyLad69 (1075 in chips) 
CashMatteo: posts small blind 30
LuckyLad69: posts big blind 60
*** HOLE CARDS ***
Dealt to CashMatteo [Ac Jh]
CashMatteo: raises 120 to 180
LuckyLad69: raises 895 to 1075 and is all-in
CashMatteo: calls 245 and is all-in
Uncalled bet (650) returned to LuckyLad69
*** FLOP *** [5h 7d Kh]
*** TURN *** [5h 7d Kh] [Qs]
*** RIVER *** [5h 7d Kh Qs] [5d]
*** SHOW DOWN ***
LuckyLad69: shows [9c Kc] (two pair, Kings and Fives)
CashMatteo: shows [Ac Jh] (a pair of Fives)
LuckyLad69 collected 850 from pot
CashMatteo finished the tournament in 2nd place
LuckyLad69 wins the tournament and receives $10.00 - congratulations!
*** SUMMARY ***
Total pot 850 | Rake 0 
Board [5h 7d Kh Qs 5d]
Seat 2: CashMatteo (button) (small blind) showed [Ac Jh] and lost with a pair of Fives
Seat 3: LuckyLad69 (big blind) showed [9c Kc] and won (850) with two pair, Kings and Fives

Hand #724: 

PokerStars Hand #246290490029: Tournament #3652627505, $9.30+$0.70 CAD Hold'em No Limit - Level I (10/20) - 2023/10/01 14:09:36 ET
Table '3652627505 1' 3-max Seat #1 is the button
Seat 1: CashMatteo (500 in chips) 
Seat 2: gto guy 01 (500 in chips) 
Seat 3: Spyderman238 (500 in chips) 
gto guy 01: posts small blind 10
Spyderman238: posts big blind 20
*** HOLE CARDS ***
Dealt to CashMatteo [Qc 5h]
CashMatteo: folds 
gto guy 01: folds 
Uncalled bet (10) returned to Spyderman238
Spyderman238 collected 20 from pot
*** SUMMARY ***
Total pot 20 | Rake 0 
Seat 1: CashMatteo (button) folded before Flop (didn't bet)
Seat 2: gto guy 01 (small blind) folded before Flop
Seat 3: Spyderman238 (big blind) collected (20)

Hand #725: 

PokerStars Hand #246290493161: Tournament #3652627505, $9.30+$0.70 CAD Hold'em No Limit - Level I (10/20) - 2023/10/01 14:09:43 ET
Table '3652627505 1' 3-max Seat #2 is the button
Seat 1: CashMatteo (500 in chips) 
Seat 2: gto guy 01 (490 in chips) 
Seat 3: Spyderman238 (510 in chips) 
Spyderman238: posts small blind 10
CashMatteo: posts big blind 20
*** HOLE CARDS ***
Dealt to CashMatteo [8c 8d]
gto guy 01: folds 
Spyderman238: raises 40 to 60
CashMatteo: calls 40
*** FLOP *** [6s Jh 2c]
Spyderman238: checks 
CashMatteo: bets 60
Spyderman238: calls 60
*** TURN *** [6s Jh 2c] [Ac]
Spyderman238: checks 
CashMatteo: checks 
*** RIVER *** [6s Jh 2c Ac] [4c]
Spyderman238: bets 240
CashMatteo: folds 
Uncalled bet (240) returned to Spyderman238
Spyderman238 collected 240 from pot
*** SUMMARY ***
Total pot 240 | Rake 0 
Board [6s Jh 2c Ac 4c]
Seat 1: CashMatteo (big blind) folded on the River
Seat 2: gto guy 01 (button) folded before Flop (didn't bet)
Seat 3: Spyderman238 (small blind) collected (240)

Hand #726: 

PokerStars Hand #246290504925: Tournament #3652627505, $9.30+$0.70 CAD Hold'em No Limit - Level I (10/20) - 2023/10/01 14:10:08 ET
Table '3652627505 1' 3-max Seat #3 is the button
Seat 1: CashMatteo (380 in chips) 
Seat 2: gto guy 01 (490 in chips) 
Seat 3: Spyderman238 (630 in chips) 
CashMatteo: posts small blind 10
gto guy 01: posts big blind 20
*** HOLE CARDS ***
Dealt to CashMatteo [7h 5s]
Spyderman238: calls 20
CashMatteo: folds 
gto guy 01: checks 
*** FLOP *** [6s Jd 7c]
gto guy 01: checks 
Spyderman238: checks 
*** TURN *** [6s Jd 7c] [Ks]
gto guy 01: bets 20
Spyderman238: folds 
Uncalled bet (20) returned to gto guy 01
gto guy 01 collected 50 from pot
*** SUMMARY ***
Total pot 50 | Rake 0 
Board [6s Jd 7c Ks]
Seat 1: CashMatteo (small blind) folded before Flop
Seat 2: gto guy 01 (big blind) collected (50)
Seat 3: Spyderman238 (button) folded on the Turn

Hand #727: 

PokerStars Hand #246290513015: Tournament #3652627505, $9.30+$0.70 CAD Hold'em No Limit - Level I (10/20) - 2023/10/01 14:10:26 ET
Table '3652627505 1' 3-max Seat #1 is the button
Seat 1: CashMatteo (370 in chips) 
Seat 2: gto guy 01 (520 in chips) 
Seat 3: Spyderman238 (610 in chips) 
gto guy 01: posts small blind 10
Spyderman238: posts big blind 20
*** HOLE CARDS ***
Dealt to CashMatteo [Jc 5d]
CashMatteo: folds 
gto guy 01: folds 
Uncalled bet (10) returned to Spyderman238
Spyderman238 collected 20 from pot
*** SUMMARY ***
Total pot 20 | Rake 0 
Seat 1: CashMatteo (button) folded before Flop (didn't bet)
Seat 2: gto guy 01 (small blind) folded before Flop
Seat 3: Spyderman238 (big blind) collected (20)

Hand #728: 

PokerStars Hand #246290515680: Tournament #3652627505, $9.30+$0.70 CAD Hold'em No Limit - Level I (10/20) - 2023/10/01 14:10:32 ET
Table '3652627505 1' 3-max Seat #2 is the button
Seat 1: CashMatteo (370 in chips) 
Seat 2: gto guy 01 (510 in chips) 
Seat 3: Spyderman238 (620 in chips) 
Spyderman238: posts small blind 10
CashMatteo: posts big blind 20
*** HOLE CARDS ***
Dealt to CashMatteo [9h 8c]
gto guy 01: calls 20
Spyderman238: calls 10
CashMatteo: checks 
*** FLOP *** [3c Ah Js]
Spyderman238: checks 
CashMatteo: bets 30
gto guy 01: calls 30
Spyderman238: calls 30
*** TURN *** [3c Ah Js] [7c]
Spyderman238: checks 
CashMatteo: checks 
gto guy 01: checks 
*** RIVER *** [3c Ah Js 7c] [3d]
Spyderman238: checks 
CashMatteo: checks 
gto guy 01: checks 
*** SHOW DOWN ***
Spyderman238: shows [9s Td] (a pair of Threes)
CashMatteo: mucks hand 
gto guy 01: shows [Kd Tc] (a pair of Threes - Ace+King kicker)
gto guy 01 collected 150 from pot
*** SUMMARY ***
Total pot 150 | Rake 0 
Board [3c Ah Js 7c 3d]
Seat 1: CashMatteo (big blind) mucked [9h 8c]
Seat 2: gto guy 01 (button) showed [Kd Tc] and won (150) with a pair of Threes
Seat 3: Spyderman238 (small blind) showed [9s Td] and lost with a pair of Threes

Hand #729: 

PokerStars Hand #246290531466: Tournament #3652627505, $9.30+$0.70 CAD Hold'em No Limit - Level I (10/20) - 2023/10/01 14:11:06 ET
Table '3652627505 1' 3-max Seat #3 is the button
Seat 1: CashMatteo (320 in chips) 
Seat 2: gto guy 01 (610 in chips) 
Seat 3: Spyderman238 (570 in chips) 
CashMatteo: posts small blind 10
gto guy 01: posts big blind 20
*** HOLE CARDS ***
Dealt to CashMatteo [5h Ks]
Spyderman238: calls 20
CashMatteo: folds 
gto guy 01: checks 
*** FLOP *** [Jc 2c Ac]
gto guy 01: checks 
Spyderman238: checks 
*** TURN *** [Jc 2c Ac] [9d]
gto guy 01: checks 
Spyderman238: bets 25
gto guy 01: calls 25
*** RIVER *** [Jc 2c Ac 9d] [5s]
gto guy 01: checks 
Spyderman238: checks 
*** SHOW DOWN ***
gto guy 01: shows [8d Qc] (high card Ace)
Spyderman238: mucks hand 
gto guy 01 collected 100 from pot
*** SUMMARY ***
Total pot 100 | Rake 0 
Board [Jc 2c Ac 9d 5s]
Seat 1: CashMatteo (small blind) folded before Flop
Seat 2: gto guy 01 (big blind) showed [8d Qc] and won (100) with high card Ace
Seat 3: Spyderman238 (button) mucked [7s 8h]

Hand #730: 

PokerStars Hand #246290544083: Tournament #3652627505, $9.30+$0.70 CAD Hold'em No Limit - Level I (10/20) - 2023/10/01 14:11:34 ET
Table '3652627505 1' 3-max Seat #1 is the button
Seat 1: CashMatteo (310 in chips) 
Seat 2: gto guy 01 (665 in chips) 
Seat 3: Spyderman238 (525 in chips) 
gto guy 01: posts small blind 10
Spyderman238: posts big blind 20
*** HOLE CARDS ***
Dealt to CashMatteo [9s 2s]
CashMatteo: folds 
gto guy 01: calls 10
Spyderman238: checks 
*** FLOP *** [9h 7s Ah]
gto guy 01: checks 
Spyderman238: checks 
*** TURN *** [9h 7s Ah] [9d]
gto guy 01: bets 20
Spyderman238: calls 20
*** RIVER *** [9h 7s Ah 9d] [8c]
gto guy 01: checks 
Spyderman238: checks 
*** SHOW DOWN ***
gto guy 01: shows [Th Qs] (a pair of Nines)
Spyderman238: shows [Ad Qc] (two pair, Aces and Nines)
Spyderman238 collected 80 from pot
*** SUMMARY ***
Total pot 80 | Rake 0 
Board [9h 7s Ah 9d 8c]
Seat 1: CashMatteo (button) folded before Flop (didn't bet)
Seat 2: gto guy 01 (small blind) showed [Th Qs] and lost with a pair of Nines
Seat 3: Spyderman238 (big blind) showed [Ad Qc] and won (80) with two pair, Aces and Nines

Hand #731: 

PokerStars Hand #246290554576: Tournament #3652627505, $9.30+$0.70 CAD Hold'em No Limit - Level II (15/30) - 2023/10/01 14:11:57 ET
Table '3652627505 1' 3-max Seat #2 is the button
Seat 1: CashMatteo (310 in chips) 
Seat 2: gto guy 01 (625 in chips) 
Seat 3: Spyderman238 (565 in chips) 
Spyderman238: posts small blind 15
CashMatteo: posts big blind 30
*** HOLE CARDS ***
Dealt to CashMatteo [3h 5s]
gto guy 01: calls 30
Spyderman238: calls 15
CashMatteo: checks 
*** FLOP *** [3s 7s 3c]
Spyderman238: checks 
CashMatteo: checks 
gto guy 01: checks 
*** TURN *** [3s 7s 3c] [Ac]
Spyderman238: checks 
CashMatteo: bets 30
gto guy 01: folds 
Spyderman238: calls 30
*** RIVER *** [3s 7s 3c Ac] [8s]
Spyderman238: bets 75
CashMatteo: raises 175 to 250 and is all-in
Spyderman238: calls 175
*** SHOW DOWN ***
CashMatteo: shows [3h 5s] (three of a kind, Threes)
Spyderman238: shows [As 6h] (two pair, Aces and Threes)
CashMatteo collected 650 from pot
*** SUMMARY ***
Total pot 650 | Rake 0 
Board [3s 7s 3c Ac 8s]
Seat 1: CashMatteo (big blind) showed [3h 5s] and won (650) with three of a kind, Threes
Seat 2: gto guy 01 (button) folded on the Turn
Seat 3: Spyderman238 (small blind) showed [As 6h] and lost with two pair, Aces and Threes

Hand #732: 

PokerStars Hand #246290569730: Tournament #3652627505, $9.30+$0.70 CAD Hold'em No Limit - Level II (15/30) - 2023/10/01 14:12:30 ET
Table '3652627505 1' 3-max Seat #3 is the button
Seat 1: CashMatteo (650 in chips) 
Seat 2: gto guy 01 (595 in chips) 
Seat 3: Spyderman238 (255 in chips) 
CashMatteo: posts small blind 15
gto guy 01: posts big blind 30
*** HOLE CARDS ***
Dealt to CashMatteo [Jc Jd]
Spyderman238: calls 30
CashMatteo: raises 60 to 90
gto guy 01: folds 
Spyderman238: raises 165 to 255 and is all-in
CashMatteo: calls 165
*** FLOP *** [Qc Th 5d]
*** TURN *** [Qc Th 5d] [9s]
*** RIVER *** [Qc Th 5d 9s] [4s]
*** SHOW DOWN ***
CashMatteo: shows [Jc Jd] (a pair of Jacks)
Spyderman238: shows [Ac Ad] (a pair of Aces)
Spyderman238 collected 540 from pot
*** SUMMARY ***
Total pot 540 | Rake 0 
Board [Qc Th 5d 9s 4s]
Seat 1: CashMatteo (small blind) showed [Jc Jd] and lost with a pair of Jacks
Seat 2: gto guy 01 (big blind) folded before Flop
Seat 3: Spyderman238 (button) showed [Ac Ad] and won (540) with a pair of Aces

Hand #733: 

PokerStars Hand #246290578787: Tournament #3652627505, $9.30+$0.70 CAD Hold'em No Limit - Level II (15/30) - 2023/10/01 14:12:50 ET
Table '3652627505 1' 3-max Seat #1 is the button
Seat 1: CashMatteo (395 in chips) 
Seat 2: gto guy 01 (565 in chips) 
Seat 3: Spyderman238 (540 in chips) 
gto guy 01: posts small blind 15
Spyderman238: posts big blind 30
*** HOLE CARDS ***
Dealt to CashMatteo [Qd Jc]
CashMatteo: raises 60 to 90
gto guy 01: folds 
Spyderman238: folds 
Uncalled bet (60) returned to CashMatteo
CashMatteo collected 75 from pot
CashMatteo: doesn't show hand 
*** SUMMARY ***
Total pot 75 | Rake 0 
Seat 1: CashMatteo (button) collected (75)
Seat 2: gto guy 01 (small blind) folded before Flop
Seat 3: Spyderman238 (big blind) folded before Flop

Hand #734: 

PokerStars Hand #246290583293: Tournament #3652627505, $9.30+$0.70 CAD Hold'em No Limit - Level II (15/30) - 2023/10/01 14:13:00 ET
Table '3652627505 1' 3-max Seat #2 is the button
Seat 1: CashMatteo (440 in chips) 
Seat 2: gto guy 01 (550 in chips) 
Seat 3: Spyderman238 (510 in chips) 
Spyderman238: posts small blind 15
CashMatteo: posts big blind 30
*** HOLE CARDS ***
Dealt to CashMatteo [5s Jh]
gto guy 01: calls 30
Spyderman238: calls 15
CashMatteo: checks 
*** FLOP *** [Tc Ts Jc]
Spyderman238: checks 
CashMatteo: bets 45
gto guy 01: calls 45
Spyderman238: calls 45
*** TURN *** [Tc Ts Jc] [Ah]
Spyderman238: bets 113
CashMatteo: folds 
gto guy 01: calls 113
*** RIVER *** [Tc Ts Jc Ah] [4s]
Spyderman238: checks 
gto guy 01: checks 
*** SHOW DOWN ***
Spyderman238: shows [Js 7h] (two pair, Jacks and Tens)
gto guy 01: shows [Kd As] (two pair, Aces and Tens)
gto guy 01 collected 451 from pot
*** SUMMARY ***
Total pot 451 | Rake 0 
Board [Tc Ts Jc Ah 4s]
Seat 1: CashMatteo (big blind) folded on the Turn
Seat 2: gto guy 01 (button) showed [Kd As] and won (451) with two pair, Aces and Tens
Seat 3: Spyderman238 (small blind) showed [Js 7h] and lost with two pair, Jacks and Tens

Hand #735: 

PokerStars Hand #246290597195: Tournament #3652627505, $9.30+$0.70 CAD Hold'em No Limit - Level II (15/30) - 2023/10/01 14:13:31 ET
Table '3652627505 1' 3-max Seat #3 is the button
Seat 1: CashMatteo (365 in chips) 
Seat 2: gto guy 01 (813 in chips) 
Seat 3: Spyderman238 (322 in chips) 
CashMatteo: posts small blind 15
gto guy 01: posts big blind 30
*** HOLE CARDS ***
Dealt to CashMatteo [9d Qc]
Spyderman238: calls 30
CashMatteo: calls 15
gto guy 01: checks 
*** FLOP *** [2h Qs Jh]
CashMatteo: bets 30
gto guy 01: calls 30
Spyderman238: raises 262 to 292 and is all-in
CashMatteo: calls 262
gto guy 01: folds 
*** TURN *** [2h Qs Jh] [Qd]
*** RIVER *** [2h Qs Jh Qd] [4h]
*** SHOW DOWN ***
CashMatteo: shows [9d Qc] (three of a kind, Queens)
Spyderman238: shows [8h Qh] (a flush, Queen high)
Spyderman238 collected 704 from pot
*** SUMMARY ***
Total pot 704 | Rake 0 
Board [2h Qs Jh Qd 4h]
Seat 1: CashMatteo (small blind) showed [9d Qc] and lost with three of a kind, Queens
Seat 2: gto guy 01 (big blind) folded on the Flop
Seat 3: Spyderman238 (button) showed [8h Qh] and won (704) with a flush, Queen high

Hand #736: 

PokerStars Hand #246290613997: Tournament #3652627505, $9.30+$0.70 CAD Hold'em No Limit - Level III (20/40) - 2023/10/01 14:14:08 ET
Table '3652627505 1' 3-max Seat #1 is the button
Seat 1: CashMatteo (43 in chips) 
Seat 2: gto guy 01 (753 in chips) 
Seat 3: Spyderman238 (704 in chips) 
gto guy 01: posts small blind 20
Spyderman238: posts big blind 40
*** HOLE CARDS ***
Dealt to CashMatteo [5h 7c]
CashMatteo: folds 
gto guy 01: calls 20
Spyderman238: checks 
*** FLOP *** [2c 9c 2h]
gto guy 01: bets 40
Spyderman238: calls 40
*** TURN *** [2c 9c 2h] [2d]
gto guy 01: bets 40
Spyderman238: calls 40
*** RIVER *** [2c 9c 2h 2d] [5s]
gto guy 01: checks 
Spyderman238: checks 
*** SHOW DOWN ***
gto guy 01: shows [Ah Ts] (three of a kind, Deuces)
Spyderman238: shows [Jc 9h] (a full house, Deuces full of Nines)
Spyderman238 collected 240 from pot
*** SUMMARY ***
Total pot 240 | Rake 0 
Board [2c 9c 2h 2d 5s]
Seat 1: CashMatteo (button) folded before Flop (didn't bet)
Seat 2: gto guy 01 (small blind) showed [Ah Ts] and lost with three of a kind, Deuces
Seat 3: Spyderman238 (big blind) showed [Jc 9h] and won (240) with a full house, Deuces full of Nines

Hand #737: 

PokerStars Hand #246290623067: Tournament #3652627505, $9.30+$0.70 CAD Hold'em No Limit - Level III (20/40) - 2023/10/01 14:14:28 ET
Table '3652627505 1' 3-max Seat #2 is the button
Seat 1: CashMatteo (43 in chips) 
Seat 2: gto guy 01 (633 in chips) 
Seat 3: Spyderman238 (824 in chips) 
Spyderman238: posts small blind 20
CashMatteo: posts big blind 40
*** HOLE CARDS ***
Dealt to CashMatteo [2d Qs]
gto guy 01: calls 40
Spyderman238: calls 20
CashMatteo: raises 3 to 43 and is all-in
gto guy 01: calls 3
Spyderman238: calls 3
*** FLOP *** [Ah Ad Ts]
Spyderman238: checks 
gto guy 01: checks 
*** TURN *** [Ah Ad Ts] [Js]
Spyderman238: checks 
gto guy 01: checks 
*** RIVER *** [Ah Ad Ts Js] [9c]
Spyderman238: checks 
gto guy 01: checks 
*** SHOW DOWN ***
Spyderman238: shows [2c 5s] (a pair of Aces)
CashMatteo: shows [2d Qs] (a pair of Aces - Queen kicker)
gto guy 01: shows [Jd Kd] (two pair, Aces and Jacks)
gto guy 01 collected 129 from pot
CashMatteo finished the tournament in 3rd place
*** SUMMARY ***
Total pot 129 | Rake 0 
Board [Ah Ad Ts Js 9c]
Seat 1: CashMatteo (big blind) showed [2d Qs] and lost with a pair of Aces
Seat 2: gto guy 01 (button) showed [Jd Kd] and won (129) with two pair, Aces and Jacks
Seat 3: Spyderman238 (small blind) showed [2c 5s] and lost with a pair of Aces

Hand #738: 

PokerStars Hand #246290714079: Tournament #3652629947, $9.30+$0.70 CAD Hold'em No Limit - Level I (10/20) - 2023/10/01 14:17:47 ET
Table '3652629947 1' 3-max Seat #1 is the button
Seat 1: Marchbrook (500 in chips) 
Seat 2: CashMatteo (500 in chips) 
Seat 3: moneymama6 (500 in chips) 
CashMatteo: posts small blind 10
moneymama6: posts big blind 20
*** HOLE CARDS ***
Dealt to CashMatteo [7c As]
Marchbrook: raises 480 to 500 and is all-in
CashMatteo: folds 
moneymama6: folds 
Uncalled bet (480) returned to Marchbrook
Marchbrook collected 50 from pot
*** SUMMARY ***
Total pot 50 | Rake 0 
Seat 1: Marchbrook (button) collected (50)
Seat 2: CashMatteo (small blind) folded before Flop
Seat 3: moneymama6 (big blind) folded before Flop

Hand #739: 

PokerStars Hand #246290719117: Tournament #3652629947, $9.30+$0.70 CAD Hold'em No Limit - Level I (10/20) - 2023/10/01 14:17:57 ET
Table '3652629947 1' 3-max Seat #2 is the button
Seat 1: Marchbrook (530 in chips) 
Seat 2: CashMatteo (490 in chips) 
Seat 3: moneymama6 (480 in chips) 
moneymama6: posts small blind 10
Marchbrook: posts big blind 20
*** HOLE CARDS ***
Dealt to CashMatteo [3c 2d]
CashMatteo: folds 
moneymama6: calls 10
Marchbrook: raises 510 to 530 and is all-in
moneymama6: folds 
Uncalled bet (510) returned to Marchbrook
Marchbrook collected 40 from pot
*** SUMMARY ***
Total pot 40 | Rake 0 
Seat 1: Marchbrook (big blind) collected (40)
Seat 2: CashMatteo (button) folded before Flop (didn't bet)
Seat 3: moneymama6 (small blind) folded before Flop

Hand #740: 

PokerStars Hand #246290724203: Tournament #3652629947, $9.30+$0.70 CAD Hold'em No Limit - Level I (10/20) - 2023/10/01 14:18:08 ET
Table '3652629947 1' 3-max Seat #3 is the button
Seat 1: Marchbrook (550 in chips) 
Seat 2: CashMatteo (490 in chips) 
Seat 3: moneymama6 (460 in chips) 
Marchbrook: posts small blind 10
CashMatteo: posts big blind 20
*** HOLE CARDS ***
Dealt to CashMatteo [2c 5c]
moneymama6: raises 440 to 460 and is all-in
Marchbrook: folds 
CashMatteo: folds 
Uncalled bet (440) returned to moneymama6
moneymama6 collected 50 from pot
moneymama6: doesn't show hand 
*** SUMMARY ***
Total pot 50 | Rake 0 
Seat 1: Marchbrook (small blind) folded before Flop
Seat 2: CashMatteo (big blind) folded before Flop
Seat 3: moneymama6 (button) collected (50)

Hand #741: 

PokerStars Hand #246290728775: Tournament #3652629947, $9.30+$0.70 CAD Hold'em No Limit - Level I (10/20) - 2023/10/01 14:18:18 ET
Table '3652629947 1' 3-max Seat #1 is the button
Seat 1: Marchbrook (540 in chips) 
Seat 2: CashMatteo (470 in chips) 
Seat 3: moneymama6 (490 in chips) 
CashMatteo: posts small blind 10
moneymama6: posts big blind 20
*** HOLE CARDS ***
Dealt to CashMatteo [As 4s]
Marchbrook: folds 
CashMatteo: calls 10
moneymama6: raises 470 to 490 and is all-in
CashMatteo: folds 
Uncalled bet (470) returned to moneymama6
moneymama6 collected 40 from pot
moneymama6: doesn't show hand 
*** SUMMARY ***
Total pot 40 | Rake 0 
Seat 1: Marchbrook (button) folded before Flop (didn't bet)
Seat 2: CashMatteo (small blind) folded before Flop
Seat 3: moneymama6 (big blind) collected (40)

Hand #742: 

PokerStars Hand #246290736888: Tournament #3652629947, $9.30+$0.70 CAD Hold'em No Limit - Level I (10/20) - 2023/10/01 14:18:36 ET
Table '3652629947 1' 3-max Seat #2 is the button
Seat 1: Marchbrook (540 in chips) 
Seat 2: CashMatteo (450 in chips) 
Seat 3: moneymama6 (510 in chips) 
moneymama6: posts small blind 10
Marchbrook: posts big blind 20
*** HOLE CARDS ***
Dealt to CashMatteo [Ac Ks]
CashMatteo: calls 20
moneymama6: folds 
Marchbrook: checks 
*** FLOP *** [5s Tc Ts]
Marchbrook: checks 
CashMatteo: checks 
*** TURN *** [5s Tc Ts] [5d]
Marchbrook: checks 
CashMatteo: bets 50
Marchbrook: calls 50
*** RIVER *** [5s Tc Ts 5d] [9s]
Marchbrook: bets 75
CashMatteo: calls 75
*** SHOW DOWN ***
Marchbrook: shows [7h Qc] (two pair, Tens and Fives)
CashMatteo: shows [Ac Ks] (two pair, Tens and Fives - Ace kicker)
CashMatteo collected 300 from pot
*** SUMMARY ***
Total pot 300 | Rake 0 
Board [5s Tc Ts 5d 9s]
Seat 1: Marchbrook (big blind) showed [7h Qc] and lost with two pair, Tens and Fives
Seat 2: CashMatteo (button) showed [Ac Ks] and won (300) with two pair, Tens and Fives
Seat 3: moneymama6 (small blind) folded before Flop

Hand #743: 

PokerStars Hand #246290750895: Tournament #3652629947, $9.30+$0.70 CAD Hold'em No Limit - Level I (10/20) - 2023/10/01 14:19:07 ET
Table '3652629947 1' 3-max Seat #3 is the button
Seat 1: Marchbrook (395 in chips) 
Seat 2: CashMatteo (605 in chips) 
Seat 3: moneymama6 (500 in chips) 
Marchbrook: posts small blind 10
CashMatteo: posts big blind 20
*** HOLE CARDS ***
Dealt to CashMatteo [Ts 4h]
moneymama6: calls 20
Marchbrook: calls 10
CashMatteo: checks 
*** FLOP *** [Ah Kh 6h]
Marchbrook: checks 
CashMatteo: checks 
moneymama6: bets 20
Marchbrook: folds 
CashMatteo: folds 
Uncalled bet (20) returned to moneymama6
moneymama6 collected 60 from pot
moneymama6: doesn't show hand 
*** SUMMARY ***
Total pot 60 | Rake 0 
Board [Ah Kh 6h]
Seat 1: Marchbrook (small blind) folded on the Flop
Seat 2: CashMatteo (big blind) folded on the Flop
Seat 3: moneymama6 (button) collected (60)

Hand #744: 

PokerStars Hand #246290757946: Tournament #3652629947, $9.30+$0.70 CAD Hold'em No Limit - Level I (10/20) - 2023/10/01 14:19:22 ET
Table '3652629947 1' 3-max Seat #1 is the button
Seat 1: Marchbrook (375 in chips) 
Seat 2: CashMatteo (585 in chips) 
Seat 3: moneymama6 (540 in chips) 
CashMatteo: posts small blind 10
moneymama6: posts big blind 20
*** HOLE CARDS ***
Dealt to CashMatteo [4h 9c]
Marchbrook: calls 20
CashMatteo: folds 
moneymama6: checks 
*** FLOP *** [Th Tc 3h]
moneymama6: bets 20
Marchbrook: raises 335 to 355 and is all-in
moneymama6: folds 
Uncalled bet (335) returned to Marchbrook
Marchbrook collected 90 from pot
*** SUMMARY ***
Total pot 90 | Rake 0 
Board [Th Tc 3h]
Seat 1: Marchbrook (button) collected (90)
Seat 2: CashMatteo (small blind) folded before Flop
Seat 3: moneymama6 (big blind) folded on the Flop

Hand #745: 

PokerStars Hand #246290767157: Tournament #3652629947, $9.30+$0.70 CAD Hold'em No Limit - Level I (10/20) - 2023/10/01 14:19:42 ET
Table '3652629947 1' 3-max Seat #2 is the button
Seat 1: Marchbrook (425 in chips) 
Seat 2: CashMatteo (575 in chips) 
Seat 3: moneymama6 (500 in chips) 
moneymama6: posts small blind 10
Marchbrook: posts big blind 20
*** HOLE CARDS ***
Dealt to CashMatteo [5c 8c]
CashMatteo: calls 20
moneymama6: folds 
Marchbrook: raises 50 to 70
CashMatteo: folds 
Uncalled bet (50) returned to Marchbrook
Marchbrook collected 50 from pot
*** SUMMARY ***
Total pot 50 | Rake 0 
Seat 1: Marchbrook (big blind) collected (50)
Seat 2: CashMatteo (button) folded before Flop
Seat 3: moneymama6 (small blind) folded before Flop

Hand #746: 

PokerStars Hand #246290772434: Tournament #3652629947, $9.30+$0.70 CAD Hold'em No Limit - Level I (10/20) - 2023/10/01 14:19:53 ET
Table '3652629947 1' 3-max Seat #3 is the button
Seat 1: Marchbrook (455 in chips) 
Seat 2: CashMatteo (555 in chips) 
Seat 3: moneymama6 (490 in chips) 
Marchbrook: posts small blind 10
CashMatteo: posts big blind 20
*** HOLE CARDS ***
Dealt to CashMatteo [Kc 3c]
moneymama6: raises 470 to 490 and is all-in
Marchbrook: folds 
CashMatteo: folds 
Uncalled bet (470) returned to moneymama6
moneymama6 collected 50 from pot
moneymama6: doesn't show hand 
*** SUMMARY ***
Total pot 50 | Rake 0 
Seat 1: Marchbrook (small blind) folded before Flop
Seat 2: CashMatteo (big blind) folded before Flop
Seat 3: moneymama6 (button) collected (50)

Hand #747: 

PokerStars Hand #246290776229: Tournament #3652629947, $9.30+$0.70 CAD Hold'em No Limit - Level I (10/20) - 2023/10/01 14:20:02 ET
Table '3652629947 1' 3-max Seat #1 is the button
Seat 1: Marchbrook (445 in chips) 
Seat 2: CashMatteo (535 in chips) 
Seat 3: moneymama6 (520 in chips) 
CashMatteo: posts small blind 10
moneymama6: posts big blind 20
*** HOLE CARDS ***
Dealt to CashMatteo [3h Qs]
Marchbrook: raises 50 to 70
CashMatteo: folds 
moneymama6: folds 
Uncalled bet (50) returned to Marchbrook
Marchbrook collected 50 from pot
*** SUMMARY ***
Total pot 50 | Rake 0 
Seat 1: Marchbrook (button) collected (50)
Seat 2: CashMatteo (small blind) folded before Flop
Seat 3: moneymama6 (big blind) folded before Flop

Hand #748: 

PokerStars Hand #246290779631: Tournament #3652629947, $9.30+$0.70 CAD Hold'em No Limit - Level I (10/20) - 2023/10/01 14:20:09 ET
Table '3652629947 1' 3-max Seat #2 is the button
Seat 1: Marchbrook (475 in chips) 
Seat 2: CashMatteo (525 in chips) 
Seat 3: moneymama6 (500 in chips) 
moneymama6: posts small blind 10
Marchbrook: posts big blind 20
*** HOLE CARDS ***
Dealt to CashMatteo [Jh 6h]
CashMatteo: folds 
moneymama6: folds 
Uncalled bet (10) returned to Marchbrook
Marchbrook collected 20 from pot
*** SUMMARY ***
Total pot 20 | Rake 0 
Seat 1: Marchbrook (big blind) collected (20)
Seat 2: CashMatteo (button) folded before Flop (didn't bet)
Seat 3: moneymama6 (small blind) folded before Flop

Hand #749: 

PokerStars Hand #246290782470: Tournament #3652629947, $9.30+$0.70 CAD Hold'em No Limit - Level I (10/20) - 2023/10/01 14:20:15 ET
Table '3652629947 1' 3-max Seat #3 is the button
Seat 1: Marchbrook (485 in chips) 
Seat 2: CashMatteo (525 in chips) 
Seat 3: moneymama6 (490 in chips) 
Marchbrook: posts small blind 10
CashMatteo: posts big blind 20
*** HOLE CARDS ***
Dealt to CashMatteo [4d 5d]
moneymama6: calls 20
Marchbrook: folds 
CashMatteo: checks 
*** FLOP *** [3d 2d 3h]
CashMatteo: bets 20
moneymama6: folds 
Uncalled bet (20) returned to CashMatteo
CashMatteo collected 50 from pot
CashMatteo: doesn't show hand 
*** SUMMARY ***
Total pot 50 | Rake 0 
Board [3d 2d 3h]
Seat 1: Marchbrook (small blind) folded before Flop
Seat 2: CashMatteo (big blind) collected (50)
Seat 3: moneymama6 (button) folded on the Flop

Hand #750: 

PokerStars Hand #246290788358: Tournament #3652629947, $9.30+$0.70 CAD Hold'em No Limit - Level I (10/20) - 2023/10/01 14:20:28 ET
Table '3652629947 1' 3-max Seat #1 is the button
Seat 1: Marchbrook (475 in chips) 
Seat 2: CashMatteo (555 in chips) 
Seat 3: moneymama6 (470 in chips) 
CashMatteo: posts small blind 10
moneymama6: posts big blind 20
*** HOLE CARDS ***
Dealt to CashMatteo [5h Kc]
Marchbrook: folds 
CashMatteo: folds 
Uncalled bet (10) returned to moneymama6
moneymama6 collected 20 from pot
moneymama6: doesn't show hand 
*** SUMMARY ***
Total pot 20 | Rake 0 
Seat 1: Marchbrook (button) folded before Flop (didn't bet)
Seat 2: CashMatteo (small blind) folded before Flop
Seat 3: moneymama6 (big blind) collected (20)

Hand #751: 

PokerStars Hand #246290790960: Tournament #3652629947, $9.30+$0.70 CAD Hold'em No Limit - Level I (10/20) - 2023/10/01 14:20:34 ET
Table '3652629947 1' 3-max Seat #2 is the button
Seat 1: Marchbrook (475 in chips) 
Seat 2: CashMatteo (545 in chips) 
Seat 3: moneymama6 (480 in chips) 
moneymama6: posts small blind 10
Marchbrook: posts big blind 20
*** HOLE CARDS ***
Dealt to CashMatteo [Ah 9h]
CashMatteo: calls 20
moneymama6: calls 10
Marchbrook: checks 
*** FLOP *** [4s Kc 7c]
moneymama6: checks 
Marchbrook: checks 
CashMatteo: bets 20
moneymama6: folds 
Marchbrook: calls 20
*** TURN *** [4s Kc 7c] [3s]
Marchbrook: bets 20
CashMatteo: calls 20
*** RIVER *** [4s Kc 7c 3s] [6s]
Marchbrook: bets 70
CashMatteo: folds 
Uncalled bet (70) returned to Marchbrook
Marchbrook collected 140 from pot
*** SUMMARY ***
Total pot 140 | Rake 0 
Board [4s Kc 7c 3s 6s]
Seat 1: Marchbrook (big blind) collected (140)
Seat 2: CashMatteo (button) folded on the River
Seat 3: moneymama6 (small blind) folded on the Flop

Hand #752: 

PokerStars Hand #246290810660: Tournament #3652629947, $9.30+$0.70 CAD Hold'em No Limit - Level II (15/30) - 2023/10/01 14:21:16 ET
Table '3652629947 1' 3-max Seat #3 is the button
Seat 1: Marchbrook (555 in chips) 
Seat 2: CashMatteo (485 in chips) 
Seat 3: moneymama6 (460 in chips) 
Marchbrook: posts small blind 15
CashMatteo: posts big blind 30
*** HOLE CARDS ***
Dealt to CashMatteo [Kd Js]
moneymama6: folds 
Marchbrook: calls 15
CashMatteo: raises 60 to 90
Marchbrook: calls 60
*** FLOP *** [Jh Tc 8s]
Marchbrook: checks 
CashMatteo: bets 90
Marchbrook: calls 90
*** TURN *** [Jh Tc 8s] [7c]
Marchbrook: checks 
CashMatteo: checks 
*** RIVER *** [Jh Tc 8s 7c] [5c]
Marchbrook: bets 180
CashMatteo: calls 180
*** SHOW DOWN ***
Marchbrook: shows [6c Qs] (high card Queen)
CashMatteo: shows [Kd Js] (a pair of Jacks)
CashMatteo collected 720 from pot
*** SUMMARY ***
Total pot 720 | Rake 0 
Board [Jh Tc 8s 7c 5c]
Seat 1: Marchbrook (small blind) showed [6c Qs] and lost with high card Queen
Seat 2: CashMatteo (big blind) showed [Kd Js] and won (720) with a pair of Jacks
Seat 3: moneymama6 (button) folded before Flop (didn't bet)

Hand #753: 

PokerStars Hand #246290827913: Tournament #3652629947, $9.30+$0.70 CAD Hold'em No Limit - Level II (15/30) - 2023/10/01 14:21:54 ET
Table '3652629947 1' 3-max Seat #1 is the button
Seat 1: Marchbrook (195 in chips) 
Seat 2: CashMatteo (845 in chips) 
Seat 3: moneymama6 (460 in chips) 
CashMatteo: posts small blind 15
moneymama6: posts big blind 30
*** HOLE CARDS ***
Dealt to CashMatteo [4d Jh]
Marchbrook: raises 165 to 195 and is all-in
CashMatteo: folds 
moneymama6: calls 165
*** FLOP *** [8s 2s 6d]
*** TURN *** [8s 2s 6d] [2d]
*** RIVER *** [8s 2s 6d 2d] [As]
*** SHOW DOWN ***
moneymama6: shows [Tc Jc] (a pair of Deuces)
Marchbrook: shows [7d Ad] (two pair, Aces and Deuces)
Marchbrook collected 405 from pot
*** SUMMARY ***
Total pot 405 | Rake 0 
Board [8s 2s 6d 2d As]
Seat 1: Marchbrook (button) showed [7d Ad] and won (405) with two pair, Aces and Deuces
Seat 2: CashMatteo (small blind) folded before Flop
Seat 3: moneymama6 (big blind) showed [Tc Jc] and lost with a pair of Deuces

Hand #754: 

PokerStars Hand #246290834974: Tournament #3652629947, $9.30+$0.70 CAD Hold'em No Limit - Level II (15/30) - 2023/10/01 14:22:10 ET
Table '3652629947 1' 3-max Seat #2 is the button
Seat 1: Marchbrook (405 in chips) 
Seat 2: CashMatteo (830 in chips) 
Seat 3: moneymama6 (265 in chips) 
moneymama6: posts small blind 15
Marchbrook: posts big blind 30
*** HOLE CARDS ***
Dealt to CashMatteo [Qc 2d]
CashMatteo: folds 
moneymama6: calls 15
Marchbrook: checks 
*** FLOP *** [7s 4h 5c]
moneymama6: checks 
Marchbrook: bets 375 and is all-in
moneymama6: folds 
Uncalled bet (375) returned to Marchbrook
Marchbrook collected 60 from pot
*** SUMMARY ***
Total pot 60 | Rake 0 
Board [7s 4h 5c]
Seat 1: Marchbrook (big blind) collected (60)
Seat 2: CashMatteo (button) folded before Flop (didn't bet)
Seat 3: moneymama6 (small blind) folded on the Flop

Hand #755: 

PokerStars Hand #246290841694: Tournament #3652629947, $9.30+$0.70 CAD Hold'em No Limit - Level II (15/30) - 2023/10/01 14:22:25 ET
Table '3652629947 1' 3-max Seat #3 is the button
Seat 1: Marchbrook (435 in chips) 
Seat 2: CashMatteo (830 in chips) 
Seat 3: moneymama6 (235 in chips) 
Marchbrook: posts small blind 15
CashMatteo: posts big blind 30
*** HOLE CARDS ***
Dealt to CashMatteo [8s 8d]
moneymama6: folds 
Marchbrook: calls 15
CashMatteo: raises 60 to 90
Marchbrook: calls 60
*** FLOP *** [5h Js Ts]
Marchbrook: bets 345 and is all-in
CashMatteo: folds 
Uncalled bet (345) returned to Marchbrook
Marchbrook collected 180 from pot
*** SUMMARY ***
Total pot 180 | Rake 0 
Board [5h Js Ts]
Seat 1: Marchbrook (small blind) collected (180)
Seat 2: CashMatteo (big blind) folded on the Flop
Seat 3: moneymama6 (button) folded before Flop (didn't bet)

Hand #756: 

PokerStars Hand #246290849780: Tournament #3652629947, $9.30+$0.70 CAD Hold'em No Limit - Level II (15/30) - 2023/10/01 14:22:42 ET
Table '3652629947 1' 3-max Seat #1 is the button
Seat 1: Marchbrook (525 in chips) 
Seat 2: CashMatteo (740 in chips) 
Seat 3: moneymama6 (235 in chips) 
CashMatteo: posts small blind 15
moneymama6: posts big blind 30
*** HOLE CARDS ***
Dealt to CashMatteo [Qs Ks]
Marchbrook: raises 75 to 105
CashMatteo: raises 165 to 270
moneymama6: folds 
Marchbrook: calls 165
*** FLOP *** [6s 8d Ad]
CashMatteo: bets 285
Marchbrook: calls 255 and is all-in
Uncalled bet (30) returned to CashMatteo
*** TURN *** [6s 8d Ad] [5h]
*** RIVER *** [6s 8d Ad 5h] [Qd]
*** SHOW DOWN ***
CashMatteo: shows [Qs Ks] (a pair of Queens)
Marchbrook: shows [9d Ah] (a pair of Aces)
Marchbrook collected 1080 from pot
*** SUMMARY ***
Total pot 1080 | Rake 0 
Board [6s 8d Ad 5h Qd]
Seat 1: Marchbrook (button) showed [9d Ah] and won (1080) with a pair of Aces
Seat 2: CashMatteo (small blind) showed [Qs Ks] and lost with a pair of Queens
Seat 3: moneymama6 (big blind) folded before Flop

Hand #757: 

PokerStars Hand #246290860872: Tournament #3652629947, $9.30+$0.70 CAD Hold'em No Limit - Level II (15/30) - 2023/10/01 14:23:07 ET
Table '3652629947 1' 3-max Seat #2 is the button
Seat 1: Marchbrook (1080 in chips) 
Seat 2: CashMatteo (215 in chips) 
Seat 3: moneymama6 (205 in chips) 
moneymama6: posts small blind 15
Marchbrook: posts big blind 30
*** HOLE CARDS ***
Dealt to CashMatteo [2d 2s]
CashMatteo: raises 185 to 215 and is all-in
moneymama6: folds 
Marchbrook: folds 
Uncalled bet (185) returned to CashMatteo
CashMatteo collected 75 from pot
CashMatteo: doesn't show hand 
*** SUMMARY ***
Total pot 75 | Rake 0 
Seat 1: Marchbrook (big blind) folded before Flop
Seat 2: CashMatteo (button) collected (75)
Seat 3: moneymama6 (small blind) folded before Flop

Hand #758: 

PokerStars Hand #246290865727: Tournament #3652629947, $9.30+$0.70 CAD Hold'em No Limit - Level II (15/30) - 2023/10/01 14:23:18 ET
Table '3652629947 1' 3-max Seat #3 is the button
Seat 1: Marchbrook (1050 in chips) 
Seat 2: CashMatteo (260 in chips) 
Seat 3: moneymama6 (190 in chips) 
Marchbrook: posts small blind 15
CashMatteo: posts big blind 30
*** HOLE CARDS ***
Dealt to CashMatteo [6c Ks]
moneymama6: raises 160 to 190 and is all-in
Marchbrook: folds 
CashMatteo: folds 
Uncalled bet (160) returned to moneymama6
moneymama6 collected 75 from pot
moneymama6: doesn't show hand 
*** SUMMARY ***
Total pot 75 | Rake 0 
Seat 1: Marchbrook (small blind) folded before Flop
Seat 2: CashMatteo (big blind) folded before Flop
Seat 3: moneymama6 (button) collected (75)

Hand #759: 

PokerStars Hand #246290869242: Tournament #3652629947, $9.30+$0.70 CAD Hold'em No Limit - Level II (15/30) - 2023/10/01 14:23:26 ET
Table '3652629947 1' 3-max Seat #1 is the button
Seat 1: Marchbrook (1035 in chips) 
Seat 2: CashMatteo (230 in chips) 
Seat 3: moneymama6 (235 in chips) 
CashMatteo: posts small blind 15
moneymama6: posts big blind 30
*** HOLE CARDS ***
Dealt to CashMatteo [Ks 5c]
Marchbrook: folds 
CashMatteo: folds 
Uncalled bet (15) returned to moneymama6
moneymama6 collected 30 from pot
moneymama6: doesn't show hand 
*** SUMMARY ***
Total pot 30 | Rake 0 
Seat 1: Marchbrook (button) folded before Flop (didn't bet)
Seat 2: CashMatteo (small blind) folded before Flop
Seat 3: moneymama6 (big blind) collected (30)

Hand #760: 

PokerStars Hand #246290872015: Tournament #3652629947, $9.30+$0.70 CAD Hold'em No Limit - Level II (15/30) - 2023/10/01 14:23:31 ET
Table '3652629947 1' 3-max Seat #2 is the button
Seat 1: Marchbrook (1035 in chips) 
Seat 2: CashMatteo (215 in chips) 
Seat 3: moneymama6 (250 in chips) 
moneymama6: posts small blind 15
Marchbrook: posts big blind 30
*** HOLE CARDS ***
Dealt to CashMatteo [7d 9d]
CashMatteo: folds 
moneymama6: calls 15
Marchbrook: checks 
*** FLOP *** [3c 7c 9s]
moneymama6: bets 220 and is all-in
Marchbrook: folds 
Uncalled bet (220) returned to moneymama6
moneymama6 collected 60 from pot
moneymama6: doesn't show hand 
*** SUMMARY ***
Total pot 60 | Rake 0 
Board [3c 7c 9s]
Seat 1: Marchbrook (big blind) folded on the Flop
Seat 2: CashMatteo (button) folded before Flop (didn't bet)
Seat 3: moneymama6 (small blind) collected (60)

Hand #761: 

PokerStars Hand #246290878061: Tournament #3652629947, $9.30+$0.70 CAD Hold'em No Limit - Level II (15/30) - 2023/10/01 14:23:44 ET
Table '3652629947 1' 3-max Seat #3 is the button
Seat 1: Marchbrook (1005 in chips) 
Seat 2: CashMatteo (215 in chips) 
Seat 3: moneymama6 (280 in chips) 
Marchbrook: posts small blind 15
CashMatteo: posts big blind 30
*** HOLE CARDS ***
Dealt to CashMatteo [3s Ad]
moneymama6: calls 30
Marchbrook: calls 15
CashMatteo: raises 185 to 215 and is all-in
moneymama6: calls 185
Marchbrook: folds 
*** FLOP *** [7c 4h 3d]
*** TURN *** [7c 4h 3d] [8c]
*** RIVER *** [7c 4h 3d 8c] [7s]
*** SHOW DOWN ***
CashMatteo: shows [3s Ad] (two pair, Sevens and Threes)
moneymama6: shows [Td Jc] (a pair of Sevens)
CashMatteo collected 460 from pot
*** SUMMARY ***
Total pot 460 | Rake 0 
Board [7c 4h 3d 8c 7s]
Seat 1: Marchbrook (small blind) folded before Flop
Seat 2: CashMatteo (big blind) showed [3s Ad] and won (460) with two pair, Sevens and Threes
Seat 3: moneymama6 (button) showed [Td Jc] and lost with a pair of Sevens

Hand #762: 

PokerStars Hand #246290887972: Tournament #3652629947, $9.30+$0.70 CAD Hold'em No Limit - Level III (20/40) - 2023/10/01 14:24:06 ET
Table '3652629947 1' 3-max Seat #1 is the button
Seat 1: Marchbrook (975 in chips) 
Seat 2: CashMatteo (460 in chips) 
Seat 3: moneymama6 (65 in chips) 
CashMatteo: posts small blind 20
moneymama6: posts big blind 40
*** HOLE CARDS ***
Dealt to CashMatteo [5c 4c]
Marchbrook: folds 
CashMatteo: folds 
Uncalled bet (20) returned to moneymama6
moneymama6 collected 40 from pot
moneymama6: doesn't show hand 
*** SUMMARY ***
Total pot 40 | Rake 0 
Seat 1: Marchbrook (button) folded before Flop (didn't bet)
Seat 2: CashMatteo (small blind) folded before Flop
Seat 3: moneymama6 (big blind) collected (40)

Hand #763: 

PokerStars Hand #246290891583: Tournament #3652629947, $9.30+$0.70 CAD Hold'em No Limit - Level III (20/40) - 2023/10/01 14:24:14 ET
Table '3652629947 1' 3-max Seat #2 is the button
Seat 1: Marchbrook (975 in chips) 
Seat 2: CashMatteo (440 in chips) 
Seat 3: moneymama6 (85 in chips) 
moneymama6: posts small blind 20
Marchbrook: posts big blind 40
*** HOLE CARDS ***
Dealt to CashMatteo [Qs 9h]
CashMatteo: raises 80 to 120
moneymama6: calls 65 and is all-in
Marchbrook: calls 80
*** FLOP *** [Kc 2s Th]
Marchbrook: bets 40
CashMatteo: calls 40
*** TURN *** [Kc 2s Th] [6d]
Marchbrook: bets 40
CashMatteo: folds 
Uncalled bet (40) returned to Marchbrook
*** RIVER *** [Kc 2s Th 6d] [4s]
*** SHOW DOWN ***
Marchbrook: shows [3d 2c] (a pair of Deuces)
Marchbrook collected 150 from side pot
moneymama6: shows [8s Qd] (high card King)
Marchbrook collected 255 from main pot
moneymama6 finished the tournament in 3rd place
*** SUMMARY ***
Total pot 405 Main pot 255. Side pot 150. | Rake 0 
Board [Kc 2s Th 6d 4s]
Seat 1: Marchbrook (big blind) showed [3d 2c] and won (405) with a pair of Deuces
Seat 2: CashMatteo (button) folded on the Turn
Seat 3: moneymama6 (small blind) showed [8s Qd] and lost with high card King

Hand #764: 

PokerStars Hand #246290903948: Tournament #3652629947, $9.30+$0.70 CAD Hold'em No Limit - Level III (20/40) - 2023/10/01 14:24:41 ET
Table '3652629947 1' 3-max Seat #1 is the button
Seat 1: Marchbrook (1220 in chips) 
Seat 2: CashMatteo (280 in chips) 
Marchbrook: posts small blind 20
CashMatteo: posts big blind 40
*** HOLE CARDS ***
Dealt to CashMatteo [Ad 7c]
Marchbrook: calls 20
CashMatteo: raises 240 to 280 and is all-in
Marchbrook: folds 
Uncalled bet (240) returned to CashMatteo
CashMatteo collected 80 from pot
CashMatteo: doesn't show hand 
*** SUMMARY ***
Total pot 80 | Rake 0 
Seat 1: Marchbrook (button) (small blind) folded before Flop
Seat 2: CashMatteo (big blind) collected (80)

Hand #765: 

PokerStars Hand #246290909365: Tournament #3652629947, $9.30+$0.70 CAD Hold'em No Limit - Level III (20/40) - 2023/10/01 14:24:53 ET
Table '3652629947 1' 3-max Seat #2 is the button
Seat 1: Marchbrook (1180 in chips) 
Seat 2: CashMatteo (320 in chips) 
CashMatteo: posts small blind 20
Marchbrook: posts big blind 40
*** HOLE CARDS ***
Dealt to CashMatteo [4c 6s]
CashMatteo: folds 
Uncalled bet (20) returned to Marchbrook
Marchbrook collected 40 from pot
*** SUMMARY ***
Total pot 40 | Rake 0 
Seat 1: Marchbrook (big blind) collected (40)
Seat 2: CashMatteo (button) (small blind) folded before Flop

Hand #766: 

PokerStars Hand #246290911604: Tournament #3652629947, $9.30+$0.70 CAD Hold'em No Limit - Level III (20/40) - 2023/10/01 14:24:58 ET
Table '3652629947 1' 3-max Seat #1 is the button
Seat 1: Marchbrook (1200 in chips) 
Seat 2: CashMatteo (300 in chips) 
Marchbrook: posts small blind 20
CashMatteo: posts big blind 40
*** HOLE CARDS ***
Dealt to CashMatteo [7d Ad]
Marchbrook: calls 20
CashMatteo: raises 260 to 300 and is all-in
Marchbrook: folds 
Uncalled bet (260) returned to CashMatteo
CashMatteo collected 80 from pot
CashMatteo: doesn't show hand 
*** SUMMARY ***
Total pot 80 | Rake 0 
Seat 1: Marchbrook (button) (small blind) folded before Flop
Seat 2: CashMatteo (big blind) collected (80)

Hand #767: 

PokerStars Hand #246290914815: Tournament #3652629947, $9.30+$0.70 CAD Hold'em No Limit - Level III (20/40) - 2023/10/01 14:25:05 ET
Table '3652629947 1' 3-max Seat #2 is the button
Seat 1: Marchbrook (1160 in chips) 
Seat 2: CashMatteo (340 in chips) 
CashMatteo: posts small blind 20
Marchbrook: posts big blind 40
*** HOLE CARDS ***
Dealt to CashMatteo [2d 3c]
CashMatteo: folds 
Uncalled bet (20) returned to Marchbrook
Marchbrook collected 40 from pot
*** SUMMARY ***
Total pot 40 | Rake 0 
Seat 1: Marchbrook (big blind) collected (40)
Seat 2: CashMatteo (button) (small blind) folded before Flop

Hand #768: 

PokerStars Hand #246290916847: Tournament #3652629947, $9.30+$0.70 CAD Hold'em No Limit - Level III (20/40) - 2023/10/01 14:25:09 ET
Table '3652629947 1' 3-max Seat #1 is the button
Seat 1: Marchbrook (1180 in chips) 
Seat 2: CashMatteo (320 in chips) 
Marchbrook: posts small blind 20
CashMatteo: posts big blind 40
*** HOLE CARDS ***
Dealt to CashMatteo [6c 6s]
Marchbrook: calls 20
CashMatteo: raises 280 to 320 and is all-in
Marchbrook: folds 
Uncalled bet (280) returned to CashMatteo
CashMatteo collected 80 from pot
*** SUMMARY ***
Total pot 80 | Rake 0 
Seat 1: Marchbrook (button) (small blind) folded before Flop
Seat 2: CashMatteo (big blind) collected (80)

Hand #769: 

PokerStars Hand #246290920816: Tournament #3652629947, $9.30+$0.70 CAD Hold'em No Limit - Level III (20/40) - 2023/10/01 14:25:18 ET
Table '3652629947 1' 3-max Seat #2 is the button
Seat 1: Marchbrook (1140 in chips) 
Seat 2: CashMatteo (360 in chips) 
CashMatteo: posts small blind 20
Marchbrook: posts big blind 40
*** HOLE CARDS ***
Dealt to CashMatteo [Qd Jd]
CashMatteo: raises 320 to 360 and is all-in
Marchbrook: folds 
Uncalled bet (320) returned to CashMatteo
CashMatteo collected 80 from pot
CashMatteo: doesn't show hand 
*** SUMMARY ***
Total pot 80 | Rake 0 
Seat 1: Marchbrook (big blind) folded before Flop
Seat 2: CashMatteo (button) (small blind) collected (80)

Hand #770: 

PokerStars Hand #246290924705: Tournament #3652629947, $9.30+$0.70 CAD Hold'em No Limit - Level III (20/40) - 2023/10/01 14:25:27 ET
Table '3652629947 1' 3-max Seat #1 is the button
Seat 1: Marchbrook (1100 in chips) 
Seat 2: CashMatteo (400 in chips) 
Marchbrook: posts small blind 20
CashMatteo: posts big blind 40
*** HOLE CARDS ***
Dealt to CashMatteo [4s Ts]
Marchbrook: raises 80 to 120
CashMatteo: folds 
Uncalled bet (80) returned to Marchbrook
Marchbrook collected 80 from pot
*** SUMMARY ***
Total pot 80 | Rake 0 
Seat 1: Marchbrook (button) (small blind) collected (80)
Seat 2: CashMatteo (big blind) folded before Flop

Hand #771: 

PokerStars Hand #246290927563: Tournament #3652629947, $9.30+$0.70 CAD Hold'em No Limit - Level III (20/40) - 2023/10/01 14:25:33 ET
Table '3652629947 1' 3-max Seat #2 is the button
Seat 1: Marchbrook (1140 in chips) 
Seat 2: CashMatteo (360 in chips) 
CashMatteo: posts small blind 20
Marchbrook: posts big blind 40
*** HOLE CARDS ***
Dealt to CashMatteo [5s Qs]
CashMatteo: raises 40 to 80
Marchbrook: raises 1060 to 1140 and is all-in
CashMatteo: folds 
Uncalled bet (1060) returned to Marchbrook
Marchbrook collected 160 from pot
*** SUMMARY ***
Total pot 160 | Rake 0 
Seat 1: Marchbrook (big blind) collected (160)
Seat 2: CashMatteo (button) (small blind) folded before Flop

Hand #772: 

PokerStars Hand #246290932643: Tournament #3652629947, $9.30+$0.70 CAD Hold'em No Limit - Level III (20/40) - 2023/10/01 14:25:44 ET
Table '3652629947 1' 3-max Seat #1 is the button
Seat 1: Marchbrook (1220 in chips) 
Seat 2: CashMatteo (280 in chips) 
Marchbrook: posts small blind 20
CashMatteo: posts big blind 40
*** HOLE CARDS ***
Dealt to CashMatteo [7s Td]
Marchbrook: raises 1180 to 1220 and is all-in
CashMatteo: folds 
Uncalled bet (1180) returned to Marchbrook
Marchbrook collected 80 from pot
*** SUMMARY ***
Total pot 80 | Rake 0 
Seat 1: Marchbrook (button) (small blind) collected (80)
Seat 2: CashMatteo (big blind) folded before Flop

Hand #773: 

PokerStars Hand #246290935926: Tournament #3652629947, $9.30+$0.70 CAD Hold'em No Limit - Level III (20/40) - 2023/10/01 14:25:51 ET
Table '3652629947 1' 3-max Seat #2 is the button
Seat 1: Marchbrook (1260 in chips) 
Seat 2: CashMatteo (240 in chips) 
CashMatteo: posts small blind 20
Marchbrook: posts big blind 40
*** HOLE CARDS ***
Dealt to CashMatteo [6s Tc]
CashMatteo: folds 
Uncalled bet (20) returned to Marchbrook
Marchbrook collected 40 from pot
*** SUMMARY ***
Total pot 40 | Rake 0 
Seat 1: Marchbrook (big blind) collected (40)
Seat 2: CashMatteo (button) (small blind) folded before Flop

Hand #774: 

PokerStars Hand #246290937789: Tournament #3652629947, $9.30+$0.70 CAD Hold'em No Limit - Level III (20/40) - 2023/10/01 14:25:56 ET
Table '3652629947 1' 3-max Seat #1 is the button
Seat 1: Marchbrook (1280 in chips) 
Seat 2: CashMatteo (220 in chips) 
Marchbrook: posts small blind 20
CashMatteo: posts big blind 40
*** HOLE CARDS ***
Dealt to CashMatteo [6d Tc]
Marchbrook: raises 1240 to 1280 and is all-in
CashMatteo: folds 
Uncalled bet (1240) returned to Marchbrook
Marchbrook collected 80 from pot
*** SUMMARY ***
Total pot 80 | Rake 0 
Seat 1: Marchbrook (button) (small blind) collected (80)
Seat 2: CashMatteo (big blind) folded before Flop

Hand #775: 

PokerStars Hand #246290941351: Tournament #3652629947, $9.30+$0.70 CAD Hold'em No Limit - Level III (20/40) - 2023/10/01 14:26:03 ET
Table '3652629947 1' 3-max Seat #2 is the button
Seat 1: Marchbrook (1320 in chips) 
Seat 2: CashMatteo (180 in chips) 
CashMatteo: posts small blind 20
Marchbrook: posts big blind 40
*** HOLE CARDS ***
Dealt to CashMatteo [6c Js]
CashMatteo: raises 140 to 180 and is all-in
Marchbrook: calls 140
*** FLOP *** [Ad 7h 2c]
*** TURN *** [Ad 7h 2c] [Th]
*** RIVER *** [Ad 7h 2c Th] [4c]
*** SHOW DOWN ***
Marchbrook: shows [Kh 2d] (a pair of Deuces)
CashMatteo: shows [6c Js] (high card Ace)
Marchbrook collected 360 from pot
CashMatteo finished the tournament in 2nd place
Marchbrook wins the tournament and receives $30.00 - congratulations!
*** SUMMARY ***
Total pot 360 | Rake 0 
Board [Ad 7h 2c Th 4c]
Seat 1: Marchbrook (big blind) showed [Kh 2d] and won (360) with a pair of Deuces
Seat 2: CashMatteo (button) (small blind) showed [6c Js] and lost with high card Ace

Hand #776: 

PokerStars Hand #246295102990: Tournament #3649979404, $0.94+$0.06 CAD Hold'em No Limit - Level X (150/300) - 2023/10/01 16:39:26 ET
Table '3649979404 6' 8-max Seat #3 is the button
Seat 1: Kwanku (2395 in chips) 
Seat 2: IQxYu (6393 in chips) 
Seat 3: 9Walla (3795 in chips) 
Seat 4: sexxy984 (3180 in chips) 
Seat 5: CashMatteo (3000 in chips) 
Seat 7: leaffan6 (7005 in chips) 
Seat 8: SteveStudAA22 (6335 in chips) 
Kwanku: posts the ante 75
IQxYu: posts the ante 75
9Walla: posts the ante 75
sexxy984: posts the ante 75
CashMatteo: posts the ante 75
leaffan6: posts the ante 75
SteveStudAA22: posts the ante 75
sexxy984: posts small blind 150
CashMatteo: posts big blind 300
*** HOLE CARDS ***
Dealt to CashMatteo [Kh 3h]
leaffan6: folds 
SteveStudAA22: folds 
Kwanku: raises 2020 to 2320 and is all-in
IQxYu: folds 
9Walla: folds 
sexxy984: folds 
CashMatteo: folds 
Uncalled bet (2020) returned to Kwanku
Kwanku collected 1275 from pot
Kwanku: doesn't show hand 
*** SUMMARY ***
Total pot 1275 | Rake 0 
Seat 1: Kwanku collected (1275)
Seat 2: IQxYu folded before Flop (didn't bet)
Seat 3: 9Walla (button) folded before Flop (didn't bet)
Seat 4: sexxy984 (small blind) folded before Flop
Seat 5: CashMatteo (big blind) folded before Flop
Seat 7: leaffan6 folded before Flop (didn't bet)
Seat 8: SteveStudAA22 folded before Flop (didn't bet)

Hand #777: 

PokerStars Hand #246295110528: Tournament #3649979404, $0.94+$0.06 CAD Hold'em No Limit - Level X (150/300) - 2023/10/01 16:39:43 ET
Table '3649979404 6' 8-max Seat #4 is the button
Seat 1: Kwanku (3295 in chips) 
Seat 2: IQxYu (6318 in chips) 
Seat 3: 9Walla (3720 in chips) 
Seat 4: sexxy984 (2955 in chips) 
Seat 5: CashMatteo (2625 in chips) 
Seat 7: leaffan6 (6930 in chips) 
Seat 8: SteveStudAA22 (6260 in chips) 
Kwanku: posts the ante 75
IQxYu: posts the ante 75
9Walla: posts the ante 75
sexxy984: posts the ante 75
CashMatteo: posts the ante 75
leaffan6: posts the ante 75
SteveStudAA22: posts the ante 75
CashMatteo: posts small blind 150
leaffan6: posts big blind 300
*** HOLE CARDS ***
Dealt to CashMatteo [3d 8d]
SteveStudAA22: folds 
Kwanku: folds 
IQxYu: folds 
9Walla: folds 
sexxy984: folds 
CashMatteo: folds 
Uncalled bet (150) returned to leaffan6
leaffan6 collected 825 from pot
*** SUMMARY ***
Total pot 825 | Rake 0 
Seat 1: Kwanku folded before Flop (didn't bet)
Seat 2: IQxYu folded before Flop (didn't bet)
Seat 3: 9Walla folded before Flop (didn't bet)
Seat 4: sexxy984 (button) folded before Flop (didn't bet)
Seat 5: CashMatteo (small blind) folded before Flop
Seat 7: leaffan6 (big blind) collected (825)
Seat 8: SteveStudAA22 folded before Flop (didn't bet)

Hand #778: 

PokerStars Hand #246295114351: Tournament #3649979404, $0.94+$0.06 CAD Hold'em No Limit - Level X (150/300) - 2023/10/01 16:39:51 ET
Table '3649979404 6' 8-max Seat #5 is the button
Seat 1: Kwanku (3220 in chips) 
Seat 2: IQxYu (6243 in chips) 
Seat 3: 9Walla (3645 in chips) 
Seat 4: sexxy984 (2880 in chips) 
Seat 5: CashMatteo (2400 in chips) 
Seat 7: leaffan6 (7530 in chips) 
Seat 8: SteveStudAA22 (6185 in chips) 
Kwanku: posts the ante 75
IQxYu: posts the ante 75
9Walla: posts the ante 75
sexxy984: posts the ante 75
CashMatteo: posts the ante 75
leaffan6: posts the ante 75
SteveStudAA22: posts the ante 75
leaffan6: posts small blind 150
SteveStudAA22: posts big blind 300
*** HOLE CARDS ***
Dealt to CashMatteo [2d Td]
Kwanku: raises 360 to 660
IQxYu: folds 
9Walla: calls 660
sexxy984: folds 
CashMatteo: folds 
leaffan6: calls 510
SteveStudAA22: folds 
*** FLOP *** [6s 9c 6d]
leaffan6: bets 6795 and is all-in
Kwanku: calls 2485 and is all-in
9Walla: folds 
Uncalled bet (4310) returned to leaffan6
*** TURN *** [6s 9c 6d] [7c]
*** RIVER *** [6s 9c 6d 7c] [Kc]
*** SHOW DOWN ***
leaffan6: shows [3s 9s] (two pair, Nines and Sixes)
Kwanku: shows [Jh Ah] (a pair of Sixes)
leaffan6 collected 7775 from pot
Kwanku finished the tournament in 38th place
*** SUMMARY ***
Total pot 7775 | Rake 0 
Board [6s 9c 6d 7c Kc]
Seat 1: Kwanku showed [Jh Ah] and lost with a pair of Sixes
Seat 2: IQxYu folded before Flop (didn't bet)
Seat 3: 9Walla folded on the Flop
Seat 4: sexxy984 folded before Flop (didn't bet)
Seat 5: CashMatteo (button) folded before Flop (didn't bet)
Seat 7: leaffan6 (small blind) showed [3s 9s] and won (7775) with two pair, Nines and Sixes
Seat 8: SteveStudAA22 (big blind) folded before Flop

Hand #779: 

PokerStars Hand #246295130354: Tournament #3649979404, $0.94+$0.06 CAD Hold'em No Limit - Level X (150/300) - 2023/10/01 16:40:25 ET
Table '3649979404 6' 8-max Seat #7 is the button
Seat 2: IQxYu (6168 in chips) 
Seat 3: 9Walla (2910 in chips) 
Seat 4: sexxy984 (2805 in chips) 
Seat 5: CashMatteo (2325 in chips) 
Seat 7: leaffan6 (12085 in chips) 
Seat 8: SteveStudAA22 (5810 in chips) 
IQxYu: posts the ante 75
9Walla: posts the ante 75
sexxy984: posts the ante 75
CashMatteo: posts the ante 75
leaffan6: posts the ante 75
SteveStudAA22: posts the ante 75
SteveStudAA22: posts small blind 150
IQxYu: posts big blind 300
*** HOLE CARDS ***
Dealt to CashMatteo [3c 7s]
9Walla: raises 300 to 600
sexxy984: raises 2130 to 2730 and is all-in
CashMatteo: folds 
leaffan6: calls 2730
SteveStudAA22: folds 
IQxYu: folds 
9Walla: folds 
*** FLOP *** [4d 8c As]
*** TURN *** [4d 8c As] [8s]
*** RIVER *** [4d 8c As 8s] [2s]
*** SHOW DOWN ***
sexxy984: shows [Jd Js] (two pair, Jacks and Eights)
leaffan6: shows [Qd Td] (a pair of Eights)
sexxy984 collected 6960 from pot
*** SUMMARY ***
Total pot 6960 | Rake 0 
Board [4d 8c As 8s 2s]
Seat 2: IQxYu (big blind) folded before Flop
Seat 3: 9Walla folded before Flop
Seat 4: sexxy984 showed [Jd Js] and won (6960) with two pair, Jacks and Eights
Seat 5: CashMatteo folded before Flop (didn't bet)
Seat 7: leaffan6 (button) showed [Qd Td] and lost with a pair of Eights
Seat 8: SteveStudAA22 (small blind) folded before Flop

Hand #780: 

PokerStars Hand #246295143335: Tournament #3649979404, $0.94+$0.06 CAD Hold'em No Limit - Level X (150/300) - 2023/10/01 16:40:53 ET
Table '3649979404 6' 8-max Seat #8 is the button
Seat 2: IQxYu (5793 in chips) 
Seat 3: 9Walla (2235 in chips) 
Seat 4: sexxy984 (6960 in chips) 
Seat 5: CashMatteo (2250 in chips) 
Seat 6: edmilan93 (3000 in chips) 
Seat 7: leaffan6 (9280 in chips) 
Seat 8: SteveStudAA22 (5585 in chips) 
IQxYu: posts the ante 75
9Walla: posts the ante 75
sexxy984: posts the ante 75
CashMatteo: posts the ante 75
edmilan93: posts the ante 75
leaffan6: posts the ante 75
SteveStudAA22: posts the ante 75
IQxYu: posts small blind 150
9Walla: posts big blind 300
*** HOLE CARDS ***
Dealt to CashMatteo [8h Ac]
sexxy984: folds 
CashMatteo: raises 1875 to 2175 and is all-in
edmilan93: folds 
leaffan6: folds 
SteveStudAA22: folds 
IQxYu: folds 
9Walla: folds 
Uncalled bet (1875) returned to CashMatteo
CashMatteo collected 1275 from pot
*** SUMMARY ***
Total pot 1275 | Rake 0 
Seat 2: IQxYu (small blind) folded before Flop
Seat 3: 9Walla (big blind) folded before Flop
Seat 4: sexxy984 folded before Flop (didn't bet)
Seat 5: CashMatteo collected (1275)
Seat 6: edmilan93 folded before Flop (didn't bet)
Seat 7: leaffan6 folded before Flop (didn't bet)
Seat 8: SteveStudAA22 (button) folded before Flop (didn't bet)

Hand #781: 

PokerStars Hand #246295156573: Tournament #3649979404, $0.94+$0.06 CAD Hold'em No Limit - Level XI (200/400) - 2023/10/01 16:41:21 ET
Table '3649979404 6' 8-max Seat #2 is the button
Seat 2: IQxYu (5568 in chips) 
Seat 3: 9Walla (1860 in chips) 
Seat 4: sexxy984 (6885 in chips) 
Seat 5: CashMatteo (3150 in chips) 
Seat 6: edmilan93 (2925 in chips) 
Seat 7: leaffan6 (9205 in chips) 
Seat 8: SteveStudAA22 (5510 in chips) 
IQxYu: posts the ante 100
9Walla: posts the ante 100
sexxy984: posts the ante 100
CashMatteo: posts the ante 100
edmilan93: posts the ante 100
leaffan6: posts the ante 100
SteveStudAA22: posts the ante 100
9Walla: posts small blind 200
sexxy984: posts big blind 400
*** HOLE CARDS ***
Dealt to CashMatteo [6s Ks]
CashMatteo: raises 2650 to 3050 and is all-in
edmilan93: folds 
leaffan6: folds 
SteveStudAA22: folds 
IQxYu: folds 
9Walla: folds 
sexxy984 has timed out
sexxy984: folds 
sexxy984 is sitting out
Uncalled bet (2650) returned to CashMatteo
CashMatteo collected 1700 from pot
CashMatteo: doesn't show hand 
*** SUMMARY ***
Total pot 1700 | Rake 0 
Seat 2: IQxYu (button) folded before Flop (didn't bet)
Seat 3: 9Walla (small blind) folded before Flop
Seat 4: sexxy984 (big blind) folded before Flop
Seat 5: CashMatteo collected (1700)
Seat 6: edmilan93 folded before Flop (didn't bet)
Seat 7: leaffan6 folded before Flop (didn't bet)
Seat 8: SteveStudAA22 folded before Flop (didn't bet)

Hand #782: 

PokerStars Hand #246295176936: Tournament #3649979404, $0.94+$0.06 CAD Hold'em No Limit - Level XI (200/400) - 2023/10/01 16:42:04 ET
Table '3649979404 6' 8-max Seat #3 is the button
Seat 2: IQxYu (5468 in chips) 
Seat 3: 9Walla (1560 in chips) 
Seat 4: sexxy984 (6385 in chips) is sitting out
Seat 5: CashMatteo (4350 in chips) 
Seat 6: edmilan93 (2825 in chips) 
Seat 7: leaffan6 (9105 in chips) 
Seat 8: SteveStudAA22 (5410 in chips) 
IQxYu: posts the ante 100
9Walla: posts the ante 100
sexxy984: posts the ante 100
CashMatteo: posts the ante 100
edmilan93: posts the ante 100
leaffan6: posts the ante 100
SteveStudAA22: posts the ante 100
sexxy984: posts small blind 200
CashMatteo: posts big blind 400
*** HOLE CARDS ***
Dealt to CashMatteo [3s 8c]
edmilan93: folds 
leaffan6: calls 400
SteveStudAA22: folds 
IQxYu: raises 4968 to 5368 and is all-in
9Walla: calls 1460 and is all-in
sexxy984: folds 
CashMatteo: folds 
leaffan6: calls 4968
*** FLOP *** [Ks Qc 8d]
*** TURN *** [Ks Qc 8d] [9h]
*** RIVER *** [Ks Qc 8d 9h] [4h]
*** SHOW DOWN ***
leaffan6: shows [4s As] (a pair of Fours)
IQxYu: shows [7s Ac] (high card Ace)
leaffan6 collected 7816 from side pot
9Walla: shows [Ah 8h] (a pair of Eights)
9Walla collected 5680 from main pot
IQxYu finished the tournament in 34th place
sexxy984 has returned
*** SUMMARY ***
Total pot 13496 Main pot 5680. Side pot 7816. | Rake 0 
Board [Ks Qc 8d 9h 4h]
Seat 2: IQxYu showed [7s Ac] and lost with high card Ace
Seat 3: 9Walla (button) showed [Ah 8h] and won (5680) with a pair of Eights
Seat 4: sexxy984 (small blind) folded before Flop
Seat 5: CashMatteo (big blind) folded before Flop
Seat 6: edmilan93 folded before Flop (didn't bet)
Seat 7: leaffan6 showed [4s As] and won (7816) with a pair of Fours
Seat 8: SteveStudAA22 folded before Flop (didn't bet)

Hand #783: 

PokerStars Hand #246295192379: Tournament #3649979404, $0.94+$0.06 CAD Hold'em No Limit - Level XI (200/400) - 2023/10/01 16:42:38 ET
Table '3649979404 6' 8-max Seat #4 is the button
Seat 3: 9Walla (5680 in chips) 
Seat 4: sexxy984 (6085 in chips) 
Seat 5: CashMatteo (3850 in chips) 
Seat 6: edmilan93 (2725 in chips) 
Seat 7: leaffan6 (11453 in chips) 
Seat 8: SteveStudAA22 (5310 in chips) 
9Walla: posts the ante 100
sexxy984: posts the ante 100
CashMatteo: posts the ante 100
edmilan93: posts the ante 100
leaffan6: posts the ante 100
SteveStudAA22: posts the ante 100
CashMatteo: posts small blind 200
edmilan93: posts big blind 400
*** HOLE CARDS ***
Dealt to CashMatteo [2c 7c]
leaffan6: folds 
SteveStudAA22: folds 
9Walla: folds 
sexxy984: folds 
CashMatteo: folds 
Uncalled bet (200) returned to edmilan93
edmilan93 collected 1000 from pot
*** SUMMARY ***
Total pot 1000 | Rake 0 
Seat 3: 9Walla folded before Flop (didn't bet)
Seat 4: sexxy984 (button) folded before Flop (didn't bet)
Seat 5: CashMatteo (small blind) folded before Flop
Seat 6: edmilan93 (big blind) collected (1000)
Seat 7: leaffan6 folded before Flop (didn't bet)
Seat 8: SteveStudAA22 folded before Flop (didn't bet)

Hand #784: 

PokerStars Hand #246295199664: Tournament #3649979404, $0.94+$0.06 CAD Hold'em No Limit - Level XI (200/400) - 2023/10/01 16:42:53 ET
Table '3649979404 6' 8-max Seat #5 is the button
Seat 3: 9Walla (5580 in chips) 
Seat 4: sexxy984 (5985 in chips) 
Seat 5: CashMatteo (3550 in chips) 
Seat 6: edmilan93 (3425 in chips) 
Seat 7: leaffan6 (11353 in chips) 
Seat 8: SteveStudAA22 (5210 in chips) 
9Walla: posts the ante 100
sexxy984: posts the ante 100
CashMatteo: posts the ante 100
edmilan93: posts the ante 100
leaffan6: posts the ante 100
SteveStudAA22: posts the ante 100
edmilan93: posts small blind 200
leaffan6: posts big blind 400
*** HOLE CARDS ***
Dealt to CashMatteo [6h 5s]
SteveStudAA22: folds 
crazyivan20 is disconnected 
9Walla: raises 400 to 800
sexxy984: folds 
CashMatteo: folds 
edmilan93: folds 
leaffan6: calls 400
*** FLOP *** [6s 3c Jd]
leaffan6: checks 
9Walla: bets 800
leaffan6: calls 800
*** TURN *** [6s 3c Jd] [4s]
leaffan6: checks 
9Walla: bets 1200
leaffan6: calls 1200
*** RIVER *** [6s 3c Jd 4s] [8c]
leaffan6: checks 
9Walla: bets 2680 and is all-in
leaffan6: folds 
Uncalled bet (2680) returned to 9Walla
9Walla collected 6400 from pot
*** SUMMARY ***
Total pot 6400 | Rake 0 
Board [6s 3c Jd 4s 8c]
Seat 3: 9Walla collected (6400)
Seat 4: sexxy984 folded before Flop (didn't bet)
Seat 5: CashMatteo (button) folded before Flop (didn't bet)
Seat 6: edmilan93 (small blind) folded before Flop
Seat 7: leaffan6 (big blind) folded on the River
Seat 8: SteveStudAA22 folded before Flop (didn't bet)

Hand #785: 

PokerStars Hand #246295240927: Tournament #3649979404, $0.94+$0.06 CAD Hold'em No Limit - Level XII (250/500) - 2023/10/01 16:44:21 ET
Table '3649979404 8' 8-max Seat #1 is the button
Seat 1: FloraForage (1452 in chips) 
Seat 2: Dracoserpent (3550 in chips) 
Seat 4: pokermanmd (21871 in chips) 
Seat 5: Dtoal#1 (3849 in chips) 
Seat 6: ILUVCH1PS (2125 in chips) 
Seat 7: CashMatteo (3450 in chips) 
Seat 8: Maui_Riley (2275 in chips) 
FloraForage: posts the ante 125
Dracoserpent: posts the ante 125
pokermanmd: posts the ante 125
Dtoal#1: posts the ante 125
ILUVCH1PS: posts the ante 125
CashMatteo: posts the ante 125
Maui_Riley: posts the ante 125
Dracoserpent: posts small blind 250
pokermanmd: posts big blind 500
*** HOLE CARDS ***
Dealt to CashMatteo [5h 4h]
Dtoal#1: folds 
ILUVCH1PS: folds 
CashMatteo: folds 
Maui_Riley: folds 
FloraForage: folds 
Dracoserpent: folds 
Uncalled bet (250) returned to pokermanmd
pokermanmd collected 1375 from pot
pokermanmd: doesn't show hand 
*** SUMMARY ***
Total pot 1375 | Rake 0 
Seat 1: FloraForage (button) folded before Flop (didn't bet)
Seat 2: Dracoserpent (small blind) folded before Flop
Seat 4: pokermanmd (big blind) collected (1375)
Seat 5: Dtoal#1 folded before Flop (didn't bet)
Seat 6: ILUVCH1PS folded before Flop (didn't bet)
Seat 7: CashMatteo folded before Flop (didn't bet)
Seat 8: Maui_Riley folded before Flop (didn't bet)

Hand #786: 

PokerStars Hand #246295250080: Tournament #3649979404, $0.94+$0.06 CAD Hold'em No Limit - Level XII (250/500) - 2023/10/01 16:44:41 ET
Table '3649979404 8' 8-max Seat #2 is the button
Seat 1: FloraForage (1327 in chips) 
Seat 2: Dracoserpent (3175 in chips) 
Seat 4: pokermanmd (22871 in chips) 
Seat 5: Dtoal#1 (3724 in chips) 
Seat 6: ILUVCH1PS (2000 in chips) 
Seat 7: CashMatteo (3325 in chips) 
Seat 8: Maui_Riley (2150 in chips) 
FloraForage: posts the ante 125
Dracoserpent: posts the ante 125
pokermanmd: posts the ante 125
Dtoal#1: posts the ante 125
ILUVCH1PS: posts the ante 125
CashMatteo: posts the ante 125
Maui_Riley: posts the ante 125
pokermanmd: posts small blind 250
Dtoal#1: posts big blind 500
*** HOLE CARDS ***
Dealt to CashMatteo [8h 9c]
ILUVCH1PS: raises 1375 to 1875 and is all-in
CashMatteo: folds 
Maui_Riley: folds 
FloraForage: calls 1202 and is all-in
Dracoserpent: folds 
pokermanmd: folds 
Dtoal#1: folds 
Uncalled bet (673) returned to ILUVCH1PS
*** FLOP *** [6h 5c Ad]
*** TURN *** [6h 5c Ad] [Qd]
*** RIVER *** [6h 5c Ad Qd] [7c]
*** SHOW DOWN ***
ILUVCH1PS: shows [7s Ah] (two pair, Aces and Sevens)
FloraForage: shows [Kd Jh] (high card Ace)
ILUVCH1PS collected 4029 from pot
FloraForage finished the tournament in 26th place
*** SUMMARY ***
Total pot 4029 | Rake 0 
Board [6h 5c Ad Qd 7c]
Seat 1: FloraForage showed [Kd Jh] and lost with high card Ace
Seat 2: Dracoserpent (button) folded before Flop (didn't bet)
Seat 4: pokermanmd (small blind) folded before Flop
Seat 5: Dtoal#1 (big blind) folded before Flop
Seat 6: ILUVCH1PS showed [7s Ah] and won (4029) with two pair, Aces and Sevens
Seat 7: CashMatteo folded before Flop (didn't bet)
Seat 8: Maui_Riley folded before Flop (didn't bet)

Hand #787: 

PokerStars Hand #246295262722: Tournament #3649979404, $0.94+$0.06 CAD Hold'em No Limit - Level XII (250/500) - 2023/10/01 16:45:08 ET
Table '3649979404 8' 8-max Seat #4 is the button
Seat 2: Dracoserpent (3050 in chips) 
Seat 4: pokermanmd (22496 in chips) 
Seat 5: Dtoal#1 (3099 in chips) 
Seat 6: ILUVCH1PS (4702 in chips) 
Seat 7: CashMatteo (3200 in chips) 
Seat 8: Maui_Riley (2025 in chips) 
Dracoserpent: posts the ante 125
pokermanmd: posts the ante 125
Dtoal#1: posts the ante 125
ILUVCH1PS: posts the ante 125
CashMatteo: posts the ante 125
Maui_Riley: posts the ante 125
Dtoal#1: posts small blind 250
ILUVCH1PS: posts big blind 500
*** HOLE CARDS ***
Dealt to CashMatteo [Ks Js]
CashMatteo: raises 2575 to 3075 and is all-in
Maui_Riley: folds 
Dracoserpent: folds 
pokermanmd: folds 
Dtoal#1: folds 
ILUVCH1PS: calls 2575
*** FLOP *** [5c Ad 9s]
*** TURN *** [5c Ad 9s] [7h]
*** RIVER *** [5c Ad 9s 7h] [2d]
*** SHOW DOWN ***
ILUVCH1PS: shows [Jc Kc] (high card Ace)
CashMatteo: shows [Ks Js] (high card Ace)
ILUVCH1PS collected 3575 from pot
CashMatteo collected 3575 from pot
*** SUMMARY ***
Total pot 7150 | Rake 0 
Board [5c Ad 9s 7h 2d]
Seat 2: Dracoserpent folded before Flop (didn't bet)
Seat 4: pokermanmd (button) folded before Flop (didn't bet)
Seat 5: Dtoal#1 (small blind) folded before Flop
Seat 6: ILUVCH1PS (big blind) showed [Jc Kc] and won (3575) with high card Ace
Seat 7: CashMatteo showed [Ks Js] and won (3575) with high card Ace
Seat 8: Maui_Riley folded before Flop (didn't bet)

Hand #788: 

PokerStars Hand #246295274426: Tournament #3649979404, $0.94+$0.06 CAD Hold'em No Limit - Level XII (250/500) - 2023/10/01 16:45:32 ET
Table '3649979404 8' 8-max Seat #5 is the button
Seat 2: Dracoserpent (2925 in chips) 
Seat 4: pokermanmd (22371 in chips) 
Seat 5: Dtoal#1 (2724 in chips) 
Seat 6: ILUVCH1PS (5077 in chips) 
Seat 7: CashMatteo (3575 in chips) 
Seat 8: Maui_Riley (1900 in chips) 
Dracoserpent: posts the ante 125
pokermanmd: posts the ante 125
Dtoal#1: posts the ante 125
ILUVCH1PS: posts the ante 125
CashMatteo: posts the ante 125
Maui_Riley: posts the ante 125
ILUVCH1PS: posts small blind 250
CashMatteo: posts big blind 500
*** HOLE CARDS ***
Dealt to CashMatteo [9h 3s]
Maui_Riley: calls 500
Dracoserpent: folds 
pokermanmd: calls 500
Dtoal#1: folds 
ILUVCH1PS: calls 250
CashMatteo: checks 
*** FLOP *** [Tc Ad 6d]
ILUVCH1PS: checks 
CashMatteo: checks 
Maui_Riley: bets 1275 and is all-in
pokermanmd: raises 1275 to 2550
ILUVCH1PS: folds 
CashMatteo: folds 
Uncalled bet (1275) returned to pokermanmd
*** TURN *** [Tc Ad 6d] [2s]
*** RIVER *** [Tc Ad 6d 2s] [3d]
*** SHOW DOWN ***
Maui_Riley: shows [As 2h] (two pair, Aces and Deuces)
pokermanmd: shows [5s Ac] (a pair of Aces)
Maui_Riley collected 5300 from pot
*** SUMMARY ***
Total pot 5300 | Rake 0 
Board [Tc Ad 6d 2s 3d]
Seat 2: Dracoserpent folded before Flop (didn't bet)
Seat 4: pokermanmd showed [5s Ac] and lost with a pair of Aces
Seat 5: Dtoal#1 (button) folded before Flop (didn't bet)
Seat 6: ILUVCH1PS (small blind) folded on the Flop
Seat 7: CashMatteo (big blind) folded on the Flop
Seat 8: Maui_Riley showed [As 2h] and won (5300) with two pair, Aces and Deuces

Hand #789: 

PokerStars Hand #246295297809: Tournament #3649979404, $0.94+$0.06 CAD Hold'em No Limit - Level XII (250/500) - 2023/10/01 16:46:21 ET
Table '3649979404 8' 8-max Seat #6 is the button
Seat 2: Dracoserpent (2800 in chips) 
Seat 4: pokermanmd (20471 in chips) 
Seat 5: Dtoal#1 (2599 in chips) 
Seat 6: ILUVCH1PS (4452 in chips) 
Seat 7: CashMatteo (2950 in chips) 
Seat 8: Maui_Riley (5300 in chips) 
Dracoserpent: posts the ante 125
pokermanmd: posts the ante 125
Dtoal#1: posts the ante 125
ILUVCH1PS: posts the ante 125
CashMatteo: posts the ante 125
Maui_Riley: posts the ante 125
CashMatteo: posts small blind 250
Maui_Riley: posts big blind 500
*** HOLE CARDS ***
Dealt to CashMatteo [Ks 6h]
Dracoserpent: folds 
pokermanmd: raises 4000 to 4500
Dtoal#1: folds 
ILUVCH1PS: folds 
CashMatteo: folds 
Maui_Riley: folds 
Uncalled bet (4000) returned to pokermanmd
pokermanmd collected 2000 from pot
pokermanmd: doesn't show hand 
willie1111 is disconnected 
*** SUMMARY ***
Total pot 2000 | Rake 0 
Seat 2: Dracoserpent folded before Flop (didn't bet)
Seat 4: pokermanmd collected (2000)
Seat 5: Dtoal#1 folded before Flop (didn't bet)
Seat 6: ILUVCH1PS (button) folded before Flop (didn't bet)
Seat 7: CashMatteo (small blind) folded before Flop
Seat 8: Maui_Riley (big blind) folded before Flop

Hand #790: 

PokerStars Hand #246295311522: Tournament #3649979404, $0.94+$0.06 CAD Hold'em No Limit - Level XII (250/500) - 2023/10/01 16:46:50 ET
Table '3649979404 8' 8-max Seat #7 is the button
Seat 1: bdiggery (6323 in chips) 
Seat 2: Dracoserpent (2675 in chips) 
Seat 3: willie1111 (5242 in chips) 
Seat 4: pokermanmd (21846 in chips) 
Seat 5: Dtoal#1 (2474 in chips) 
Seat 6: ILUVCH1PS (4327 in chips) 
Seat 7: CashMatteo (2575 in chips) 
Seat 8: Maui_Riley (4675 in chips) 
bdiggery: posts the ante 125
Dracoserpent: posts the ante 125
willie1111: posts the ante 125
pokermanmd: posts the ante 125
Dtoal#1: posts the ante 125
ILUVCH1PS: posts the ante 125
CashMatteo: posts the ante 125
Maui_Riley: posts the ante 125
Maui_Riley: posts small blind 250
bdiggery: posts big blind 500
*** HOLE CARDS ***
Dealt to CashMatteo [2d 5h]
Dracoserpent: folds 
willie1111: folds 
pokermanmd: raises 500 to 1000
Dtoal#1: folds 
ILUVCH1PS: folds 
CashMatteo: folds 
Maui_Riley: folds 
bdiggery: calls 500
*** FLOP *** [Qc 6s 4d]
bdiggery: checks 
pokermanmd: bets 3250
bdiggery: folds 
Uncalled bet (3250) returned to pokermanmd
pokermanmd collected 3250 from pot
pokermanmd: doesn't show hand 
*** SUMMARY ***
Total pot 3250 | Rake 0 
Board [Qc 6s 4d]
Seat 1: bdiggery (big blind) folded on the Flop
Seat 2: Dracoserpent folded before Flop (didn't bet)
Seat 3: willie1111 folded before Flop (didn't bet)
Seat 4: pokermanmd collected (3250)
Seat 5: Dtoal#1 folded before Flop (didn't bet)
Seat 6: ILUVCH1PS folded before Flop (didn't bet)
Seat 7: CashMatteo (button) folded before Flop (didn't bet)
Seat 8: Maui_Riley (small blind) folded before Flop

Hand #791: 

PokerStars Hand #246295327635: Tournament #3649979404, $0.94+$0.06 CAD Hold'em No Limit - Level XIII (300/600) - 2023/10/01 16:47:25 ET
Table '3649979404 8' 8-max Seat #8 is the button
Seat 1: bdiggery (5198 in chips) 
Seat 2: Dracoserpent (2550 in chips) 
Seat 3: willie1111 (5117 in chips) 
Seat 4: pokermanmd (23971 in chips) 
Seat 5: Dtoal#1 (2349 in chips) 
Seat 6: ILUVCH1PS (4202 in chips) 
Seat 7: CashMatteo (2450 in chips) 
Seat 8: Maui_Riley (4300 in chips) 
bdiggery: posts the ante 150
Dracoserpent: posts the ante 150
willie1111: posts the ante 150
pokermanmd: posts the ante 150
Dtoal#1: posts the ante 150
ILUVCH1PS: posts the ante 150
CashMatteo: posts the ante 150
Maui_Riley: posts the ante 150
bdiggery: posts small blind 300
Dracoserpent: posts big blind 600
*** HOLE CARDS ***
Dealt to CashMatteo [6h Ah]
willie1111: folds 
pokermanmd: folds 
Dtoal#1: folds 
ILUVCH1PS: folds 
CashMatteo: raises 1700 to 2300 and is all-in
Maui_Riley: folds 
bdiggery: folds 
Dracoserpent: folds 
Uncalled bet (1700) returned to CashMatteo
CashMatteo collected 2700 from pot
CashMatteo: doesn't show hand 
*** SUMMARY ***
Total pot 2700 | Rake 0 
Seat 1: bdiggery (small blind) folded before Flop
Seat 2: Dracoserpent (big blind) folded before Flop
Seat 3: willie1111 folded before Flop (didn't bet)
Seat 4: pokermanmd folded before Flop (didn't bet)
Seat 5: Dtoal#1 folded before Flop (didn't bet)
Seat 6: ILUVCH1PS folded before Flop (didn't bet)
Seat 7: CashMatteo collected (2700)
Seat 8: Maui_Riley (button) folded before Flop (didn't bet)

Hand #792: 

PokerStars Hand #246295336120: Tournament #3649979404, $0.94+$0.06 CAD Hold'em No Limit - Level XIII (300/600) - 2023/10/01 16:47:43 ET
Table '3649979404 8' 8-max Seat #1 is the button
Seat 1: bdiggery (4748 in chips) 
Seat 2: Dracoserpent (1800 in chips) 
Seat 3: willie1111 (4967 in chips) 
Seat 4: pokermanmd (23821 in chips) 
Seat 5: Dtoal#1 (2199 in chips) 
Seat 6: ILUVCH1PS (4052 in chips) 
Seat 7: CashMatteo (4400 in chips) 
Seat 8: Maui_Riley (4150 in chips) 
bdiggery: posts the ante 150
Dracoserpent: posts the ante 150
willie1111: posts the ante 150
pokermanmd: posts the ante 150
Dtoal#1: posts the ante 150
ILUVCH1PS: posts the ante 150
CashMatteo: posts the ante 150
Maui_Riley: posts the ante 150
Dracoserpent: posts small blind 300
willie1111: posts big blind 600
*** HOLE CARDS ***
Dealt to CashMatteo [Qc Tc]
pokermanmd has timed out
pokermanmd: folds 
pokermanmd is sitting out
Dtoal#1: raises 1449 to 2049 and is all-in
ILUVCH1PS: folds 
pokermanmd has returned
CashMatteo: raises 2201 to 4250 and is all-in
Maui_Riley: folds 
bdiggery: raises 348 to 4598 and is all-in
Dracoserpent: folds 
willie1111: folds 
Uncalled bet (348) returned to bdiggery
*** FLOP *** [Th Qs Td]
*** TURN *** [Th Qs Td] [6c]
*** RIVER *** [Th Qs Td 6c] [Jh]
*** SHOW DOWN ***
CashMatteo: shows [Qc Tc] (a full house, Tens full of Queens)
bdiggery: shows [Jc Jd] (a full house, Jacks full of Tens)
bdiggery collected 4402 from side pot
Dtoal#1: shows [Qh Ts] (a full house, Tens full of Queens)
bdiggery collected 8247 from main pot
CashMatteo finished the tournament in 21st place
Dtoal#1 finished the tournament in 22nd place
*** SUMMARY ***
Total pot 12649 Main pot 8247. Side pot 4402. | Rake 0 
Board [Th Qs Td 6c Jh]
Seat 1: bdiggery (button) showed [Jc Jd] and won (12649) with a full house, Jacks full of Tens
Seat 2: Dracoserpent (small blind) folded before Flop
Seat 3: willie1111 (big blind) folded before Flop
Seat 4: pokermanmd folded before Flop (didn't bet)
Seat 5: Dtoal#1 showed [Qh Ts] and lost with a full house, Tens full of Queens
Seat 6: ILUVCH1PS folded before Flop (didn't bet)
Seat 7: CashMatteo showed [Qc Tc] and lost with a full house, Tens full of Queens
Seat 8: Maui_Riley folded before Flop (didn't bet)

Hand #793: 

PokerStars Hand #246295507488:  Hold'em No Limit ($0.01/$0.02 CAD) - 2023/10/01 16:53:51 ET
Table 'Abundantia III' 6-max Seat #6 is the button
Seat 2: momonnez ($2.06 in chips) 
Seat 3: CashMatteo ($2 in chips) 
Seat 4: richard woo ($1.14 in chips) 
Seat 5: Mikey121213 ($1.79 in chips) 
Seat 6: pink810251 ($0.77 in chips) 
Jokerc777 will be allowed to play after the button
momonnez: posts small blind $0.01
CashMatteo: posts big blind $0.02
*** HOLE CARDS ***
Dealt to CashMatteo [4d 5d]
richard woo: folds 
Mikey121213: folds 
pink810251: folds 
momonnez: raises $0.04 to $0.06
CashMatteo: calls $0.04
*** FLOP *** [Ah 7d As]
momonnez: bets $0.06
CashMatteo: folds 
Uncalled bet ($0.06) returned to momonnez
momonnez collected $0.12 from pot
momonnez: doesn't show hand 
*** SUMMARY ***
Total pot $0.12 | Rake $0 
Board [Ah 7d As]
Seat 2: momonnez (small blind) collected ($0.12)
Seat 3: CashMatteo (big blind) folded on the Flop
Seat 4: richard woo folded before Flop (didn't bet)
Seat 5: Mikey121213 folded before Flop (didn't bet)
Seat 6: pink810251 (button) folded before Flop (didn't bet)

Hand #794: 

PokerStars Hand #246295515921:  Hold'em No Limit ($0.01/$0.02 CAD) - 2023/10/01 16:54:10 ET
Table 'Abundantia III' 6-max Seat #2 is the button
Seat 1: Jokerc777 ($0.86 in chips) 
Seat 2: momonnez ($2.12 in chips) 
Seat 3: CashMatteo ($1.94 in chips) 
Seat 4: richard woo ($1.14 in chips) 
Seat 5: Mikey121213 ($1.79 in chips) 
Seat 6: pink810251 ($0.77 in chips) 
CashMatteo: posts small blind $0.01
richard woo: posts big blind $0.02
Jokerc777: posts big blind $0.02
*** HOLE CARDS ***
Dealt to CashMatteo [6c Tc]
Mikey121213: folds 
pink810251: folds 
Jokerc777: checks 
momonnez: raises $0.04 to $0.06
CashMatteo: folds 
richard woo: folds 
Jokerc777: folds 
Uncalled bet ($0.04) returned to momonnez
momonnez collected $0.07 from pot
momonnez: doesn't show hand 
*** SUMMARY ***
Total pot $0.07 | Rake $0 
Seat 1: Jokerc777 folded before Flop (didn't bet)
Seat 2: momonnez (button) collected ($0.07)
Seat 3: CashMatteo (small blind) folded before Flop
Seat 4: richard woo (big blind) folded before Flop
Seat 5: Mikey121213 folded before Flop (didn't bet)
Seat 6: pink810251 folded before Flop (didn't bet)

Hand #795: 

PokerStars Hand #246295531027:  Hold'em No Limit ($0.01/$0.02 CAD) - 2023/10/01 16:54:43 ET
Table 'Abundantia III' 6-max Seat #3 is the button
Seat 1: Jokerc777 ($0.84 in chips) 
Seat 2: momonnez ($2.17 in chips) 
Seat 3: CashMatteo ($1.93 in chips) 
Seat 4: richard woo ($1.12 in chips) 
Seat 5: Mikey121213 ($1.79 in chips) 
Seat 6: pink810251 ($0.77 in chips) 
richard woo: posts small blind $0.01
Mikey121213: posts big blind $0.02
*** HOLE CARDS ***
Dealt to CashMatteo [Ad 3s]
pink810251: folds 
Jokerc777: folds 
momonnez: folds 
CashMatteo: calls $0.02
richard woo: calls $0.01
Mikey121213: checks 
*** FLOP *** [7c 2h 9d]
richard woo: checks 
Mikey121213: checks 
CashMatteo: checks 
*** TURN *** [7c 2h 9d] [Ks]
richard woo: checks 
Mikey121213: checks 
CashMatteo: checks 
*** RIVER *** [7c 2h 9d Ks] [2d]
richard woo: bets $0.02
Mikey121213: raises $0.02 to $0.04
CashMatteo: folds 
richard woo: calls $0.02
*** SHOW DOWN ***
Mikey121213: shows [Td 7h] (two pair, Sevens and Deuces)
richard woo: shows [Jc 9h] (two pair, Nines and Deuces)
richard woo collected $0.14 from pot
*** SUMMARY ***
Total pot $0.14 | Rake $0 
Board [7c 2h 9d Ks 2d]
Seat 1: Jokerc777 folded before Flop (didn't bet)
Seat 2: momonnez folded before Flop (didn't bet)
Seat 3: CashMatteo (button) folded on the River
Seat 4: richard woo (small blind) showed [Jc 9h] and won ($0.14) with two pair, Nines and Deuces
Seat 5: Mikey121213 (big blind) showed [Td 7h] and lost with two pair, Sevens and Deuces
Seat 6: pink810251 folded before Flop (didn't bet)

Hand #796: 

PokerStars Hand #246295547373:  Hold'em No Limit ($0.01/$0.02 CAD) - 2023/10/01 16:55:27 ET
Table 'Abundantia III' 6-max Seat #4 is the button
Seat 1: Jokerc777 ($0.84 in chips) 
Seat 2: momonnez ($2.17 in chips) 
Seat 3: CashMatteo ($1.91 in chips) 
Seat 4: richard woo ($1.20 in chips) 
Seat 5: Mikey121213 ($1.73 in chips) 
Seat 6: pink810251 ($0.77 in chips) 
Mikey121213: posts small blind $0.01
pink810251: posts big blind $0.02
*** HOLE CARDS ***
Dealt to CashMatteo [7h 5h]
Jokerc777: folds 
momonnez: folds 
CashMatteo: calls $0.02
richard woo: folds 
Mikey121213: raises $0.02 to $0.04
pink810251: folds 
CashMatteo: calls $0.02
*** FLOP *** [Ks 4d 6d]
Mikey121213: checks 
CashMatteo: bets $0.05
Mikey121213: calls $0.05
*** TURN *** [Ks 4d 6d] [Qc]
Mikey121213: bets $0.04
CashMatteo: calls $0.04
*** RIVER *** [Ks 4d 6d Qc] [As]
Mikey121213: bets $1.60 and is all-in
CashMatteo: folds 
Uncalled bet ($1.60) returned to Mikey121213
Mikey121213 collected $0.27 from pot
*** SUMMARY ***
Total pot $0.28 | Rake $0.01 
Board [Ks 4d 6d Qc As]
Seat 1: Jokerc777 folded before Flop (didn't bet)
Seat 2: momonnez folded before Flop (didn't bet)
Seat 3: CashMatteo folded on the River
Seat 4: richard woo (button) folded before Flop (didn't bet)
Seat 5: Mikey121213 (small blind) collected ($0.27)
Seat 6: pink810251 (big blind) folded before Flop

Hand #797: 

PokerStars Hand #246295558062:  Hold'em No Limit ($0.01/$0.02 CAD) - 2023/10/01 16:56:10 ET
Table 'Abundantia III' 6-max Seat #5 is the button
Seat 1: Jokerc777 ($0.84 in chips) 
Seat 2: momonnez ($2.17 in chips) 
Seat 3: CashMatteo ($1.78 in chips) 
Seat 4: richard woo ($1.20 in chips) 
Seat 5: Mikey121213 ($1.87 in chips) 
Seat 6: pink810251 ($0.75 in chips) 
pink810251: posts small blind $0.01
Jokerc777: posts big blind $0.02
*** HOLE CARDS ***
Dealt to CashMatteo [Ac Jd]
momonnez: folds 
CashMatteo: raises $0.04 to $0.06
richard woo: folds 
Mikey121213: calls $0.06
pink810251: folds 
Jokerc777: calls $0.04
*** FLOP *** [6d 8h 5d]
Jokerc777: bets $0.04
CashMatteo: folds 
Mikey121213: raises $0.06 to $0.10
Jokerc777: raises $0.68 to $0.78 and is all-in
Mikey121213: calls $0.68
*** TURN *** [6d 8h 5d] [Ah]
*** RIVER *** [6d 8h 5d Ah] [Ks]
*** SHOW DOWN ***
Jokerc777: shows [Jh Kc] (a pair of Kings)
Mikey121213: shows [8d 9d] (a pair of Eights)
Jokerc777 collected $1.69 from pot
*** SUMMARY ***
Total pot $1.75 | Rake $0.06 
Board [6d 8h 5d Ah Ks]
Seat 1: Jokerc777 (big blind) showed [Jh Kc] and won ($1.69) with a pair of Kings
Seat 2: momonnez folded before Flop (didn't bet)
Seat 3: CashMatteo folded on the Flop
Seat 4: richard woo folded before Flop (didn't bet)
Seat 5: Mikey121213 (button) showed [8d 9d] and lost with a pair of Eights
Seat 6: pink810251 (small blind) folded before Flop

Hand #798: 

PokerStars Hand #246295573518:  Hold'em No Limit ($0.01/$0.02 CAD) - 2023/10/01 16:57:11 ET
Table 'Abundantia III' 6-max Seat #6 is the button
Seat 1: Jokerc777 ($1.69 in chips) 
Seat 2: momonnez ($2.17 in chips) 
Seat 3: CashMatteo ($1.72 in chips) 
Seat 4: richard woo ($1.20 in chips) 
Seat 5: Mikey121213 ($1.03 in chips) 
Seat 6: pink810251 ($0.74 in chips) 
Jokerc777: posts small blind $0.01
momonnez: posts big blind $0.02
*** HOLE CARDS ***
Dealt to CashMatteo [4s Kh]
CashMatteo: folds 
richard woo: folds 
Mikey121213: folds 
pink810251: folds 
Jokerc777: folds 
Uncalled bet ($0.01) returned to momonnez
momonnez collected $0.02 from pot
momonnez: doesn't show hand 
*** SUMMARY ***
Total pot $0.02 | Rake $0 
Seat 1: Jokerc777 (small blind) folded before Flop
Seat 2: momonnez (big blind) collected ($0.02)
Seat 3: CashMatteo folded before Flop (didn't bet)
Seat 4: richard woo folded before Flop (didn't bet)
Seat 5: Mikey121213 folded before Flop (didn't bet)
Seat 6: pink810251 (button) folded before Flop (didn't bet)

Hand #799: 

PokerStars Hand #246295578169:  Hold'em No Limit ($0.01/$0.02 CAD) - 2023/10/01 16:57:30 ET
Table 'Abundantia III' 6-max Seat #1 is the button
Seat 1: Jokerc777 ($1.68 in chips) 
Seat 2: momonnez ($2.18 in chips) 
Seat 3: CashMatteo ($1.72 in chips) 
Seat 4: richard woo ($1.20 in chips) 
Seat 5: Mikey121213 ($1.03 in chips) 
Seat 6: pink810251 ($0.74 in chips) 
momonnez: posts small blind $0.01
CashMatteo: posts big blind $0.02
*** HOLE CARDS ***
Dealt to CashMatteo [Qh Qs]
richard woo: folds 
Mikey121213: folds 
pink810251: folds 
Jokerc777: folds 
momonnez: folds 
Uncalled bet ($0.01) returned to CashMatteo
CashMatteo collected $0.02 from pot
CashMatteo: doesn't show hand 
*** SUMMARY ***
Total pot $0.02 | Rake $0 
Seat 1: Jokerc777 (button) folded before Flop (didn't bet)
Seat 2: momonnez (small blind) folded before Flop
Seat 3: CashMatteo (big blind) collected ($0.02)
Seat 4: richard woo folded before Flop (didn't bet)
Seat 5: Mikey121213 folded before Flop (didn't bet)
Seat 6: pink810251 folded before Flop (didn't bet)

Hand #800: 

PokerStars Hand #246295580522:  Hold'em No Limit ($0.01/$0.02 CAD) - 2023/10/01 16:57:39 ET
Table 'Abundantia III' 6-max Seat #2 is the button
Seat 1: Jokerc777 ($1.68 in chips) 
Seat 2: momonnez ($2.17 in chips) 
Seat 3: CashMatteo ($1.73 in chips) 
Seat 4: richard woo ($1.20 in chips) 
Seat 5: Mikey121213 ($1.03 in chips) 
Seat 6: pink810251 ($0.74 in chips) 
CashMatteo: posts small blind $0.01
richard woo: posts big blind $0.02
*** HOLE CARDS ***
Dealt to CashMatteo [5d Kd]
Mikey121213: calls $0.02
pink810251: folds 
Jokerc777: folds 
momonnez: folds 
CashMatteo: calls $0.01
richard woo: checks 
*** FLOP *** [As 9d 8h]
CashMatteo: checks 
richard woo: checks 
Mikey121213: checks 
*** TURN *** [As 9d 8h] [Td]
CashMatteo: bets $0.03
richard woo: folds 
Mikey121213: folds 
Uncalled bet ($0.03) returned to CashMatteo
CashMatteo collected $0.06 from pot
CashMatteo: doesn't show hand 
*** SUMMARY ***
Total pot $0.06 | Rake $0 
Board [As 9d 8h Td]
Seat 1: Jokerc777 folded before Flop (didn't bet)
Seat 2: momonnez (button) folded before Flop (didn't bet)
Seat 3: CashMatteo (small blind) collected ($0.06)
Seat 4: richard woo (big blind) folded on the Turn
Seat 5: Mikey121213 folded on the Turn
Seat 6: pink810251 folded before Flop (didn't bet)

Hand #801: 

PokerStars Hand #246295586942:  Hold'em No Limit ($0.01/$0.02 CAD) - 2023/10/01 16:58:04 ET
Table 'Abundantia III' 6-max Seat #3 is the button
Seat 1: Jokerc777 ($1.68 in chips) 
Seat 2: momonnez ($2.17 in chips) 
Seat 3: CashMatteo ($1.77 in chips) 
Seat 4: richard woo ($1.18 in chips) 
Seat 5: Mikey121213 ($1.01 in chips) 
Seat 6: pink810251 ($0.74 in chips) 
richard woo: posts small blind $0.01
Mikey121213: posts big blind $0.02
*** HOLE CARDS ***
Dealt to CashMatteo [Jh 2s]
pink810251: folds 
Jokerc777: folds 
momonnez: folds 
CashMatteo: folds 
richard woo: raises $0.04 to $0.06
Mikey121213: folds 
Uncalled bet ($0.04) returned to richard woo
richard woo collected $0.04 from pot
*** SUMMARY ***
Total pot $0.04 | Rake $0 
Seat 1: Jokerc777 folded before Flop (didn't bet)
Seat 2: momonnez folded before Flop (didn't bet)
Seat 3: CashMatteo (button) folded before Flop (didn't bet)
Seat 4: richard woo (small blind) collected ($0.04)
Seat 5: Mikey121213 (big blind) folded before Flop
Seat 6: pink810251 folded before Flop (didn't bet)

Hand #802: 

PokerStars Hand #246295590429:  Hold'em No Limit ($0.01/$0.02 CAD) - 2023/10/01 16:58:18 ET
Table 'Abundantia III' 6-max Seat #4 is the button
Seat 1: Jokerc777 ($1.68 in chips) 
Seat 2: momonnez ($2.17 in chips) 
Seat 3: CashMatteo ($1.77 in chips) 
Seat 4: richard woo ($1.20 in chips) 
Seat 5: Mikey121213 ($0.99 in chips) 
Seat 6: pink810251 ($0.74 in chips) 
Mikey121213: posts small blind $0.01
pink810251: posts big blind $0.02
*** HOLE CARDS ***
Dealt to CashMatteo [5s 3d]
Jokerc777: raises $0.02 to $0.04
momonnez: folds 
CashMatteo: folds 
richard woo: folds 
Mikey121213: calls $0.03
pink810251: folds 
*** FLOP *** [6c 5d Kd]
Mikey121213: checks 
Jokerc777: bets $0.16
Mikey121213: folds 
Uncalled bet ($0.16) returned to Jokerc777
Jokerc777 collected $0.10 from pot
*** SUMMARY ***
Total pot $0.10 | Rake $0 
Board [6c 5d Kd]
Seat 1: Jokerc777 collected ($0.10)
Seat 2: momonnez folded before Flop (didn't bet)
Seat 3: CashMatteo folded before Flop (didn't bet)
Seat 4: richard woo (button) folded before Flop (didn't bet)
Seat 5: Mikey121213 (small blind) folded on the Flop
Seat 6: pink810251 (big blind) folded before Flop

Hand #803: 

PokerStars Hand #246295599780:  Hold'em No Limit ($0.01/$0.02 CAD) - 2023/10/01 16:58:55 ET
Table 'Abundantia III' 6-max Seat #5 is the button
Seat 1: Jokerc777 ($1.74 in chips) 
Seat 2: momonnez ($2.17 in chips) 
Seat 3: CashMatteo ($1.77 in chips) 
Seat 4: richard woo ($1.20 in chips) 
Seat 5: Mikey121213 ($0.95 in chips) 
Jokerc777: posts small blind $0.01
momonnez: posts big blind $0.02
*** HOLE CARDS ***
Dealt to CashMatteo [Th Qh]
CashMatteo: raises $0.04 to $0.06
richard woo: folds 
Mikey121213: folds 
Jokerc777: folds 
momonnez: calls $0.04
*** FLOP *** [5c 5h 9d]
momonnez: bets $0.07
CashMatteo: calls $0.07
*** TURN *** [5c 5h 9d] [As]
momonnez: checks 
CashMatteo: bets $0.13
momonnez: folds 
Uncalled bet ($0.13) returned to CashMatteo
CashMatteo collected $0.26 from pot
CashMatteo: doesn't show hand 
*** SUMMARY ***
Total pot $0.27 | Rake $0.01 
Board [5c 5h 9d As]
Seat 1: Jokerc777 (small blind) folded before Flop
Seat 2: momonnez (big blind) folded on the Turn
Seat 3: CashMatteo collected ($0.26)
Seat 4: richard woo folded before Flop (didn't bet)
Seat 5: Mikey121213 (button) folded before Flop (didn't bet)

Hand #804: 

PokerStars Hand #246295607375:  Hold'em No Limit ($0.01/$0.02 CAD) - 2023/10/01 16:59:24 ET
Table 'Abundantia III' 6-max Seat #1 is the button
Seat 1: Jokerc777 ($1.73 in chips) 
Seat 2: momonnez ($2.04 in chips) 
Seat 3: CashMatteo ($1.90 in chips) 
Seat 4: richard woo ($1.20 in chips) 
Seat 5: Mikey121213 ($0.95 in chips) 
momonnez: posts small blind $0.01
CashMatteo: posts big blind $0.02
*** HOLE CARDS ***
Dealt to CashMatteo [As Ts]
richard woo: folds 
Mikey121213: calls $0.02
Jokerc777: folds 
momonnez: folds 
CashMatteo: raises $0.04 to $0.06
Mikey121213: calls $0.04
*** FLOP *** [Ah 7h 8d]
CashMatteo: bets $0.07
Mikey121213: folds 
Uncalled bet ($0.07) returned to CashMatteo
CashMatteo collected $0.13 from pot
CashMatteo: doesn't show hand 
*** SUMMARY ***
Total pot $0.13 | Rake $0 
Board [Ah 7h 8d]
Seat 1: Jokerc777 (button) folded before Flop (didn't bet)
Seat 2: momonnez (small blind) folded before Flop
Seat 3: CashMatteo (big blind) collected ($0.13)
Seat 4: richard woo folded before Flop (didn't bet)
Seat 5: Mikey121213 folded on the Flop

Hand #805: 

PokerStars Hand #246295613603:  Hold'em No Limit ($0.01/$0.02 CAD) - 2023/10/01 16:59:49 ET
Table 'Abundantia III' 6-max Seat #2 is the button
Seat 1: Jokerc777 ($1.73 in chips) 
Seat 2: momonnez ($2.03 in chips) 
Seat 3: CashMatteo ($1.97 in chips) 
Seat 4: richard woo ($1.20 in chips) 
Seat 5: Mikey121213 ($0.89 in chips) 
CashMatteo: posts small blind $0.01
richard woo: posts big blind $0.02
*** HOLE CARDS ***
Dealt to CashMatteo [Qc 6d]
Mikey121213: calls $0.02
Jokerc777: folds 
momonnez: raises $0.04 to $0.06
CashMatteo: folds 
richard woo: calls $0.04
Mikey121213: calls $0.04
*** FLOP *** [4h 3c 6h]
richard woo: checks 
Mikey121213: checks 
momonnez: checks 
*** TURN *** [4h 3c 6h] [9d]
richard woo: checks 
Mikey121213: checks 
momonnez: bets $0.09
richard woo: calls $0.09
Mikey121213: folds 
*** RIVER *** [4h 3c 6h 9d] [Ah]
richard woo: checks 
momonnez: bets $0.36
richard woo: calls $0.36
*** SHOW DOWN ***
momonnez: shows [Td 9s] (a pair of Nines)
richard woo: shows [2c Ac] (a pair of Aces)
richard woo collected $1.05 from pot
*** SUMMARY ***
Total pot $1.09 | Rake $0.04 
Board [4h 3c 6h 9d Ah]
Seat 1: Jokerc777 folded before Flop (didn't bet)
Seat 2: momonnez (button) showed [Td 9s] and lost with a pair of Nines
Seat 3: CashMatteo (small blind) folded before Flop
Seat 4: richard woo (big blind) showed [2c Ac] and won ($1.05) with a pair of Aces
Seat 5: Mikey121213 folded on the Turn

Hand #806: 

PokerStars Hand #246295630526:  Hold'em No Limit ($0.01/$0.02 CAD) - 2023/10/01 17:00:51 ET
Table 'Abundantia III' 6-max Seat #3 is the button
Seat 1: Jokerc777 ($1.73 in chips) 
Seat 2: momonnez ($1.52 in chips) 
Seat 3: CashMatteo ($1.96 in chips) 
Seat 4: richard woo ($1.74 in chips) 
Seat 5: Mikey121213 ($0.83 in chips) 
richard woo: posts small blind $0.01
Mikey121213: posts big blind $0.02
*** HOLE CARDS ***
Dealt to CashMatteo [2s Kd]
Jokerc777: folds 
momonnez: raises $0.04 to $0.06
CashMatteo: folds 
richard woo: folds 
Mikey121213: calls $0.04
*** FLOP *** [Qc Ac 9s]
Mikey121213: checks 
momonnez: bets $0.07
Mikey121213: folds 
Uncalled bet ($0.07) returned to momonnez
momonnez collected $0.13 from pot
momonnez: doesn't show hand 
*** SUMMARY ***
Total pot $0.13 | Rake $0 
Board [Qc Ac 9s]
Seat 1: Jokerc777 folded before Flop (didn't bet)
Seat 2: momonnez collected ($0.13)
Seat 3: CashMatteo (button) folded before Flop (didn't bet)
Seat 4: richard woo (small blind) folded before Flop
Seat 5: Mikey121213 (big blind) folded on the Flop

Hand #807: 

PokerStars Hand #246295640687:  Hold'em No Limit ($0.01/$0.02 CAD) - 2023/10/01 17:01:23 ET
Table 'Abundantia III' 6-max Seat #4 is the button
Seat 1: Jokerc777 ($1.73 in chips) 
Seat 2: momonnez ($1.59 in chips) 
Seat 3: CashMatteo ($1.96 in chips) 
Seat 4: richard woo ($1.73 in chips) 
Seat 5: Mikey121213 ($0.77 in chips) 
Mikey121213: posts small blind $0.01
Jokerc777: posts big blind $0.02
*** HOLE CARDS ***
Dealt to CashMatteo [7c 7s]
momonnez: raises $0.04 to $0.06
CashMatteo: raises $0.11 to $0.17
richard woo: folds 
Mikey121213: folds 
Jokerc777: folds 
momonnez: raises $0.37 to $0.54
CashMatteo: calls $0.37
*** FLOP *** [5s 2s 9s]
momonnez: bets $1.05 and is all-in
CashMatteo: calls $1.05
*** TURN *** [5s 2s 9s] [Ac]
*** RIVER *** [5s 2s 9s Ac] [Th]
*** SHOW DOWN ***
momonnez: shows [9h As] (two pair, Aces and Nines)
CashMatteo: shows [7c 7s] (a pair of Sevens)
momonnez collected $3.10 from pot
*** SUMMARY ***
Total pot $3.21 | Rake $0.11 
Board [5s 2s 9s Ac Th]
Seat 1: Jokerc777 (big blind) folded before Flop
Seat 2: momonnez showed [9h As] and won ($3.10) with two pair, Aces and Nines
Seat 3: CashMatteo showed [7c 7s] and lost with a pair of Sevens
Seat 4: richard woo (button) folded before Flop (didn't bet)
Seat 5: Mikey121213 (small blind) folded before Flop

Hand #808: 

PokerStars Hand #246295660674:  Hold'em No Limit ($0.01/$0.02 CAD) - 2023/10/01 17:02:17 ET
Table 'Abundantia III' 6-max Seat #5 is the button
Seat 1: Jokerc777 ($1.71 in chips) 
Seat 2: momonnez ($3.10 in chips) 
Seat 3: CashMatteo ($0.37 in chips) 
Seat 4: richard woo ($1.73 in chips) 
Seat 5: Mikey121213 ($0.76 in chips) 
Jokerc777: posts small blind $0.01
momonnez: posts big blind $0.02
*** HOLE CARDS ***
Dealt to CashMatteo [2d Kd]
CashMatteo: raises $0.35 to $0.37 and is all-in
richard woo: folds 
Mikey121213: folds 
Jokerc777: folds 
momonnez: calls $0.35
*** FLOP *** [5d Qs 5s]
*** TURN *** [5d Qs 5s] [Ks]
*** RIVER *** [5d Qs 5s Ks] [9h]
*** SHOW DOWN ***
momonnez: shows [8d Ad] (a pair of Fives)
CashMatteo: shows [2d Kd] (two pair, Kings and Fives)
CashMatteo collected $0.72 from pot
*** SUMMARY ***
Total pot $0.75 | Rake $0.03 
Board [5d Qs 5s Ks 9h]
Seat 1: Jokerc777 (small blind) folded before Flop
Seat 2: momonnez (big blind) showed [8d Ad] and lost with a pair of Fives
Seat 3: CashMatteo showed [2d Kd] and won ($0.72) with two pair, Kings and Fives
Seat 4: richard woo folded before Flop (didn't bet)
Seat 5: Mikey121213 (button) folded before Flop (didn't bet)

Hand #809: 

PokerStars Hand #246295669751:  Hold'em No Limit ($0.01/$0.02 CAD) - 2023/10/01 17:02:40 ET
Table 'Abundantia III' 6-max Seat #1 is the button
Seat 1: Jokerc777 ($1.70 in chips) 
Seat 2: momonnez ($2.73 in chips) 
Seat 3: CashMatteo ($0.72 in chips) 
Seat 4: richard woo ($1.73 in chips) 
Seat 5: Mikey121213 ($0.76 in chips) 
momonnez: posts small blind $0.01
CashMatteo: posts big blind $0.02
pink810251: sits out 
*** HOLE CARDS ***
Dealt to CashMatteo [4s 3h]
richard woo: folds 
Mikey121213: calls $0.02
Jokerc777: raises $0.02 to $0.04
momonnez: raises $0.02 to $0.06
CashMatteo: folds 
Mikey121213: calls $0.04
Jokerc777: calls $0.02
*** FLOP *** [3c Qs 6c]
momonnez: checks 
Mikey121213: checks 
Jokerc777: bets $0.10
momonnez: folds 
Mikey121213: folds 
Uncalled bet ($0.10) returned to Jokerc777
Jokerc777 collected $0.19 from pot
*** SUMMARY ***
Total pot $0.20 | Rake $0.01 
Board [3c Qs 6c]
Seat 1: Jokerc777 (button) collected ($0.19)
Seat 2: momonnez (small blind) folded on the Flop
Seat 3: CashMatteo (big blind) folded before Flop
Seat 4: richard woo folded before Flop (didn't bet)
Seat 5: Mikey121213 folded on the Flop

Hand #810: 

PokerStars Hand #246295686106:  Hold'em No Limit ($0.01/$0.02 CAD) - 2023/10/01 17:03:16 ET
Table 'Abundantia III' 6-max Seat #2 is the button
Seat 1: Jokerc777 ($1.83 in chips) 
Seat 2: momonnez ($2.67 in chips) 
Seat 3: CashMatteo ($0.70 in chips) 
Seat 4: richard woo ($1.73 in chips) 
Seat 5: Mikey121213 ($0.70 in chips) 
CashMatteo: posts small blind $0.01
richard woo: posts big blind $0.02
pink810251: sits out 
*** HOLE CARDS ***
Dealt to CashMatteo [Ac 4s]
Mikey121213: folds 
Jokerc777: folds 
momonnez: raises $0.04 to $0.06
CashMatteo: folds 
richard woo: folds 
Uncalled bet ($0.04) returned to momonnez
momonnez collected $0.05 from pot
momonnez: doesn't show hand 
*** SUMMARY ***
Total pot $0.05 | Rake $0 
Seat 1: Jokerc777 folded before Flop (didn't bet)
Seat 2: momonnez (button) collected ($0.05)
Seat 3: CashMatteo (small blind) folded before Flop
Seat 4: richard woo (big blind) folded before Flop
Seat 5: Mikey121213 folded before Flop (didn't bet)

Hand #811: 

PokerStars Hand #246295696902:  Hold'em No Limit ($0.01/$0.02 CAD) - 2023/10/01 17:03:42 ET
Table 'Abundantia III' 6-max Seat #3 is the button
Seat 1: Jokerc777 ($1.83 in chips) 
Seat 2: momonnez ($2.70 in chips) 
Seat 3: CashMatteo ($0.69 in chips) 
Seat 4: richard woo ($1.71 in chips) 
Seat 5: Mikey121213 ($0.70 in chips) 
richard woo: posts small blind $0.01
Mikey121213: posts big blind $0.02
pink810251: sits out 
*** HOLE CARDS ***
Dealt to CashMatteo [Jd 2c]
Jokerc777: folds 
momonnez: folds 
CashMatteo: folds 
richard woo: calls $0.01
Mikey121213: checks 
*** FLOP *** [6s Kc 2h]
richard woo: checks 
Mikey121213: bets $0.02
richard woo: calls $0.02
*** TURN *** [6s Kc 2h] [3c]
richard woo: checks 
Mikey121213: bets $0.04
richard woo: calls $0.04
*** RIVER *** [6s Kc 2h 3c] [4s]
richard woo: checks 
Mikey121213: bets $0.62 and is all-in
richard woo: calls $0.62
*** SHOW DOWN ***
Mikey121213: shows [4h 3s] (two pair, Fours and Threes)
richard woo: shows [5h 3h] (a straight, Deuce to Six)
richard woo collected $1.35 from pot
*** SUMMARY ***
Total pot $1.40 | Rake $0.05 
Board [6s Kc 2h 3c 4s]
Seat 1: Jokerc777 folded before Flop (didn't bet)
Seat 2: momonnez folded before Flop (didn't bet)
Seat 3: CashMatteo (button) folded before Flop (didn't bet)
Seat 4: richard woo (small blind) showed [5h 3h] and won ($1.35) with a straight, Deuce to Six
Seat 5: Mikey121213 (big blind) showed [4h 3s] and lost with two pair, Fours and Threes

Hand #812: 

PokerStars Hand #246295718352:  Hold'em No Limit ($0.01/$0.02 CAD) - 2023/10/01 17:04:32 ET
Table 'Abundantia III' 6-max Seat #4 is the button
Seat 1: Jokerc777 ($1.83 in chips) 
Seat 2: momonnez ($2.70 in chips) 
Seat 3: CashMatteo ($0.69 in chips) 
Seat 4: richard woo ($2.36 in chips) 
pink810251 will be allowed to play after the button
Jokerc777: posts small blind $0.01
momonnez: posts big blind $0.02
*** HOLE CARDS ***
Dealt to CashMatteo [Qc 8c]
CashMatteo: calls $0.02
Mikey121213 is disconnected 
richard woo: calls $0.02
Jokerc777: calls $0.01
momonnez: raises $0.04 to $0.06
CashMatteo: calls $0.04
richard woo: calls $0.04
Jokerc777: calls $0.04
*** FLOP *** [5d 8h 3s]
Jokerc777: checks 
momonnez: bets $0.12
CashMatteo: calls $0.12
richard woo: folds 
Jokerc777: folds 
*** TURN *** [5d 8h 3s] [4c]
momonnez: checks 
CashMatteo: checks 
*** RIVER *** [5d 8h 3s 4c] [Ks]
momonnez: checks 
CashMatteo: checks 
*** SHOW DOWN ***
momonnez: shows [7d Ah] (high card Ace)
CashMatteo: shows [Qc 8c] (a pair of Eights)
CashMatteo collected $0.46 from pot
*** SUMMARY ***
Total pot $0.48 | Rake $0.02 
Board [5d 8h 3s 4c Ks]
Seat 1: Jokerc777 (small blind) folded on the Flop
Seat 2: momonnez (big blind) showed [7d Ah] and lost with high card Ace
Seat 3: CashMatteo showed [Qc 8c] and won ($0.46) with a pair of Eights
Seat 4: richard woo (button) folded on the Flop

Hand #813: 

PokerStars Hand #246295754370:  Hold'em No Limit ($0.01/$0.02 CAD) - 2023/10/01 17:05:49 ET
Table 'Abundantia III' 6-max Seat #1 is the button
Seat 1: Jokerc777 ($1.77 in chips) 
Seat 2: momonnez ($2.52 in chips) 
Seat 3: CashMatteo ($0.97 in chips) 
Seat 4: richard woo ($2.30 in chips) 
momonnez: posts small blind $0.01
CashMatteo: posts big blind $0.02
pink810251: sits out 
*** HOLE CARDS ***
Dealt to CashMatteo [4c 4s]
richard woo: raises $0.04 to $0.06
Jokerc777: folds 
momonnez: calls $0.05
CashMatteo: calls $0.04
*** FLOP *** [Qd 6c 4h]
momonnez: checks 
CashMatteo: checks 
richard woo: checks 
*** TURN *** [Qd 6c 4h] [7h]
momonnez: bets $0.09
CashMatteo: calls $0.09
richard woo: folds 
*** RIVER *** [Qd 6c 4h 7h] [Qh]
momonnez: checks 
CashMatteo: bets $0.18
momonnez: folds 
Uncalled bet ($0.18) returned to CashMatteo
CashMatteo collected $0.35 from pot
CashMatteo: doesn't show hand 
*** SUMMARY ***
Total pot $0.36 | Rake $0.01 
Board [Qd 6c 4h 7h Qh]
Seat 1: Jokerc777 (button) folded before Flop (didn't bet)
Seat 2: momonnez (small blind) folded on the River
Seat 3: CashMatteo (big blind) collected ($0.35)
Seat 4: richard woo folded on the Turn

Hand #814: 

PokerStars Hand #246295779582:  Hold'em No Limit ($0.01/$0.02 CAD) - 2023/10/01 17:06:44 ET
Table 'Abundantia III' 6-max Seat #2 is the button
Seat 1: Jokerc777 ($1.77 in chips) 
Seat 2: momonnez ($2.37 in chips) 
Seat 3: CashMatteo ($1.17 in chips) 
Seat 4: richard woo ($2.24 in chips) 
CashMatteo: posts small blind $0.01
richard woo: posts big blind $0.02
pink810251: sits out 
*** HOLE CARDS ***
Dealt to CashMatteo [Ks Ts]
Jokerc777: raises $0.02 to $0.04
momonnez: calls $0.04
CashMatteo: calls $0.03
richard woo: calls $0.02
*** FLOP *** [6s 3c 3d]
CashMatteo: checks 
richard woo: checks 
Jokerc777: bets $0.16
momonnez: calls $0.16
CashMatteo: folds 
richard woo: folds 
*** TURN *** [6s 3c 3d] [Td]
Jokerc777: checks 
momonnez: checks 
*** RIVER *** [6s 3c 3d Td] [Jh]
Jokerc777: checks 
momonnez: checks 
*** SHOW DOWN ***
Jokerc777: shows [8d 8c] (two pair, Eights and Threes)
momonnez: mucks hand 
Jokerc777 collected $0.46 from pot
*** SUMMARY ***
Total pot $0.48 | Rake $0.02 
Board [6s 3c 3d Td Jh]
Seat 1: Jokerc777 showed [8d 8c] and won ($0.46) with two pair, Eights and Threes
Seat 2: momonnez (button) mucked [2d 2h]
Seat 3: CashMatteo (small blind) folded on the Flop
Seat 4: richard woo (big blind) folded on the Flop

Hand #815: 

PokerStars Hand #246295810023:  Hold'em No Limit ($0.01/$0.02 CAD) - 2023/10/01 17:07:50 ET
Table 'Abundantia III' 6-max Seat #3 is the button
Seat 1: Jokerc777 ($2.03 in chips) 
Seat 2: momonnez ($2.17 in chips) 
Seat 3: CashMatteo ($1.13 in chips) 
Seat 4: richard woo ($2.20 in chips) 
Seat 6: pink810251 ($0.72 in chips) 
richard woo: posts small blind $0.01
pink810251: posts big blind $0.02
*** HOLE CARDS ***
Dealt to CashMatteo [Th 3h]
Jokerc777: folds 
momonnez: folds 
CashMatteo: folds 
richard woo: folds 
Uncalled bet ($0.01) returned to pink810251
pink810251 collected $0.02 from pot
*** SUMMARY ***
Total pot $0.02 | Rake $0 
Seat 1: Jokerc777 folded before Flop (didn't bet)
Seat 2: momonnez folded before Flop (didn't bet)
Seat 3: CashMatteo (button) folded before Flop (didn't bet)
Seat 4: richard woo (small blind) folded before Flop
Seat 6: pink810251 (big blind) collected ($0.02)

Hand #816: 

PokerStars Hand #246295814269:  Hold'em No Limit ($0.01/$0.02 CAD) - 2023/10/01 17:07:59 ET
Table 'Abundantia III' 6-max Seat #4 is the button
Seat 1: Jokerc777 ($2.03 in chips) 
Seat 2: momonnez ($2.17 in chips) 
Seat 3: CashMatteo ($1.13 in chips) 
Seat 4: richard woo ($2.19 in chips) 
Seat 6: pink810251 ($0.73 in chips) 
pink810251: posts small blind $0.01
Jokerc777: posts big blind $0.02
*** HOLE CARDS ***
Dealt to CashMatteo [3h 8h]
momonnez: folds 
CashMatteo: folds 
richard woo: raises $0.04 to $0.06
pink810251: folds 
Jokerc777: folds 
Uncalled bet ($0.04) returned to richard woo
richard woo collected $0.05 from pot
*** SUMMARY ***
Total pot $0.05 | Rake $0 
Seat 1: Jokerc777 (big blind) folded before Flop
Seat 2: momonnez folded before Flop (didn't bet)
Seat 3: CashMatteo folded before Flop (didn't bet)
Seat 4: richard woo (button) collected ($0.05)
Seat 6: pink810251 (small blind) folded before Flop

Hand #817: 

PokerStars Hand #246295822547:  Hold'em No Limit ($0.01/$0.02 CAD) - 2023/10/01 17:08:17 ET
Table 'Abundantia III' 6-max Seat #6 is the button
Seat 1: Jokerc777 ($2.01 in chips) 
Seat 2: momonnez ($2.17 in chips) 
Seat 3: CashMatteo ($1.13 in chips) 
Seat 4: richard woo ($2.22 in chips) 
Seat 6: pink810251 ($0.72 in chips) 
Jokerc777: posts small blind $0.01
momonnez: posts big blind $0.02
*** HOLE CARDS ***
Dealt to CashMatteo [Kc 3d]
CashMatteo: folds 
richard woo: folds 
pink810251: folds 
Jokerc777: folds 
Uncalled bet ($0.01) returned to momonnez
momonnez collected $0.02 from pot
momonnez: doesn't show hand 
*** SUMMARY ***
Total pot $0.02 | Rake $0 
Seat 1: Jokerc777 (small blind) folded before Flop
Seat 2: momonnez (big blind) collected ($0.02)
Seat 3: CashMatteo folded before Flop (didn't bet)
Seat 4: richard woo folded before Flop (didn't bet)
Seat 6: pink810251 (button) folded before Flop (didn't bet)

Hand #818: 

PokerStars Hand #246295827176:  Hold'em No Limit ($0.01/$0.02 CAD) - 2023/10/01 17:08:27 ET
Table 'Abundantia III' 6-max Seat #1 is the button
Seat 1: Jokerc777 ($2 in chips) 
Seat 2: momonnez ($2.18 in chips) 
Seat 3: CashMatteo ($1.13 in chips) 
Seat 4: richard woo ($2.22 in chips) 
Seat 6: pink810251 ($0.72 in chips) 
momonnez: posts small blind $0.01
CashMatteo: posts big blind $0.02
*** HOLE CARDS ***
Dealt to CashMatteo [6c 3c]
richard woo: folds 
pink810251: calls $0.02
Jokerc777: raises $0.04 to $0.06
momonnez: calls $0.05
CashMatteo: folds 
pink810251: calls $0.04
*** FLOP *** [9s 6h 3d]
momonnez: bets $0.10
pink810251: folds 
Jokerc777: calls $0.10
*** TURN *** [9s 6h 3d] [9d]
momonnez: bets $0.39
Jokerc777: folds 
Uncalled bet ($0.39) returned to momonnez
momonnez collected $0.39 from pot
momonnez: doesn't show hand 
*** SUMMARY ***
Total pot $0.40 | Rake $0.01 
Board [9s 6h 3d 9d]
Seat 1: Jokerc777 (button) folded on the Turn
Seat 2: momonnez (small blind) collected ($0.39)
Seat 3: CashMatteo (big blind) folded before Flop
Seat 4: richard woo folded before Flop (didn't bet)
Seat 6: pink810251 folded on the Flop

Hand #819: 

PokerStars Hand #246295848967:  Hold'em No Limit ($0.01/$0.02 CAD) - 2023/10/01 17:09:14 ET
Table 'Abundantia III' 6-max Seat #2 is the button
Seat 1: Jokerc777 ($1.84 in chips) 
Seat 2: momonnez ($2.41 in chips) 
Seat 3: CashMatteo ($1.11 in chips) 
Seat 4: richard woo ($2.22 in chips) 
Seat 6: pink810251 ($0.66 in chips) 
CashMatteo: posts small blind $0.01
richard woo: posts big blind $0.02
*** HOLE CARDS ***
Dealt to CashMatteo [2c 9s]
pink810251: calls $0.02
Jokerc777: folds 
Jokerc777 leaves the table
momonnez: folds 
CashMatteo: folds 
richard woo: checks 
*** FLOP *** [3h Js 7s]
richard woo: checks 
pink810251: bets $0.05
richard woo: calls $0.05
*** TURN *** [3h Js 7s] [5d]
richard woo: checks 
pink810251: bets $0.14
spidernet joins the table at seat #1 
richard woo: folds 
Uncalled bet ($0.14) returned to pink810251
pink810251 collected $0.14 from pot
*** SUMMARY ***
Total pot $0.15 | Rake $0.01 
Board [3h Js 7s 5d]
Seat 1: Jokerc777 folded before Flop (didn't bet)
Seat 2: momonnez (button) folded before Flop (didn't bet)
Seat 3: CashMatteo (small blind) folded before Flop
Seat 4: richard woo (big blind) folded on the Turn
Seat 6: pink810251 collected ($0.14)

Hand #820: 

PokerStars Hand #246295872976:  Hold'em No Limit ($0.01/$0.02 CAD) - 2023/10/01 17:10:06 ET
Table 'Abundantia III' 6-max Seat #3 is the button
Seat 2: momonnez ($2.41 in chips) 
Seat 3: CashMatteo ($1.10 in chips) 
Seat 4: richard woo ($2.15 in chips) 
Seat 6: pink810251 ($0.73 in chips) 
richard woo: posts small blind $0.01
pink810251: posts big blind $0.02
spidernet: sits out 
*** HOLE CARDS ***
Dealt to CashMatteo [6d Ks]
momonnez: folds 
CashMatteo: calls $0.02
richard woo: calls $0.01
pink810251: checks 
*** FLOP *** [Tc Kd 9h]
richard woo: checks 
pink810251: checks 
CashMatteo: bets $0.03
richard woo: folds 
pink810251: folds 
Uncalled bet ($0.03) returned to CashMatteo
CashMatteo collected $0.06 from pot
CashMatteo: doesn't show hand 
*** SUMMARY ***
Total pot $0.06 | Rake $0 
Board [Tc Kd 9h]
Seat 2: momonnez folded before Flop (didn't bet)
Seat 3: CashMatteo (button) collected ($0.06)
Seat 4: richard woo (small blind) folded on the Flop
Seat 6: pink810251 (big blind) folded on the Flop

Hand #821: 

PokerStars Hand #246295886127:  Hold'em No Limit ($0.01/$0.02 CAD) - 2023/10/01 17:10:34 ET
Table 'Abundantia III' 6-max Seat #4 is the button
Seat 2: momonnez ($2.41 in chips) 
Seat 3: CashMatteo ($1.14 in chips) 
Seat 4: richard woo ($2.13 in chips) 
spidernet will be allowed to play after the button
momonnez: posts small blind $0.01
CashMatteo: posts big blind $0.02
*** HOLE CARDS ***
Dealt to CashMatteo [As Ah]
richard woo: folds 
momonnez: raises $0.04 to $0.06
CashMatteo: raises $0.08 to $0.14
momonnez: folds 
Uncalled bet ($0.08) returned to CashMatteo
CashMatteo collected $0.12 from pot
CashMatteo: doesn't show hand 
*** SUMMARY ***
Total pot $0.12 | Rake $0 
Seat 2: momonnez (small blind) folded before Flop
Seat 3: CashMatteo (big blind) collected ($0.12)
Seat 4: richard woo (button) folded before Flop (didn't bet)

Hand #822: 

PokerStars Hand #246295894874:  Hold'em No Limit ($0.01/$0.02 CAD) - 2023/10/01 17:10:53 ET
Table 'Abundantia III' 6-max Seat #2 is the button
Seat 2: momonnez ($2.35 in chips) 
Seat 3: CashMatteo ($1.20 in chips) 
Seat 4: richard woo ($2.13 in chips) 
CashMatteo: posts small blind $0.01
richard woo: posts big blind $0.02
spidernet: sits out 
*** HOLE CARDS ***
Dealt to CashMatteo [Ts Kc]
momonnez: folds 
CashMatteo: raises $0.04 to $0.06
richard woo: folds 
Uncalled bet ($0.04) returned to CashMatteo
CashMatteo collected $0.04 from pot
CashMatteo: doesn't show hand 
*** SUMMARY ***
Total pot $0.04 | Rake $0 
Seat 2: momonnez (button) folded before Flop (didn't bet)
Seat 3: CashMatteo (small blind) collected ($0.04)
Seat 4: richard woo (big blind) folded before Flop

Hand #823: 

PokerStars Hand #246295899671:  Hold'em No Limit ($0.01/$0.02 CAD) - 2023/10/01 17:11:04 ET
Table 'Abundantia III' 6-max Seat #3 is the button
Seat 1: spidernet ($2 in chips) 
Seat 2: momonnez ($2.35 in chips) 
Seat 3: CashMatteo ($1.22 in chips) 
Seat 4: richard woo ($2.11 in chips) 
richard woo: posts small blind $0.01
spidernet: posts big blind $0.02
*** HOLE CARDS ***
Dealt to CashMatteo [5h 2s]
momonnez: folds 
CashMatteo: folds 
richard woo: calls $0.01
spidernet: raises $0.04 to $0.06
richard woo: folds 
Uncalled bet ($0.04) returned to spidernet
spidernet collected $0.04 from pot
Mikey121213 was removed from the table for failing to post
Mikey121213 leaves the table
spidernet: doesn't show hand 
*** SUMMARY ***
Total pot $0.04 | Rake $0 
Seat 1: spidernet (big blind) collected ($0.04)
Seat 2: momonnez folded before Flop (didn't bet)
Seat 3: CashMatteo (button) folded before Flop (didn't bet)
Seat 4: richard woo (small blind) folded before Flop

Hand #824: 

PokerStars Hand #246295906930:  Hold'em No Limit ($0.01/$0.02 CAD) - 2023/10/01 17:11:19 ET
Table 'Abundantia III' 6-max Seat #4 is the button
Seat 1: spidernet ($2.02 in chips) 
Seat 2: momonnez ($2.35 in chips) 
Seat 3: CashMatteo ($1.22 in chips) 
Seat 4: richard woo ($2.09 in chips) 
spidernet: posts small blind $0.01
momonnez: posts big blind $0.02
*** HOLE CARDS ***
Dealt to CashMatteo [Kc 3d]
CashMatteo: calls $0.02
richard woo: folds 
spidernet: calls $0.01
momonnez: raises $0.04 to $0.06
CashMatteo: folds 
realkaliuchis joins the table at seat #5 
spidernet: calls $0.04
*** FLOP *** [Jd 7c 2d]
spidernet: checks 
momonnez: bets $0.07
spidernet: folds 
Uncalled bet ($0.07) returned to momonnez
momonnez collected $0.14 from pot
momonnez: doesn't show hand 
*** SUMMARY ***
Total pot $0.14 | Rake $0 
Board [Jd 7c 2d]
Seat 1: spidernet (small blind) folded on the Flop
Seat 2: momonnez (big blind) collected ($0.14)
Seat 3: CashMatteo folded before Flop
Seat 4: richard woo (button) folded before Flop (didn't bet)

Hand #825: 

PokerStars Hand #246295919558:  Hold'em No Limit ($0.01/$0.02 CAD) - 2023/10/01 17:11:47 ET
Table 'Abundantia III' 6-max Seat #1 is the button
Seat 1: spidernet ($1.96 in chips) 
Seat 2: momonnez ($2.43 in chips) 
Seat 3: CashMatteo ($1.20 in chips) 
Seat 4: richard woo ($2.09 in chips) 
momonnez: posts small blind $0.01
CashMatteo: posts big blind $0.02
realkaliuchis: sits out 
*** HOLE CARDS ***
Dealt to CashMatteo [3s Kh]
richard woo: folds 
spidernet: calls $0.02
momonnez: raises $0.04 to $0.06
CashMatteo: folds 
spidernet: calls $0.04
*** FLOP *** [7s 2c 7c]
momonnez: bets $0.07
spidernet: calls $0.07
*** TURN *** [7s 2c 7c] [Td]
momonnez: checks 
spidernet: bets $0.25
momonnez: folds 
Uncalled bet ($0.25) returned to spidernet
spidernet collected $0.27 from pot
spidernet: doesn't show hand 
*** SUMMARY ***
Total pot $0.28 | Rake $0.01 
Board [7s 2c 7c Td]
Seat 1: spidernet (button) collected ($0.27)
Seat 2: momonnez (small blind) folded on the Turn
Seat 3: CashMatteo (big blind) folded before Flop
Seat 4: richard woo folded before Flop (didn't bet)

Hand #826: 

PokerStars Hand #246295936807:  Hold'em No Limit ($0.01/$0.02 CAD) - 2023/10/01 17:12:25 ET
Table 'Abundantia III' 6-max Seat #2 is the button
Seat 1: spidernet ($2.10 in chips) 
Seat 2: momonnez ($2.30 in chips) 
Seat 3: CashMatteo ($1.18 in chips) 
Seat 4: richard woo ($2.09 in chips) 
CashMatteo: posts small blind $0.01
richard woo: posts big blind $0.02
realkaliuchis: sits out 
*** HOLE CARDS ***
Dealt to CashMatteo [Jh 7c]
spidernet: folds 
momonnez: raises $0.04 to $0.06
CashMatteo: folds 
richard woo: folds 
Uncalled bet ($0.04) returned to momonnez
momonnez collected $0.05 from pot
momonnez: doesn't show hand 
*** SUMMARY ***
Total pot $0.05 | Rake $0 
Seat 1: spidernet folded before Flop (didn't bet)
Seat 2: momonnez (button) collected ($0.05)
Seat 3: CashMatteo (small blind) folded before Flop
Seat 4: richard woo (big blind) folded before Flop

Hand #827: 

PokerStars Hand #246295949356:  Hold'em No Limit ($0.01/$0.02 CAD) - 2023/10/01 17:12:52 ET
Table 'Abundantia III' 6-max Seat #3 is the button
Seat 1: spidernet ($2.10 in chips) 
Seat 2: momonnez ($2.33 in chips) 
Seat 3: CashMatteo ($1.17 in chips) 
Seat 4: richard woo ($2.07 in chips) 
Seat 5: realkaliuchis ($1.20 in chips) 
richard woo: posts small blind $0.01
realkaliuchis: posts big blind $0.02
*** HOLE CARDS ***
Dealt to CashMatteo [7d Ts]
spidernet: calls $0.02
momonnez: folds 
CashMatteo: folds 
richard woo: folds 
realkaliuchis: checks 
*** FLOP *** [Qd 8d 4c]
realkaliuchis: bets $0.06
spidernet: calls $0.06
*** TURN *** [Qd 8d 4c] [4d]
realkaliuchis: bets $0.08
spidernet: calls $0.08
*** RIVER *** [Qd 8d 4c 4d] [As]
realkaliuchis: bets $0.06
spidernet: calls $0.06
*** SHOW DOWN ***
realkaliuchis: shows [Kd 4s] (three of a kind, Fours)
spidernet: mucks hand 
realkaliuchis collected $0.43 from pot
*** SUMMARY ***
Total pot $0.45 | Rake $0.02 
Board [Qd 8d 4c 4d As]
Seat 1: spidernet mucked [8c Jd]
Seat 2: momonnez folded before Flop (didn't bet)
Seat 3: CashMatteo (button) folded before Flop (didn't bet)
Seat 4: richard woo (small blind) folded before Flop
Seat 5: realkaliuchis (big blind) showed [Kd 4s] and won ($0.43) with three of a kind, Fours

Hand #828: 

PokerStars Hand #246295969996:  Hold'em No Limit ($0.01/$0.02 CAD) - 2023/10/01 17:13:38 ET
Table 'Abundantia III' 6-max Seat #4 is the button
Seat 1: spidernet ($1.88 in chips) 
Seat 2: momonnez ($2.33 in chips) 
Seat 3: CashMatteo ($1.17 in chips) 
Seat 4: richard woo ($2.06 in chips) 
Seat 5: realkaliuchis ($1.41 in chips) 
realkaliuchis: posts small blind $0.01
spidernet: posts big blind $0.02
*** HOLE CARDS ***
Dealt to CashMatteo [As 7h]
momonnez: folds 
CashMatteo: raises $0.04 to $0.06
richard woo: folds 
realkaliuchis: calls $0.05
spidernet: calls $0.04
*** FLOP *** [Ah 7s 4s]
realkaliuchis: bets $0.06
spidernet: calls $0.06
CashMatteo: raises $0.18 to $0.24
realkaliuchis: folds 
spidernet: folds 
Uncalled bet ($0.18) returned to CashMatteo
CashMatteo collected $0.35 from pot
CashMatteo: doesn't show hand 
*** SUMMARY ***
Total pot $0.36 | Rake $0.01 
Board [Ah 7s 4s]
Seat 1: spidernet (big blind) folded on the Flop
Seat 2: momonnez folded before Flop (didn't bet)
Seat 3: CashMatteo collected ($0.35)
Seat 4: richard woo (button) folded before Flop (didn't bet)
Seat 5: realkaliuchis (small blind) folded on the Flop

Hand #829: 

PokerStars Hand #246295987955:  Hold'em No Limit ($0.01/$0.02 CAD) - 2023/10/01 17:14:17 ET
Table 'Abundantia III' 6-max Seat #5 is the button
Seat 1: spidernet ($1.76 in chips) 
Seat 2: momonnez ($2.33 in chips) 
Seat 3: CashMatteo ($1.40 in chips) 
Seat 4: richard woo ($2.06 in chips) 
Seat 5: realkaliuchis ($1.29 in chips) 
spidernet: posts small blind $0.01
momonnez: posts big blind $0.02
*** HOLE CARDS ***
Dealt to CashMatteo [7h Qd]
CashMatteo: folds 
richard woo: folds 
realkaliuchis: calls $0.02
spidernet: calls $0.01
momonnez: checks 
*** FLOP *** [Kd 6c Td]
spidernet: checks 
momonnez: bets $0.03
realkaliuchis: folds 
spidernet: folds 
Uncalled bet ($0.03) returned to momonnez
momonnez collected $0.06 from pot
momonnez: doesn't show hand 
*** SUMMARY ***
Total pot $0.06 | Rake $0 
Board [Kd 6c Td]
Seat 1: spidernet (small blind) folded on the Flop
Seat 2: momonnez (big blind) collected ($0.06)
Seat 3: CashMatteo folded before Flop (didn't bet)
Seat 4: richard woo folded before Flop (didn't bet)
Seat 5: realkaliuchis (button) folded on the Flop

Hand #830: 

PokerStars Hand #246296002386:  Hold'em No Limit ($0.01/$0.02 CAD) - 2023/10/01 17:14:49 ET
Table 'Abundantia III' 6-max Seat #1 is the button
Seat 1: spidernet ($1.74 in chips) 
Seat 2: momonnez ($2.37 in chips) 
Seat 3: CashMatteo ($1.40 in chips) 
Seat 4: richard woo ($2.06 in chips) 
Seat 5: realkaliuchis ($1.27 in chips) 
momonnez: posts small blind $0.01
CashMatteo: posts big blind $0.02
*** HOLE CARDS ***
Dealt to CashMatteo [Qh Kh]
richard woo: folds 
realkaliuchis: calls $0.02
spidernet: calls $0.02
momonnez: folds 
CashMatteo: raises $0.04 to $0.06
realkaliuchis: folds 
spidernet: calls $0.04
*** FLOP *** [2s 2d 4d]
CashMatteo: checks 
spidernet: bets $0.02
CashMatteo: calls $0.02
*** TURN *** [2s 2d 4d] [2c]
CashMatteo: bets $0.09
spidernet: calls $0.09
*** RIVER *** [2s 2d 4d 2c] [Qs]
CashMatteo: bets $0.18
spidernet: raises $0.22 to $0.40
CashMatteo: calls $0.22
*** SHOW DOWN ***
spidernet: shows [4h 4s] (a full house, Fours full of Deuces)
CashMatteo: mucks hand 
spidernet collected $1.13 from pot
*** SUMMARY ***
Total pot $1.17 | Rake $0.04 
Board [2s 2d 4d 2c Qs]
Seat 1: spidernet (button) showed [4h 4s] and won ($1.13) with a full house, Fours full of Deuces
Seat 2: momonnez (small blind) folded before Flop
Seat 3: CashMatteo (big blind) mucked [Qh Kh]
Seat 4: richard woo folded before Flop (didn't bet)
Seat 5: realkaliuchis folded before Flop

Hand #831: 

PokerStars Hand #246296029292:  Hold'em No Limit ($0.01/$0.02 CAD) - 2023/10/01 17:15:48 ET
Table 'Abundantia III' 6-max Seat #2 is the button
Seat 1: spidernet ($2.30 in chips) 
Seat 2: momonnez ($2.36 in chips) 
Seat 3: CashMatteo ($0.83 in chips) 
Seat 4: richard woo ($2.06 in chips) 
Seat 5: realkaliuchis ($1.25 in chips) 
CashMatteo: posts small blind $0.01
richard woo: posts big blind $0.02
pink810251: sits out 
*** HOLE CARDS ***
Dealt to CashMatteo [Tc Ah]
realkaliuchis: folds 
spidernet: calls $0.02
momonnez: folds 
CashMatteo: raises $0.04 to $0.06
richard woo: calls $0.04
spidernet: calls $0.04
*** FLOP *** [Th Qh 4d]
CashMatteo: checks 
richard woo: checks 
spidernet: checks 
*** TURN *** [Th Qh 4d] [6h]
CashMatteo: bets $0.09
richard woo: calls $0.09
spidernet: folds 
*** RIVER *** [Th Qh 4d 6h] [Qc]
CashMatteo: checks 
richard woo: checks 
*** SHOW DOWN ***
CashMatteo: shows [Tc Ah] (two pair, Queens and Tens)
richard woo: mucks hand 
CashMatteo collected $0.35 from pot
*** SUMMARY ***
Total pot $0.36 | Rake $0.01 
Board [Th Qh 4d 6h Qc]
Seat 1: spidernet folded on the Turn
Seat 2: momonnez (button) folded before Flop (didn't bet)
Seat 3: CashMatteo (small blind) showed [Tc Ah] and won ($0.35) with two pair, Queens and Tens
Seat 4: richard woo (big blind) mucked [6d 7h]
Seat 5: realkaliuchis folded before Flop (didn't bet)

Hand #832: 

PokerStars Hand #246296054589:  Hold'em No Limit ($0.01/$0.02 CAD) - 2023/10/01 17:16:44 ET
Table 'Abundantia III' 6-max Seat #3 is the button
Seat 1: spidernet ($2.24 in chips) 
Seat 2: momonnez ($2.36 in chips) 
Seat 3: CashMatteo ($1.03 in chips) 
Seat 4: richard woo ($1.91 in chips) 
Seat 5: realkaliuchis ($1.25 in chips) 
richard woo: posts small blind $0.01
realkaliuchis: posts big blind $0.02
pink810251: sits out 
*** HOLE CARDS ***
Dealt to CashMatteo [7h 5h]
spidernet: calls $0.02
momonnez: folds 
CashMatteo: folds 
richard woo: calls $0.01
realkaliuchis: checks 
*** FLOP *** [Qh 8c Qs]
richard woo: checks 
realkaliuchis: checks 
spidernet: checks 
*** TURN *** [Qh 8c Qs] [6h]
richard woo: checks 
realkaliuchis: checks 
spidernet: bets $0.06
richard woo: folds 
realkaliuchis: calls $0.06
*** RIVER *** [Qh 8c Qs 6h] [3s]
realkaliuchis: checks 
spidernet: bets $0.08
realkaliuchis: calls $0.08
*** SHOW DOWN ***
spidernet: shows [Ad 8h] (two pair, Queens and Eights)
realkaliuchis: mucks hand 
spidernet collected $0.33 from pot
*** SUMMARY ***
Total pot $0.34 | Rake $0.01 
Board [Qh 8c Qs 6h 3s]
Seat 1: spidernet showed [Ad 8h] and won ($0.33) with two pair, Queens and Eights
Seat 2: momonnez folded before Flop (didn't bet)
Seat 3: CashMatteo (button) folded before Flop (didn't bet)
Seat 4: richard woo (small blind) folded on the Turn
Seat 5: realkaliuchis (big blind) mucked [Th Kh]

Hand #833: 

PokerStars Hand #246296078002:  Hold'em No Limit ($0.01/$0.02 CAD) - 2023/10/01 17:17:36 ET
Table 'Abundantia III' 6-max Seat #4 is the button
Seat 1: spidernet ($2.41 in chips) 
Seat 2: momonnez ($2.36 in chips) 
Seat 3: CashMatteo ($1.03 in chips) 
Seat 4: richard woo ($1.89 in chips) 
Seat 5: realkaliuchis ($1.09 in chips) 
Seat 6: pink810251 ($0.71 in chips) 
realkaliuchis: posts small blind $0.01
pink810251: posts big blind $0.02
*** HOLE CARDS ***
Dealt to CashMatteo [5c 4h]
spidernet: folds 
momonnez: folds 
CashMatteo: folds 
richard woo: raises $0.04 to $0.06
realkaliuchis: folds 
pink810251: folds 
Uncalled bet ($0.04) returned to richard woo
richard woo collected $0.05 from pot
*** SUMMARY ***
Total pot $0.05 | Rake $0 
Seat 1: spidernet folded before Flop (didn't bet)
Seat 2: momonnez folded before Flop (didn't bet)
Seat 3: CashMatteo folded before Flop (didn't bet)
Seat 4: richard woo (button) collected ($0.05)
Seat 5: realkaliuchis (small blind) folded before Flop
Seat 6: pink810251 (big blind) folded before Flop

Hand #834: 

PokerStars Hand #246296089203:  Hold'em No Limit ($0.01/$0.02 CAD) - 2023/10/01 17:18:01 ET
Table 'Abundantia III' 6-max Seat #5 is the button
Seat 1: spidernet ($2.41 in chips) 
Seat 2: momonnez ($2.36 in chips) 
Seat 3: CashMatteo ($1.03 in chips) 
Seat 4: richard woo ($1.92 in chips) 
Seat 5: realkaliuchis ($1.08 in chips) 
Seat 6: pink810251 ($0.69 in chips) 
pink810251: posts small blind $0.01
spidernet: posts big blind $0.02
*** HOLE CARDS ***
Dealt to CashMatteo [5d 4h]
momonnez: folds 
CashMatteo: folds 
richard woo: folds 
realkaliuchis: calls $0.02
pink810251: folds 
spidernet: checks 
*** FLOP *** [5c Qh 8s]
spidernet: checks 
realkaliuchis: checks 
*** TURN *** [5c Qh 8s] [9h]
spidernet: bets $0.05
realkaliuchis: folds 
Uncalled bet ($0.05) returned to spidernet
spidernet collected $0.05 from pot
spidernet: doesn't show hand 
*** SUMMARY ***
Total pot $0.05 | Rake $0 
Board [5c Qh 8s 9h]
Seat 1: spidernet (big blind) collected ($0.05)
Seat 2: momonnez folded before Flop (didn't bet)
Seat 3: CashMatteo folded before Flop (didn't bet)
Seat 4: richard woo folded before Flop (didn't bet)
Seat 5: realkaliuchis (button) folded on the Turn
Seat 6: pink810251 (small blind) folded before Flop

Hand #835: 

PokerStars Hand #246296101660:  Hold'em No Limit ($0.01/$0.02 CAD) - 2023/10/01 17:18:28 ET
Table 'Abundantia III' 6-max Seat #6 is the button
Seat 1: spidernet ($2.44 in chips) 
Seat 2: momonnez ($2.36 in chips) 
Seat 3: CashMatteo ($1.03 in chips) 
Seat 4: richard woo ($1.92 in chips) 
Seat 5: realkaliuchis ($1.06 in chips) 
Seat 6: pink810251 ($0.68 in chips) 
spidernet: posts small blind $0.01
momonnez: posts big blind $0.02
*** HOLE CARDS ***
Dealt to CashMatteo [2d 3h]
CashMatteo: folds 
richard woo: folds 
realkaliuchis: calls $0.02
pink810251: folds 
spidernet: calls $0.01
momonnez: checks 
*** FLOP *** [Ks 2h Jc]
spidernet: checks 
momonnez: checks 
realkaliuchis: checks 
*** TURN *** [Ks 2h Jc] [Ah]
spidernet: checks 
momonnez: bets $0.06
realkaliuchis: calls $0.06
spidernet: folds 
*** RIVER *** [Ks 2h Jc Ah] [2s]
momonnez: checks 
realkaliuchis: bets $0.02
momonnez: calls $0.02
*** SHOW DOWN ***
realkaliuchis: shows [5d As] (two pair, Aces and Deuces)
momonnez: mucks hand 
realkaliuchis collected $0.21 from pot
*** SUMMARY ***
Total pot $0.22 | Rake $0.01 
Board [Ks 2h Jc Ah 2s]
Seat 1: spidernet (small blind) folded on the Turn
Seat 2: momonnez (big blind) mucked [6d 7s]
Seat 3: CashMatteo folded before Flop (didn't bet)
Seat 4: richard woo folded before Flop (didn't bet)
Seat 5: realkaliuchis showed [5d As] and won ($0.21) with two pair, Aces and Deuces
Seat 6: pink810251 (button) folded before Flop (didn't bet)

Hand #836: 

PokerStars Hand #246296121515:  Hold'em No Limit ($0.01/$0.02 CAD) - 2023/10/01 17:19:12 ET
Table 'Abundantia III' 6-max Seat #1 is the button
Seat 1: spidernet ($2.42 in chips) 
Seat 2: momonnez ($2.26 in chips) 
Seat 3: CashMatteo ($1.03 in chips) 
Seat 4: richard woo ($1.92 in chips) 
Seat 5: realkaliuchis ($1.17 in chips) 
Seat 6: pink810251 ($0.68 in chips) 
momonnez: posts small blind $0.01
CashMatteo: posts big blind $0.02
*** HOLE CARDS ***
Dealt to CashMatteo [Tc 4h]
richard woo: folds 
realkaliuchis: folds 
pink810251: folds 
spidernet: raises $0.06 to $0.08
momonnez: folds 
CashMatteo: folds 
Uncalled bet ($0.06) returned to spidernet
spidernet collected $0.05 from pot
spidernet: doesn't show hand 
*** SUMMARY ***
Total pot $0.05 | Rake $0 
Seat 1: spidernet (button) collected ($0.05)
Seat 2: momonnez (small blind) folded before Flop
Seat 3: CashMatteo (big blind) folded before Flop
Seat 4: richard woo folded before Flop (didn't bet)
Seat 5: realkaliuchis folded before Flop (didn't bet)
Seat 6: pink810251 folded before Flop (didn't bet)

Hand #837: 

PokerStars Hand #246296129141:  Hold'em No Limit ($0.01/$0.02 CAD) - 2023/10/01 17:19:30 ET
Table 'Abundantia III' 6-max Seat #2 is the button
Seat 1: spidernet ($2.45 in chips) 
Seat 2: momonnez ($2.25 in chips) 
Seat 3: CashMatteo ($1.01 in chips) 
Seat 4: richard woo ($1.92 in chips) 
Seat 5: realkaliuchis ($1.17 in chips) 
Seat 6: pink810251 ($0.68 in chips) 
CashMatteo: posts small blind $0.01
richard woo: posts big blind $0.02
*** HOLE CARDS ***
Dealt to CashMatteo [5h 8s]
realkaliuchis: calls $0.02
pink810251: folds 
spidernet: raises $0.06 to $0.08
momonnez: folds 
CashMatteo: folds 
richard woo: calls $0.06
realkaliuchis: folds 
*** FLOP *** [Ks 7s 2d]
richard woo: checks 
spidernet: bets $0.09
richard woo: calls $0.09
*** TURN *** [Ks 7s 2d] [As]
richard woo: checks 
spidernet: checks 
*** RIVER *** [Ks 7s 2d As] [9c]
richard woo: checks 
spidernet: checks 
*** SHOW DOWN ***
richard woo: shows [5c 7c] (a pair of Sevens)
spidernet: shows [Js Jd] (a pair of Jacks)
spidernet collected $0.36 from pot
*** SUMMARY ***
Total pot $0.37 | Rake $0.01 
Board [Ks 7s 2d As 9c]
Seat 1: spidernet showed [Js Jd] and won ($0.36) with a pair of Jacks
Seat 2: momonnez (button) folded before Flop (didn't bet)
Seat 3: CashMatteo (small blind) folded before Flop
Seat 4: richard woo (big blind) showed [5c 7c] and lost with a pair of Sevens
Seat 5: realkaliuchis folded before Flop
Seat 6: pink810251 folded before Flop (didn't bet)

Hand #838: 

PokerStars Hand #246296147709:  Hold'em No Limit ($0.01/$0.02 CAD) - 2023/10/01 17:20:11 ET
Table 'Abundantia III' 6-max Seat #3 is the button
Seat 1: spidernet ($2.64 in chips) 
Seat 2: momonnez ($2.25 in chips) 
Seat 3: CashMatteo ($1 in chips) 
Seat 4: richard woo ($1.75 in chips) 
Seat 5: realkaliuchis ($1.15 in chips) 
Seat 6: pink810251 ($0.68 in chips) 
richard woo: posts small blind $0.01
realkaliuchis: posts big blind $0.02
*** HOLE CARDS ***
Dealt to CashMatteo [5c Ah]
pink810251: folds 
spidernet: folds 
momonnez: raises $0.04 to $0.06
CashMatteo: calls $0.06
richard woo: calls $0.05
realkaliuchis: folds 
*** FLOP *** [Qd 4s 3c]
richard woo: checks 
momonnez: bets $0.10
CashMatteo: calls $0.10
richard woo: calls $0.10
*** TURN *** [Qd 4s 3c] [2h]
richard woo: checks 
momonnez: checks 
CashMatteo: checks 
*** RIVER *** [Qd 4s 3c 2h] [Kd]
richard woo: checks 
momonnez: bets $0.24
CashMatteo: raises $0.44 to $0.68
richard woo: folds 
momonnez: calls $0.44
*** SHOW DOWN ***
CashMatteo: shows [5c Ah] (a straight, Ace to Five)
momonnez: mucks hand 
CashMatteo collected $1.79 from pot
*** SUMMARY ***
Total pot $1.86 | Rake $0.07 
Board [Qd 4s 3c 2h Kd]
Seat 1: spidernet folded before Flop (didn't bet)
Seat 2: momonnez mucked [Ac Ks]
Seat 3: CashMatteo (button) showed [5c Ah] and won ($1.79) with a straight, Ace to Five
Seat 4: richard woo (small blind) folded on the River
Seat 5: realkaliuchis (big blind) folded before Flop
Seat 6: pink810251 folded before Flop (didn't bet)

Hand #839: 

PokerStars Hand #246296181879:  Hold'em No Limit ($0.01/$0.02 CAD) - 2023/10/01 17:21:28 ET
Table 'Abundantia III' 6-max Seat #4 is the button
Seat 1: spidernet ($2.64 in chips) 
Seat 2: momonnez ($1.41 in chips) 
Seat 3: CashMatteo ($1.95 in chips) 
Seat 4: richard woo ($1.59 in chips) 
Seat 5: realkaliuchis ($1.13 in chips) 
Seat 6: pink810251 ($0.68 in chips) 
realkaliuchis: posts small blind $0.01
pink810251: posts big blind $0.02
*** HOLE CARDS ***
Dealt to CashMatteo [Kc Ad]
spidernet: folds 
momonnez: raises $0.04 to $0.06
CashMatteo: raises $0.10 to $0.16
richard woo: folds 
realkaliuchis: folds 
pink810251: folds 
momonnez: calls $0.10
*** FLOP *** [6h 5d 4d]
momonnez: checks 
CashMatteo: checks 
*** TURN *** [6h 5d 4d] [Jc]
momonnez: bets $0.17
CashMatteo: calls $0.17
*** RIVER *** [6h 5d 4d Jc] [As]
momonnez: checks 
CashMatteo: bets $0.28
momonnez: folds 
Uncalled bet ($0.28) returned to CashMatteo
CashMatteo collected $0.67 from pot
CashMatteo: doesn't show hand 
*** SUMMARY ***
Total pot $0.69 | Rake $0.02 
Board [6h 5d 4d Jc As]
Seat 1: spidernet folded before Flop (didn't bet)
Seat 2: momonnez folded on the River
Seat 3: CashMatteo collected ($0.67)
Seat 4: richard woo (button) folded before Flop (didn't bet)
Seat 5: realkaliuchis (small blind) folded before Flop
Seat 6: pink810251 (big blind) folded before Flop

Hand #840: 

PokerStars Hand #246296206481:  Hold'em No Limit ($0.01/$0.02 CAD) - 2023/10/01 17:22:23 ET
Table 'Abundantia III' 6-max Seat #5 is the button
Seat 1: spidernet ($2.64 in chips) 
Seat 2: momonnez ($1.08 in chips) 
Seat 3: CashMatteo ($2.29 in chips) 
Seat 4: richard woo ($1.59 in chips) 
Seat 5: realkaliuchis ($1.12 in chips) 
Seat 6: pink810251 ($0.66 in chips) 
pink810251: posts small blind $0.01
spidernet: posts big blind $0.02
*** HOLE CARDS ***
Dealt to CashMatteo [4h 3s]
momonnez: folds 
CashMatteo: folds 
richard woo: folds 
realkaliuchis: calls $0.02
pink810251: raises $0.02 to $0.04
spidernet: calls $0.02
realkaliuchis: calls $0.02
*** FLOP *** [Kh 6s 3h]
pink810251: bets $0.12
spidernet: folds 
realkaliuchis: calls $0.12
*** TURN *** [Kh 6s 3h] [Jh]
pink810251: bets $0.35
realkaliuchis: calls $0.35
*** RIVER *** [Kh 6s 3h Jh] [2d]
pink810251: checks 
realkaliuchis: bets $0.10
pink810251: calls $0.10
*** SHOW DOWN ***
realkaliuchis: shows [Ah 9h] (a flush, Ace high)
pink810251: mucks hand 
realkaliuchis collected $1.22 from pot
*** SUMMARY ***
Total pot $1.26 | Rake $0.04 
Board [Kh 6s 3h Jh 2d]
Seat 1: spidernet (big blind) folded on the Flop
Seat 2: momonnez folded before Flop (didn't bet)
Seat 3: CashMatteo folded before Flop (didn't bet)
Seat 4: richard woo folded before Flop (didn't bet)
Seat 5: realkaliuchis (button) showed [Ah 9h] and won ($1.22) with a flush, Ace high
Seat 6: pink810251 (small blind) mucked [Ad Td]

Hand #841: 

PokerStars Hand #246296229872:  Hold'em No Limit ($0.01/$0.02 CAD) - 2023/10/01 17:23:15 ET
Table 'Abundantia III' 6-max Seat #6 is the button
Seat 1: spidernet ($2.60 in chips) 
Seat 2: momonnez ($1.08 in chips) 
Seat 3: CashMatteo ($2.29 in chips) 
Seat 4: richard woo ($1.59 in chips) 
Seat 5: realkaliuchis ($1.73 in chips) 
Seat 6: pink810251 ($0.05 in chips) 
spidernet: posts small blind $0.01
momonnez: posts big blind $0.02
*** HOLE CARDS ***
Dealt to CashMatteo [3c Jc]
CashMatteo: calls $0.02
richard woo: folds 
realkaliuchis: calls $0.02
pink810251: folds 
spidernet: calls $0.01
momonnez: checks 
*** FLOP *** [6c Qh Ts]
spidernet: checks 
momonnez: checks 
CashMatteo: checks 
realkaliuchis: bets $0.02
spidernet: folds 
momonnez: folds 
CashMatteo: folds 
Uncalled bet ($0.02) returned to realkaliuchis
realkaliuchis collected $0.08 from pot
realkaliuchis: doesn't show hand 
*** SUMMARY ***
Total pot $0.08 | Rake $0 
Board [6c Qh Ts]
Seat 1: spidernet (small blind) folded on the Flop
Seat 2: momonnez (big blind) folded on the Flop
Seat 3: CashMatteo folded on the Flop
Seat 4: richard woo folded before Flop (didn't bet)
Seat 5: realkaliuchis collected ($0.08)
Seat 6: pink810251 (button) folded before Flop (didn't bet)

Hand #842: 

PokerStars Hand #246296249842:  Hold'em No Limit ($0.01/$0.02 CAD) - 2023/10/01 17:24:01 ET
Table 'Abundantia III' 6-max Seat #1 is the button
Seat 1: spidernet ($2.58 in chips) 
Seat 2: momonnez ($1.06 in chips) 
Seat 3: CashMatteo ($2.27 in chips) 
Seat 4: richard woo ($1.59 in chips) 
Seat 5: realkaliuchis ($1.79 in chips) 
Seat 6: pink810251 ($0.05 in chips) 
momonnez: posts small blind $0.01
CashMatteo: posts big blind $0.02
*** HOLE CARDS ***
Dealt to CashMatteo [7c Tc]
richard woo: folds 
realkaliuchis: calls $0.02
pink810251: folds 
spidernet: folds 
momonnez: raises $0.04 to $0.06
CashMatteo: calls $0.04
realkaliuchis: folds 
*** FLOP *** [5h Js 4d]
momonnez: bets $0.07
CashMatteo: folds 
Uncalled bet ($0.07) returned to momonnez
momonnez collected $0.14 from pot
momonnez: doesn't show hand 
*** SUMMARY ***
Total pot $0.14 | Rake $0 
Board [5h Js 4d]
Seat 1: spidernet (button) folded before Flop (didn't bet)
Seat 2: momonnez (small blind) collected ($0.14)
Seat 3: CashMatteo (big blind) folded on the Flop
Seat 4: richard woo folded before Flop (didn't bet)
Seat 5: realkaliuchis folded before Flop
Seat 6: pink810251 folded before Flop (didn't bet)

Hand #843: 

PokerStars Hand #246296262536:  Hold'em No Limit ($0.01/$0.02 CAD) - 2023/10/01 17:24:29 ET
Table 'Abundantia III' 6-max Seat #2 is the button
Seat 1: spidernet ($2.58 in chips) 
Seat 2: momonnez ($1.14 in chips) 
Seat 3: CashMatteo ($2.21 in chips) 
Seat 4: richard woo ($1.59 in chips) 
Seat 5: realkaliuchis ($1.77 in chips) 
Seat 6: pink810251 ($0.05 in chips) 
CashMatteo: posts small blind $0.01
richard woo: posts big blind $0.02
*** HOLE CARDS ***
Dealt to CashMatteo [4h 7s]
realkaliuchis: calls $0.02
pink810251: raises $0.02 to $0.04
spidernet: calls $0.04
momonnez: raises $0.17 to $0.21
CashMatteo: folds 
richard woo: folds 
realkaliuchis: folds 
pink810251: calls $0.01 and is all-in
spidernet: calls $0.17
*** FLOP *** [Js 2c Tc]
spidernet: checks 
momonnez: checks 
*** TURN *** [Js 2c Tc] [8c]
spidernet: bets $0.50
momonnez: calls $0.50
*** RIVER *** [Js 2c Tc 8c] [2h]
spidernet: checks 
momonnez: checks 
*** SHOW DOWN ***
spidernet: shows [Jh Td] (two pair, Jacks and Tens)
momonnez: mucks hand 
spidernet collected $1.28 from side pot
pink810251: mucks hand 
spidernet collected $0.19 from main pot
*** SUMMARY ***
Total pot $1.52 Main pot $0.19. Side pot $1.28. | Rake $0.05 
Board [Js 2c Tc 8c 2h]
Seat 1: spidernet showed [Jh Td] and won ($1.47) with two pair, Jacks and Tens
Seat 2: momonnez (button) mucked [Ac Qh]
Seat 3: CashMatteo (small blind) folded before Flop
Seat 4: richard woo (big blind) folded before Flop
Seat 5: realkaliuchis folded before Flop
Seat 6: pink810251 mucked [5d Ad]

Hand #844: 

PokerStars Hand #246296291121:  Hold'em No Limit ($0.01/$0.02 CAD) - 2023/10/01 17:25:34 ET
Table 'Abundantia III' 6-max Seat #3 is the button
Seat 1: spidernet ($3.34 in chips) 
Seat 2: momonnez ($0.43 in chips) 
Seat 3: CashMatteo ($2.20 in chips) 
Seat 4: richard woo ($1.57 in chips) 
Seat 5: realkaliuchis ($1.75 in chips) 
richard woo: posts small blind $0.01
realkaliuchis: posts big blind $0.02
*** HOLE CARDS ***
Dealt to CashMatteo [5s 5d]
spidernet: folds 
momonnez: folds 
CashMatteo: raises $0.04 to $0.06
richard woo: folds 
realkaliuchis: folds 
Uncalled bet ($0.04) returned to CashMatteo
CashMatteo collected $0.05 from pot
CashMatteo: doesn't show hand 
*** SUMMARY ***
Total pot $0.05 | Rake $0 
Seat 1: spidernet folded before Flop (didn't bet)
Seat 2: momonnez folded before Flop (didn't bet)
Seat 3: CashMatteo (button) collected ($0.05)
Seat 4: richard woo (small blind) folded before Flop
Seat 5: realkaliuchis (big blind) folded before Flop

Hand #845: 

PokerStars Hand #246296298692:  Hold'em No Limit ($0.01/$0.02 CAD) - 2023/10/01 17:25:51 ET
Table 'Abundantia III' 6-max Seat #4 is the button
Seat 1: spidernet ($3.34 in chips) 
Seat 2: momonnez ($0.43 in chips) 
Seat 3: CashMatteo ($2.23 in chips) 
Seat 4: richard woo ($1.56 in chips) 
Seat 5: realkaliuchis ($1.73 in chips) 
Seat 6: pink810251 ($0.80 in chips) 
realkaliuchis: posts small blind $0.01
pink810251: posts big blind $0.02
*** HOLE CARDS ***
Dealt to CashMatteo [Th 9s]
spidernet: folds 
momonnez: folds 
CashMatteo: calls $0.02
richard woo: folds 
realkaliuchis: calls $0.01
pink810251: checks 
*** FLOP *** [Ac Ks 8d]
realkaliuchis: bets $0.02
pink810251: folds 
CashMatteo: folds 
Uncalled bet ($0.02) returned to realkaliuchis
realkaliuchis collected $0.06 from pot
realkaliuchis: doesn't show hand 
*** SUMMARY ***
Total pot $0.06 | Rake $0 
Board [Ac Ks 8d]
Seat 1: spidernet folded before Flop (didn't bet)
Seat 2: momonnez folded before Flop (didn't bet)
Seat 3: CashMatteo folded on the Flop
Seat 4: richard woo (button) folded before Flop (didn't bet)
Seat 5: realkaliuchis (small blind) collected ($0.06)
Seat 6: pink810251 (big blind) folded on the Flop

Hand #846: 

PokerStars Hand #246296308696:  Hold'em No Limit ($0.01/$0.02 CAD) - 2023/10/01 17:26:13 ET
Table 'Abundantia III' 6-max Seat #5 is the button
Seat 1: spidernet ($3.34 in chips) 
Seat 2: momonnez ($0.43 in chips) 
Seat 3: CashMatteo ($2.21 in chips) 
Seat 4: richard woo ($1.56 in chips) 
Seat 5: realkaliuchis ($1.77 in chips) 
Seat 6: pink810251 ($0.78 in chips) 
pink810251: posts small blind $0.01
spidernet: posts big blind $0.02
*** HOLE CARDS ***
Dealt to CashMatteo [9d As]
momonnez: folds 
CashMatteo: raises $0.04 to $0.06
richard woo: calls $0.06
realkaliuchis: calls $0.06
pink810251: folds 
spidernet: calls $0.04
*** FLOP *** [6s 4d Th]
spidernet: checks 
CashMatteo: bets $0.12
richard woo: folds 
realkaliuchis: folds 
spidernet: folds 
Uncalled bet ($0.12) returned to CashMatteo
CashMatteo collected $0.24 from pot
CashMatteo: doesn't show hand 
*** SUMMARY ***
Total pot $0.25 | Rake $0.01 
Board [6s 4d Th]
Seat 1: spidernet (big blind) folded on the Flop
Seat 2: momonnez folded before Flop (didn't bet)
Seat 3: CashMatteo collected ($0.24)
Seat 4: richard woo folded on the Flop
Seat 5: realkaliuchis (button) folded on the Flop
Seat 6: pink810251 (small blind) folded before Flop

Hand #847: 

PokerStars Hand #246296327937:  Hold'em No Limit ($0.01/$0.02 CAD) - 2023/10/01 17:26:56 ET
Table 'Abundantia III' 6-max Seat #6 is the button
Seat 1: spidernet ($3.28 in chips) 
Seat 2: momonnez ($0.43 in chips) 
Seat 3: CashMatteo ($2.39 in chips) 
Seat 4: richard woo ($1.50 in chips) 
Seat 5: realkaliuchis ($1.71 in chips) 
Seat 6: pink810251 ($0.77 in chips) 
spidernet: posts small blind $0.01
momonnez: posts big blind $0.02
*** HOLE CARDS ***
Dealt to CashMatteo [Qs Qd]
CashMatteo: raises $0.04 to $0.06
richard woo: raises $0.10 to $0.16
realkaliuchis: folds 
pink810251: folds 
spidernet: folds 
momonnez: raises $0.27 to $0.43 and is all-in
CashMatteo: raises $1.96 to $2.39 and is all-in
richard woo: folds 
Uncalled bet ($1.96) returned to CashMatteo
*** FLOP *** [3s 7h Js]
*** TURN *** [3s 7h Js] [Ts]
*** RIVER *** [3s 7h Js Ts] [Ac]
*** SHOW DOWN ***
momonnez: shows [Qc Kc] (a straight, Ten to Ace)
CashMatteo: shows [Qs Qd] (a pair of Queens)
momonnez collected $0.99 from pot
*** SUMMARY ***
Total pot $1.03 | Rake $0.04 
Board [3s 7h Js Ts Ac]
Seat 1: spidernet (small blind) folded before Flop
Seat 2: momonnez (big blind) showed [Qc Kc] and won ($0.99) with a straight, Ten to Ace
Seat 3: CashMatteo showed [Qs Qd] and lost with a pair of Queens
Seat 4: richard woo folded before Flop
Seat 5: realkaliuchis folded before Flop (didn't bet)
Seat 6: pink810251 (button) folded before Flop (didn't bet)

Hand #848: 

PokerStars Hand #246296347217:  Hold'em No Limit ($0.01/$0.02 CAD) - 2023/10/01 17:27:40 ET
Table 'Abundantia III' 6-max Seat #1 is the button
Seat 1: spidernet ($3.27 in chips) 
Seat 2: momonnez ($0.99 in chips) 
Seat 3: CashMatteo ($1.96 in chips) 
Seat 4: richard woo ($1.34 in chips) 
Seat 5: realkaliuchis ($1.71 in chips) 
Seat 6: pink810251 ($0.77 in chips) 
momonnez: posts small blind $0.01
CashMatteo: posts big blind $0.02
*** HOLE CARDS ***
Dealt to CashMatteo [2d 9s]
richard woo: raises $0.04 to $0.06
realkaliuchis: calls $0.06
pink810251 has timed out
pink810251: folds 
spidernet: folds 
momonnez: calls $0.05
CashMatteo: folds 
*** FLOP *** [4h Js 4c]
momonnez: checks 
richard woo: bets $0.12
realkaliuchis: folds 
momonnez: folds 
Uncalled bet ($0.12) returned to richard woo
richard woo collected $0.19 from pot
*** SUMMARY ***
Total pot $0.20 | Rake $0.01 
Board [4h Js 4c]
Seat 1: spidernet (button) folded before Flop (didn't bet)
Seat 2: momonnez (small blind) folded on the Flop
Seat 3: CashMatteo (big blind) folded before Flop
Seat 4: richard woo collected ($0.19)
Seat 5: realkaliuchis folded on the Flop
Seat 6: pink810251 folded before Flop (didn't bet)

Hand #849: 

PokerStars Hand #246296369209:  Hold'em No Limit ($0.01/$0.02 CAD) - 2023/10/01 17:28:29 ET
Table 'Abundantia III' 6-max Seat #2 is the button
Seat 1: spidernet ($3.27 in chips) 
Seat 2: momonnez ($0.93 in chips) 
Seat 3: CashMatteo ($1.94 in chips) 
Seat 4: richard woo ($1.47 in chips) 
Seat 5: realkaliuchis ($1.65 in chips) 
Seat 6: pink810251 ($0.77 in chips) 
CashMatteo: posts small blind $0.01
richard woo: posts big blind $0.02
*** HOLE CARDS ***
Dealt to CashMatteo [2d 3d]
realkaliuchis: calls $0.02
pink810251: folds 
spidernet: folds 
momonnez: folds 
CashMatteo: calls $0.01
richard woo: checks 
*** FLOP *** [8c 5d Ad]
CashMatteo: bets $0.03
richard woo: calls $0.03
realkaliuchis: calls $0.03
*** TURN *** [8c 5d Ad] [4h]
CashMatteo: bets $0.14
richard woo: folds 
realkaliuchis: folds 
Uncalled bet ($0.14) returned to CashMatteo
CashMatteo collected $0.14 from pot
CashMatteo: doesn't show hand 
*** SUMMARY ***
Total pot $0.15 | Rake $0.01 
Board [8c 5d Ad 4h]
Seat 1: spidernet folded before Flop (didn't bet)
Seat 2: momonnez (button) folded before Flop (didn't bet)
Seat 3: CashMatteo (small blind) collected ($0.14)
Seat 4: richard woo (big blind) folded on the Turn
Seat 5: realkaliuchis folded on the Turn
Seat 6: pink810251 folded before Flop (didn't bet)

Hand #850: 

PokerStars Hand #246296391019:  Hold'em No Limit ($0.01/$0.02 CAD) - 2023/10/01 17:29:19 ET
Table 'Abundantia III' 6-max Seat #3 is the button
Seat 1: spidernet ($3.27 in chips) 
Seat 2: momonnez ($0.93 in chips) 
Seat 3: CashMatteo ($2.03 in chips) 
Seat 4: richard woo ($1.42 in chips) 
Seat 5: realkaliuchis ($1.60 in chips) 
Seat 6: pink810251 ($0.77 in chips) 
richard woo: posts small blind $0.01
realkaliuchis: posts big blind $0.02
*** HOLE CARDS ***
Dealt to CashMatteo [Th 2h]
pink810251: folds 
spidernet: folds 
momonnez: raises $0.04 to $0.06
CashMatteo: folds 
richard woo: folds 
realkaliuchis: folds 
Uncalled bet ($0.04) returned to momonnez
momonnez collected $0.05 from pot
momonnez: doesn't show hand 
*** SUMMARY ***
Total pot $0.05 | Rake $0 
Seat 1: spidernet folded before Flop (didn't bet)
Seat 2: momonnez collected ($0.05)
Seat 3: CashMatteo (button) folded before Flop (didn't bet)
Seat 4: richard woo (small blind) folded before Flop
Seat 5: realkaliuchis (big blind) folded before Flop
Seat 6: pink810251 folded before Flop (didn't bet)

Hand #851: 

PokerStars Hand #246296400169:  Hold'em No Limit ($0.01/$0.02 CAD) - 2023/10/01 17:29:40 ET
Table 'Abundantia III' 6-max Seat #4 is the button
Seat 1: spidernet ($3.27 in chips) 
Seat 2: momonnez ($0.96 in chips) 
Seat 3: CashMatteo ($2.03 in chips) 
Seat 4: richard woo ($1.41 in chips) 
Seat 5: realkaliuchis ($1.58 in chips) 
Seat 6: pink810251 ($0.77 in chips) 
realkaliuchis: posts small blind $0.01
pink810251: posts big blind $0.02
*** HOLE CARDS ***
Dealt to CashMatteo [Th 5h]
spidernet: folds 
momonnez: folds 
CashMatteo: folds 
richard woo: folds 
realkaliuchis: calls $0.01
pink810251: checks 
*** FLOP *** [4d 6h 2c]
realkaliuchis: checks 
pink810251: checks 
*** TURN *** [4d 6h 2c] [8c]
realkaliuchis: checks 
pink810251 has timed out
pink810251: checks 
*** RIVER *** [4d 6h 2c 8c] [2d]
realkaliuchis: checks 
pink810251 has timed out
pink810251: checks 
*** SHOW DOWN ***
realkaliuchis: shows [Ad 7c] (a pair of Deuces)
pink810251: mucks hand 
realkaliuchis collected $0.04 from pot
*** SUMMARY ***
Total pot $0.04 | Rake $0 
Board [4d 6h 2c 8c 2d]
Seat 1: spidernet folded before Flop (didn't bet)
Seat 2: momonnez folded before Flop (didn't bet)
Seat 3: CashMatteo folded before Flop (didn't bet)
Seat 4: richard woo (button) folded before Flop (didn't bet)
Seat 5: realkaliuchis (small blind) showed [Ad 7c] and won ($0.04) with a pair of Deuces
Seat 6: pink810251 (big blind) mucked [Qc 9s]

Hand #852: 

PokerStars Hand #246296445390:  Hold'em No Limit ($0.01/$0.02 CAD) - 2023/10/01 17:31:23 ET
Table 'Abundantia III' 6-max Seat #5 is the button
Seat 1: spidernet ($3.27 in chips) 
Seat 2: momonnez ($0.96 in chips) 
Seat 3: CashMatteo ($2.03 in chips) 
Seat 4: richard woo ($1.41 in chips) 
Seat 5: realkaliuchis ($1.60 in chips) 
spidernet: posts small blind $0.01
momonnez: posts big blind $0.02
*** HOLE CARDS ***
Dealt to CashMatteo [Qh Kh]
CashMatteo: raises $0.04 to $0.06
richard woo: folds 
realkaliuchis: folds 
spidernet: folds 
momonnez: folds 
Uncalled bet ($0.04) returned to CashMatteo
CashMatteo collected $0.05 from pot
CashMatteo: doesn't show hand 
*** SUMMARY ***
Total pot $0.05 | Rake $0 
Seat 1: spidernet (small blind) folded before Flop
Seat 2: momonnez (big blind) folded before Flop
Seat 3: CashMatteo collected ($0.05)
Seat 4: richard woo folded before Flop (didn't bet)
Seat 5: realkaliuchis (button) folded before Flop (didn't bet)

Hand #853: 

PokerStars Hand #246296455171:  Hold'em No Limit ($0.01/$0.02 CAD) - 2023/10/01 17:31:46 ET
Table 'Abundantia III' 6-max Seat #1 is the button
Seat 1: spidernet ($3.26 in chips) 
Seat 2: momonnez ($0.94 in chips) 
Seat 3: CashMatteo ($2.06 in chips) 
Seat 4: richard woo ($1.41 in chips) 
Seat 5: realkaliuchis ($1.60 in chips) 
momonnez: posts small blind $0.01
CashMatteo: posts big blind $0.02
*** HOLE CARDS ***
Dealt to CashMatteo [Qc Ac]
richard woo: folds 
realkaliuchis: folds 
pink810251 leaves the table
realkaliuchis leaves the table
spidernet: folds 
momonnez: raises $0.04 to $0.06
Jstu17 joins the table at seat #5 
CashMatteo: raises $0.10 to $0.16
momonnez: folds 
Uncalled bet ($0.10) returned to CashMatteo
CashMatteo collected $0.12 from pot
CashMatteo: doesn't show hand 
*** SUMMARY ***
Total pot $0.12 | Rake $0 
Seat 1: spidernet (button) folded before Flop (didn't bet)
Seat 2: momonnez (small blind) folded before Flop
Seat 3: CashMatteo (big blind) collected ($0.12)
Seat 4: richard woo folded before Flop (didn't bet)
Seat 5: realkaliuchis folded before Flop (didn't bet)

Hand #854: 

PokerStars Hand #246296468726:  Hold'em No Limit ($0.01/$0.02 CAD) - 2023/10/01 17:32:18 ET
Table 'Abundantia III' 6-max Seat #2 is the button
Seat 1: spidernet ($3.26 in chips) 
Seat 2: momonnez ($0.88 in chips) 
Seat 3: CashMatteo ($2.12 in chips) 
Seat 4: richard woo ($1.41 in chips) 
Seat 5: Jstu17 ($2 in chips) 
CashMatteo: posts small blind $0.01
richard woo: posts big blind $0.02
Jstu17: posts big blind $0.02
*** HOLE CARDS ***
Dealt to CashMatteo [7s 9c]
Jstu17: checks 
spidernet: folds 
momonnez: folds 
CashMatteo: folds 
richard woo: checks 
*** FLOP *** [4d Td 5s]
richard woo: checks 
Jstu17: checks 
*** TURN *** [4d Td 5s] [9d]
richard woo: bets $0.02
Jstu17: calls $0.02
*** RIVER *** [4d Td 5s 9d] [3c]
richard woo: bets $0.02
Jstu17: folds 
Uncalled bet ($0.02) returned to richard woo
richard woo collected $0.09 from pot
*** SUMMARY ***
Total pot $0.09 | Rake $0 
Board [4d Td 5s 9d 3c]
Seat 1: spidernet folded before Flop (didn't bet)
Seat 2: momonnez (button) folded before Flop (didn't bet)
Seat 3: CashMatteo (small blind) folded before Flop
Seat 4: richard woo (big blind) collected ($0.09)
Seat 5: Jstu17 folded on the River

Hand #855: 

PokerStars Hand #246296481568:  Hold'em No Limit ($0.01/$0.02 CAD) - 2023/10/01 17:32:47 ET
Table 'Abundantia III' 6-max Seat #3 is the button
Seat 1: spidernet ($3.26 in chips) 
Seat 2: momonnez ($0.88 in chips) 
Seat 3: CashMatteo ($2.11 in chips) 
Seat 4: richard woo ($1.46 in chips) 
Seat 5: Jstu17 ($1.96 in chips) 
richard woo: posts small blind $0.01
Jstu17: posts big blind $0.02
*** HOLE CARDS ***
Dealt to CashMatteo [7c Qs]
charlemaigne joins the table at seat #6 
spidernet: folds 
momonnez: raises $0.04 to $0.06
CashMatteo: folds 
richard woo: raises $0.18 to $0.24
Jstu17: folds 
momonnez: folds 
Uncalled bet ($0.18) returned to richard woo
richard woo collected $0.14 from pot
*** SUMMARY ***
Total pot $0.14 | Rake $0 
Seat 1: spidernet folded before Flop (didn't bet)
Seat 2: momonnez folded before Flop
Seat 3: CashMatteo (button) folded before Flop (didn't bet)
Seat 4: richard woo (small blind) collected ($0.14)
Seat 5: Jstu17 (big blind) folded before Flop

Hand #856: 

PokerStars Hand #246296492611:  Hold'em No Limit ($0.01/$0.02 CAD) - 2023/10/01 17:33:12 ET
Table 'Abundantia III' 6-max Seat #4 is the button
Seat 1: spidernet ($3.26 in chips) 
Seat 2: momonnez ($0.82 in chips) 
Seat 3: CashMatteo ($2.11 in chips) 
Seat 4: richard woo ($1.54 in chips) 
Seat 5: Jstu17 ($1.94 in chips) 
Seat 6: charlemaigne ($0.80 in chips) 
Jstu17: posts small blind $0.01
charlemaigne: posts big blind $0.02
*** HOLE CARDS ***
Dealt to CashMatteo [9s Ac]
spidernet: folds 
momonnez: folds 
CashMatteo: calls $0.02
richard woo: folds 
Jstu17: calls $0.01
charlemaigne: checks 
*** FLOP *** [Jc 2c Qd]
Jstu17: checks 
charlemaigne: checks 
CashMatteo: checks 
*** TURN *** [Jc 2c Qd] [Td]
Jstu17: checks 
charlemaigne: checks 
CashMatteo: bets $0.03
Jstu17: calls $0.03
charlemaigne: folds 
*** RIVER *** [Jc 2c Qd Td] [3s]
Jstu17: checks 
CashMatteo: checks 
*** SHOW DOWN ***
Jstu17: shows [Kh 8c] (high card King)
CashMatteo: shows [9s Ac] (high card Ace)
CashMatteo collected $0.12 from pot
*** SUMMARY ***
Total pot $0.12 | Rake $0 
Board [Jc 2c Qd Td 3s]
Seat 1: spidernet folded before Flop (didn't bet)
Seat 2: momonnez folded before Flop (didn't bet)
Seat 3: CashMatteo showed [9s Ac] and won ($0.12) with high card Ace
Seat 4: richard woo (button) folded before Flop (didn't bet)
Seat 5: Jstu17 (small blind) showed [Kh 8c] and lost with high card King
Seat 6: charlemaigne (big blind) folded on the Turn

Hand #857: 

PokerStars Hand #246296506477:  Hold'em No Limit ($0.01/$0.02 CAD) - 2023/10/01 17:33:45 ET
Table 'Abundantia III' 6-max Seat #5 is the button
Seat 1: spidernet ($3.26 in chips) 
Seat 2: momonnez ($0.82 in chips) 
Seat 3: CashMatteo ($2.18 in chips) 
Seat 4: richard woo ($1.54 in chips) 
Seat 5: Jstu17 ($1.89 in chips) 
Seat 6: charlemaigne ($0.78 in chips) 
charlemaigne: posts small blind $0.01
spidernet: posts big blind $0.02
*** HOLE CARDS ***
Dealt to CashMatteo [6c 8c]
momonnez: raises $0.04 to $0.06
CashMatteo: folds 
richard woo: calls $0.06
Jstu17: folds 
charlemaigne: folds 
spidernet: calls $0.04
*** FLOP *** [5h Kc Ac]
spidernet: checks 
momonnez: bets $0.09
richard woo: folds 
spidernet: calls $0.09
*** TURN *** [5h Kc Ac] [Jd]
spidernet: bets $0.40
momonnez: raises $0.27 to $0.67 and is all-in
spidernet: calls $0.27
*** RIVER *** [5h Kc Ac Jd] [7s]
*** SHOW DOWN ***
spidernet: shows [As 5d] (two pair, Aces and Fives)
momonnez: shows [Ad 9c] (a pair of Aces)
spidernet collected $1.65 from pot
*** SUMMARY ***
Total pot $1.71 | Rake $0.06 
Board [5h Kc Ac Jd 7s]
Seat 1: spidernet (big blind) showed [As 5d] and won ($1.65) with two pair, Aces and Fives
Seat 2: momonnez showed [Ad 9c] and lost with a pair of Aces
Seat 3: CashMatteo folded before Flop (didn't bet)
Seat 4: richard woo folded on the Flop
Seat 5: Jstu17 (button) folded before Flop (didn't bet)
Seat 6: charlemaigne (small blind) folded before Flop

Hand #858: 

PokerStars Hand #246296538421:  Hold'em No Limit ($0.01/$0.02 CAD) - 2023/10/01 17:34:58 ET
Table 'Abundantia III' 6-max Seat #6 is the button
Seat 1: spidernet ($4.09 in chips) 
Seat 3: CashMatteo ($2.18 in chips) 
Seat 4: richard woo ($1.48 in chips) 
Seat 5: Jstu17 ($1.89 in chips) 
Seat 6: charlemaigne ($0.77 in chips) 
spidernet: posts small blind $0.01
CashMatteo: posts big blind $0.02
*** HOLE CARDS ***
Dealt to CashMatteo [5h 5s]
richard woo: folds 
Jstu17: calls $0.02
charlemaigne: raises $0.04 to $0.06
spidernet: folds 
CashMatteo: calls $0.04
Jstu17: calls $0.04
*** FLOP *** [As 9d 2s]
CashMatteo: checks 
Jstu17: checks 
charlemaigne: checks 
*** TURN *** [As 9d 2s] [9c]
CashMatteo: bets $0.09
Jstu17: folds 
charlemaigne: calls $0.09
*** RIVER *** [As 9d 2s 9c] [8s]
CashMatteo: checks 
charlemaigne: checks 
*** SHOW DOWN ***
CashMatteo: shows [5h 5s] (two pair, Nines and Fives)
charlemaigne: shows [Jd Jc] (two pair, Jacks and Nines)
charlemaigne collected $0.36 from pot
*** SUMMARY ***
Total pot $0.37 | Rake $0.01 
Board [As 9d 2s 9c 8s]
Seat 1: spidernet (small blind) folded before Flop
Seat 3: CashMatteo (big blind) showed [5h 5s] and lost with two pair, Nines and Fives
Seat 4: richard woo folded before Flop (didn't bet)
Seat 5: Jstu17 folded on the Turn
Seat 6: charlemaigne (button) showed [Jd Jc] and won ($0.36) with two pair, Jacks and Nines

Hand #859: 

PokerStars Hand #246296555435:  Hold'em No Limit ($0.01/$0.02 CAD) - 2023/10/01 17:35:37 ET
Table 'Abundantia III' 6-max Seat #1 is the button
Seat 1: spidernet ($4.08 in chips) 
Seat 3: CashMatteo ($2.03 in chips) 
Seat 4: richard woo ($1.48 in chips) 
Seat 5: Jstu17 ($1.83 in chips) 
Seat 6: charlemaigne ($0.98 in chips) 
CashMatteo: posts small blind $0.01
richard woo: posts big blind $0.02
*** HOLE CARDS ***
Dealt to CashMatteo [8c 7s]
Jstu17: calls $0.02
charlemaigne: folds 
spidernet: calls $0.02
CashMatteo: folds 
richard woo: raises $0.10 to $0.12
Jstu17: calls $0.10
spidernet: calls $0.10
*** FLOP *** [Qh 6d 4c]
richard woo: bets $0.18
Jstu17: folds 
spidernet: folds 
Uncalled bet ($0.18) returned to richard woo
richard woo collected $0.36 from pot
momonnez is disconnected 
*** SUMMARY ***
Total pot $0.37 | Rake $0.01 
Board [Qh 6d 4c]
Seat 1: spidernet (button) folded on the Flop
Seat 3: CashMatteo (small blind) folded before Flop
Seat 4: richard woo (big blind) collected ($0.36)
Seat 5: Jstu17 folded on the Flop
Seat 6: charlemaigne folded before Flop (didn't bet)

Hand #860: 

PokerStars Hand #246296572001:  Hold'em No Limit ($0.01/$0.02 CAD) - 2023/10/01 17:36:15 ET
Table 'Abundantia III' 6-max Seat #3 is the button
Seat 1: spidernet ($3.96 in chips) 
Seat 3: CashMatteo ($2.02 in chips) 
Seat 4: richard woo ($1.72 in chips) 
Seat 5: Jstu17 ($1.71 in chips) 
Seat 6: charlemaigne ($0.98 in chips) 
richard woo: posts small blind $0.01
Jstu17: posts big blind $0.02
*** HOLE CARDS ***
Dealt to CashMatteo [8h 3h]
charlemaigne: raises $0.04 to $0.06
spidernet: calls $0.06
CashMatteo: folds 
richard woo: folds 
Jstu17: calls $0.04
*** FLOP *** [2c Qd 5c]
Jstu17: checks 
charlemaigne: checks 
spidernet: checks 
*** TURN *** [2c Qd 5c] [Qs]
Jstu17: checks 
charlemaigne: checks 
spidernet: bets $0.09
Jstu17: folds 
charlemaigne: calls $0.09
*** RIVER *** [2c Qd 5c Qs] [2d]
charlemaigne: checks 
spidernet: checks 
*** SHOW DOWN ***
charlemaigne: shows [Ad 9s] (two pair, Queens and Deuces)
spidernet: shows [Ah Ks] (two pair, Queens and Deuces)
charlemaigne collected $0.18 from pot
spidernet collected $0.18 from pot
*** SUMMARY ***
Total pot $0.37 | Rake $0.01 
Board [2c Qd 5c Qs 2d]
Seat 1: spidernet showed [Ah Ks] and won ($0.18) with two pair, Queens and Deuces
Seat 3: CashMatteo (button) folded before Flop (didn't bet)
Seat 4: richard woo (small blind) folded before Flop
Seat 5: Jstu17 (big blind) folded on the Turn
Seat 6: charlemaigne showed [Ad 9s] and won ($0.18) with two pair, Queens and Deuces

Hand #861: 

PokerStars Hand #246296591479:  Hold'em No Limit ($0.01/$0.02 CAD) - 2023/10/01 17:37:00 ET
Table 'Abundantia III' 6-max Seat #4 is the button
Seat 1: spidernet ($3.99 in chips) 
Seat 3: CashMatteo ($2.02 in chips) 
Seat 4: richard woo ($1.71 in chips) 
Seat 5: Jstu17 ($1.65 in chips) 
Seat 6: charlemaigne ($1.01 in chips) 
Jstu17: posts small blind $0.01
charlemaigne: posts big blind $0.02
*** HOLE CARDS ***
Dealt to CashMatteo [Kc 5s]
spidernet: folds 
CashMatteo: calls $0.02
richard woo: raises $0.06 to $0.08
Jstu17: folds 
charlemaigne: folds 
CashMatteo: folds 
Uncalled bet ($0.06) returned to richard woo
richard woo collected $0.07 from pot
*** SUMMARY ***
Total pot $0.07 | Rake $0 
Seat 1: spidernet folded before Flop (didn't bet)
Seat 3: CashMatteo folded before Flop
Seat 4: richard woo (button) collected ($0.07)
Seat 5: Jstu17 (small blind) folded before Flop
Seat 6: charlemaigne (big blind) folded before Flop

Hand #862: 

PokerStars Hand #246296600222:  Hold'em No Limit ($0.01/$0.02 CAD) - 2023/10/01 17:37:20 ET
Table 'Abundantia III' 6-max Seat #5 is the button
Seat 3: CashMatteo ($2 in chips) 
Seat 4: richard woo ($1.76 in chips) 
Seat 5: Jstu17 ($1.64 in chips) 
Seat 6: charlemaigne ($0.99 in chips) 
charlemaigne: posts small blind $0.01
spidernet: is sitting out 
CashMatteo: posts big blind $0.02
*** HOLE CARDS ***
Dealt to CashMatteo [8d 4s]
richard woo: folds 
Jstu17: folds 
charlemaigne: folds 
Uncalled bet ($0.01) returned to CashMatteo
CashMatteo collected $0.02 from pot
CashMatteo: doesn't show hand 
*** SUMMARY ***
Total pot $0.02 | Rake $0 
Seat 3: CashMatteo (big blind) collected ($0.02)
Seat 4: richard woo folded before Flop (didn't bet)
Seat 5: Jstu17 (button) folded before Flop (didn't bet)
Seat 6: charlemaigne (small blind) folded before Flop

Hand #863: 

PokerStars Hand #246296603894:  Hold'em No Limit ($0.01/$0.02 CAD) - 2023/10/01 17:37:29 ET
Table 'Abundantia III' 6-max Seat #6 is the button
Seat 3: CashMatteo ($2.01 in chips) 
Seat 4: richard woo ($1.76 in chips) 
Seat 5: Jstu17 ($1.64 in chips) 
Seat 6: charlemaigne ($0.98 in chips) 
CashMatteo: posts small blind $0.01
richard woo: posts big blind $0.02
*** HOLE CARDS ***
Dealt to CashMatteo [9d Ts]
Jstu17: calls $0.02
charlemaigne: raises $0.04 to $0.06
CashMatteo: folds 
richard woo: folds 
Jstu17: calls $0.04
*** FLOP *** [3c Ah 9c]
Jstu17: checks 
charlemaigne: bets $0.08
Jstu17: folds 
Uncalled bet ($0.08) returned to charlemaigne
charlemaigne collected $0.14 from pot
*** SUMMARY ***
Total pot $0.15 | Rake $0.01 
Board [3c Ah 9c]
Seat 3: CashMatteo (small blind) folded before Flop
Seat 4: richard woo (big blind) folded before Flop
Seat 5: Jstu17 folded on the Flop
Seat 6: charlemaigne (button) collected ($0.14)

Hand #864: 

PokerStars Hand #246296613336:  Hold'em No Limit ($0.01/$0.02 CAD) - 2023/10/01 17:37:51 ET
Table 'Abundantia III' 6-max Seat #3 is the button
Seat 3: CashMatteo ($2 in chips) 
Seat 4: richard woo ($1.74 in chips) 
Seat 5: Jstu17 ($1.58 in chips) 
Seat 6: charlemaigne ($1.06 in chips) 
richard woo: posts small blind $0.01
Jstu17: posts big blind $0.02
*** HOLE CARDS ***
Dealt to CashMatteo [Tc 2d]
charlemaigne: folds 
CashMatteo: folds 
richard woo: folds 
Uncalled bet ($0.01) returned to Jstu17
charlemaigne leaves the table
Jstu17 collected $0.02 from pot
*** SUMMARY ***
Total pot $0.02 | Rake $0 
Seat 3: CashMatteo (button) folded before Flop (didn't bet)
Seat 4: richard woo (small blind) folded before Flop
Seat 5: Jstu17 (big blind) collected ($0.02)
Seat 6: charlemaigne folded before Flop (didn't bet)

Hand #865: 

PokerStars Hand #246296618081:  Hold'em No Limit ($0.01/$0.02 CAD) - 2023/10/01 17:38:01 ET
Table 'Abundantia III' 6-max Seat #4 is the button
Seat 3: CashMatteo ($2 in chips) 
Seat 4: richard woo ($1.73 in chips) 
Seat 5: Jstu17 ($1.59 in chips) 
Jstu17: posts small blind $0.01
CashMatteo: posts big blind $0.02
*** HOLE CARDS ***
Dealt to CashMatteo [9c 8h]
richard woo: folds 
Jstu17: calls $0.01
CashMatteo: checks 
*** FLOP *** [Qh Ts 2s]
Jstu17: checks 
CashMatteo: checks 
*** TURN *** [Qh Ts 2s] [2h]
Jstu17: checks 
CashMatteo: bets $0.04
Jstu17: calls $0.04
*** RIVER *** [Qh Ts 2s 2h] [8s]
Jstu17: bets $0.02
CashMatteo: calls $0.02
*** SHOW DOWN ***
Jstu17: shows [5c Qd] (two pair, Queens and Deuces)
CashMatteo: mucks hand 
Jstu17 collected $0.15 from pot
*** SUMMARY ***
Total pot $0.16 | Rake $0.01 
Board [Qh Ts 2s 2h 8s]
Seat 3: CashMatteo (big blind) mucked [9c 8h]
Seat 4: richard woo (button) folded before Flop (didn't bet)
Seat 5: Jstu17 (small blind) showed [5c Qd] and won ($0.15) with two pair, Queens and Deuces

Hand #866: 

PokerStars Hand #246296628459:  Hold'em No Limit ($0.01/$0.02 CAD) - 2023/10/01 17:38:26 ET
Table 'Abundantia III' 6-max Seat #5 is the button
Seat 3: CashMatteo ($1.92 in chips) 
Seat 4: richard woo ($1.73 in chips) 
Seat 5: Jstu17 ($1.66 in chips) 
CashMatteo: posts small blind $0.01
richard woo: posts big blind $0.02
*** HOLE CARDS ***
Dealt to CashMatteo [3s Kh]
Jstu17: folds 
CashMatteo: folds 
Uncalled bet ($0.01) returned to richard woo
richard woo collected $0.02 from pot
*** SUMMARY ***
Total pot $0.02 | Rake $0 
Seat 3: CashMatteo (small blind) folded before Flop
Seat 4: richard woo (big blind) collected ($0.02)
Seat 5: Jstu17 (button) folded before Flop (didn't bet)

Hand #867: 

PokerStars Hand #246296631814:  Hold'em No Limit ($0.01/$0.02 CAD) - 2023/10/01 17:38:34 ET
Table 'Abundantia III' 6-max Seat #3 is the button
Seat 3: CashMatteo ($1.91 in chips) 
Seat 4: richard woo ($1.74 in chips) 
Seat 5: Jstu17 ($1.66 in chips) 
richard woo: posts small blind $0.01
Jstu17: posts big blind $0.02
*** HOLE CARDS ***
Dealt to CashMatteo [7d Jc]
CashMatteo: calls $0.02
richard woo: calls $0.01
Jstu17: checks 
*** FLOP *** [Jh 2h 8s]
richard woo: checks 
Jstu17: checks 
CashMatteo: bets $0.03
richard woo: calls $0.03
Jstu17: folds 
*** TURN *** [Jh 2h 8s] [As]
richard woo: checks 
CashMatteo: bets $0.06
richard woo: calls $0.06
*** RIVER *** [Jh 2h 8s As] [3h]
richard woo: checks 
spidernet leaves the table
CashMatteo: checks 
*** SHOW DOWN ***
richard woo: shows [Jd 5d] (a pair of Jacks)
CashMatteo: shows [7d Jc] (a pair of Jacks - Ace+Eight+Seven kicker)
CashMatteo collected $0.23 from pot
*** SUMMARY ***
Total pot $0.24 | Rake $0.01 
Board [Jh 2h 8s As 3h]
Seat 3: CashMatteo (button) showed [7d Jc] and won ($0.23) with a pair of Jacks
Seat 4: richard woo (small blind) showed [Jd 5d] and lost with a pair of Jacks
Seat 5: Jstu17 (big blind) folded on the Flop

Hand #868: 

PokerStars Hand #246296650365:  Hold'em No Limit ($0.01/$0.02 CAD) - 2023/10/01 17:39:17 ET
Table 'Abundantia III' 6-max Seat #4 is the button
Seat 3: CashMatteo ($2.03 in chips) 
Seat 4: richard woo ($1.63 in chips) 
Seat 5: Jstu17 ($1.64 in chips) 
Jstu17: posts small blind $0.01
CashMatteo: posts big blind $0.02
*** HOLE CARDS ***
Dealt to CashMatteo [As 2s]
richard woo: folds 
Jstu17: calls $0.01
CashMatteo: checks 
*** FLOP *** [7s 4d 7d]
Jstu17: checks 
CashMatteo: checks 
*** TURN *** [7s 4d 7d] [Ad]
Jstu17: checks 
CashMatteo: checks 
*** RIVER *** [7s 4d 7d Ad] [Jc]
Jstu17: checks 
CashMatteo: bets $0.04
Jstu17: calls $0.04
*** SHOW DOWN ***
CashMatteo: shows [As 2s] (two pair, Aces and Sevens)
Jstu17: mucks hand 
CashMatteo collected $0.12 from pot
momonnez was removed from the table for failing to post
momonnez leaves the table
*** SUMMARY ***
Total pot $0.12 | Rake $0 
Board [7s 4d 7d Ad Jc]
Seat 3: CashMatteo (big blind) showed [As 2s] and won ($0.12) with two pair, Aces and Sevens
Seat 4: richard woo (button) folded before Flop (didn't bet)
Seat 5: Jstu17 (small blind) mucked [5h Js]

Hand #869: 

PokerStars Hand #246296660491:  Hold'em No Limit ($0.01/$0.02 CAD) - 2023/10/01 17:39:41 ET
Table 'Abundantia III' 6-max Seat #5 is the button
Seat 3: CashMatteo ($2.09 in chips) 
Seat 4: richard woo ($1.63 in chips) 
Seat 5: Jstu17 ($1.58 in chips) 
CashMatteo: posts small blind $0.01
richard woo: posts big blind $0.02
*** HOLE CARDS ***
Dealt to CashMatteo [Ac 8d]
Jstu17: calls $0.02
CashMatteo: calls $0.01
richard woo: checks 
*** FLOP *** [Jc 2s 9d]
CashMatteo: checks 
richard woo: checks 
Jstu17: checks 
*** TURN *** [Jc 2s 9d] [5c]
CashMatteo: checks 
richard woo: bets $0.03
Jstu17: folds 
CashMatteo: folds 
Uncalled bet ($0.03) returned to richard woo
richard woo collected $0.06 from pot
*** SUMMARY ***
Total pot $0.06 | Rake $0 
Board [Jc 2s 9d 5c]
Seat 3: CashMatteo (small blind) folded on the Turn
Seat 4: richard woo (big blind) collected ($0.06)
Seat 5: Jstu17 (button) folded on the Turn

Hand #870: 

PokerStars Hand #246296671561:  Hold'em No Limit ($0.01/$0.02 CAD) - 2023/10/01 17:40:07 ET
Table 'Abundantia III' 6-max Seat #3 is the button
Seat 3: CashMatteo ($2.07 in chips) 
Seat 4: richard woo ($1.67 in chips) 
Seat 5: Jstu17 ($1.56 in chips) 
richard woo: posts small blind $0.01
Jstu17: posts big blind $0.02
*** HOLE CARDS ***
Dealt to CashMatteo [Th 7d]
CashMatteo: folds 
CashMatteo leaves the table
richard woo: calls $0.01
Jstu17: checks 
*** FLOP *** [9s 9h 8c]
orlyoosh joins the table at seat #2 
richard woo: checks 
Jstu17: checks 
*** TURN *** [9s 9h 8c] [Kh]
richard woo: checks 
Jstu17: checks 
*** RIVER *** [9s 9h 8c Kh] [Jc]
cpoup046 joins the table at seat #6 
richard woo: checks 
Jstu17: checks 
*** SHOW DOWN ***
richard woo: shows [Tc Ah] (a pair of Nines)
Jstu17: shows [Ac 5c] (a pair of Nines)
richard woo collected $0.02 from pot
Jstu17 collected $0.02 from pot
*** SUMMARY ***
Total pot $0.04 | Rake $0 
Board [9s 9h 8c Kh Jc]
Seat 3: CashMatteo (button) folded before Flop (didn't bet)
Seat 4: richard woo (small blind) showed [Tc Ah] and won ($0.02) with a pair of Nines
Seat 5: Jstu17 (big blind) showed [Ac 5c] and won ($0.02) with a pair of Nines

Hand #871: 

PokerStars Hand #246297077879:  Hold'em No Limit ($0.01/$0.02 CAD) - 2023/10/01 17:57:38 ET
Table 'Thernoe II' 6-max Seat #5 is the button
Seat 2: Zeako123 ($2.31 in chips) 
Seat 3: CashMatteo ($2 in chips) 
Seat 4: indyjones45 ($1.71 in chips) 
Seat 5: tyke143 ($1.04 in chips) 
Zeako123: posts small blind $0.01
CashMatteo: posts big blind $0.02
*** HOLE CARDS ***
Dealt to CashMatteo [2h 9d]
indyjones45: calls $0.02
tyke143: calls $0.02
Zeako123: calls $0.01
CashMatteo: checks 
*** FLOP *** [Kc Jd 9s]
Zeako123: checks 
CashMatteo: checks 
indyjones45: checks 
tyke143: checks 
*** TURN *** [Kc Jd 9s] [Qs]
Zeako123: checks 
CashMatteo: checks 
indyjones45: bets $0.16
tyke143: folds 
Zeako123: folds 
CashMatteo: folds 
Uncalled bet ($0.16) returned to indyjones45
indyjones45 collected $0.08 from pot
indyjones45: doesn't show hand 
*** SUMMARY ***
Total pot $0.08 | Rake $0 
Board [Kc Jd 9s Qs]
Seat 2: Zeako123 (small blind) folded on the Turn
Seat 3: CashMatteo (big blind) folded on the Turn
Seat 4: indyjones45 collected ($0.08)
Seat 5: tyke143 (button) folded on the Turn

Hand #872: 

PokerStars Hand #246297094842:  Hold'em No Limit ($0.01/$0.02 CAD) - 2023/10/01 17:58:50 ET
Table 'Thernoe II' 6-max Seat #2 is the button
Seat 2: Zeako123 ($2.29 in chips) 
Seat 3: CashMatteo ($1.98 in chips) 
Seat 4: indyjones45 ($1.77 in chips) 
Seat 5: tyke143 ($1.02 in chips) 
CashMatteo: posts small blind $0.01
indyjones45: posts big blind $0.02
*** HOLE CARDS ***
Dealt to CashMatteo [9d 3s]
tyke143: calls $0.02
Zeako123: calls $0.02
CashMatteo: folds 
indyjones45: checks 
*** FLOP *** [3h Kc 4d]
indyjones45: checks 
tyke143: checks 
Zeako123: bets $0.02
Rockpile615 joins the table at seat #1 
indyjones45: folds 
tyke143: folds 
Uncalled bet ($0.02) returned to Zeako123
Zeako123 collected $0.07 from pot
*** SUMMARY ***
Total pot $0.07 | Rake $0 
Board [3h Kc 4d]
Seat 2: Zeako123 (button) collected ($0.07)
Seat 3: CashMatteo (small blind) folded before Flop
Seat 4: indyjones45 (big blind) folded on the Flop
Seat 5: tyke143 folded on the Flop

Hand #873: 

PokerStars Hand #246297104555:  Hold'em No Limit ($0.01/$0.02 CAD) - 2023/10/01 17:59:30 ET
Table 'Thernoe II' 6-max Seat #3 is the button
Seat 1: Rockpile615 ($2 in chips) 
Seat 2: Zeako123 ($2.34 in chips) 
Seat 3: CashMatteo ($1.97 in chips) 
Seat 4: indyjones45 ($1.75 in chips) 
Seat 5: tyke143 ($1 in chips) 
indyjones45: posts small blind $0.01
tyke143: posts big blind $0.02
Rockpile615: posts big blind $0.02
*** HOLE CARDS ***
Dealt to CashMatteo [9d 9h]
Rockpile615: raises $0.02 to $0.04
Zeako123: folds 
CashMatteo: raises $0.02 to $0.06
indyjones45: raises $0.20 to $0.26
tyke143: folds 
Rockpile615: folds 
CashMatteo: calls $0.20
*** FLOP *** [6c 2h 4d]
indyjones45: bets $0.56
CashMatteo: calls $0.56
*** TURN *** [6c 2h 4d] [4c]
indyjones45: bets $0.93 and is all-in
CashMatteo: folds 
Uncalled bet ($0.93) returned to indyjones45
indyjones45 collected $1.64 from pot
indyjones45: doesn't show hand 
*** SUMMARY ***
Total pot $1.70 | Rake $0.06 
Board [6c 2h 4d 4c]
Seat 1: Rockpile615 folded before Flop
Seat 2: Zeako123 folded before Flop (didn't bet)
Seat 3: CashMatteo (button) folded on the Turn
Seat 4: indyjones45 (small blind) collected ($1.64)
Seat 5: tyke143 (big blind) folded before Flop

Hand #874: 

PokerStars Hand #246297119077:  Hold'em No Limit ($0.01/$0.02 CAD) - 2023/10/01 18:00:29 ET
Table 'Thernoe II' 6-max Seat #4 is the button
Seat 1: Rockpile615 ($1.96 in chips) 
Seat 2: Zeako123 ($2.34 in chips) 
Seat 3: CashMatteo ($1.15 in chips) 
Seat 4: indyjones45 ($2.57 in chips) 
Seat 5: tyke143 ($0.98 in chips) 
tyke143: posts small blind $0.01
Rockpile615: posts big blind $0.02
*** HOLE CARDS ***
Dealt to CashMatteo [8d 2s]
Zeako123: folds 
CashMatteo: folds 
indyjones45: calls $0.02
tyke143: calls $0.01
Rockpile615: checks 
*** FLOP *** [5c 2c 4c]
tyke143: checks 
Rockpile615: bets $0.06
indyjones45: folds 
tyke143: calls $0.06
*** TURN *** [5c 2c 4c] [7d]
tyke143: checks 
Rockpile615: checks 
*** RIVER *** [5c 2c 4c 7d] [Td]
tyke143: checks 
Rockpile615: checks 
*** SHOW DOWN ***
tyke143: shows [4s 8c] (a pair of Fours)
Rockpile615: mucks hand 
tyke143 collected $0.17 from pot
pink810251 was removed from the table for failing to post
pink810251 leaves the table
*** SUMMARY ***
Total pot $0.18 | Rake $0.01 
Board [5c 2c 4c 7d Td]
Seat 1: Rockpile615 (big blind) mucked [Kd 2d]
Seat 2: Zeako123 folded before Flop (didn't bet)
Seat 3: CashMatteo folded before Flop (didn't bet)
Seat 4: indyjones45 (button) folded on the Flop
Seat 5: tyke143 (small blind) showed [4s 8c] and won ($0.17) with a pair of Fours

Hand #875: 

PokerStars Hand #246297132828:  Hold'em No Limit ($0.01/$0.02 CAD) - 2023/10/01 18:01:18 ET
Table 'Thernoe II' 6-max Seat #5 is the button
Seat 1: Rockpile615 ($1.88 in chips) 
Seat 2: Zeako123 ($2.34 in chips) 
Seat 3: CashMatteo ($1.15 in chips) 
Seat 4: indyjones45 ($2.55 in chips) 
Seat 5: tyke143 ($1.07 in chips) 
Rockpile615: posts small blind $0.01
Zeako123: posts big blind $0.02
*** HOLE CARDS ***
Dealt to CashMatteo [Jd 3c]
CashMatteo: folds 
indyjones45: calls $0.02
tyke143: calls $0.02
Rockpile615: raises $0.08 to $0.10
Zeako123: folds 
indyjones45: calls $0.08
tyke143: calls $0.08
*** FLOP *** [Qh 3s 8s]
Rockpile615: bets $0.16
indyjones45: raises $0.16 to $0.32
tyke143: folds 
Rockpile615: raises $0.16 to $0.48
indyjones45: calls $0.16
*** TURN *** [Qh 3s 8s] [6s]
Rockpile615: bets $1.24
indyjones45: raises $0.73 to $1.97 and is all-in
Rockpile615: calls $0.06 and is all-in
Uncalled bet ($0.67) returned to indyjones45
*** RIVER *** [Qh 3s 8s 6s] [6h]
*** SHOW DOWN ***
Rockpile615: shows [Ad Ac] (two pair, Aces and Sixes)
indyjones45: shows [Ts 2s] (a flush, Ten high)
indyjones45 collected $3.74 from pot
*** SUMMARY ***
Total pot $3.88 | Rake $0.14 
Board [Qh 3s 8s 6s 6h]
Seat 1: Rockpile615 (small blind) showed [Ad Ac] and lost with two pair, Aces and Sixes
Seat 2: Zeako123 (big blind) folded before Flop
Seat 3: CashMatteo folded before Flop (didn't bet)
Seat 4: indyjones45 showed [Ts 2s] and won ($3.74) with a flush, Ten high
Seat 5: tyke143 (button) folded on the Flop

Hand #876: 

PokerStars Hand #246297157609:  Hold'em No Limit ($0.01/$0.02 CAD) - 2023/10/01 18:02:32 ET
Table 'Thernoe II' 6-max Seat #2 is the button
Seat 2: Zeako123 ($2.32 in chips) 
Seat 3: CashMatteo ($1.15 in chips) 
Seat 4: indyjones45 ($4.41 in chips) 
Seat 5: tyke143 ($0.97 in chips) 
CashMatteo: posts small blind $0.01
indyjones45: posts big blind $0.02
*** HOLE CARDS ***
Dealt to CashMatteo [9c 6h]
tyke143: calls $0.02
Zeako123: raises $0.04 to $0.06
CashMatteo: folds 
indyjones45: raises $0.04 to $0.10
tyke143: calls $0.08
Zeako123: calls $0.04
*** FLOP *** [3h 5c 8s]
indyjones45: bets $0.10
tyke143: folds 
Zeako123: calls $0.10
*** TURN *** [3h 5c 8s] [7c]
Spor1050 joins the table at seat #6 
indyjones45: bets $0.10
Zeako123: calls $0.10
*** RIVER *** [3h 5c 8s 7c] [Kd]
indyjones45: bets $0.10
Zeako123: calls $0.10
*** SHOW DOWN ***
indyjones45: shows [6d 6s] (a pair of Sixes)
Zeako123: shows [9s Kh] (a pair of Kings)
Zeako123 collected $0.88 from pot
*** SUMMARY ***
Total pot $0.91 | Rake $0.03 
Board [3h 5c 8s 7c Kd]
Seat 2: Zeako123 (button) showed [9s Kh] and won ($0.88) with a pair of Kings
Seat 3: CashMatteo (small blind) folded before Flop
Seat 4: indyjones45 (big blind) showed [6d 6s] and lost with a pair of Sixes
Seat 5: tyke143 folded on the Flop

Hand #877: 

PokerStars Hand #246297175997:  Hold'em No Limit ($0.01/$0.02 CAD) - 2023/10/01 18:03:22 ET
Table 'Thernoe II' 6-max Seat #3 is the button
Seat 1: Rockpile615 ($2 in chips) 
Seat 2: Zeako123 ($2.80 in chips) 
Seat 3: CashMatteo ($1.14 in chips) 
Seat 4: indyjones45 ($4.01 in chips) 
Seat 5: tyke143 ($0.87 in chips) 
Seat 6: Spor1050 ($1.60 in chips) 
indyjones45: posts small blind $0.01
tyke143: posts big blind $0.02
Spor1050: posts big blind $0.02
*** HOLE CARDS ***
Dealt to CashMatteo [Kd 8d]
Spor1050: checks 
Rockpile615: calls $0.02
Zeako123: calls $0.02
CashMatteo: raises $0.04 to $0.06
indyjones45: raises $0.20 to $0.26
tyke143: folds 
Spor1050: folds 
Rockpile615: folds 
Zeako123: calls $0.24
CashMatteo: folds 
*** FLOP *** [Jc Qd 4s]
indyjones45: bets $3.75 and is all-in
Zeako123: calls $2.54 and is all-in
Uncalled bet ($1.21) returned to indyjones45
*** TURN *** [Jc Qd 4s] [8c]
*** RIVER *** [Jc Qd 4s 8c] [7h]
*** SHOW DOWN ***
indyjones45: shows [4c 9h] (a pair of Fours)
Zeako123: shows [Td Ad] (high card Ace)
indyjones45 collected $5.52 from pot
*** SUMMARY ***
Total pot $5.72 | Rake $0.20 
Board [Jc Qd 4s 8c 7h]
Seat 1: Rockpile615 folded before Flop
Seat 2: Zeako123 showed [Td Ad] and lost with high card Ace
Seat 3: CashMatteo (button) folded before Flop
Seat 4: indyjones45 (small blind) showed [4c 9h] and won ($5.52) with a pair of Fours
Seat 5: tyke143 (big blind) folded before Flop
Seat 6: Spor1050 folded before Flop (didn't bet)

Hand #878: 

PokerStars Hand #246297194839:  Hold'em No Limit ($0.01/$0.02 CAD) - 2023/10/01 18:04:11 ET
Table 'Thernoe II' 6-max Seat #4 is the button
Seat 1: Rockpile615 ($1.98 in chips) 
Seat 3: CashMatteo ($1.08 in chips) 
Seat 4: indyjones45 ($6.73 in chips) 
Seat 5: tyke143 ($0.85 in chips) 
Seat 6: Spor1050 ($1.58 in chips) 
tyke143: posts small blind $0.01
Spor1050: posts big blind $0.02
*** HOLE CARDS ***
Dealt to CashMatteo [7c 5h]
Rockpile615: calls $0.02
CashMatteo: folds 
indyjones45: calls $0.02
tyke143: calls $0.01
Spor1050: checks 
*** FLOP *** [6s 8s 8h]
tyke143: checks 
Spor1050: checks 
Rockpile615: bets $0.08
indyjones45: folds 
tyke143: folds 
Spor1050: folds 
Uncalled bet ($0.08) returned to Rockpile615
Rockpile615 collected $0.08 from pot
*** SUMMARY ***
Total pot $0.08 | Rake $0 
Board [6s 8s 8h]
Seat 1: Rockpile615 collected ($0.08)
Seat 3: CashMatteo folded before Flop (didn't bet)
Seat 4: indyjones45 (button) folded on the Flop
Seat 5: tyke143 (small blind) folded on the Flop
Seat 6: Spor1050 (big blind) folded on the Flop

Hand #879: 

PokerStars Hand #246297208654:  Hold'em No Limit ($0.01/$0.02 CAD) - 2023/10/01 18:04:47 ET
Table 'Thernoe II' 6-max Seat #5 is the button
Seat 1: Rockpile615 ($2.04 in chips) 
Seat 2: Zeako123 ($2 in chips) 
Seat 3: CashMatteo ($1.08 in chips) 
Seat 4: indyjones45 ($6.71 in chips) 
Seat 5: tyke143 ($0.83 in chips) 
Seat 6: Spor1050 ($1.56 in chips) 
Spor1050: posts small blind $0.01
Rockpile615: posts big blind $0.02
*** HOLE CARDS ***
Dealt to CashMatteo [3s 2d]
Zeako123: calls $0.02
CashMatteo: folds 
indyjones45: calls $0.02
tyke143: calls $0.02
Spor1050: calls $0.01
Rockpile615: raises $0.02 to $0.04
Zeako123: calls $0.02
indyjones45: calls $0.02
tyke143: calls $0.02
Spor1050: calls $0.02
*** FLOP *** [6h 3c Ts]
Spor1050: checks 
Rockpile615: bets $0.19
Zeako123: calls $0.19
indyjones45: folds 
tyke143: folds 
Spor1050: folds 
*** TURN *** [6h 3c Ts] [6s]
Rockpile615: bets $0.28
Zeako123: folds 
Uncalled bet ($0.28) returned to Rockpile615
Rockpile615 collected $0.56 from pot
*** SUMMARY ***
Total pot $0.58 | Rake $0.02 
Board [6h 3c Ts 6s]
Seat 1: Rockpile615 (big blind) collected ($0.56)
Seat 2: Zeako123 folded on the Turn
Seat 3: CashMatteo folded before Flop (didn't bet)
Seat 4: indyjones45 folded on the Flop
Seat 5: tyke143 (button) folded on the Flop
Seat 6: Spor1050 (small blind) folded on the Flop

Hand #880: 

PokerStars Hand #246297240405:  Hold'em No Limit ($0.01/$0.02 CAD) - 2023/10/01 18:06:07 ET
Table 'Thernoe II' 6-max Seat #6 is the button
Seat 1: Rockpile615 ($2.37 in chips) 
Seat 2: Zeako123 ($1.77 in chips) 
Seat 3: CashMatteo ($1.08 in chips) 
Seat 4: indyjones45 ($6.67 in chips) 
Seat 5: tyke143 ($0.79 in chips) 
Seat 6: Spor1050 ($1.52 in chips) 
Rockpile615: posts small blind $0.01
Zeako123: posts big blind $0.02
*** HOLE CARDS ***
Dealt to CashMatteo [Ts Kd]
CashMatteo: raises $0.04 to $0.06
indyjones45: raises $0.04 to $0.10
tyke143: calls $0.10
Spor1050: folds 
Rockpile615: folds 
Zeako123: raises $0.14 to $0.24
CashMatteo: folds 
indyjones45: calls $0.14
tyke143: calls $0.14
*** FLOP *** [Th 6d 2s]
Zeako123: checks 
indyjones45: bets $0.76
tyke143: folds 
Zeako123: calls $0.76
*** TURN *** [Th 6d 2s] [Kh]
Zeako123: checks 
indyjones45: bets $5.67 and is all-in
Zeako123: calls $0.77 and is all-in
Uncalled bet ($4.90) returned to indyjones45
*** RIVER *** [Th 6d 2s Kh] [Ah]
*** SHOW DOWN ***
Zeako123: shows [Js Ks] (a pair of Kings)
indyjones45: shows [9d 9h] (a pair of Nines)
Zeako123 collected $3.72 from pot
*** SUMMARY ***
Total pot $3.85 | Rake $0.13 
Board [Th 6d 2s Kh Ah]
Seat 1: Rockpile615 (small blind) folded before Flop
Seat 2: Zeako123 (big blind) showed [Js Ks] and won ($3.72) with a pair of Kings
Seat 3: CashMatteo folded before Flop
Seat 4: indyjones45 showed [9d 9h] and lost with a pair of Nines
Seat 5: tyke143 folded on the Flop
Seat 6: Spor1050 (button) folded before Flop (didn't bet)

Hand #881: 

PokerStars Hand #246297266797:  Hold'em No Limit ($0.01/$0.02 CAD) - 2023/10/01 18:07:14 ET
Table 'Thernoe II' 6-max Seat #1 is the button
Seat 1: Rockpile615 ($2.36 in chips) 
Seat 2: Zeako123 ($3.72 in chips) 
Seat 3: CashMatteo ($1.02 in chips) 
Seat 4: indyjones45 ($4.90 in chips) 
Seat 5: tyke143 ($0.55 in chips) 
Seat 6: Spor1050 ($1.52 in chips) 
Zeako123: posts small blind $0.01
CashMatteo: posts big blind $0.02
*** HOLE CARDS ***
Dealt to CashMatteo [7h 7c]
indyjones45: raises $0.10 to $0.12
tyke143: calls $0.12
Spor1050: folds 
Rockpile615: calls $0.12
Zeako123: calls $0.11
CashMatteo: raises $0.16 to $0.28
indyjones45: calls $0.16
tyke143: calls $0.16
Rockpile615: calls $0.16
Zeako123: calls $0.16
*** FLOP *** [2c 8c Qs]
Zeako123: checks 
CashMatteo: checks 
indyjones45: checks 
tyke143: checks 
Rockpile615: checks 
*** TURN *** [2c 8c Qs] [8h]
Zeako123: bets $0.68
CashMatteo: raises $0.06 to $0.74 and is all-in
indyjones45: folds 
tyke143: folds 
Rockpile615: folds 
Zeako123: calls $0.06
*** RIVER *** [2c 8c Qs 8h] [5d]
*** SHOW DOWN ***
Zeako123: shows [Qd Th] (two pair, Queens and Eights)
CashMatteo: shows [7h 7c] (two pair, Eights and Sevens)
Zeako123 collected $2.78 from pot
*** SUMMARY ***
Total pot $2.88 | Rake $0.10 
Board [2c 8c Qs 8h 5d]
Seat 1: Rockpile615 (button) folded on the Turn
Seat 2: Zeako123 (small blind) showed [Qd Th] and won ($2.78) with two pair, Queens and Eights
Seat 3: CashMatteo (big blind) showed [7h 7c] and lost with two pair, Eights and Sevens
Seat 4: indyjones45 folded on the Turn
Seat 5: tyke143 folded on the Turn
Seat 6: Spor1050 folded before Flop (didn't bet)

Hand #882: 

PokerStars Hand #246297305498:  Hold'em No Limit ($0.01/$0.02 CAD) - 2023/10/01 18:08:52 ET
Table 'Thernoe II' 6-max Seat #4 is the button
Seat 2: Zeako123 ($5.46 in chips) 
Seat 3: CashMatteo ($2 in chips) 
Seat 4: indyjones45 ($4.66 in chips) 
Seat 5: tyke143 ($0.25 in chips) 
Seat 6: Spor1050 ($1.52 in chips) 
tyke143: posts small blind $0.01
Spor1050: posts big blind $0.02
CashMatteo: posts small blind $0.01
*** HOLE CARDS ***
Dealt to CashMatteo [Qs 9c]
Zeako123: folds 
CashMatteo: calls $0.02
indyjones45: raises $0.16 to $0.18
tyke143: folds 
Spor1050: calls $0.16
CashMatteo: folds 
*** FLOP *** [Kd Jh 6c]
Spor1050: bets $0.24
indyjones45: raises $4.24 to $4.48 and is all-in
Spor1050: calls $1.10 and is all-in
Uncalled bet ($3.14) returned to indyjones45
*** TURN *** [Kd Jh 6c] [Ks]
*** RIVER *** [Kd Jh 6c Ks] [Kc]
*** SHOW DOWN ***
Spor1050: shows [Ad 9d] (three of a kind, Kings)
indyjones45: shows [Td Th] (a full house, Kings full of Tens)
indyjones45 collected $2.97 from pot
*** SUMMARY ***
Total pot $3.08 | Rake $0.11 
Board [Kd Jh 6c Ks Kc]
Seat 2: Zeako123 folded before Flop (didn't bet)
Seat 3: CashMatteo folded before Flop
Seat 4: indyjones45 (button) showed [Td Th] and won ($2.97) with a full house, Kings full of Tens
Seat 5: tyke143 (small blind) folded before Flop
Seat 6: Spor1050 (big blind) showed [Ad 9d] and lost with three of a kind, Kings

Hand #883: 

PokerStars Hand #246297317846:  Hold'em No Limit ($0.01/$0.02 CAD) - 2023/10/01 18:09:23 ET
Table 'Thernoe II' 6-max Seat #5 is the button
Seat 2: Zeako123 ($5.46 in chips) 
Seat 3: CashMatteo ($1.97 in chips) 
Seat 4: indyjones45 ($6.11 in chips) 
Seat 5: tyke143 ($0.24 in chips) 
Zeako123: posts small blind $0.01
CashMatteo: posts big blind $0.02
*** HOLE CARDS ***
Dealt to CashMatteo [5d 8d]
indyjones45: raises $0.10 to $0.12
tyke143: calls $0.12
Spor1050 leaves the table
Zeako123: folds 
CashMatteo: folds 
*** FLOP *** [Ts 8c Tc]
indyjones45: bets $0.26
tyke143: calls $0.12 and is all-in
Uncalled bet ($0.14) returned to indyjones45
*** TURN *** [Ts 8c Tc] [3s]
*** RIVER *** [Ts 8c Tc 3s] [Ks]
*** SHOW DOWN ***
indyjones45: shows [7d 4c] (a pair of Tens)
tyke143: shows [9c 9h] (two pair, Tens and Nines)
tyke143 collected $0.49 from pot
*** SUMMARY ***
Total pot $0.51 | Rake $0.02 
Board [Ts 8c Tc 3s Ks]
Seat 2: Zeako123 (small blind) folded before Flop
Seat 3: CashMatteo (big blind) folded before Flop
Seat 4: indyjones45 showed [7d 4c] and lost with a pair of Tens
Seat 5: tyke143 (button) showed [9c 9h] and won ($0.49) with two pair, Tens and Nines

Hand #884: 

PokerStars Hand #246297328311:  Hold'em No Limit ($0.01/$0.02 CAD) - 2023/10/01 18:09:50 ET
Table 'Thernoe II' 6-max Seat #2 is the button
Seat 2: Zeako123 ($5.45 in chips) 
Seat 3: CashMatteo ($1.95 in chips) 
Seat 4: indyjones45 ($5.87 in chips) 
Seat 5: tyke143 ($0.49 in chips) 
CashMatteo: posts small blind $0.01
indyjones45: posts big blind $0.02
*** HOLE CARDS ***
Dealt to CashMatteo [Kc 9h]
tyke143: folds 
Zeako123: calls $0.02
CashMatteo: calls $0.01
indyjones45: raises $0.34 to $0.36
spidernet joins the table at seat #6 
Zeako123: folds 
CashMatteo: folds 
Uncalled bet ($0.34) returned to indyjones45
indyjones45 collected $0.06 from pot
indyjones45: doesn't show hand 
*** SUMMARY ***
Total pot $0.06 | Rake $0 
Seat 2: Zeako123 (button) folded before Flop
Seat 3: CashMatteo (small blind) folded before Flop
Seat 4: indyjones45 (big blind) collected ($0.06)
Seat 5: tyke143 folded before Flop (didn't bet)

Hand #885: 

PokerStars Hand #246297346497:  Hold'em No Limit ($0.01/$0.02 CAD) - 2023/10/01 18:10:36 ET
Table 'Thernoe II' 6-max Seat #3 is the button
Seat 2: Zeako123 ($5.43 in chips) 
Seat 3: CashMatteo ($1.93 in chips) 
Seat 4: indyjones45 ($5.91 in chips) 
Seat 5: tyke143 ($0.49 in chips) 
indyjones45: posts small blind $0.01
tyke143: posts big blind $0.02
spidernet: sits out 
*** HOLE CARDS ***
Dealt to CashMatteo [7c Ad]
Zeako123: calls $0.02
CashMatteo: calls $0.02
indyjones45: calls $0.01
tyke143: raises $0.02 to $0.04
Zeako123: raises $0.02 to $0.06
CashMatteo: calls $0.04
indyjones45: calls $0.04
tyke143: calls $0.02
*** FLOP *** [3h Tc 6d]
indyjones45: checks 
tyke143: bets $0.02
Zeako123: calls $0.02
CashMatteo: folds 
indyjones45: calls $0.02
*** TURN *** [3h Tc 6d] [Qs]
indyjones45: checks 
tyke143: bets $0.02
Zeako123: calls $0.02
indyjones45: folds 
*** RIVER *** [3h Tc 6d Qs] [9h]
tyke143: bets $0.02
Zeako123: calls $0.02
*** SHOW DOWN ***
tyke143: shows [Th Kd] (a pair of Tens)
Zeako123: mucks hand 
tyke143 collected $0.37 from pot
*** SUMMARY ***
Total pot $0.38 | Rake $0.01 
Board [3h Tc 6d Qs 9h]
Seat 2: Zeako123 mucked [Ks As]
Seat 3: CashMatteo (button) folded on the Flop
Seat 4: indyjones45 (small blind) folded on the Turn
Seat 5: tyke143 (big blind) showed [Th Kd] and won ($0.37) with a pair of Tens

Hand #886: 

PokerStars Hand #246297369446:  Hold'em No Limit ($0.01/$0.02 CAD) - 2023/10/01 18:11:35 ET
Table 'Thernoe II' 6-max Seat #4 is the button
Seat 2: Zeako123 ($5.31 in chips) 
Seat 3: CashMatteo ($1.87 in chips) 
Seat 4: indyjones45 ($5.83 in chips) 
Seat 5: tyke143 ($0.74 in chips) 
Seat 6: spidernet ($2 in chips) 
tyke143: posts small blind $0.01
spidernet: posts big blind $0.02
*** HOLE CARDS ***
Dealt to CashMatteo [6d 2d]
Zeako123: calls $0.02
CashMatteo: folds 
indyjones45: calls $0.02
tyke143: raises $0.02 to $0.04
spidernet: calls $0.02
Zeako123: calls $0.02
indyjones45: calls $0.02
*** FLOP *** [Th Tc Kc]
tyke143: bets $0.02
spidernet: raises $0.23 to $0.25
Zeako123: folds 
indyjones45: folds 
tyke143: calls $0.23
*** TURN *** [Th Tc Kc] [9d]
tyke143: bets $0.02
spidernet: raises $0.68 to $0.70
tyke143: calls $0.43 and is all-in
Uncalled bet ($0.25) returned to spidernet
*** RIVER *** [Th Tc Kc 9d] [7h]
*** SHOW DOWN ***
tyke143: shows [9h Qh] (two pair, Tens and Nines)
spidernet: shows [5s Td] (three of a kind, Tens)
spidernet collected $1.51 from pot
*** SUMMARY ***
Total pot $1.56 | Rake $0.05 
Board [Th Tc Kc 9d 7h]
Seat 2: Zeako123 folded on the Flop
Seat 3: CashMatteo folded before Flop (didn't bet)
Seat 4: indyjones45 (button) folded on the Flop
Seat 5: tyke143 (small blind) showed [9h Qh] and lost with two pair, Tens and Nines
Seat 6: spidernet (big blind) showed [5s Td] and won ($1.51) with three of a kind, Tens

Hand #887: 

PokerStars Hand #246297387906:  Hold'em No Limit ($0.01/$0.02 CAD) - 2023/10/01 18:12:22 ET
Table 'Thernoe II' 6-max Seat #6 is the button
Seat 2: Zeako123 ($5.27 in chips) 
Seat 3: CashMatteo ($1.87 in chips) 
Seat 4: indyjones45 ($5.79 in chips) 
Seat 6: spidernet ($2.77 in chips) 
Zeako123: posts small blind $0.01
CashMatteo: posts big blind $0.02
*** HOLE CARDS ***
Dealt to CashMatteo [9h 2d]
indyjones45: calls $0.02
spidernet: calls $0.02
Zeako123: folds 
CashMatteo: checks 
*** FLOP *** [5c Ac 5h]
Zeako123 leaves the table
CashMatteo: checks 
indyjones45: checks 
spidernet: checks 
*** TURN *** [5c Ac 5h] [6d]
CashMatteo: checks 
indyjones45: checks 
spidernet: checks 
*** RIVER *** [5c Ac 5h 6d] [Kh]
CashMatteo: checks 
indyjones45: checks 
spidernet: checks 
*** SHOW DOWN ***
CashMatteo: shows [9h 2d] (a pair of Fives)
indyjones45: shows [Qh 4c] (a pair of Fives - Ace+King+Queen kicker)
spidernet: mucks hand 
indyjones45 collected $0.07 from pot
*** SUMMARY ***
Total pot $0.07 | Rake $0 
Board [5c Ac 5h 6d Kh]
Seat 2: Zeako123 (small blind) folded before Flop
Seat 3: CashMatteo (big blind) showed [9h 2d] and lost with a pair of Fives
Seat 4: indyjones45 showed [Qh 4c] and won ($0.07) with a pair of Fives
Seat 6: spidernet (button) mucked [Td 9d]

Hand #888: 

PokerStars Hand #246297405687:  Hold'em No Limit ($0.01/$0.02 CAD) - 2023/10/01 18:13:08 ET
Table 'Thernoe II' 6-max Seat #3 is the button
Seat 3: CashMatteo ($1.85 in chips) 
Seat 4: indyjones45 ($5.84 in chips) 
Seat 5: tyke143 ($0.80 in chips) 
Seat 6: spidernet ($2.75 in chips) 
indyjones45: posts small blind $0.01
tyke143: posts big blind $0.02
*** HOLE CARDS ***
Dealt to CashMatteo [Kc 3s]
indyjones45 is disconnected 
spidernet: raises $0.04 to $0.06
CashMatteo: folds 
indyjones45 has timed out while disconnected
indyjones45: folds 
Sinlessmoon joins the table at seat #2 
tyke143: calls $0.04
*** FLOP *** [8h 2d 4c]
tyke143: checks 
spidernet: bets $0.07
tyke143: folds 
Uncalled bet ($0.07) returned to spidernet
spidernet collected $0.13 from pot
spidernet: doesn't show hand 
*** SUMMARY ***
Total pot $0.13 | Rake $0 
Board [8h 2d 4c]
Seat 3: CashMatteo (button) folded before Flop (didn't bet)
Seat 4: indyjones45 (small blind) folded before Flop
Seat 5: tyke143 (big blind) folded on the Flop
Seat 6: spidernet collected ($0.13)

Hand #889: 

PokerStars Hand #246297420346:  Hold'em No Limit ($0.01/$0.02 CAD) - 2023/10/01 18:13:46 ET
Table 'Thernoe II' 6-max Seat #5 is the button
Seat 2: Sinlessmoon ($2 in chips) 
Seat 3: CashMatteo ($1.85 in chips) 
Seat 5: tyke143 ($0.74 in chips) 
Seat 6: spidernet ($2.82 in chips) 
spidernet: posts small blind $0.01
Sinlessmoon: posts big blind $0.02
*** HOLE CARDS ***
Dealt to CashMatteo [7h 2h]
CashMatteo: folds 
tyke143: raises $0.72 to $0.74 and is all-in
spidernet: folds 
Sinlessmoon: folds 
Uncalled bet ($0.72) returned to tyke143
tyke143 collected $0.05 from pot
*** SUMMARY ***
Total pot $0.05 | Rake $0 
Seat 2: Sinlessmoon (big blind) folded before Flop
Seat 3: CashMatteo folded before Flop (didn't bet)
Seat 5: tyke143 (button) collected ($0.05)
Seat 6: spidernet (small blind) folded before Flop

Hand #890: 

PokerStars Hand #246297425130:  Hold'em No Limit ($0.01/$0.02 CAD) - 2023/10/01 18:13:59 ET
Table 'Thernoe II' 6-max Seat #6 is the button
Seat 2: Sinlessmoon ($1.98 in chips) 
Seat 3: CashMatteo ($1.85 in chips) 
Seat 5: tyke143 ($0.77 in chips) 
Seat 6: spidernet ($2.81 in chips) 
Sinlessmoon: posts small blind $0.01
CashMatteo: posts big blind $0.02
*** HOLE CARDS ***
Dealt to CashMatteo [3h 8c]
tyke143: calls $0.02
spidernet: raises $0.04 to $0.06
Sinlessmoon: folds 
CashMatteo: folds 
tyke143: calls $0.04
*** FLOP *** [7c 6c 2s]
tyke143: checks 
Sinlessmoon leaves the table
spidernet: bets $0.08
tyke143: folds 
Uncalled bet ($0.08) returned to spidernet
spidernet collected $0.14 from pot
spidernet: doesn't show hand 
*** SUMMARY ***
Total pot $0.15 | Rake $0.01 
Board [7c 6c 2s]
Seat 2: Sinlessmoon (small blind) folded before Flop
Seat 3: CashMatteo (big blind) folded before Flop
Seat 5: tyke143 folded on the Flop
Seat 6: spidernet (button) collected ($0.14)

Hand #891: 

PokerStars Hand #246297435773:  Hold'em No Limit ($0.01/$0.02 CAD) - 2023/10/01 18:14:27 ET
Table 'Thernoe II' 6-max Seat #3 is the button
Seat 3: CashMatteo ($1.83 in chips) 
Seat 5: tyke143 ($0.71 in chips) 
Seat 6: spidernet ($2.89 in chips) 
tyke143: posts small blind $0.01
spidernet: posts big blind $0.02
*** HOLE CARDS ***
Dealt to CashMatteo [2s Ts]
CashMatteo: folds 
kingsandsteel joins the table at seat #2 
tyke143: raises $0.69 to $0.71 and is all-in
spidernet: folds 
Uncalled bet ($0.69) returned to tyke143
tyke143 collected $0.04 from pot
*** SUMMARY ***
Total pot $0.04 | Rake $0 
Seat 3: CashMatteo (button) folded before Flop (didn't bet)
Seat 5: tyke143 (small blind) collected ($0.04)
Seat 6: spidernet (big blind) folded before Flop

Hand #892: 

PokerStars Hand #246297442786:  Hold'em No Limit ($0.01/$0.02 CAD) - 2023/10/01 18:14:45 ET
Table 'Thernoe II' 6-max Seat #5 is the button
Seat 2: kingsandsteel ($2 in chips) 
Seat 3: CashMatteo ($1.83 in chips) 
Seat 5: tyke143 ($0.73 in chips) 
Seat 6: spidernet ($2.87 in chips) 
spidernet: posts small blind $0.01
kingsandsteel: posts big blind $0.02
*** HOLE CARDS ***
Dealt to CashMatteo [8d 2d]
CashMatteo: folds 
tyke143: raises $0.71 to $0.73 and is all-in
spidernet: folds 
kingsandsteel: folds 
Uncalled bet ($0.71) returned to tyke143
tyke143 collected $0.05 from pot
Rockpile615 was removed from the table for failing to post
Rockpile615 leaves the table
*** SUMMARY ***
Total pot $0.05 | Rake $0 
Seat 2: kingsandsteel (big blind) folded before Flop
Seat 3: CashMatteo folded before Flop (didn't bet)
Seat 5: tyke143 (button) collected ($0.05)
Seat 6: spidernet (small blind) folded before Flop

Hand #893: 

PokerStars Hand #246297447939:  Hold'em No Limit ($0.01/$0.02 CAD) - 2023/10/01 18:14:58 ET
Table 'Thernoe II' 6-max Seat #6 is the button
Seat 2: kingsandsteel ($1.98 in chips) 
Seat 3: CashMatteo ($1.83 in chips) 
Seat 5: tyke143 ($0.76 in chips) 
Seat 6: spidernet ($2.86 in chips) 
kingsandsteel: posts small blind $0.01
CashMatteo: posts big blind $0.02
*** HOLE CARDS ***
Dealt to CashMatteo [2h 3h]
butt_reynolds19 joins the table at seat #1 
tyke143: folds 
spidernet: calls $0.02
kingsandsteel: calls $0.01
CashMatteo: checks 
*** FLOP *** [As 7s 9d]
kingsandsteel: bets $0.03
CashMatteo: folds 
spidernet: calls $0.03
*** TURN *** [As 7s 9d] [3d]
kingsandsteel: bets $0.02
spidernet: raises $0.08 to $0.10
kingsandsteel: calls $0.08
*** RIVER *** [As 7s 9d 3d] [Th]
kingsandsteel: checks 
spidernet: checks 
*** SHOW DOWN ***
kingsandsteel: shows [Kd 7h] (a pair of Sevens)
spidernet: shows [Ah 6d] (a pair of Aces)
spidernet collected $0.31 from pot
*** SUMMARY ***
Total pot $0.32 | Rake $0.01 
Board [As 7s 9d 3d Th]
Seat 2: kingsandsteel (small blind) showed [Kd 7h] and lost with a pair of Sevens
Seat 3: CashMatteo (big blind) folded on the Flop
Seat 5: tyke143 folded before Flop (didn't bet)
Seat 6: spidernet (button) showed [Ah 6d] and won ($0.31) with a pair of Aces

Hand #894: 

PokerStars Hand #246297462376:  Hold'em No Limit ($0.01/$0.02 CAD) - 2023/10/01 18:15:37 ET
Table 'Thernoe II' 6-max Seat #2 is the button
Seat 2: kingsandsteel ($1.83 in chips) 
Seat 3: CashMatteo ($1.81 in chips) 
Seat 5: tyke143 ($0.76 in chips) 
Seat 6: spidernet ($3.02 in chips) 
CashMatteo: posts small blind $0.01
tyke143: posts big blind $0.02
butt_reynolds19: sits out 
*** HOLE CARDS ***
Dealt to CashMatteo [7h 4s]
spidernet: calls $0.02
kingsandsteel: folds 
CashMatteo: folds 
tyke143: checks 
*** FLOP *** [2s 7c 9d]
tyke143: checks 
spidernet: bets $0.07
tyke143: folds 
Uncalled bet ($0.07) returned to spidernet
spidernet collected $0.05 from pot
spidernet: doesn't show hand 
*** SUMMARY ***
Total pot $0.05 | Rake $0 
Board [2s 7c 9d]
Seat 2: kingsandsteel (button) folded before Flop (didn't bet)
Seat 3: CashMatteo (small blind) folded before Flop
Seat 5: tyke143 (big blind) folded on the Flop
Seat 6: spidernet collected ($0.05)

Hand #895: 

PokerStars Hand #246297473571:  Hold'em No Limit ($0.01/$0.02 CAD) - 2023/10/01 18:16:06 ET
Table 'Thernoe II' 6-max Seat #3 is the button
Seat 2: kingsandsteel ($1.83 in chips) 
Seat 3: CashMatteo ($1.80 in chips) 
Seat 5: tyke143 ($0.74 in chips) 
Seat 6: spidernet ($3.05 in chips) 
tyke143: posts small blind $0.01
spidernet: posts big blind $0.02
butt_reynolds19: sits out 
*** HOLE CARDS ***
Dealt to CashMatteo [Kc 8c]
kingsandsteel: raises $0.02 to $0.04
CashMatteo: calls $0.04
tyke143: folds 
spidernet: calls $0.02
*** FLOP *** [2h Js Td]
spidernet: checks 
kingsandsteel: bets $0.07
CashMatteo: folds 
spidernet: calls $0.07
*** TURN *** [2h Js Td] [Th]
spidernet: checks 
kingsandsteel: bets $0.13
spidernet: calls $0.13
*** RIVER *** [2h Js Td Th] [9c]
spidernet: checks 
kingsandsteel: checks 
*** SHOW DOWN ***
spidernet: shows [Ts 3s] (three of a kind, Tens)
kingsandsteel: mucks hand 
spidernet collected $0.51 from pot
*** SUMMARY ***
Total pot $0.53 | Rake $0.02 
Board [2h Js Td Th 9c]
Seat 2: kingsandsteel mucked [Jd Kd]
Seat 3: CashMatteo (button) folded on the Flop
Seat 5: tyke143 (small blind) folded before Flop
Seat 6: spidernet (big blind) showed [Ts 3s] and won ($0.51) with three of a kind, Tens

Hand #896: 

PokerStars Hand #246297489671:  Hold'em No Limit ($0.01/$0.02 CAD) - 2023/10/01 18:16:49 ET
Table 'Thernoe II' 6-max Seat #5 is the button
Seat 1: butt_reynolds19 ($2 in chips) 
Seat 2: kingsandsteel ($1.59 in chips) 
Seat 3: CashMatteo ($1.76 in chips) 
Seat 5: tyke143 ($0.73 in chips) 
Seat 6: spidernet ($3.32 in chips) 
spidernet: posts small blind $0.01
butt_reynolds19: posts big blind $0.02
*** HOLE CARDS ***
Dealt to CashMatteo [3s 6h]
kingsandsteel: folds 
CashMatteo: folds 
tyke143: folds 
spidernet: calls $0.01
butt_reynolds19: checks 
*** FLOP *** [9s 4d Qs]
spidernet: checks 
butt_reynolds19: checks 
*** TURN *** [9s 4d Qs] [7d]
spidernet: checks 
butt_reynolds19: bets $0.04
spidernet: folds 
Uncalled bet ($0.04) returned to butt_reynolds19
butt_reynolds19 collected $0.04 from pot
butt_reynolds19: doesn't show hand 
*** SUMMARY ***
Total pot $0.04 | Rake $0 
Board [9s 4d Qs 7d]
Seat 1: butt_reynolds19 (big blind) collected ($0.04)
Seat 2: kingsandsteel folded before Flop (didn't bet)
Seat 3: CashMatteo folded before Flop (didn't bet)
Seat 5: tyke143 (button) folded before Flop (didn't bet)
Seat 6: spidernet (small blind) folded on the Turn

Hand #897: 

PokerStars Hand #246297501724:  Hold'em No Limit ($0.01/$0.02 CAD) - 2023/10/01 18:17:21 ET
Table 'Thernoe II' 6-max Seat #6 is the button
Seat 1: butt_reynolds19 ($2.02 in chips) 
Seat 2: kingsandsteel ($1.59 in chips) 
Seat 3: CashMatteo ($1.76 in chips) 
Seat 5: tyke143 ($0.73 in chips) 
Seat 6: spidernet ($3.30 in chips) 
butt_reynolds19: posts small blind $0.01
kingsandsteel: posts big blind $0.02
*** HOLE CARDS ***
Dealt to CashMatteo [6c 7h]
CashMatteo: folds 
tyke143: calls $0.02
spidernet: folds 
butt_reynolds19: folds 
kingsandsteel: checks 
*** FLOP *** [Th 2d 6d]
kingsandsteel: checks 
tyke143: checks 
*** TURN *** [Th 2d 6d] [5d]
kingsandsteel: checks 
tyke143: checks 
*** RIVER *** [Th 2d 6d 5d] [Kc]
kingsandsteel: checks 
tyke143: bets $0.02
kingsandsteel: folds 
Uncalled bet ($0.02) returned to tyke143
tyke143 collected $0.05 from pot
*** SUMMARY ***
Total pot $0.05 | Rake $0 
Board [Th 2d 6d 5d Kc]
Seat 1: butt_reynolds19 (small blind) folded before Flop
Seat 2: kingsandsteel (big blind) folded on the River
Seat 3: CashMatteo folded before Flop (didn't bet)
Seat 5: tyke143 collected ($0.05)
Seat 6: spidernet (button) folded before Flop (didn't bet)

Hand #898: 

PokerStars Hand #246297513958:  Hold'em No Limit ($0.01/$0.02 CAD) - 2023/10/01 18:17:54 ET
Table 'Thernoe II' 6-max Seat #1 is the button
Seat 1: butt_reynolds19 ($2.01 in chips) 
Seat 2: kingsandsteel ($1.57 in chips) 
Seat 3: CashMatteo ($1.76 in chips) 
Seat 5: tyke143 ($0.76 in chips) 
Seat 6: spidernet ($3.30 in chips) 
kingsandsteel: posts small blind $0.01
CashMatteo: posts big blind $0.02
*** HOLE CARDS ***
Dealt to CashMatteo [9h Tc]
tyke143: folds 
spidernet: raises $0.06 to $0.08
butt_reynolds19: raises $0.16 to $0.24
kingsandsteel: folds 
CashMatteo: calls $0.22
spidernet: calls $0.16
*** FLOP *** [As Kd 6s]
CashMatteo: checks 
spidernet: bets $0.70
butt_reynolds19: folds 
CashMatteo: folds 
Uncalled bet ($0.70) returned to spidernet
spidernet collected $0.70 from pot
spidernet: doesn't show hand 
*** SUMMARY ***
Total pot $0.73 | Rake $0.03 
Board [As Kd 6s]
Seat 1: butt_reynolds19 (button) folded on the Flop
Seat 2: kingsandsteel (small blind) folded before Flop
Seat 3: CashMatteo (big blind) folded on the Flop
Seat 5: tyke143 folded before Flop (didn't bet)
Seat 6: spidernet collected ($0.70)

Hand #899: 

PokerStars Hand #246297530943:  Hold'em No Limit ($0.01/$0.02 CAD) - 2023/10/01 18:18:39 ET
Table 'Thernoe II' 6-max Seat #2 is the button
Seat 1: butt_reynolds19 ($2 in chips) 
Seat 2: kingsandsteel ($1.56 in chips) 
Seat 3: CashMatteo ($1.52 in chips) 
Seat 5: tyke143 ($0.76 in chips) 
Seat 6: spidernet ($3.76 in chips) 
CashMatteo: posts small blind $0.01
tyke143: posts big blind $0.02
*** HOLE CARDS ***
Dealt to CashMatteo [Ac 4s]
spidernet: folds 
butt_reynolds19: folds 
kingsandsteel: calls $0.02
CashMatteo: calls $0.01
tyke143: raises $0.12 to $0.14
kingsandsteel: raises $1.42 to $1.56 and is all-in
CashMatteo: folds 
tyke143: calls $0.62 and is all-in
Uncalled bet ($0.80) returned to kingsandsteel
*** FLOP *** [2c 8d 3h]
*** TURN *** [2c 8d 3h] [5h]
*** RIVER *** [2c 8d 3h 5h] [8s]
*** SHOW DOWN ***
tyke143: shows [Qd Js] (a pair of Eights)
kingsandsteel: shows [Qh Th] (a pair of Eights - lower kicker)
tyke143 collected $1.49 from pot
*** SUMMARY ***
Total pot $1.54 | Rake $0.05 
Board [2c 8d 3h 5h 8s]
Seat 1: butt_reynolds19 folded before Flop (didn't bet)
Seat 2: kingsandsteel (button) showed [Qh Th] and lost with a pair of Eights
Seat 3: CashMatteo (small blind) folded before Flop
Seat 5: tyke143 (big blind) showed [Qd Js] and won ($1.49) with a pair of Eights
Seat 6: spidernet folded before Flop (didn't bet)

Hand #900: 

PokerStars Hand #246297542100:  Hold'em No Limit ($0.01/$0.02 CAD) - 2023/10/01 18:19:10 ET
Table 'Thernoe II' 6-max Seat #3 is the button
Seat 1: butt_reynolds19 ($2 in chips) 
Seat 2: kingsandsteel ($0.80 in chips) 
Seat 3: CashMatteo ($1.50 in chips) 
Seat 5: tyke143 ($1.49 in chips) 
Seat 6: spidernet ($3.76 in chips) 
tyke143: posts small blind $0.01
spidernet: posts big blind $0.02
*** HOLE CARDS ***
Dealt to CashMatteo [Qd 8c]
butt_reynolds19: folds 
kingsandsteel: raises $0.78 to $0.80 and is all-in
CashMatteo: folds 
tyke143: folds 
spidernet: folds 
Uncalled bet ($0.78) returned to kingsandsteel
kingsandsteel collected $0.05 from pot
*** SUMMARY ***
Total pot $0.05 | Rake $0 
Seat 1: butt_reynolds19 folded before Flop (didn't bet)
Seat 2: kingsandsteel collected ($0.05)
Seat 3: CashMatteo (button) folded before Flop (didn't bet)
Seat 5: tyke143 (small blind) folded before Flop
Seat 6: spidernet (big blind) folded before Flop

Hand #901: 

PokerStars Hand #246297550516:  Hold'em No Limit ($0.01/$0.02 CAD) - 2023/10/01 18:19:32 ET
Table 'Thernoe II' 6-max Seat #5 is the button
Seat 1: butt_reynolds19 ($2 in chips) 
Seat 2: kingsandsteel ($0.83 in chips) 
Seat 3: CashMatteo ($1.50 in chips) 
Seat 5: tyke143 ($1.48 in chips) 
Seat 6: spidernet ($3.74 in chips) 
spidernet: posts small blind $0.01
butt_reynolds19: posts big blind $0.02
*** HOLE CARDS ***
Dealt to CashMatteo [Jd 4h]
kingsandsteel: folds 
CashMatteo: folds 
tyke143: raises $0.02 to $0.04
spidernet: calls $0.03
butt_reynolds19: calls $0.02
*** FLOP *** [8d 4s Qs]
spidernet: checks 
butt_reynolds19: checks 
tyke143: checks 
*** TURN *** [8d 4s Qs] [Qd]
spidernet: checks 
butt_reynolds19: checks 
tyke143: bets $0.02
spidernet: calls $0.02
butt_reynolds19: folds 
*** RIVER *** [8d 4s Qs Qd] [9c]
spidernet: checks 
tyke143: checks 
*** SHOW DOWN ***
spidernet: shows [Ad 6c] (a pair of Queens)
tyke143: shows [Td As] (a pair of Queens - Ace+Ten kicker)
tyke143 collected $0.15 from pot
*** SUMMARY ***
Total pot $0.16 | Rake $0.01 
Board [8d 4s Qs Qd 9c]
Seat 1: butt_reynolds19 (big blind) folded on the Turn
Seat 2: kingsandsteel folded before Flop (didn't bet)
Seat 3: CashMatteo folded before Flop (didn't bet)
Seat 5: tyke143 (button) showed [Td As] and won ($0.15) with a pair of Queens
Seat 6: spidernet (small blind) showed [Ad 6c] and lost with a pair of Queens

Hand #902: 

PokerStars Hand #246297572887:  Hold'em No Limit ($0.01/$0.02 CAD) - 2023/10/01 18:20:32 ET
Table 'Thernoe II' 6-max Seat #6 is the button
Seat 1: butt_reynolds19 ($2 in chips) 
Seat 2: kingsandsteel ($0.83 in chips) 
Seat 3: CashMatteo ($1.50 in chips) 
Seat 5: tyke143 ($1.57 in chips) 
Seat 6: spidernet ($3.68 in chips) 
butt_reynolds19: posts small blind $0.01
kingsandsteel: posts big blind $0.02
*** HOLE CARDS ***
Dealt to CashMatteo [Qs 6c]
CashMatteo: folds 
tyke143: folds 
spidernet: calls $0.02
butt_reynolds19: folds 
kingsandsteel: checks 
*** FLOP *** [6h 7d 5h]
kingsandsteel: bets $0.02
spidernet: calls $0.02
*** TURN *** [6h 7d 5h] [6s]
kingsandsteel: bets $0.09
spidernet: calls $0.09
*** RIVER *** [6h 7d 5h 6s] [Ah]
kingsandsteel: bets $0.26
spidernet: raises $3.29 to $3.55 and is all-in
kingsandsteel: calls $0.44 and is all-in
Uncalled bet ($2.85) returned to spidernet
*** SHOW DOWN ***
spidernet: shows [9h Kh] (a flush, Ace high)
kingsandsteel: shows [7h Ac] (two pair, Aces and Sevens)
spidernet collected $1.61 from pot
*** SUMMARY ***
Total pot $1.67 | Rake $0.06 
Board [6h 7d 5h 6s Ah]
Seat 1: butt_reynolds19 (small blind) folded before Flop
Seat 2: kingsandsteel (big blind) showed [7h Ac] and lost with two pair, Aces and Sevens
Seat 3: CashMatteo folded before Flop (didn't bet)
Seat 5: tyke143 folded before Flop (didn't bet)
Seat 6: spidernet (button) showed [9h Kh] and won ($1.61) with a flush, Ace high

Hand #903: 

PokerStars Hand #246297593353:  Hold'em No Limit ($0.01/$0.02 CAD) - 2023/10/01 18:21:28 ET
Table 'Thernoe II' 6-max Seat #1 is the button
Seat 1: butt_reynolds19 ($2 in chips) 
Seat 3: CashMatteo ($1.50 in chips) 
Seat 5: tyke143 ($1.57 in chips) 
Seat 6: spidernet ($4.46 in chips) 
CashMatteo: posts small blind $0.01
tyke143: posts big blind $0.02
*** HOLE CARDS ***
Dealt to CashMatteo [4s 4c]
spidernet: calls $0.02
butt_reynolds19: folds 
CashMatteo: raises $0.04 to $0.06
kingsandsteel leaves the table
tyke143: calls $0.04
spidernet: calls $0.04
*** FLOP *** [9s Jh Qs]
CashMatteo: bets $0.09
Sinlessmoon joins the table at seat #2 
tyke143: folds 
spidernet: calls $0.09
*** TURN *** [9s Jh Qs] [8h]
CashMatteo: checks 
spidernet: bets $0.02
CashMatteo: calls $0.02
*** RIVER *** [9s Jh Qs 8h] [2s]
CashMatteo: checks 
spidernet: checks 
*** SHOW DOWN ***
CashMatteo: shows [4s 4c] (a pair of Fours)
spidernet: shows [9h Qh] (two pair, Queens and Nines)
spidernet collected $0.39 from pot
indyjones45 was removed from the table for failing to post
indyjones45 leaves the table
*** SUMMARY ***
Total pot $0.40 | Rake $0.01 
Board [9s Jh Qs 8h 2s]
Seat 1: butt_reynolds19 (button) folded before Flop (didn't bet)
Seat 3: CashMatteo (small blind) showed [4s 4c] and lost with a pair of Fours
Seat 5: tyke143 (big blind) folded on the Flop
Seat 6: spidernet showed [9h Qh] and won ($0.39) with two pair, Queens and Nines

Hand #904: 

PokerStars Hand #246297612055:  Hold'em No Limit ($0.01/$0.02 CAD) - 2023/10/01 18:22:18 ET
Table 'Thernoe II' 6-max Seat #3 is the button
Seat 1: butt_reynolds19 ($2 in chips) 
Seat 2: Sinlessmoon ($2 in chips) 
Seat 3: CashMatteo ($1.33 in chips) 
Seat 5: tyke143 ($1.51 in chips) 
Seat 6: spidernet ($4.68 in chips) 
tyke143: posts small blind $0.01
spidernet: posts big blind $0.02
Sinlessmoon: posts big blind $0.02
*** HOLE CARDS ***
Dealt to CashMatteo [4s Kh]
butt_reynolds19: folds 
Sinlessmoon: checks 
CashMatteo: folds 
tyke143: calls $0.01
rusty438 joins the table at seat #4 
spidernet: checks 
*** FLOP *** [Ah 9h Qs]
tyke143: checks 
spidernet: checks 
Sinlessmoon: checks 
*** TURN *** [Ah 9h Qs] [3s]
tyke143: checks 
spidernet: bets $0.06
Sinlessmoon: folds 
tyke143: folds 
Uncalled bet ($0.06) returned to spidernet
spidernet collected $0.06 from pot
spidernet: doesn't show hand 
*** SUMMARY ***
Total pot $0.06 | Rake $0 
Board [Ah 9h Qs 3s]
Seat 1: butt_reynolds19 folded before Flop (didn't bet)
Seat 2: Sinlessmoon folded on the Turn (didn't bet)
Seat 3: CashMatteo (button) folded before Flop (didn't bet)
Seat 5: tyke143 (small blind) folded on the Turn
Seat 6: spidernet (big blind) collected ($0.06)

Hand #905: 

PokerStars Hand #246297626852:  Hold'em No Limit ($0.01/$0.02 CAD) - 2023/10/01 18:22:57 ET
Table 'Thernoe II' 6-max Seat #5 is the button
Seat 1: butt_reynolds19 ($2 in chips) 
Seat 2: Sinlessmoon ($1.98 in chips) 
Seat 3: CashMatteo ($1.33 in chips) 
Seat 5: tyke143 ($1.49 in chips) 
Seat 6: spidernet ($4.72 in chips) 
spidernet: posts small blind $0.01
butt_reynolds19: posts big blind $0.02
rusty438: sits out 
*** HOLE CARDS ***
Dealt to CashMatteo [3s As]
Sinlessmoon: folds 
CashMatteo: raises $0.02 to $0.04
tyke143: calls $0.04
spidernet: calls $0.03
butt_reynolds19: calls $0.02
*** FLOP *** [Kh Jc 6d]
spidernet: checks 
butt_reynolds19: checks 
CashMatteo: checks 
tyke143: bets $1.45 and is all-in
spidernet: folds 
butt_reynolds19: folds 
CashMatteo: folds 
Uncalled bet ($1.45) returned to tyke143
tyke143 collected $0.15 from pot
*** SUMMARY ***
Total pot $0.16 | Rake $0.01 
Board [Kh Jc 6d]
Seat 1: butt_reynolds19 (big blind) folded on the Flop
Seat 2: Sinlessmoon folded before Flop (didn't bet)
Seat 3: CashMatteo folded on the Flop
Seat 5: tyke143 (button) collected ($0.15)
Seat 6: spidernet (small blind) folded on the Flop

Hand #906: 

PokerStars Hand #246297645306:  Hold'em No Limit ($0.01/$0.02 CAD) - 2023/10/01 18:23:47 ET
Table 'Thernoe II' 6-max Seat #6 is the button
Seat 1: butt_reynolds19 ($2 in chips) 
Seat 2: Sinlessmoon ($1.98 in chips) 
Seat 3: CashMatteo ($1.29 in chips) 
Seat 5: tyke143 ($1.60 in chips) 
Seat 6: spidernet ($4.68 in chips) 
butt_reynolds19: posts small blind $0.01
Sinlessmoon: posts big blind $0.02
rusty438: sits out 
*** HOLE CARDS ***
Dealt to CashMatteo [8h 3d]
CashMatteo: folds 
tyke143: folds 
spidernet: calls $0.02
butt_reynolds19: folds 
Sinlessmoon: raises $0.04 to $0.06
spidernet: calls $0.04
*** FLOP *** [9d Ah Td]
Sinlessmoon: bets $0.07
spidernet: folds 
Uncalled bet ($0.07) returned to Sinlessmoon
Sinlessmoon collected $0.13 from pot
*** SUMMARY ***
Total pot $0.13 | Rake $0 
Board [9d Ah Td]
Seat 1: butt_reynolds19 (small blind) folded before Flop
Seat 2: Sinlessmoon (big blind) collected ($0.13)
Seat 3: CashMatteo folded before Flop (didn't bet)
Seat 5: tyke143 folded before Flop (didn't bet)
Seat 6: spidernet (button) folded on the Flop

Hand #907: 

PokerStars Hand #246297658508:  Hold'em No Limit ($0.01/$0.02 CAD) - 2023/10/01 18:24:23 ET
Table 'Thernoe II' 6-max Seat #1 is the button
Seat 1: butt_reynolds19 ($2 in chips) 
Seat 2: Sinlessmoon ($2.05 in chips) 
Seat 3: CashMatteo ($1.29 in chips) 
Seat 5: tyke143 ($1.60 in chips) 
Seat 6: spidernet ($4.62 in chips) 
Sinlessmoon: posts small blind $0.01
CashMatteo: posts big blind $0.02
rusty438: sits out 
*** HOLE CARDS ***
Dealt to CashMatteo [7s Js]
rusty438 leaves the table
tyke143: folds 
spidernet: folds 
Epangpoker joins the table at seat #4 
butt_reynolds19: raises $0.02 to $0.04
Sinlessmoon: folds 
CashMatteo: calls $0.02
*** FLOP *** [3d Jd 7d]
CashMatteo: checks 
butt_reynolds19: checks 
*** TURN *** [3d Jd 7d] [9c]
CashMatteo: bets $0.09
butt_reynolds19: folds 
Uncalled bet ($0.09) returned to CashMatteo
CashMatteo collected $0.09 from pot
CashMatteo: doesn't show hand 
*** SUMMARY ***
Total pot $0.09 | Rake $0 
Board [3d Jd 7d 9c]
Seat 1: butt_reynolds19 (button) folded on the Turn
Seat 2: Sinlessmoon (small blind) folded before Flop
Seat 3: CashMatteo (big blind) collected ($0.09)
Seat 5: tyke143 folded before Flop (didn't bet)
Seat 6: spidernet folded before Flop (didn't bet)

Hand #908: 

PokerStars Hand #246297680881:  Hold'em No Limit ($0.01/$0.02 CAD) - 2023/10/01 18:25:23 ET
Table 'Thernoe II' 6-max Seat #2 is the button
Seat 1: butt_reynolds19 ($2 in chips) 
Seat 2: Sinlessmoon ($2.04 in chips) 
Seat 3: CashMatteo ($1.34 in chips) 
Seat 4: Epangpoker ($0.80 in chips) 
Seat 5: tyke143 ($1.60 in chips) 
Seat 6: spidernet ($4.62 in chips) 
CashMatteo: posts small blind $0.01
Epangpoker: posts big blind $0.02
*** HOLE CARDS ***
Dealt to CashMatteo [2h 9s]
tyke143: raises $0.30 to $0.32
spidernet: folds 
butt_reynolds19: folds 
Sinlessmoon: raises $0.30 to $0.62
CashMatteo: folds 
spidernet leaves the table
Epangpoker: folds 
tyke143: raises $0.98 to $1.60 and is all-in
Sinlessmoon: calls $0.98
*** FLOP *** [Jd 3c Ks]
*** TURN *** [Jd 3c Ks] [Kc]
*** RIVER *** [Jd 3c Ks Kc] [Th]
*** SHOW DOWN ***
tyke143: shows [3s Ad] (two pair, Kings and Threes)
Sinlessmoon: shows [Kd Kh] (four of a kind, Kings)
Sinlessmoon collected $3.12 from pot
*** SUMMARY ***
Total pot $3.23 | Rake $0.11 
Board [Jd 3c Ks Kc Th]
Seat 1: butt_reynolds19 folded before Flop (didn't bet)
Seat 2: Sinlessmoon (button) showed [Kd Kh] and won ($3.12) with four of a kind, Kings
Seat 3: CashMatteo (small blind) folded before Flop
Seat 4: Epangpoker (big blind) folded before Flop
Seat 5: tyke143 showed [3s Ad] and lost with two pair, Kings and Threes
Seat 6: spidernet folded before Flop (didn't bet)

Hand #909: 

PokerStars Hand #246297699094:  Hold'em No Limit ($0.01/$0.02 CAD) - 2023/10/01 18:26:12 ET
Table 'Thernoe II' 6-max Seat #3 is the button
Seat 1: butt_reynolds19 ($2 in chips) 
Seat 2: Sinlessmoon ($3.56 in chips) 
Seat 3: CashMatteo ($1.33 in chips) 
Seat 4: Epangpoker ($0.78 in chips) 
Epangpoker: posts small blind $0.01
butt_reynolds19: posts big blind $0.02
*** HOLE CARDS ***
Dealt to CashMatteo [Tc 6s]
pink810251 joins the table at seat #6 
Sinlessmoon: folds 
CashMatteo: folds 
Epangpoker: raises $0.04 to $0.06
tyke143 leaves the table
butt_reynolds19: folds 
Uncalled bet ($0.04) returned to Epangpoker
Epangpoker collected $0.04 from pot
*** SUMMARY ***
Total pot $0.04 | Rake $0 
Seat 1: butt_reynolds19 (big blind) folded before Flop
Seat 2: Sinlessmoon folded before Flop (didn't bet)
Seat 3: CashMatteo (button) folded before Flop (didn't bet)
Seat 4: Epangpoker (small blind) collected ($0.04)

Hand #910: 

PokerStars Hand #246297706489:  Hold'em No Limit ($0.01/$0.02 CAD) - 2023/10/01 18:26:32 ET
Table 'Thernoe II' 6-max Seat #4 is the button
Seat 1: butt_reynolds19 ($2 in chips) 
Seat 2: Sinlessmoon ($3.56 in chips) 
Seat 3: CashMatteo ($1.33 in chips) 
Seat 4: Epangpoker ($0.80 in chips) 
pink810251 will be allowed to play after the button
butt_reynolds19: posts small blind $0.01
Sinlessmoon: posts big blind $0.02
*** HOLE CARDS ***
Dealt to CashMatteo [6s Tc]
CashMatteo: folds 
Epangpoker: folds 
butt_reynolds19: folds 
Uncalled bet ($0.01) returned to Sinlessmoon
Sinlessmoon collected $0.02 from pot
*** SUMMARY ***
Total pot $0.02 | Rake $0 
Seat 1: butt_reynolds19 (small blind) folded before Flop
Seat 2: Sinlessmoon (big blind) collected ($0.02)
Seat 3: CashMatteo folded before Flop (didn't bet)
Seat 4: Epangpoker (button) folded before Flop (didn't bet)

Hand #911: 

PokerStars Hand #246297713335:  Hold'em No Limit ($0.01/$0.02 CAD) - 2023/10/01 18:26:51 ET
Table 'Thernoe II' 6-max Seat #1 is the button
Seat 1: butt_reynolds19 ($2 in chips) 
Seat 2: Sinlessmoon ($3.57 in chips) 
Seat 3: CashMatteo ($1.33 in chips) 
Seat 4: Epangpoker ($0.80 in chips) 
Sinlessmoon: posts small blind $0.01
CashMatteo: posts big blind $0.02
pink810251: sits out 
*** HOLE CARDS ***
Dealt to CashMatteo [8h Ad]
Epangpoker: calls $0.02
butt_reynolds19: raises $0.06 to $0.08
Sinlessmoon: calls $0.07
CashMatteo: calls $0.06
Epangpoker: calls $0.06
*** FLOP *** [Js 4s 9h]
Sinlessmoon: bets $0.16
CashMatteo: folds 
Epangpoker: calls $0.16
butt_reynolds19: raises $1.76 to $1.92 and is all-in
Sinlessmoon: folds 
Epangpoker: calls $0.56 and is all-in
Uncalled bet ($1.20) returned to butt_reynolds19
*** TURN *** [Js 4s 9h] [9c]
*** RIVER *** [Js 4s 9h 9c] [5c]
*** SHOW DOWN ***
Epangpoker: shows [7h Jh] (two pair, Jacks and Nines)
butt_reynolds19: shows [Kc Ks] (two pair, Kings and Nines)
butt_reynolds19 collected $1.85 from pot
*** SUMMARY ***
Total pot $1.92 | Rake $0.07 
Board [Js 4s 9h 9c 5c]
Seat 1: butt_reynolds19 (button) showed [Kc Ks] and won ($1.85) with two pair, Kings and Nines
Seat 2: Sinlessmoon (small blind) folded on the Flop
Seat 3: CashMatteo (big blind) folded on the Flop
Seat 4: Epangpoker showed [7h Jh] and lost with two pair, Jacks and Nines

Hand #912: 

PokerStars Hand #246297744484:  Hold'em No Limit ($0.01/$0.02 CAD) - 2023/10/01 18:28:15 ET
Table 'Thernoe II' 6-max Seat #2 is the button
Seat 1: butt_reynolds19 ($3.05 in chips) 
Seat 2: Sinlessmoon ($3.33 in chips) 
Seat 3: CashMatteo ($1.25 in chips) 
Seat 6: pink810251 ($0.75 in chips) 
CashMatteo: posts small blind $0.01
pink810251: posts big blind $0.02
*** HOLE CARDS ***
Dealt to CashMatteo [2s 7h]
butt_reynolds19: folds 
Sinlessmoon: folds 
CashMatteo: folds 
Uncalled bet ($0.01) returned to pink810251
pink810251 collected $0.02 from pot
*** SUMMARY ***
Total pot $0.02 | Rake $0 
Seat 1: butt_reynolds19 folded before Flop (didn't bet)
Seat 2: Sinlessmoon (button) folded before Flop (didn't bet)
Seat 3: CashMatteo (small blind) folded before Flop
Seat 6: pink810251 (big blind) collected ($0.02)

Hand #913: 

PokerStars Hand #246297749145:  Hold'em No Limit ($0.01/$0.02 CAD) - 2023/10/01 18:28:28 ET
Table 'Thernoe II' 6-max Seat #3 is the button
Seat 1: butt_reynolds19 ($3.05 in chips) 
Seat 2: Sinlessmoon ($3.33 in chips) 
Seat 3: CashMatteo ($1.24 in chips) 
Seat 6: pink810251 ($0.76 in chips) 
Epangpoker will be allowed to play after the button
pink810251: posts small blind $0.01
butt_reynolds19: posts big blind $0.02
*** HOLE CARDS ***
Dealt to CashMatteo [3c 7c]
Sinlessmoon: folds 
CashMatteo: folds 
pink810251: folds 
Uncalled bet ($0.01) returned to butt_reynolds19
butt_reynolds19 collected $0.02 from pot
butt_reynolds19: doesn't show hand 
*** SUMMARY ***
Total pot $0.02 | Rake $0 
Seat 1: butt_reynolds19 (big blind) collected ($0.02)
Seat 2: Sinlessmoon folded before Flop (didn't bet)
Seat 3: CashMatteo (button) folded before Flop (didn't bet)
Seat 6: pink810251 (small blind) folded before Flop

Hand #914: 

PokerStars Hand #246297751709:  Hold'em No Limit ($0.01/$0.02 CAD) - 2023/10/01 18:28:35 ET
Table 'Thernoe II' 6-max Seat #6 is the button
Seat 1: butt_reynolds19 ($3.06 in chips) 
Seat 2: Sinlessmoon ($3.33 in chips) 
Seat 3: CashMatteo ($1.24 in chips) 
Seat 4: Epangpoker ($0.80 in chips) 
Seat 6: pink810251 ($0.75 in chips) 
butt_reynolds19: posts small blind $0.01
Sinlessmoon: posts big blind $0.02
Epangpoker: posts small & big blinds $0.03
*** HOLE CARDS ***
Dealt to CashMatteo [Ad 6h]
CashMatteo: raises $0.08 to $0.10
Epangpoker: folds 
pink810251: folds 
butt_reynolds19: folds 
Sinlessmoon: folds 
Uncalled bet ($0.08) returned to CashMatteo
CashMatteo collected $0.08 from pot
CashMatteo: doesn't show hand 
*** SUMMARY ***
Total pot $0.08 | Rake $0 
Seat 1: butt_reynolds19 (small blind) folded before Flop
Seat 2: Sinlessmoon (big blind) folded before Flop
Seat 3: CashMatteo collected ($0.08)
Seat 4: Epangpoker folded before Flop (didn't bet)
Seat 6: pink810251 (button) folded before Flop (didn't bet)

Hand #915: 

PokerStars Hand #246297757108:  Hold'em No Limit ($0.01/$0.02 CAD) - 2023/10/01 18:28:49 ET
Table 'Thernoe II' 6-max Seat #1 is the button
Seat 1: butt_reynolds19 ($3.05 in chips) 
Seat 2: Sinlessmoon ($3.31 in chips) 
Seat 3: CashMatteo ($1.30 in chips) 
Seat 4: Epangpoker ($0.77 in chips) 
Seat 6: pink810251 ($0.75 in chips) 
Sinlessmoon: posts small blind $0.01
CashMatteo: posts big blind $0.02
*** HOLE CARDS ***
Dealt to CashMatteo [2d 4d]
Epangpoker: calls $0.02
pink810251: folds 
butt_reynolds19: folds 
Sinlessmoon: folds 
CashMatteo: checks 
*** FLOP *** [Ks 2s As]
CashMatteo: checks 
Epangpoker: checks 
*** TURN *** [Ks 2s As] [Ts]
CashMatteo: checks 
Epangpoker: checks 
*** RIVER *** [Ks 2s As Ts] [Jd]
CashMatteo: bets $0.03
Epangpoker: calls $0.03
*** SHOW DOWN ***
CashMatteo: shows [2d 4d] (a pair of Deuces)
Epangpoker: shows [Qd Th] (a straight, Ten to Ace)
Epangpoker collected $0.11 from pot
*** SUMMARY ***
Total pot $0.11 | Rake $0 
Board [Ks 2s As Ts Jd]
Seat 1: butt_reynolds19 (button) folded before Flop (didn't bet)
Seat 2: Sinlessmoon (small blind) folded before Flop
Seat 3: CashMatteo (big blind) showed [2d 4d] and lost with a pair of Deuces
Seat 4: Epangpoker showed [Qd Th] and won ($0.11) with a straight, Ten to Ace
Seat 6: pink810251 folded before Flop (didn't bet)

Hand #916: 

PokerStars Hand #246297773229:  Hold'em No Limit ($0.01/$0.02 CAD) - 2023/10/01 18:29:33 ET
Table 'Thernoe II' 6-max Seat #2 is the button
Seat 1: butt_reynolds19 ($3.05 in chips) 
Seat 2: Sinlessmoon ($3.30 in chips) 
Seat 3: CashMatteo ($1.25 in chips) 
Seat 4: Epangpoker ($0.83 in chips) 
Seat 6: pink810251 ($0.75 in chips) 
CashMatteo: posts small blind $0.01
Epangpoker: posts big blind $0.02
*** HOLE CARDS ***
Dealt to CashMatteo [5s 6c]
pink810251: folds 
butt_reynolds19: raises $0.04 to $0.06
Sinlessmoon: calls $0.06
CashMatteo: folds 
gqexpos joins the table at seat #5 
Epangpoker: calls $0.04
*** FLOP *** [4h Ts Th]
Epangpoker: checks 
butt_reynolds19: bets $0.11
Sinlessmoon: folds 
Epangpoker: raises $0.13 to $0.24
butt_reynolds19: folds 
Uncalled bet ($0.13) returned to Epangpoker
Epangpoker collected $0.40 from pot
*** SUMMARY ***
Total pot $0.41 | Rake $0.01 
Board [4h Ts Th]
Seat 1: butt_reynolds19 folded on the Flop
Seat 2: Sinlessmoon (button) folded on the Flop
Seat 3: CashMatteo (small blind) folded before Flop
Seat 4: Epangpoker (big blind) collected ($0.40)
Seat 6: pink810251 folded before Flop (didn't bet)

Hand #917: 

PokerStars Hand #246297792362:  Hold'em No Limit ($0.01/$0.02 CAD) - 2023/10/01 18:30:25 ET
Table 'Thernoe II' 6-max Seat #3 is the button
Seat 1: butt_reynolds19 ($2.88 in chips) 
Seat 2: Sinlessmoon ($3.24 in chips) 
Seat 3: CashMatteo ($1.24 in chips) 
Seat 4: Epangpoker ($1.06 in chips) 
Seat 5: gqexpos ($1.50 in chips) 
Seat 6: pink810251 ($0.75 in chips) 
Epangpoker: posts small blind $0.01
gqexpos: posts big blind $0.02
*** HOLE CARDS ***
Dealt to CashMatteo [2s 6h]
pink810251 has timed out
pink810251: folds 
butt_reynolds19: folds 
Sinlessmoon: folds 
CashMatteo: folds 
Epangpoker: raises $0.04 to $0.06
gqexpos: folds 
Uncalled bet ($0.04) returned to Epangpoker
Epangpoker collected $0.04 from pot
*** SUMMARY ***
Total pot $0.04 | Rake $0 
Seat 1: butt_reynolds19 folded before Flop (didn't bet)
Seat 2: Sinlessmoon folded before Flop (didn't bet)
Seat 3: CashMatteo (button) folded before Flop (didn't bet)
Seat 4: Epangpoker (small blind) collected ($0.04)
Seat 5: gqexpos (big blind) folded before Flop
Seat 6: pink810251 folded before Flop (didn't bet)

Hand #918: 

PokerStars Hand #246297800295:  Hold'em No Limit ($0.01/$0.02 CAD) - 2023/10/01 18:30:47 ET
Table 'Thernoe II' 6-max Seat #4 is the button
Seat 1: butt_reynolds19 ($2.88 in chips) 
Seat 2: Sinlessmoon ($3.24 in chips) 
Seat 3: CashMatteo ($1.24 in chips) 
Seat 4: Epangpoker ($1.08 in chips) 
Seat 5: gqexpos ($1.48 in chips) 
gqexpos: posts small blind $0.01
butt_reynolds19: posts big blind $0.02
*** HOLE CARDS ***
Dealt to CashMatteo [5h 8h]
Sinlessmoon: folds 
CashMatteo: folds 
Epangpoker: folds 
gqexpos: calls $0.01
butt_reynolds19: checks 
*** FLOP *** [4c Js Qh]
gqexpos: bets $0.02
butt_reynolds19: calls $0.02
*** TURN *** [4c Js Qh] [Ad]
gqexpos: checks 
butt_reynolds19: checks 
*** RIVER *** [4c Js Qh Ad] [Th]
gqexpos: checks 
butt_reynolds19: checks 
*** SHOW DOWN ***
gqexpos: shows [5c 3d] (high card Ace)
butt_reynolds19: shows [9d 4d] (a pair of Fours)
butt_reynolds19 collected $0.08 from pot
*** SUMMARY ***
Total pot $0.08 | Rake $0 
Board [4c Js Qh Ad Th]
Seat 1: butt_reynolds19 (big blind) showed [9d 4d] and won ($0.08) with a pair of Fours
Seat 2: Sinlessmoon folded before Flop (didn't bet)
Seat 3: CashMatteo folded before Flop (didn't bet)
Seat 4: Epangpoker (button) folded before Flop (didn't bet)
Seat 5: gqexpos (small blind) showed [5c 3d] and lost with high card Ace

Hand #919: 

PokerStars Hand #246297814808:  Hold'em No Limit ($0.01/$0.02 CAD) - 2023/10/01 18:31:26 ET
Table 'Thernoe II' 6-max Seat #5 is the button
Seat 1: butt_reynolds19 ($2.92 in chips) 
Seat 2: Sinlessmoon ($3.24 in chips) 
Seat 3: CashMatteo ($1.24 in chips) 
Seat 4: Epangpoker ($1.08 in chips) 
Seat 5: gqexpos ($1.44 in chips) 
butt_reynolds19: posts small blind $0.01
Sinlessmoon: posts big blind $0.02
*** HOLE CARDS ***
Dealt to CashMatteo [Jd 4d]
CashMatteo: calls $0.02
Epangpoker: calls $0.02
gqexpos: calls $0.02
butt_reynolds19: calls $0.01
Sinlessmoon: checks 
*** FLOP *** [3c Ah Ks]
butt_reynolds19: checks 
Sinlessmoon: checks 
CashMatteo: checks 
Epangpoker: checks 
gqexpos: bets $0.10
butt_reynolds19: calls $0.10
Sinlessmoon: folds 
CashMatteo: folds 
Epangpoker is disconnected 
Epangpoker is connected 
Epangpoker: folds 
*** TURN *** [3c Ah Ks] [Qd]
butt_reynolds19: checks 
gqexpos: bets $0.10
butt_reynolds19: calls $0.10
*** RIVER *** [3c Ah Ks Qd] [2c]
butt_reynolds19: checks 
gqexpos: bets $0.40
butt_reynolds19: calls $0.40
*** SHOW DOWN ***
gqexpos: shows [Th 9h] (high card Ace)
butt_reynolds19: shows [8d As] (a pair of Aces)
butt_reynolds19 collected $1.25 from pot
*** SUMMARY ***
Total pot $1.30 | Rake $0.05 
Board [3c Ah Ks Qd 2c]
Seat 1: butt_reynolds19 (small blind) showed [8d As] and won ($1.25) with a pair of Aces
Seat 2: Sinlessmoon (big blind) folded on the Flop
Seat 3: CashMatteo folded on the Flop
Seat 4: Epangpoker folded on the Flop
Seat 5: gqexpos (button) showed [Th 9h] and lost with high card Ace

Hand #920: 

PokerStars Hand #246297847807:  Hold'em No Limit ($0.01/$0.02 CAD) - 2023/10/01 18:32:56 ET
Table 'Thernoe II' 6-max Seat #1 is the button
Seat 1: butt_reynolds19 ($3.55 in chips) 
Seat 2: Sinlessmoon ($3.22 in chips) 
Seat 3: CashMatteo ($1.22 in chips) 
Seat 4: Epangpoker ($1.06 in chips) 
Seat 5: gqexpos ($0.82 in chips) 
Sinlessmoon: posts small blind $0.01
CashMatteo: posts big blind $0.02
*** HOLE CARDS ***
Dealt to CashMatteo [Ac 7d]
Epangpoker: folds 
gqexpos: raises $0.08 to $0.10
butt_reynolds19: folds 
Sinlessmoon: raises $0.20 to $0.30
CashMatteo: folds 
gqexpos: calls $0.20
*** FLOP *** [9h Qs 4s]
Sinlessmoon: bets $0.60
gqexpos: folds 
Uncalled bet ($0.60) returned to Sinlessmoon
Sinlessmoon collected $0.60 from pot
gqexpos leaves the table
*** SUMMARY ***
Total pot $0.62 | Rake $0.02 
Board [9h Qs 4s]
Seat 1: butt_reynolds19 (button) folded before Flop (didn't bet)
Seat 2: Sinlessmoon (small blind) collected ($0.60)
Seat 3: CashMatteo (big blind) folded before Flop
Seat 4: Epangpoker folded before Flop (didn't bet)
Seat 5: gqexpos folded on the Flop

Hand #921: 

PokerStars Hand #246297859141:  Hold'em No Limit ($0.01/$0.02 CAD) - 2023/10/01 18:33:27 ET
Table 'Thernoe II' 6-max Seat #2 is the button
Seat 1: butt_reynolds19 ($3.55 in chips) 
Seat 2: Sinlessmoon ($3.52 in chips) 
Seat 3: CashMatteo ($1.20 in chips) 
Seat 4: Epangpoker ($1.06 in chips) 
CashMatteo: posts small blind $0.01
Epangpoker: posts big blind $0.02
*** HOLE CARDS ***
Dealt to CashMatteo [Qc Kc]
butt_reynolds19: raises $0.03 to $0.05
Sinlessmoon: folds 
tuk-tuk67 joins the table at seat #5 
CashMatteo: raises $0.12 to $0.17
Epangpoker: folds 
butt_reynolds19: calls $0.12
*** FLOP *** [As Jh 6d]
CashMatteo: bets $0.35
butt_reynolds19: raises $1.05 to $1.40
CashMatteo: calls $0.68 and is all-in
Uncalled bet ($0.37) returned to butt_reynolds19
*** TURN *** [As Jh 6d] [Kh]
*** RIVER *** [As Jh 6d Kh] [8c]
*** SHOW DOWN ***
CashMatteo: shows [Qc Kc] (a pair of Kings)
butt_reynolds19: shows [Ad Qh] (a pair of Aces)
butt_reynolds19 collected $2.34 from pot
*** SUMMARY ***
Total pot $2.42 | Rake $0.08 
Board [As Jh 6d Kh 8c]
Seat 1: butt_reynolds19 showed [Ad Qh] and won ($2.34) with a pair of Aces
Seat 2: Sinlessmoon (button) folded before Flop (didn't bet)
Seat 3: CashMatteo (small blind) showed [Qc Kc] and lost with a pair of Kings
Seat 4: Epangpoker (big blind) folded before Flop

Hand #922: 

PokerStars Hand #246297883128:  Hold'em No Limit ($0.01/$0.02 CAD) - 2023/10/01 18:34:32 ET
Table 'Thernoe II' 6-max Seat #1 is the button
Seat 1: butt_reynolds19 ($4.71 in chips) 
Seat 2: Sinlessmoon ($3.50 in chips) 
Seat 3: CashMatteo ($2 in chips) 
Seat 4: Epangpoker ($1.04 in chips) 
Sinlessmoon: posts small blind $0.01
CashMatteo: posts big blind $0.02
tuk-tuk67: sits out 
pink810251: sits out 
*** HOLE CARDS ***
Dealt to CashMatteo [Jd Ah]
Epangpoker: folds 
butt_reynolds19: folds 
Sinlessmoon: folds 
Uncalled bet ($0.01) returned to CashMatteo
CashMatteo collected $0.02 from pot
CashMatteo: doesn't show hand 
*** SUMMARY ***
Total pot $0.02 | Rake $0 
Seat 1: butt_reynolds19 (button) folded before Flop (didn't bet)
Seat 2: Sinlessmoon (small blind) folded before Flop
Seat 3: CashMatteo (big blind) collected ($0.02)
Seat 4: Epangpoker folded before Flop (didn't bet)

Hand #923: 

PokerStars Hand #246297888106:  Hold'em No Limit ($0.01/$0.02 CAD) - 2023/10/01 18:34:46 ET
Table 'Thernoe II' 6-max Seat #2 is the button
Seat 1: butt_reynolds19 ($4.71 in chips) 
Seat 2: Sinlessmoon ($3.49 in chips) 
Seat 3: CashMatteo ($2.01 in chips) 
Seat 4: Epangpoker ($1.04 in chips) 
CashMatteo: posts small blind $0.01
Epangpoker: posts big blind $0.02
tuk-tuk67: sits out 
pink810251: sits out 
*** HOLE CARDS ***
Dealt to CashMatteo [Kd 5h]
butt_reynolds19: folds 
Sinlessmoon: folds 
CashMatteo: calls $0.01
Epangpoker: raises $0.04 to $0.06
CashMatteo: calls $0.04
*** FLOP *** [8d Qh 5d]
CashMatteo: bets $0.06
Epangpoker: raises $0.08 to $0.14
CashMatteo: folds 
Uncalled bet ($0.08) returned to Epangpoker
Epangpoker collected $0.23 from pot
*** SUMMARY ***
Total pot $0.24 | Rake $0.01 
Board [8d Qh 5d]
Seat 1: butt_reynolds19 folded before Flop (didn't bet)
Seat 2: Sinlessmoon (button) folded before Flop (didn't bet)
Seat 3: CashMatteo (small blind) folded on the Flop
Seat 4: Epangpoker (big blind) collected ($0.23)

Hand #924: 

PokerStars Hand #246297908424:  Hold'em No Limit ($0.01/$0.02 CAD) - 2023/10/01 18:35:42 ET
Table 'Thernoe II' 6-max Seat #3 is the button
Seat 1: butt_reynolds19 ($4.71 in chips) 
Seat 2: Sinlessmoon ($3.49 in chips) 
Seat 3: CashMatteo ($1.89 in chips) 
Seat 4: Epangpoker ($1.15 in chips) 
Seat 5: tuk-tuk67 ($2 in chips) 
Epangpoker: posts small blind $0.01
tuk-tuk67: posts big blind $0.02
pink810251: sits out 
*** HOLE CARDS ***
Dealt to CashMatteo [9d Qs]
butt_reynolds19: folds 
Sinlessmoon: folds 
CashMatteo: raises $0.04 to $0.06
Epangpoker: raises $0.04 to $0.10
tuk-tuk67: folds 
CashMatteo: calls $0.04
*** FLOP *** [Ah 4s 6h]
Epangpoker: checks 
CashMatteo: bets $0.11
Epangpoker: folds 
Uncalled bet ($0.11) returned to CashMatteo
CashMatteo collected $0.21 from pot
CashMatteo: doesn't show hand 
*** SUMMARY ***
Total pot $0.22 | Rake $0.01 
Board [Ah 4s 6h]
Seat 1: butt_reynolds19 folded before Flop (didn't bet)
Seat 2: Sinlessmoon folded before Flop (didn't bet)
Seat 3: CashMatteo (button) collected ($0.21)
Seat 4: Epangpoker (small blind) folded on the Flop
Seat 5: tuk-tuk67 (big blind) folded before Flop

Hand #925: 

PokerStars Hand #246297927052:  Hold'em No Limit ($0.01/$0.02 CAD) - 2023/10/01 18:36:34 ET
Table 'Thernoe II' 6-max Seat #4 is the button
Seat 1: butt_reynolds19 ($4.71 in chips) 
Seat 2: Sinlessmoon ($3.49 in chips) 
Seat 3: CashMatteo ($2 in chips) 
Seat 4: Epangpoker ($1.05 in chips) 
Seat 5: tuk-tuk67 ($1.98 in chips) 
Seat 6: pink810251 ($0.75 in chips) 
tuk-tuk67: posts small blind $0.01
pink810251: posts big blind $0.02
*** HOLE CARDS ***
Dealt to CashMatteo [5s 4d]
butt_reynolds19: folds 
Sinlessmoon: folds 
CashMatteo: calls $0.02
Epangpoker: folds 
tuk-tuk67: calls $0.01
pink810251: checks 
*** FLOP *** [9c 2s 2h]
tuk-tuk67: checks 
pink810251: checks 
CashMatteo: checks 
*** TURN *** [9c 2s 2h] [Th]
tuk-tuk67: bets $0.04
pink810251: folds 
CashMatteo: folds 
Uncalled bet ($0.04) returned to tuk-tuk67
tuk-tuk67 collected $0.06 from pot
tuk-tuk67: doesn't show hand 
*** SUMMARY ***
Total pot $0.06 | Rake $0 
Board [9c 2s 2h Th]
Seat 1: butt_reynolds19 folded before Flop (didn't bet)
Seat 2: Sinlessmoon folded before Flop (didn't bet)
Seat 3: CashMatteo folded on the Turn
Seat 4: Epangpoker (button) folded before Flop (didn't bet)
Seat 5: tuk-tuk67 (small blind) collected ($0.06)
Seat 6: pink810251 (big blind) folded on the Turn

Hand #926: 

PokerStars Hand #246297948620:  Hold'em No Limit ($0.01/$0.02 CAD) - 2023/10/01 18:37:34 ET
Table 'Thernoe II' 6-max Seat #5 is the button
Seat 1: butt_reynolds19 ($4.71 in chips) 
Seat 2: Sinlessmoon ($3.49 in chips) 
Seat 3: CashMatteo ($1.98 in chips) 
Seat 4: Epangpoker ($1.05 in chips) 
Seat 5: tuk-tuk67 ($2.02 in chips) 
butt_reynolds19: posts small blind $0.01
Sinlessmoon: posts big blind $0.02
*** HOLE CARDS ***
Dealt to CashMatteo [Jc 6d]
CashMatteo: folds 
Epangpoker: folds 
tuk-tuk67: folds 
butt_reynolds19: folds 
Uncalled bet ($0.01) returned to Sinlessmoon
Sinlessmoon collected $0.02 from pot
*** SUMMARY ***
Total pot $0.02 | Rake $0 
Seat 1: butt_reynolds19 (small blind) folded before Flop
Seat 2: Sinlessmoon (big blind) collected ($0.02)
Seat 3: CashMatteo folded before Flop (didn't bet)
Seat 4: Epangpoker folded before Flop (didn't bet)
Seat 5: tuk-tuk67 (button) folded before Flop (didn't bet)

Hand #927: 

PokerStars Hand #246297954854:  Hold'em No Limit ($0.01/$0.02 CAD) - 2023/10/01 18:37:51 ET
Table 'Thernoe II' 6-max Seat #1 is the button
Seat 1: butt_reynolds19 ($4.70 in chips) 
Seat 2: Sinlessmoon ($3.50 in chips) 
Seat 3: CashMatteo ($1.98 in chips) 
Seat 4: Epangpoker ($1.05 in chips) 
Seat 5: tuk-tuk67 ($2.02 in chips) 
Sinlessmoon: posts small blind $0.01
CashMatteo: posts big blind $0.02
*** HOLE CARDS ***
Dealt to CashMatteo [Th 4s]
Epangpoker: raises $0.07 to $0.09
tuk-tuk67: folds 
butt_reynolds19: folds 
Sinlessmoon: folds 
CashMatteo: folds 
Uncalled bet ($0.07) returned to Epangpoker
Epangpoker collected $0.05 from pot
*** SUMMARY ***
Total pot $0.05 | Rake $0 
Seat 1: butt_reynolds19 (button) folded before Flop (didn't bet)
Seat 2: Sinlessmoon (small blind) folded before Flop
Seat 3: CashMatteo (big blind) folded before Flop
Seat 4: Epangpoker collected ($0.05)
Seat 5: tuk-tuk67 folded before Flop (didn't bet)

Hand #928: 

PokerStars Hand #246297959876:  Hold'em No Limit ($0.01/$0.02 CAD) - 2023/10/01 18:38:05 ET
Table 'Thernoe II' 6-max Seat #2 is the button
Seat 1: butt_reynolds19 ($4.70 in chips) 
Seat 2: Sinlessmoon ($3.49 in chips) 
Seat 3: CashMatteo ($1.96 in chips) 
Seat 4: Epangpoker ($1.08 in chips) 
Seat 5: tuk-tuk67 ($2.02 in chips) 
CashMatteo: posts small blind $0.01
Epangpoker: posts big blind $0.02
pink810251: sits out 
*** HOLE CARDS ***
Dealt to CashMatteo [Jd 4s]
tuk-tuk67: folds 
butt_reynolds19: raises $0.03 to $0.05
Sinlessmoon: folds 
CashMatteo: folds 
Epangpoker: calls $0.03
*** FLOP *** [5c Jc 2h]
Epangpoker: checks 
butt_reynolds19: bets $0.06
Epangpoker: folds 
Uncalled bet ($0.06) returned to butt_reynolds19
butt_reynolds19 collected $0.11 from pot
butt_reynolds19: doesn't show hand 
*** SUMMARY ***
Total pot $0.11 | Rake $0 
Board [5c Jc 2h]
Seat 1: butt_reynolds19 collected ($0.11)
Seat 2: Sinlessmoon (button) folded before Flop (didn't bet)
Seat 3: CashMatteo (small blind) folded before Flop
Seat 4: Epangpoker (big blind) folded on the Flop
Seat 5: tuk-tuk67 folded before Flop (didn't bet)

Hand #929: 

PokerStars Hand #246297969984:  Hold'em No Limit ($0.01/$0.02 CAD) - 2023/10/01 18:38:34 ET
Table 'Thernoe II' 6-max Seat #3 is the button
Seat 1: butt_reynolds19 ($4.76 in chips) 
Seat 2: Sinlessmoon ($3.49 in chips) 
Seat 3: CashMatteo ($1.95 in chips) 
Seat 4: Epangpoker ($1.03 in chips) 
Seat 5: tuk-tuk67 ($2.02 in chips) 
Epangpoker: posts small blind $0.01
tuk-tuk67: posts big blind $0.02
pink810251: sits out 
*** HOLE CARDS ***
Dealt to CashMatteo [2c 4c]
butt_reynolds19: folds 
Sinlessmoon: folds 
CashMatteo: folds 
Epangpoker: folds 
Uncalled bet ($0.01) returned to tuk-tuk67
tuk-tuk67 collected $0.02 from pot
tuk-tuk67: doesn't show hand 
*** SUMMARY ***
Total pot $0.02 | Rake $0 
Seat 1: butt_reynolds19 folded before Flop (didn't bet)
Seat 2: Sinlessmoon folded before Flop (didn't bet)
Seat 3: CashMatteo (button) folded before Flop (didn't bet)
Seat 4: Epangpoker (small blind) folded before Flop
Seat 5: tuk-tuk67 (big blind) collected ($0.02)

Hand #930: 

PokerStars Hand #246297976484:  Hold'em No Limit ($0.01/$0.02 CAD) - 2023/10/01 18:38:52 ET
Table 'Thernoe II' 6-max Seat #4 is the button
Seat 1: butt_reynolds19 ($4.76 in chips) 
Seat 2: Sinlessmoon ($3.49 in chips) 
Seat 3: CashMatteo ($1.95 in chips) 
Seat 4: Epangpoker ($1.02 in chips) 
Seat 5: tuk-tuk67 ($2.03 in chips) 
Seat 6: pink810251 ($0.73 in chips) 
tuk-tuk67: posts small blind $0.01
pink810251: posts big blind $0.02
*** HOLE CARDS ***
Dealt to CashMatteo [2c Qh]
butt_reynolds19: folds 
Sinlessmoon: folds 
CashMatteo: folds 
Epangpoker: folds 
tuk-tuk67: raises $0.02 to $0.04
pink810251: folds 
Uncalled bet ($0.02) returned to tuk-tuk67
tuk-tuk67 collected $0.04 from pot
tuk-tuk67: doesn't show hand 
*** SUMMARY ***
Total pot $0.04 | Rake $0 
Seat 1: butt_reynolds19 folded before Flop (didn't bet)
Seat 2: Sinlessmoon folded before Flop (didn't bet)
Seat 3: CashMatteo folded before Flop (didn't bet)
Seat 4: Epangpoker (button) folded before Flop (didn't bet)
Seat 5: tuk-tuk67 (small blind) collected ($0.04)
Seat 6: pink810251 (big blind) folded before Flop

Hand #931: 

PokerStars Hand #246297985158:  Hold'em No Limit ($0.01/$0.02 CAD) - 2023/10/01 18:39:15 ET
Table 'Thernoe II' 6-max Seat #5 is the button
Seat 1: butt_reynolds19 ($4.76 in chips) 
Seat 2: Sinlessmoon ($3.49 in chips) 
Seat 3: CashMatteo ($1.95 in chips) 
Seat 4: Epangpoker ($1.02 in chips) 
Seat 5: tuk-tuk67 ($2.05 in chips) 
Seat 6: pink810251 ($0.71 in chips) 
pink810251: posts small blind $0.01
butt_reynolds19: posts big blind $0.02
*** HOLE CARDS ***
Dealt to CashMatteo [Td 4s]
Sinlessmoon: folds 
CashMatteo: folds 
Epangpoker: folds 
tuk-tuk67: raises $0.02 to $0.04
pink810251: folds 
butt_reynolds19: calls $0.02
*** FLOP *** [2c 3d 7h]
butt_reynolds19: checks 
tuk-tuk67: bets $0.06
butt_reynolds19: folds 
Uncalled bet ($0.06) returned to tuk-tuk67
tuk-tuk67 collected $0.09 from pot
tuk-tuk67: doesn't show hand 
*** SUMMARY ***
Total pot $0.09 | Rake $0 
Board [2c 3d 7h]
Seat 1: butt_reynolds19 (big blind) folded on the Flop
Seat 2: Sinlessmoon folded before Flop (didn't bet)
Seat 3: CashMatteo folded before Flop (didn't bet)
Seat 4: Epangpoker folded before Flop (didn't bet)
Seat 5: tuk-tuk67 (button) collected ($0.09)
Seat 6: pink810251 (small blind) folded before Flop

Hand #932: 

PokerStars Hand #246297997262:  Hold'em No Limit ($0.01/$0.02 CAD) - 2023/10/01 18:39:50 ET
Table 'Thernoe II' 6-max Seat #6 is the button
Seat 1: butt_reynolds19 ($4.72 in chips) 
Seat 2: Sinlessmoon ($3.49 in chips) 
Seat 3: CashMatteo ($1.95 in chips) 
Seat 4: Epangpoker ($1.02 in chips) 
Seat 5: tuk-tuk67 ($2.10 in chips) 
Seat 6: pink810251 ($0.70 in chips) 
butt_reynolds19: posts small blind $0.01
Sinlessmoon: posts big blind $0.02
*** HOLE CARDS ***
Dealt to CashMatteo [5s 2s]
CashMatteo: folds 
Epangpoker: calls $0.02
tuk-tuk67: raises $0.04 to $0.06
pink810251: folds 
butt_reynolds19: folds 
Sinlessmoon: folds 
Epangpoker: raises $0.14 to $0.20
tuk-tuk67: calls $0.14
*** FLOP *** [Qd 2c 9s]
Epangpoker: bets $0.25
tuk-tuk67: calls $0.25
*** TURN *** [Qd 2c 9s] [3h]
Epangpoker: bets $0.57 and is all-in
tuk-tuk67: calls $0.57
*** RIVER *** [Qd 2c 9s 3h] [Ks]
*** SHOW DOWN ***
Epangpoker: shows [As Qs] (a pair of Queens)
tuk-tuk67: shows [Td Ts] (a pair of Tens)
Epangpoker collected $2 from pot
*** SUMMARY ***
Total pot $2.07 | Rake $0.07 
Board [Qd 2c 9s 3h Ks]
Seat 1: butt_reynolds19 (small blind) folded before Flop
Seat 2: Sinlessmoon (big blind) folded before Flop
Seat 3: CashMatteo folded before Flop (didn't bet)
Seat 4: Epangpoker showed [As Qs] and won ($2) with a pair of Queens
Seat 5: tuk-tuk67 showed [Td Ts] and lost with a pair of Tens
Seat 6: pink810251 (button) folded before Flop (didn't bet)

Hand #933: 

PokerStars Hand #246298016927:  Hold'em No Limit ($0.01/$0.02 CAD) - 2023/10/01 18:40:45 ET
Table 'Thernoe II' 6-max Seat #1 is the button
Seat 1: butt_reynolds19 ($4.71 in chips) 
Seat 2: Sinlessmoon ($3.47 in chips) 
Seat 3: CashMatteo ($1.95 in chips) 
Seat 4: Epangpoker ($2 in chips) 
Seat 5: tuk-tuk67 ($1.08 in chips) 
Seat 6: pink810251 ($0.70 in chips) 
Sinlessmoon: posts small blind $0.01
CashMatteo: posts big blind $0.02
*** HOLE CARDS ***
Dealt to CashMatteo [3h Kh]
Epangpoker: folds 
tuk-tuk67: folds 
pink810251: calls $0.02
butt_reynolds19: raises $0.06 to $0.08
Sinlessmoon: calls $0.07
CashMatteo: calls $0.06
pink810251: raises $0.62 to $0.70 and is all-in
butt_reynolds19: folds 
Sinlessmoon: folds 
CashMatteo: folds 
Uncalled bet ($0.62) returned to pink810251
pink810251 collected $0.32 from pot
*** SUMMARY ***
Total pot $0.32 | Rake $0 
Seat 1: butt_reynolds19 (button) folded before Flop
Seat 2: Sinlessmoon (small blind) folded before Flop
Seat 3: CashMatteo (big blind) folded before Flop
Seat 4: Epangpoker folded before Flop (didn't bet)
Seat 5: tuk-tuk67 folded before Flop (didn't bet)
Seat 6: pink810251 collected ($0.32)

Hand #934: 

PokerStars Hand #246298031170:  Hold'em No Limit ($0.01/$0.02 CAD) - 2023/10/01 18:41:25 ET
Table 'Thernoe II' 6-max Seat #2 is the button
Seat 1: butt_reynolds19 ($4.63 in chips) 
Seat 2: Sinlessmoon ($3.39 in chips) 
Seat 3: CashMatteo ($1.87 in chips) 
Seat 4: Epangpoker ($2 in chips) 
Seat 5: tuk-tuk67 ($1.08 in chips) 
Seat 6: pink810251 ($0.94 in chips) 
CashMatteo: posts small blind $0.01
Epangpoker: posts big blind $0.02
*** HOLE CARDS ***
Dealt to CashMatteo [4d 4h]
tuk-tuk67: folds 
pink810251: calls $0.02
butt_reynolds19: folds 
Sinlessmoon: folds 
CashMatteo: raises $0.04 to $0.06
Epangpoker: calls $0.04
pink810251: calls $0.04
*** FLOP *** [3h 6h 3s]
CashMatteo: checks 
Epangpoker: checks 
pink810251: bets $0.20
CashMatteo: folds 
Epangpoker: folds 
Uncalled bet ($0.20) returned to pink810251
pink810251 collected $0.17 from pot
*** SUMMARY ***
Total pot $0.18 | Rake $0.01 
Board [3h 6h 3s]
Seat 1: butt_reynolds19 folded before Flop (didn't bet)
Seat 2: Sinlessmoon (button) folded before Flop (didn't bet)
Seat 3: CashMatteo (small blind) folded on the Flop
Seat 4: Epangpoker (big blind) folded on the Flop
Seat 5: tuk-tuk67 folded before Flop (didn't bet)
Seat 6: pink810251 collected ($0.17)

Hand #935: 

PokerStars Hand #246298046733:  Hold'em No Limit ($0.01/$0.02 CAD) - 2023/10/01 18:42:09 ET
Table 'Thernoe II' 6-max Seat #3 is the button
Seat 1: butt_reynolds19 ($4.63 in chips) 
Seat 2: Sinlessmoon ($3.39 in chips) 
Seat 3: CashMatteo ($1.81 in chips) 
Seat 4: Epangpoker ($1.94 in chips) 
Seat 5: tuk-tuk67 ($1.08 in chips) 
Seat 6: pink810251 ($1.05 in chips) 
Epangpoker: posts small blind $0.01
tuk-tuk67: posts big blind $0.02
*** HOLE CARDS ***
Dealt to CashMatteo [4h Th]
pink810251: folds 
butt_reynolds19: folds 
Sinlessmoon: folds 
CashMatteo: folds 
Epangpoker: folds 
Uncalled bet ($0.01) returned to tuk-tuk67
tuk-tuk67 collected $0.02 from pot
tuk-tuk67: doesn't show hand 
*** SUMMARY ***
Total pot $0.02 | Rake $0 
Seat 1: butt_reynolds19 folded before Flop (didn't bet)
Seat 2: Sinlessmoon folded before Flop (didn't bet)
Seat 3: CashMatteo (button) folded before Flop (didn't bet)
Seat 4: Epangpoker (small blind) folded before Flop
Seat 5: tuk-tuk67 (big blind) collected ($0.02)
Seat 6: pink810251 folded before Flop (didn't bet)

Hand #936: 

PokerStars Hand #246298051869:  Hold'em No Limit ($0.01/$0.02 CAD) - 2023/10/01 18:42:23 ET
Table 'Thernoe II' 6-max Seat #4 is the button
Seat 1: butt_reynolds19 ($4.63 in chips) 
Seat 2: Sinlessmoon ($3.39 in chips) 
Seat 3: CashMatteo ($1.81 in chips) 
Seat 4: Epangpoker ($1.93 in chips) 
Seat 5: tuk-tuk67 ($1.09 in chips) 
Seat 6: pink810251 ($1.05 in chips) 
tuk-tuk67: posts small blind $0.01
pink810251: posts big blind $0.02
*** HOLE CARDS ***
Dealt to CashMatteo [Jd 6c]
butt_reynolds19: folds 
Sinlessmoon: folds 
CashMatteo: folds 
Epangpoker: folds 
tuk-tuk67: folds 
Uncalled bet ($0.01) returned to pink810251
pink810251 collected $0.02 from pot
*** SUMMARY ***
Total pot $0.02 | Rake $0 
Seat 1: butt_reynolds19 folded before Flop (didn't bet)
Seat 2: Sinlessmoon folded before Flop (didn't bet)
Seat 3: CashMatteo folded before Flop (didn't bet)
Seat 4: Epangpoker (button) folded before Flop (didn't bet)
Seat 5: tuk-tuk67 (small blind) folded before Flop
Seat 6: pink810251 (big blind) collected ($0.02)

Hand #937: 

PokerStars Hand #246298056208:  Hold'em No Limit ($0.01/$0.02 CAD) - 2023/10/01 18:42:36 ET
Table 'Thernoe II' 6-max Seat #5 is the button
Seat 1: butt_reynolds19 ($4.63 in chips) 
Seat 2: Sinlessmoon ($3.39 in chips) 
Seat 3: CashMatteo ($1.81 in chips) 
Seat 4: Epangpoker ($1.93 in chips) 
Seat 5: tuk-tuk67 ($1.08 in chips) 
Seat 6: pink810251 ($1.06 in chips) 
pink810251: posts small blind $0.01
butt_reynolds19: posts big blind $0.02
*** HOLE CARDS ***
Dealt to CashMatteo [7c 5s]
Sinlessmoon: folds 
CashMatteo: folds 
Epangpoker: raises $0.06 to $0.08
tuk-tuk67: folds 
pink810251: folds 
butt_reynolds19: folds 
Uncalled bet ($0.06) returned to Epangpoker
Epangpoker collected $0.05 from pot
*** SUMMARY ***
Total pot $0.05 | Rake $0 
Seat 1: butt_reynolds19 (big blind) folded before Flop
Seat 2: Sinlessmoon folded before Flop (didn't bet)
Seat 3: CashMatteo folded before Flop (didn't bet)
Seat 4: Epangpoker collected ($0.05)
Seat 5: tuk-tuk67 (button) folded before Flop (didn't bet)
Seat 6: pink810251 (small blind) folded before Flop

Hand #938: 

PokerStars Hand #246298065518:  Hold'em No Limit ($0.01/$0.02 CAD) - 2023/10/01 18:43:02 ET
Table 'Thernoe II' 6-max Seat #6 is the button
Seat 1: butt_reynolds19 ($4.61 in chips) 
Seat 2: Sinlessmoon ($3.39 in chips) 
Seat 3: CashMatteo ($1.81 in chips) 
Seat 4: Epangpoker ($1.96 in chips) 
Seat 5: tuk-tuk67 ($1.08 in chips) 
Seat 6: pink810251 ($1.05 in chips) 
butt_reynolds19: posts small blind $0.01
Sinlessmoon: posts big blind $0.02
*** HOLE CARDS ***
Dealt to CashMatteo [8s Js]
CashMatteo: raises $0.04 to $0.06
Epangpoker: folds 
tuk-tuk67: calls $0.06
pink810251: folds 
butt_reynolds19: calls $0.05
Sinlessmoon: folds 
*** FLOP *** [5d 9c 2d]
butt_reynolds19: checks 
CashMatteo: checks 
tuk-tuk67: checks 
*** TURN *** [5d 9c 2d] [Kh]
butt_reynolds19: bets $0.12
CashMatteo: folds 
tuk-tuk67: calls $0.12
*** RIVER *** [5d 9c 2d Kh] [4s]
butt_reynolds19: bets $0.36
tuk-tuk67: folds 
Uncalled bet ($0.36) returned to butt_reynolds19
butt_reynolds19 collected $0.42 from pot
butt_reynolds19: doesn't show hand 
*** SUMMARY ***
Total pot $0.44 | Rake $0.02 
Board [5d 9c 2d Kh 4s]
Seat 1: butt_reynolds19 (small blind) collected ($0.42)
Seat 2: Sinlessmoon (big blind) folded before Flop
Seat 3: CashMatteo folded on the Turn
Seat 4: Epangpoker folded before Flop (didn't bet)
Seat 5: tuk-tuk67 folded on the River
Seat 6: pink810251 (button) folded before Flop (didn't bet)

Hand #939: 

PokerStars Hand #246298090030:  Hold'em No Limit ($0.01/$0.02 CAD) - 2023/10/01 18:44:12 ET
Table 'Thernoe II' 6-max Seat #1 is the button
Seat 1: butt_reynolds19 ($4.85 in chips) 
Seat 2: Sinlessmoon ($3.37 in chips) 
Seat 3: CashMatteo ($1.75 in chips) 
Seat 4: Epangpoker ($1.96 in chips) 
Seat 5: tuk-tuk67 ($0.90 in chips) 
Seat 6: pink810251 ($1.05 in chips) 
Sinlessmoon: posts small blind $0.01
CashMatteo: posts big blind $0.02
*** HOLE CARDS ***
Dealt to CashMatteo [Th Qh]
Epangpoker: folds 
tuk-tuk67: raises $0.04 to $0.06
pink810251: folds 
butt_reynolds19: folds 
Sinlessmoon: folds 
CashMatteo: calls $0.04
*** FLOP *** [Qd 6s 5c]
CashMatteo: checks 
tuk-tuk67: bets $0.08
CashMatteo: calls $0.08
*** TURN *** [Qd 6s 5c] [Jc]
CashMatteo: checks 
tuk-tuk67: checks 
*** RIVER *** [Qd 6s 5c Jc] [Td]
CashMatteo: bets $0.28
tuk-tuk67: raises $0.48 to $0.76 and is all-in
CashMatteo: calls $0.48
*** SHOW DOWN ***
tuk-tuk67: shows [Ks Ah] (a straight, Ten to Ace)
CashMatteo: shows [Th Qh] (two pair, Queens and Tens)
tuk-tuk67 collected $1.75 from pot
*** SUMMARY ***
Total pot $1.81 | Rake $0.06 
Board [Qd 6s 5c Jc Td]
Seat 1: butt_reynolds19 (button) folded before Flop (didn't bet)
Seat 2: Sinlessmoon (small blind) folded before Flop
Seat 3: CashMatteo (big blind) showed [Th Qh] and lost with two pair, Queens and Tens
Seat 4: Epangpoker folded before Flop (didn't bet)
Seat 5: tuk-tuk67 showed [Ks Ah] and won ($1.75) with a straight, Ten to Ace
Seat 6: pink810251 folded before Flop (didn't bet)

Hand #940: 

PokerStars Hand #246298116461:  Hold'em No Limit ($0.01/$0.02 CAD) - 2023/10/01 18:45:28 ET
Table 'Thernoe II' 6-max Seat #2 is the button
Seat 1: butt_reynolds19 ($4.85 in chips) 
Seat 2: Sinlessmoon ($3.36 in chips) 
Seat 3: CashMatteo ($0.85 in chips) 
Seat 4: Epangpoker ($1.96 in chips) 
Seat 5: tuk-tuk67 ($1.75 in chips) 
Seat 6: pink810251 ($1.05 in chips) 
CashMatteo: posts small blind $0.01
Epangpoker: posts big blind $0.02
*** HOLE CARDS ***
Dealt to CashMatteo [Qd 7d]
tuk-tuk67: folds 
pink810251: folds 
butt_reynolds19: raises $0.03 to $0.05
Sinlessmoon: folds 
CashMatteo: calls $0.04
Epangpoker: folds 
*** FLOP *** [9d Jh 7h]
CashMatteo: checks 
butt_reynolds19: bets $0.06
CashMatteo: folds 
Uncalled bet ($0.06) returned to butt_reynolds19
butt_reynolds19 collected $0.12 from pot
butt_reynolds19: doesn't show hand 
*** SUMMARY ***
Total pot $0.12 | Rake $0 
Board [9d Jh 7h]
Seat 1: butt_reynolds19 collected ($0.12)
Seat 2: Sinlessmoon (button) folded before Flop (didn't bet)
Seat 3: CashMatteo (small blind) folded on the Flop
Seat 4: Epangpoker (big blind) folded before Flop
Seat 5: tuk-tuk67 folded before Flop (didn't bet)
Seat 6: pink810251 folded before Flop (didn't bet)

Hand #941: 

PokerStars Hand #246298131729:  Hold'em No Limit ($0.01/$0.02 CAD) - 2023/10/01 18:46:11 ET
Table 'Thernoe II' 6-max Seat #3 is the button
Seat 1: butt_reynolds19 ($4.92 in chips) 
Seat 2: Sinlessmoon ($3.36 in chips) 
Seat 3: CashMatteo ($0.80 in chips) 
Seat 4: Epangpoker ($1.94 in chips) 
Seat 5: tuk-tuk67 ($1.75 in chips) 
Seat 6: pink810251 ($1.05 in chips) 
Epangpoker: posts small blind $0.01
tuk-tuk67: posts big blind $0.02
*** HOLE CARDS ***
Dealt to CashMatteo [Ks Qh]
pink810251: raises $1.03 to $1.05 and is all-in
butt_reynolds19: folds 
Sinlessmoon: folds 
CashMatteo: calls $0.80 and is all-in
Epangpoker: folds 
tuk-tuk67: folds 
Uncalled bet ($0.25) returned to pink810251
*** FLOP *** [4s Kd Jd]
*** TURN *** [4s Kd Jd] [5c]
*** RIVER *** [4s Kd Jd 5c] [Kc]
*** SHOW DOWN ***
pink810251: shows [8d 8s] (two pair, Kings and Eights)
CashMatteo: shows [Ks Qh] (three of a kind, Kings)
CashMatteo collected $1.57 from pot
*** SUMMARY ***
Total pot $1.63 | Rake $0.06 
Board [4s Kd Jd 5c Kc]
Seat 1: butt_reynolds19 folded before Flop (didn't bet)
Seat 2: Sinlessmoon folded before Flop (didn't bet)
Seat 3: CashMatteo (button) showed [Ks Qh] and won ($1.57) with three of a kind, Kings
Seat 4: Epangpoker (small blind) folded before Flop
Seat 5: tuk-tuk67 (big blind) folded before Flop
Seat 6: pink810251 showed [8d 8s] and lost with two pair, Kings and Eights

Hand #942: 

PokerStars Hand #246298143627:  Hold'em No Limit ($0.01/$0.02 CAD) - 2023/10/01 18:46:45 ET
Table 'Thernoe II' 6-max Seat #4 is the button
Seat 1: butt_reynolds19 ($4.92 in chips) 
Seat 2: Sinlessmoon ($3.36 in chips) 
Seat 3: CashMatteo ($1.57 in chips) 
Seat 4: Epangpoker ($1.93 in chips) 
Seat 5: tuk-tuk67 ($1.73 in chips) 
tuk-tuk67: posts small blind $0.01
butt_reynolds19: posts big blind $0.02
*** HOLE CARDS ***
Dealt to CashMatteo [6d Td]
Sinlessmoon: raises $0.04 to $0.06
CashMatteo: folds 
CashMatteo leaves the table
Epangpoker: folds 
tuk-tuk67: folds 
butt_reynolds19: folds 
Uncalled bet ($0.04) returned to Sinlessmoon
Sinlessmoon collected $0.05 from pot
*** SUMMARY ***
Total pot $0.05 | Rake $0 
Seat 1: butt_reynolds19 (big blind) folded before Flop
Seat 2: Sinlessmoon collected ($0.05)
Seat 3: CashMatteo folded before Flop (didn't bet)
Seat 4: Epangpoker (button) folded before Flop (didn't bet)
Seat 5: tuk-tuk67 (small blind) folded before Flop

Hand #943: 

PokerStars Hand #246358206872:  Hold'em No Limit ($0.02/$0.05 CAD) - 2023/10/05 0:15:57 ET
Table 'Geographos' 6-max Seat #1 is the button
Seat 1: boltmiao0304 ($11.17 in chips) 
Seat 2: Hemmi191 ($4.05 in chips) 
Seat 3: TheKaKaMann ($5.26 in chips) 
Seat 4: DoubleAngle314 ($6.39 in chips) 
Seat 5: CashMatteo ($5 in chips) 
Hemmi191: posts small blind $0.02
TheKaKaMann: posts big blind $0.05
CashMatteo: posts big blind $0.05
*** HOLE CARDS ***
Dealt to CashMatteo [Qc 8s]
DoubleAngle314: raises $0.15 to $0.20
CashMatteo: folds 
stugatz1948 joins the table at seat #6 
boltmiao0304: raises $0.45 to $0.65
Hemmi191: folds 
TheKaKaMann: folds 
DoubleAngle314: calls $0.45
*** FLOP *** [8h 2s 4c]
DoubleAngle314: checks 
boltmiao0304: bets $0.55
DoubleAngle314: calls $0.55
*** TURN *** [8h 2s 4c] [8c]
DoubleAngle314: checks 
boltmiao0304: bets $1
DoubleAngle314: calls $1
*** RIVER *** [8h 2s 4c 8c] [As]
DoubleAngle314: checks 
boltmiao0304: bets $1.40
DoubleAngle314: folds 
Uncalled bet ($1.40) returned to boltmiao0304
boltmiao0304 collected $4.33 from pot
boltmiao0304: doesn't show hand 
*** SUMMARY ***
Total pot $4.52 | Rake $0.19 
Board [8h 2s 4c 8c As]
Seat 1: boltmiao0304 (button) collected ($4.33)
Seat 2: Hemmi191 (small blind) folded before Flop
Seat 3: TheKaKaMann (big blind) folded before Flop
Seat 4: DoubleAngle314 folded on the River
Seat 5: CashMatteo folded before Flop (didn't bet)

Hand #944: 

PokerStars Hand #246358214645:  Hold'em No Limit ($0.02/$0.05 CAD) - 2023/10/05 0:17:02 ET
Table 'Geographos' 6-max Seat #2 is the button
Seat 1: boltmiao0304 ($13.30 in chips) 
Seat 2: Hemmi191 ($4.03 in chips) 
Seat 3: TheKaKaMann ($5.21 in chips) 
Seat 4: DoubleAngle314 ($4.19 in chips) 
Seat 5: CashMatteo ($4.95 in chips) 
TheKaKaMann: posts small blind $0.02
DoubleAngle314: posts big blind $0.05
stugatz1948: sits out 
*** HOLE CARDS ***
Dealt to CashMatteo [Tc 5d]
CashMatteo: folds 
boltmiao0304: calls $0.05
Hemmi191: calls $0.05
TheKaKaMann: raises $0.15 to $0.20
DoubleAngle314: folds 
boltmiao0304: folds 
Hemmi191: calls $0.15
*** FLOP *** [Qc 8h 8d]
TheKaKaMann: bets $0.16
Hemmi191: folds 
Uncalled bet ($0.16) returned to TheKaKaMann
TheKaKaMann collected $0.48 from pot
TheKaKaMann: doesn't show hand 
*** SUMMARY ***
Total pot $0.50 | Rake $0.02 
Board [Qc 8h 8d]
Seat 1: boltmiao0304 folded before Flop
Seat 2: Hemmi191 (button) folded on the Flop
Seat 3: TheKaKaMann (small blind) collected ($0.48)
Seat 4: DoubleAngle314 (big blind) folded before Flop
Seat 5: CashMatteo folded before Flop (didn't bet)

Hand #945: 

PokerStars Hand #246358218285:  Hold'em No Limit ($0.02/$0.05 CAD) - 2023/10/05 0:17:34 ET
Table 'Geographos' 6-max Seat #3 is the button
Seat 1: boltmiao0304 ($13.25 in chips) 
Seat 2: Hemmi191 ($3.83 in chips) 
Seat 3: TheKaKaMann ($5.49 in chips) 
Seat 4: DoubleAngle314 ($4.14 in chips) 
Seat 5: CashMatteo ($4.95 in chips) 
DoubleAngle314: posts small blind $0.02
CashMatteo: posts big blind $0.05
stugatz1948: sits out 
*** HOLE CARDS ***
Dealt to CashMatteo [Tc Ks]
boltmiao0304: folds 
Hemmi191: folds 
TheKaKaMann: calls $0.05
DoubleAngle314: folds 
CashMatteo: checks 
*** FLOP *** [8s Qd 4d]
CashMatteo: checks 
TheKaKaMann: bets $0.08
CashMatteo: calls $0.08
*** TURN *** [8s Qd 4d] [Kd]
CashMatteo: checks 
TheKaKaMann: checks 
*** RIVER *** [8s Qd 4d Kd] [Qs]
CashMatteo: bets $0.14
TheKaKaMann: folds 
Uncalled bet ($0.14) returned to CashMatteo
CashMatteo collected $0.27 from pot
CashMatteo: doesn't show hand 
*** SUMMARY ***
Total pot $0.28 | Rake $0.01 
Board [8s Qd 4d Kd Qs]
Seat 1: boltmiao0304 folded before Flop (didn't bet)
Seat 2: Hemmi191 folded before Flop (didn't bet)
Seat 3: TheKaKaMann (button) folded on the River
Seat 4: DoubleAngle314 (small blind) folded before Flop
Seat 5: CashMatteo (big blind) collected ($0.27)

Hand #946: 

PokerStars Hand #246358223643:  Hold'em No Limit ($0.02/$0.05 CAD) - 2023/10/05 0:18:19 ET
Table 'Geographos' 6-max Seat #4 is the button
Seat 1: boltmiao0304 ($13.25 in chips) 
Seat 2: Hemmi191 ($3.83 in chips) 
Seat 3: TheKaKaMann ($5.36 in chips) 
Seat 4: DoubleAngle314 ($4.12 in chips) 
Seat 5: CashMatteo ($5.09 in chips) 
Seat 6: stugatz1948 ($3.69 in chips) 
CashMatteo: posts small blind $0.02
stugatz1948: posts big blind $0.05
*** HOLE CARDS ***
Dealt to CashMatteo [7d 8d]
boltmiao0304: folds 
Hemmi191: calls $0.05
TheKaKaMann: folds 
DoubleAngle314: raises $0.15 to $0.20
CashMatteo: calls $0.18
stugatz1948: folds 
Hemmi191: calls $0.15
*** FLOP *** [Qd 6c 9s]
CashMatteo: bets $0.31
Hemmi191: calls $0.31
DoubleAngle314: folds 
*** TURN *** [Qd 6c 9s] [Qs]
CashMatteo: checks 
Hemmi191: checks 
*** RIVER *** [Qd 6c 9s Qs] [4c]
CashMatteo: checks 
Hemmi191: checks 
*** SHOW DOWN ***
CashMatteo: shows [7d 8d] (a pair of Queens)
Hemmi191: shows [9c Ks] (two pair, Queens and Nines)
Hemmi191 collected $1.22 from pot
*** SUMMARY ***
Total pot $1.27 | Rake $0.05 
Board [Qd 6c 9s Qs 4c]
Seat 1: boltmiao0304 folded before Flop (didn't bet)
Seat 2: Hemmi191 showed [9c Ks] and won ($1.22) with two pair, Queens and Nines
Seat 3: TheKaKaMann folded before Flop (didn't bet)
Seat 4: DoubleAngle314 (button) folded on the Flop
Seat 5: CashMatteo (small blind) showed [7d 8d] and lost with a pair of Queens
Seat 6: stugatz1948 (big blind) folded before Flop

Hand #947: 

PokerStars Hand #246358228654:  Hold'em No Limit ($0.02/$0.05 CAD) - 2023/10/05 0:19:02 ET
Table 'Geographos' 6-max Seat #5 is the button
Seat 1: boltmiao0304 ($13.25 in chips) 
Seat 2: Hemmi191 ($4.54 in chips) 
Seat 3: TheKaKaMann ($5.36 in chips) 
Seat 4: DoubleAngle314 ($3.92 in chips) 
Seat 5: CashMatteo ($4.58 in chips) 
Seat 6: stugatz1948 ($3.64 in chips) 
stugatz1948: posts small blind $0.02
boltmiao0304: posts big blind $0.05
*** HOLE CARDS ***
Dealt to CashMatteo [4d 5d]
Hemmi191: folds 
TheKaKaMann: folds 
DoubleAngle314: raises $0.10 to $0.15
CashMatteo: calls $0.15
stugatz1948: folds 
boltmiao0304: calls $0.10
*** FLOP *** [2d As 5c]
boltmiao0304: checks 
DoubleAngle314: checks 
CashMatteo: checks 
*** TURN *** [2d As 5c] [9h]
boltmiao0304: checks 
DoubleAngle314: checks 
CashMatteo: bets $0.05
boltmiao0304: calls $0.05
DoubleAngle314: folds 
*** RIVER *** [2d As 5c 9h] [Jd]
boltmiao0304: checks 
CashMatteo: checks 
*** SHOW DOWN ***
boltmiao0304: shows [Kc 9c] (a pair of Nines)
CashMatteo: mucks hand 
boltmiao0304 collected $0.55 from pot
*** SUMMARY ***
Total pot $0.57 | Rake $0.02 
Board [2d As 5c 9h Jd]
Seat 1: boltmiao0304 (big blind) showed [Kc 9c] and won ($0.55) with a pair of Nines
Seat 2: Hemmi191 folded before Flop (didn't bet)
Seat 3: TheKaKaMann folded before Flop (didn't bet)
Seat 4: DoubleAngle314 folded on the Turn
Seat 5: CashMatteo (button) mucked [4d 5d]
Seat 6: stugatz1948 (small blind) folded before Flop

Hand #948: 

PokerStars Hand #246358233497:  Hold'em No Limit ($0.02/$0.05 CAD) - 2023/10/05 0:19:44 ET
Table 'Geographos' 6-max Seat #6 is the button
Seat 1: boltmiao0304 ($13.60 in chips) 
Seat 2: Hemmi191 ($4.54 in chips) 
Seat 3: TheKaKaMann ($5.36 in chips) 
Seat 4: DoubleAngle314 ($3.77 in chips) 
Seat 5: CashMatteo ($4.38 in chips) 
Seat 6: stugatz1948 ($3.62 in chips) 
boltmiao0304: posts small blind $0.02
Hemmi191: posts big blind $0.05
*** HOLE CARDS ***
Dealt to CashMatteo [6d 4h]
TheKaKaMann: calls $0.05
DoubleAngle314: folds 
CashMatteo: folds 
stugatz1948: folds 
boltmiao0304: raises $0.10 to $0.15
DoubleAngle314 leaves the table
Hemmi191 is disconnected 
Hemmi191 has timed out
Hemmi191: folds 
TheKaKaMann: calls $0.10
*** FLOP *** [9s Ac Tc]
boltmiao0304: checks 
TheKaKaMann: bets $0.20
boltmiao0304: calls $0.20
*** TURN *** [9s Ac Tc] [3c]
boltmiao0304: checks 
TheKaKaMann: bets $0.52
boltmiao0304: calls $0.52
*** RIVER *** [9s Ac Tc 3c] [4c]
boltmiao0304: bets $1.70
TheKaKaMann: folds 
Uncalled bet ($1.70) returned to boltmiao0304
boltmiao0304 collected $1.72 from pot
boltmiao0304: doesn't show hand 
*** SUMMARY ***
Total pot $1.79 | Rake $0.07 
Board [9s Ac Tc 3c 4c]
Seat 1: boltmiao0304 (small blind) collected ($1.72)
Seat 2: Hemmi191 (big blind) folded before Flop
Seat 3: TheKaKaMann folded on the River
Seat 4: DoubleAngle314 folded before Flop (didn't bet)
Seat 5: CashMatteo folded before Flop (didn't bet)
Seat 6: stugatz1948 (button) folded before Flop (didn't bet)

Hand #949: 

PokerStars Hand #246358243483:  Hold'em No Limit ($0.02/$0.05 CAD) - 2023/10/05 0:21:10 ET
Table 'Geographos' 6-max Seat #1 is the button
Seat 1: boltmiao0304 ($14.45 in chips) 
Seat 2: Hemmi191 ($4.49 in chips) 
Seat 3: TheKaKaMann ($4.49 in chips) 
Seat 5: CashMatteo ($4.38 in chips) 
Seat 6: stugatz1948 ($3.62 in chips) 
Hemmi191: posts small blind $0.02
TheKaKaMann: posts big blind $0.05
*** HOLE CARDS ***
Dealt to CashMatteo [9d 5d]
CashMatteo: folds 
stugatz1948: raises $0.12 to $0.17
boltmiao0304: folds 
Hemmi191: calls $0.15
TheKaKaMann: folds 
*** FLOP *** [Jc Td As]
Hemmi191: checks 
stugatz1948: bets $3.45 and is all-in
Hemmi191: calls $3.45
*** TURN *** [Jc Td As] [7d]
dizzylizh51 joins the table at seat #4 
*** RIVER *** [Jc Td As 7d] [Kd]
*** SHOW DOWN ***
Hemmi191: shows [Ad 4h] (a pair of Aces)
stugatz1948: shows [Qd Ac] (a straight, Ten to Ace)
stugatz1948 collected $6.99 from pot
*** SUMMARY ***
Total pot $7.29 | Rake $0.30 
Board [Jc Td As 7d Kd]
Seat 1: boltmiao0304 (button) folded before Flop (didn't bet)
Seat 2: Hemmi191 (small blind) showed [Ad 4h] and lost with a pair of Aces
Seat 3: TheKaKaMann (big blind) folded before Flop
Seat 5: CashMatteo folded before Flop (didn't bet)
Seat 6: stugatz1948 showed [Qd Ac] and won ($6.99) with a straight, Ten to Ace

Hand #950: 

PokerStars Hand #246358247891:  Hold'em No Limit ($0.02/$0.05 CAD) - 2023/10/05 0:21:48 ET
Table 'Geographos' 6-max Seat #2 is the button
Seat 1: boltmiao0304 ($14.45 in chips) 
Seat 2: Hemmi191 ($0.87 in chips) 
Seat 3: TheKaKaMann ($4.44 in chips) 
Seat 4: dizzylizh51 ($4 in chips) 
Seat 5: CashMatteo ($4.38 in chips) 
Seat 6: stugatz1948 ($6.99 in chips) 
TheKaKaMann: posts small blind $0.02
dizzylizh51 is connected 
dizzylizh51: posts big blind $0.05
*** HOLE CARDS ***
Dealt to CashMatteo [Ks Qs]
CashMatteo: raises $0.10 to $0.15
stugatz1948: folds 
boltmiao0304: folds 
Hemmi191: raises $0.72 to $0.87 and is all-in
TheKaKaMann: folds 
dizzylizh51: folds 
CashMatteo: calls $0.72
*** FLOP *** [6d Kh Ac]
*** TURN *** [6d Kh Ac] [Kd]
*** RIVER *** [6d Kh Ac Kd] [Th]
*** SHOW DOWN ***
CashMatteo: shows [Ks Qs] (three of a kind, Kings)
Hemmi191: shows [Ah 5c] (two pair, Aces and Kings)
CashMatteo collected $1.73 from pot
*** SUMMARY ***
Total pot $1.81 | Rake $0.08 
Board [6d Kh Ac Kd Th]
Seat 1: boltmiao0304 folded before Flop (didn't bet)
Seat 2: Hemmi191 (button) showed [Ah 5c] and lost with two pair, Aces and Kings
Seat 3: TheKaKaMann (small blind) folded before Flop
Seat 4: dizzylizh51 (big blind) folded before Flop
Seat 5: CashMatteo showed [Ks Qs] and won ($1.73) with three of a kind, Kings
Seat 6: stugatz1948 folded before Flop (didn't bet)

Hand #951: 

PokerStars Hand #246358251038:  Hold'em No Limit ($0.02/$0.05 CAD) - 2023/10/05 0:22:16 ET
Table 'Geographos' 6-max Seat #3 is the button
Seat 1: boltmiao0304 ($14.45 in chips) 
Seat 3: TheKaKaMann ($4.42 in chips) 
Seat 4: dizzylizh51 ($3.95 in chips) 
Seat 5: CashMatteo ($5.24 in chips) 
Seat 6: stugatz1948 ($6.99 in chips) 
dizzylizh51: posts small blind $0.02
CashMatteo: posts big blind $0.05
*** HOLE CARDS ***
Dealt to CashMatteo [4d Kc]
stugatz1948: calls $0.05
boltmiao0304: calls $0.05
TheKaKaMann: calls $0.05
dizzylizh51: calls $0.03
CashMatteo: checks 
*** FLOP *** [Jd Qs 3s]
dizzylizh51: checks 
CashMatteo: checks 
stugatz1948: checks 
boltmiao0304: bets $0.05
TheKaKaMann: calls $0.05
dizzylizh51: calls $0.05
CashMatteo: folds 
stugatz1948: calls $0.05
*** TURN *** [Jd Qs 3s] [Th]
dizzylizh51: checks 
stugatz1948: checks 
boltmiao0304: bets $0.05
TheKaKaMann: raises $0.19 to $0.24
dizzylizh51: folds 
stugatz1948: folds 
boltmiao0304: calls $0.19
*** RIVER *** [Jd Qs 3s Th] [2h]
boltmiao0304: checks 
TheKaKaMann: bets $1
boltmiao0304: calls $1
*** SHOW DOWN ***
TheKaKaMann: shows [8d 9d] (a straight, Eight to Queen)
boltmiao0304: mucks hand 
TheKaKaMann collected $2.81 from pot
*** SUMMARY ***
Total pot $2.93 | Rake $0.12 
Board [Jd Qs 3s Th 2h]
Seat 1: boltmiao0304 mucked [3h 3d]
Seat 3: TheKaKaMann (button) showed [8d 9d] and won ($2.81) with a straight, Eight to Queen
Seat 4: dizzylizh51 (small blind) folded on the Turn
Seat 5: CashMatteo (big blind) folded on the Flop
Seat 6: stugatz1948 folded on the Turn

Hand #952: 

PokerStars Hand #246358262649:  Hold'em No Limit ($0.02/$0.05 CAD) - 2023/10/05 0:23:58 ET
Table 'Geographos' 6-max Seat #4 is the button
Seat 1: boltmiao0304 ($13.11 in chips) 
Seat 2: Hemmi191 ($5 in chips) 
Seat 3: TheKaKaMann ($5.89 in chips) 
Seat 4: dizzylizh51 ($3.85 in chips) 
Seat 5: CashMatteo ($5.19 in chips) 
Seat 6: stugatz1948 ($6.89 in chips) 
CashMatteo: posts small blind $0.02
stugatz1948: posts big blind $0.05
*** HOLE CARDS ***
Dealt to CashMatteo [Td 5d]
boltmiao0304: calls $0.05
Hemmi191: calls $0.05
TheKaKaMann: folds 
dizzylizh51: calls $0.05
CashMatteo: folds 
stugatz1948: checks 
*** FLOP *** [4c 2d Js]
stugatz1948: checks 
boltmiao0304: checks 
Hemmi191: checks 
dizzylizh51: checks 
*** TURN *** [4c 2d Js] [Qs]
stugatz1948: checks 
boltmiao0304: checks 
Hemmi191: bets $0.15
dizzylizh51: folds 
stugatz1948: folds 
boltmiao0304: folds 
Uncalled bet ($0.15) returned to Hemmi191
Hemmi191 collected $0.21 from pot
*** SUMMARY ***
Total pot $0.22 | Rake $0.01 
Board [4c 2d Js Qs]
Seat 1: boltmiao0304 folded on the Turn
Seat 2: Hemmi191 collected ($0.21)
Seat 3: TheKaKaMann folded before Flop (didn't bet)
Seat 4: dizzylizh51 (button) folded on the Turn
Seat 5: CashMatteo (small blind) folded before Flop
Seat 6: stugatz1948 (big blind) folded on the Turn

Hand #953: 

PokerStars Hand #246358267489:  Hold'em No Limit ($0.02/$0.05 CAD) - 2023/10/05 0:24:41 ET
Table 'Geographos' 6-max Seat #5 is the button
Seat 1: boltmiao0304 ($13.06 in chips) 
Seat 2: Hemmi191 ($5.16 in chips) 
Seat 3: TheKaKaMann ($5.89 in chips) 
Seat 4: dizzylizh51 ($3.80 in chips) 
Seat 5: CashMatteo ($5.17 in chips) 
Seat 6: stugatz1948 ($6.84 in chips) 
stugatz1948: posts small blind $0.02
boltmiao0304: posts big blind $0.05
*** HOLE CARDS ***
Dealt to CashMatteo [Kd Ac]
Hemmi191: calls $0.05
TheKaKaMann: calls $0.05
dizzylizh51: folds 
CashMatteo: raises $0.10 to $0.15
stugatz1948: folds 
boltmiao0304: folds 
Hemmi191: calls $0.10
TheKaKaMann: calls $0.10
*** FLOP *** [Ah 7h 5c]
Hemmi191: bets $0.15
TheKaKaMann: folds 
CashMatteo: calls $0.15
*** TURN *** [Ah 7h 5c] [Qd]
Hemmi191: bets $0.15
CashMatteo: calls $0.15
*** RIVER *** [Ah 7h 5c Qd] [6c]
Hemmi191: checks 
CashMatteo: bets $0.49
Hemmi191: folds 
Uncalled bet ($0.49) returned to CashMatteo
CashMatteo collected $1.07 from pot
CashMatteo: doesn't show hand 
*** SUMMARY ***
Total pot $1.12 | Rake $0.05 
Board [Ah 7h 5c Qd 6c]
Seat 1: boltmiao0304 (big blind) folded before Flop
Seat 2: Hemmi191 folded on the River
Seat 3: TheKaKaMann folded on the Flop
Seat 4: dizzylizh51 folded before Flop (didn't bet)
Seat 5: CashMatteo (button) collected ($1.07)
Seat 6: stugatz1948 (small blind) folded before Flop

Hand #954: 

PokerStars Hand #246358272973:  Hold'em No Limit ($0.02/$0.05 CAD) - 2023/10/05 0:25:30 ET
Table 'Geographos' 6-max Seat #6 is the button
Seat 1: boltmiao0304 ($13.01 in chips) 
Seat 2: Hemmi191 ($4.71 in chips) 
Seat 3: TheKaKaMann ($5.74 in chips) 
Seat 4: dizzylizh51 ($3.80 in chips) 
Seat 5: CashMatteo ($5.79 in chips) 
Seat 6: stugatz1948 ($6.82 in chips) 
boltmiao0304: posts small blind $0.02
Hemmi191: posts big blind $0.05
*** HOLE CARDS ***
Dealt to CashMatteo [5h 9c]
TheKaKaMann: folds 
dizzylizh51: raises $0.05 to $0.10
CashMatteo: folds 
stugatz1948: folds 
boltmiao0304: calls $0.08
Hemmi191: folds 
*** FLOP *** [6s 8h Qc]
boltmiao0304: checks 
dizzylizh51: checks 
*** TURN *** [6s 8h Qc] [7h]
boltmiao0304: checks 
dizzylizh51: bets $0.15
boltmiao0304: calls $0.15
*** RIVER *** [6s 8h Qc 7h] [4h]
boltmiao0304: checks 
dizzylizh51: bets $0.27
boltmiao0304: calls $0.27
*** SHOW DOWN ***
dizzylizh51: shows [Jh Ah] (a flush, Ace high)
boltmiao0304: mucks hand 
dizzylizh51 collected $1.04 from pot
*** SUMMARY ***
Total pot $1.09 | Rake $0.05 
Board [6s 8h Qc 7h 4h]
Seat 1: boltmiao0304 (small blind) mucked [7d 4d]
Seat 2: Hemmi191 (big blind) folded before Flop
Seat 3: TheKaKaMann folded before Flop (didn't bet)
Seat 4: dizzylizh51 showed [Jh Ah] and won ($1.04) with a flush, Ace high
Seat 5: CashMatteo folded before Flop (didn't bet)
Seat 6: stugatz1948 (button) folded before Flop (didn't bet)

Hand #955: 

PokerStars Hand #246358278247:  Hold'em No Limit ($0.02/$0.05 CAD) - 2023/10/05 0:26:16 ET
Table 'Geographos' 6-max Seat #1 is the button
Seat 1: boltmiao0304 ($12.49 in chips) 
Seat 2: Hemmi191 ($4.66 in chips) 
Seat 3: TheKaKaMann ($5.74 in chips) 
Seat 4: dizzylizh51 ($4.32 in chips) 
Seat 5: CashMatteo ($5.79 in chips) 
Seat 6: stugatz1948 ($6.82 in chips) 
Hemmi191: posts small blind $0.02
TheKaKaMann: posts big blind $0.05
*** HOLE CARDS ***
Dealt to CashMatteo [6d 9d]
dizzylizh51: calls $0.05
CashMatteo: calls $0.05
stugatz1948: folds 
boltmiao0304: folds 
Hemmi191: calls $0.03
TheKaKaMann: checks 
*** FLOP *** [Th Ah 5s]
Hemmi191: checks 
TheKaKaMann: checks 
dizzylizh51: checks 
CashMatteo: checks 
*** TURN *** [Th Ah 5s] [Qd]
Hemmi191: checks 
TheKaKaMann: checks 
dizzylizh51: bets $0.05
CashMatteo: folds 
boltmiao0304 leaves the table
Hemmi191: calls $0.05
TheKaKaMann: folds 
*** RIVER *** [Th Ah 5s Qd] [3c]
kervyrx7 joins the table at seat #1 
Hemmi191: checks 
dizzylizh51: checks 
*** SHOW DOWN ***
Hemmi191: shows [8d Jh] (high card Ace)
dizzylizh51: shows [8h Qh] (a pair of Queens)
dizzylizh51 collected $0.29 from pot
*** SUMMARY ***
Total pot $0.30 | Rake $0.01 
Board [Th Ah 5s Qd 3c]
Seat 1: boltmiao0304 (button) folded before Flop (didn't bet)
Seat 2: Hemmi191 (small blind) showed [8d Jh] and lost with high card Ace
Seat 3: TheKaKaMann (big blind) folded on the Turn
Seat 4: dizzylizh51 showed [8h Qh] and won ($0.29) with a pair of Queens
Seat 5: CashMatteo folded on the Turn
Seat 6: stugatz1948 folded before Flop (didn't bet)

Hand #956: 

PokerStars Hand #246358283979:  Hold'em No Limit ($0.02/$0.05 CAD) - 2023/10/05 0:27:07 ET
Table 'Geographos' 6-max Seat #2 is the button
Seat 2: Hemmi191 ($4.56 in chips) 
Seat 3: TheKaKaMann ($5.69 in chips) 
Seat 4: dizzylizh51 ($4.51 in chips) 
Seat 5: CashMatteo ($5.74 in chips) 
Seat 6: stugatz1948 ($6.82 in chips) 
TheKaKaMann: posts small blind $0.02
dizzylizh51: posts big blind $0.05
kervyrx7: sits out 
*** HOLE CARDS ***
Dealt to CashMatteo [Qd Qh]
CashMatteo: raises $0.10 to $0.15
stugatz1948: folds 
Hemmi191: folds 
TheKaKaMann: calls $0.13
dizzylizh51: folds 
*** FLOP *** [Ks 6d Jh]
TheKaKaMann: checks 
CashMatteo: bets $0.17
TheKaKaMann: folds 
Uncalled bet ($0.17) returned to CashMatteo
CashMatteo collected $0.34 from pot
CashMatteo: doesn't show hand 
*** SUMMARY ***
Total pot $0.35 | Rake $0.01 
Board [Ks 6d Jh]
Seat 2: Hemmi191 (button) folded before Flop (didn't bet)
Seat 3: TheKaKaMann (small blind) folded on the Flop
Seat 4: dizzylizh51 (big blind) folded before Flop
Seat 5: CashMatteo collected ($0.34)
Seat 6: stugatz1948 folded before Flop (didn't bet)

Hand #957: 

PokerStars Hand #246358286930:  Hold'em No Limit ($0.02/$0.05 CAD) - 2023/10/05 0:27:34 ET
Table 'Geographos' 6-max Seat #3 is the button
Seat 2: Hemmi191 ($4.56 in chips) 
Seat 3: TheKaKaMann ($5.54 in chips) 
Seat 4: dizzylizh51 ($4.46 in chips) 
Seat 5: CashMatteo ($5.93 in chips) 
Seat 6: stugatz1948 ($6.82 in chips) 
dizzylizh51: posts small blind $0.02
CashMatteo: posts big blind $0.05
kervyrx7: sits out 
*** HOLE CARDS ***
Dealt to CashMatteo [4c Ks]
stugatz1948: folds 
Hemmi191: raises $0.05 to $0.10
TheKaKaMann: folds 
dizzylizh51: folds 
CashMatteo: calls $0.05
*** FLOP *** [6h Ts Js]
CashMatteo: checks 
Hemmi191: bets $0.21
CashMatteo: folds 
Uncalled bet ($0.21) returned to Hemmi191
Hemmi191 collected $0.21 from pot
*** SUMMARY ***
Total pot $0.22 | Rake $0.01 
Board [6h Ts Js]
Seat 2: Hemmi191 collected ($0.21)
Seat 3: TheKaKaMann (button) folded before Flop (didn't bet)
Seat 4: dizzylizh51 (small blind) folded before Flop
Seat 5: CashMatteo (big blind) folded on the Flop
Seat 6: stugatz1948 folded before Flop (didn't bet)

Hand #958: 

PokerStars Hand #246358289591:  Hold'em No Limit ($0.02/$0.05 CAD) - 2023/10/05 0:27:57 ET
Table 'Geographos' 6-max Seat #4 is the button
Seat 2: Hemmi191 ($4.67 in chips) 
Seat 3: TheKaKaMann ($5.54 in chips) 
Seat 4: dizzylizh51 ($4.44 in chips) 
Seat 5: CashMatteo ($5.83 in chips) 
Seat 6: stugatz1948 ($6.82 in chips) 
CashMatteo: posts small blind $0.02
stugatz1948: posts big blind $0.05
kervyrx7: sits out 
*** HOLE CARDS ***
Dealt to CashMatteo [Jc Kc]
Hemmi191: raises $0.05 to $0.10
TheKaKaMann: folds 
dizzylizh51: folds 
CashMatteo: calls $0.08
stugatz1948: folds 
*** FLOP *** [5d 2h 5h]
CashMatteo: checks 
Hemmi191: bets $0.24
CashMatteo: folds 
Uncalled bet ($0.24) returned to Hemmi191
Hemmi191 collected $0.24 from pot
*** SUMMARY ***
Total pot $0.25 | Rake $0.01 
Board [5d 2h 5h]
Seat 2: Hemmi191 collected ($0.24)
Seat 3: TheKaKaMann folded before Flop (didn't bet)
Seat 4: dizzylizh51 (button) folded before Flop (didn't bet)
Seat 5: CashMatteo (small blind) folded on the Flop
Seat 6: stugatz1948 (big blind) folded before Flop

Hand #959: 

PokerStars Hand #246358292722:  Hold'em No Limit ($0.02/$0.05 CAD) - 2023/10/05 0:28:26 ET
Table 'Geographos' 6-max Seat #5 is the button
Seat 1: kervyrx7 ($5 in chips) 
Seat 2: Hemmi191 ($4.81 in chips) 
Seat 3: TheKaKaMann ($5.54 in chips) 
Seat 4: dizzylizh51 ($4.44 in chips) 
Seat 5: CashMatteo ($5.73 in chips) 
Seat 6: stugatz1948 ($6.77 in chips) 
stugatz1948: posts small blind $0.02
kervyrx7: posts big blind $0.05
*** HOLE CARDS ***
Dealt to CashMatteo [3h 2h]
Hemmi191: folds 
TheKaKaMann: folds 
dizzylizh51: folds 
CashMatteo: calls $0.05
stugatz1948: folds 
kervyrx7: checks 
*** FLOP *** [7c Js 4h]
kervyrx7: checks 
CashMatteo: checks 
*** TURN *** [7c Js 4h] [Kd]
kervyrx7: checks 
CashMatteo: checks 
*** RIVER *** [7c Js 4h Kd] [Jd]
kervyrx7: checks 
CashMatteo: checks 
*** SHOW DOWN ***
kervyrx7: shows [6s Qc] (a pair of Jacks)
CashMatteo: mucks hand 
kervyrx7 collected $0.12 from pot
*** SUMMARY ***
Total pot $0.12 | Rake $0 
Board [7c Js 4h Kd Jd]
Seat 1: kervyrx7 (big blind) showed [6s Qc] and won ($0.12) with a pair of Jacks
Seat 2: Hemmi191 folded before Flop (didn't bet)
Seat 3: TheKaKaMann folded before Flop (didn't bet)
Seat 4: dizzylizh51 folded before Flop (didn't bet)
Seat 5: CashMatteo (button) mucked [3h 2h]
Seat 6: stugatz1948 (small blind) folded before Flop

Hand #960: 

PokerStars Hand #246358296396:  Hold'em No Limit ($0.02/$0.05 CAD) - 2023/10/05 0:28:59 ET
Table 'Geographos' 6-max Seat #6 is the button
Seat 1: kervyrx7 ($5.07 in chips) 
Seat 2: Hemmi191 ($4.81 in chips) 
Seat 3: TheKaKaMann ($5.54 in chips) 
Seat 4: dizzylizh51 ($4.44 in chips) 
Seat 5: CashMatteo ($5.68 in chips) 
Seat 6: stugatz1948 ($6.75 in chips) 
kervyrx7: posts small blind $0.02
Hemmi191: posts big blind $0.05
*** HOLE CARDS ***
Dealt to CashMatteo [Qs 7c]
TheKaKaMann: folds 
dizzylizh51: folds 
CashMatteo: folds 
stugatz1948: folds 
kervyrx7: raises $0.13 to $0.18
Hemmi191: raises $0.38 to $0.56
kervyrx7: folds 
Uncalled bet ($0.38) returned to Hemmi191
Hemmi191 collected $0.36 from pot
*** SUMMARY ***
Total pot $0.36 | Rake $0 
Seat 1: kervyrx7 (small blind) folded before Flop
Seat 2: Hemmi191 (big blind) collected ($0.36)
Seat 3: TheKaKaMann folded before Flop (didn't bet)
Seat 4: dizzylizh51 folded before Flop (didn't bet)
Seat 5: CashMatteo folded before Flop (didn't bet)
Seat 6: stugatz1948 (button) folded before Flop (didn't bet)

Hand #961: 

PokerStars Hand #246358299566:  Hold'em No Limit ($0.02/$0.05 CAD) - 2023/10/05 0:29:27 ET
Table 'Geographos' 6-max Seat #1 is the button
Seat 1: kervyrx7 ($5 in chips) 
Seat 2: Hemmi191 ($4.99 in chips) 
Seat 3: TheKaKaMann ($5.54 in chips) 
Seat 4: dizzylizh51 ($4.44 in chips) 
Seat 5: CashMatteo ($5.68 in chips) 
Seat 6: stugatz1948 ($6.75 in chips) 
Hemmi191: posts small blind $0.02
TheKaKaMann: posts big blind $0.05
*** HOLE CARDS ***
Dealt to CashMatteo [5s Ah]
dizzylizh51: calls $0.05
CashMatteo: calls $0.05
stugatz1948: calls $0.05
kervyrx7: folds 
Hemmi191: calls $0.03
TheKaKaMann: checks 
*** FLOP *** [5c Jh Tc]
Hemmi191: checks 
TheKaKaMann: checks 
dizzylizh51: bets $0.12
CashMatteo: calls $0.12
stugatz1948: folds 
Hemmi191: calls $0.12
TheKaKaMann: folds 
*** TURN *** [5c Jh Tc] [6h]
Hemmi191: checks 
dizzylizh51: checks 
CashMatteo: checks 
*** RIVER *** [5c Jh Tc 6h] [2h]
Hemmi191: bets $0.58
dizzylizh51: calls $0.58
CashMatteo: folds 
*** SHOW DOWN ***
Hemmi191: shows [5h 6c] (two pair, Sixes and Fives)
dizzylizh51: shows [Th Kh] (a flush, King high)
dizzylizh51 collected $1.70 from pot
*** SUMMARY ***
Total pot $1.77 | Rake $0.07 
Board [5c Jh Tc 6h 2h]
Seat 1: kervyrx7 (button) folded before Flop (didn't bet)
Seat 2: Hemmi191 (small blind) showed [5h 6c] and lost with two pair, Sixes and Fives
Seat 3: TheKaKaMann (big blind) folded on the Flop
Seat 4: dizzylizh51 showed [Th Kh] and won ($1.70) with a flush, King high
Seat 5: CashMatteo folded on the River
Seat 6: stugatz1948 folded on the Flop

Hand #962: 

PokerStars Hand #246358304507:  Hold'em No Limit ($0.02/$0.05 CAD) - 2023/10/05 0:30:12 ET
Table 'Geographos' 6-max Seat #2 is the button
Seat 1: kervyrx7 ($5 in chips) 
Seat 2: Hemmi191 ($4.24 in chips) 
Seat 3: TheKaKaMann ($5.49 in chips) 
Seat 4: dizzylizh51 ($5.39 in chips) 
Seat 5: CashMatteo ($5.51 in chips) 
Seat 6: stugatz1948 ($6.70 in chips) 
TheKaKaMann: posts small blind $0.02
dizzylizh51: posts big blind $0.05
*** HOLE CARDS ***
Dealt to CashMatteo [7h 2s]
CashMatteo: folds 
stugatz1948: folds 
kervyrx7: folds 
Hemmi191: raises $0.05 to $0.10
TheKaKaMann: folds 
dizzylizh51: calls $0.05
*** FLOP *** [Ad 8c Ks]
dizzylizh51: checks 
Hemmi191: checks 
*** TURN *** [Ad 8c Ks] [2d]
dizzylizh51: checks 
Hemmi191: checks 
*** RIVER *** [Ad 8c Ks 2d] [Ts]
dizzylizh51: checks 
Hemmi191: checks 
*** SHOW DOWN ***
dizzylizh51: shows [Js Td] (a pair of Tens)
Hemmi191: mucks hand 
dizzylizh51 collected $0.21 from pot
*** SUMMARY ***
Total pot $0.22 | Rake $0.01 
Board [Ad 8c Ks 2d Ts]
Seat 1: kervyrx7 folded before Flop (didn't bet)
Seat 2: Hemmi191 (button) mucked [4s 4d]
Seat 3: TheKaKaMann (small blind) folded before Flop
Seat 4: dizzylizh51 (big blind) showed [Js Td] and won ($0.21) with a pair of Tens
Seat 5: CashMatteo folded before Flop (didn't bet)
Seat 6: stugatz1948 folded before Flop (didn't bet)

Hand #963: 

PokerStars Hand #246358307840:  Hold'em No Limit ($0.02/$0.05 CAD) - 2023/10/05 0:30:43 ET
Table 'Geographos' 6-max Seat #3 is the button
Seat 1: kervyrx7 ($5 in chips) 
Seat 2: Hemmi191 ($4.14 in chips) 
Seat 3: TheKaKaMann ($5.47 in chips) 
Seat 4: dizzylizh51 ($5.50 in chips) 
Seat 5: CashMatteo ($5.51 in chips) 
Seat 6: stugatz1948 ($6.70 in chips) 
dizzylizh51: posts small blind $0.02
CashMatteo: posts big blind $0.05
*** HOLE CARDS ***
Dealt to CashMatteo [4s Js]
stugatz1948: folds 
kervyrx7: folds 
Hemmi191: calls $0.05
TheKaKaMann: calls $0.05
dizzylizh51: calls $0.03
CashMatteo: checks 
*** FLOP *** [8c 7h 8s]
dizzylizh51: checks 
CashMatteo: checks 
Hemmi191: checks 
TheKaKaMann: checks 
*** TURN *** [8c 7h 8s] [7c]
dizzylizh51: checks 
CashMatteo: checks 
Hemmi191: bets $0.19
TheKaKaMann: folds 
dizzylizh51: folds 
CashMatteo: folds 
Uncalled bet ($0.19) returned to Hemmi191
Hemmi191 collected $0.19 from pot
*** SUMMARY ***
Total pot $0.20 | Rake $0.01 
Board [8c 7h 8s 7c]
Seat 1: kervyrx7 folded before Flop (didn't bet)
Seat 2: Hemmi191 collected ($0.19)
Seat 3: TheKaKaMann (button) folded on the Turn
Seat 4: dizzylizh51 (small blind) folded on the Turn
Seat 5: CashMatteo (big blind) folded on the Turn
Seat 6: stugatz1948 folded before Flop (didn't bet)

Hand #964: 

PokerStars Hand #246358311304:  Hold'em No Limit ($0.02/$0.05 CAD) - 2023/10/05 0:31:15 ET
Table 'Geographos' 6-max Seat #4 is the button
Seat 1: kervyrx7 ($5 in chips) 
Seat 2: Hemmi191 ($4.28 in chips) 
Seat 3: TheKaKaMann ($5.42 in chips) 
Seat 4: dizzylizh51 ($5.45 in chips) 
Seat 5: CashMatteo ($5.46 in chips) 
Seat 6: stugatz1948 ($6.70 in chips) 
CashMatteo: posts small blind $0.02
stugatz1948: posts big blind $0.05
*** HOLE CARDS ***
Dealt to CashMatteo [3d 8d]
kervyrx7: folds 
Hemmi191: calls $0.05
TheKaKaMann: folds 
dizzylizh51: calls $0.05
CashMatteo: folds 
stugatz1948: checks 
*** FLOP *** [2h 9h Td]
stugatz1948: checks 
Hemmi191: bets $0.10
dizzylizh51: calls $0.10
stugatz1948: folds 
*** TURN *** [2h 9h Td] [7d]
Hemmi191: bets $0.10
dizzylizh51: calls $0.10
*** RIVER *** [2h 9h Td 7d] [4s]
Hemmi191: bets $0.10
dizzylizh51: calls $0.10
*** SHOW DOWN ***
Hemmi191: shows [Qs Ts] (a pair of Tens)
dizzylizh51: mucks hand 
Hemmi191 collected $0.74 from pot
*** SUMMARY ***
Total pot $0.77 | Rake $0.03 
Board [2h 9h Td 7d 4s]
Seat 1: kervyrx7 folded before Flop (didn't bet)
Seat 2: Hemmi191 showed [Qs Ts] and won ($0.74) with a pair of Tens
Seat 3: TheKaKaMann folded before Flop (didn't bet)
Seat 4: dizzylizh51 (button) mucked [Th Jd]
Seat 5: CashMatteo (small blind) folded before Flop
Seat 6: stugatz1948 (big blind) folded on the Flop

Hand #965: 

PokerStars Hand #246358315860:  Hold'em No Limit ($0.02/$0.05 CAD) - 2023/10/05 0:31:56 ET
Table 'Geographos' 6-max Seat #5 is the button
Seat 1: kervyrx7 ($5 in chips) 
Seat 2: Hemmi191 ($4.67 in chips) 
Seat 3: TheKaKaMann ($5.42 in chips) 
Seat 4: dizzylizh51 ($5.10 in chips) 
Seat 5: CashMatteo ($5.44 in chips) 
Seat 6: stugatz1948 ($6.65 in chips) 
stugatz1948: posts small blind $0.02
kervyrx7: posts big blind $0.05
*** HOLE CARDS ***
Dealt to CashMatteo [Qc Ks]
Hemmi191: calls $0.05
TheKaKaMann: folds 
dizzylizh51: raises $0.05 to $0.10
CashMatteo: calls $0.10
stugatz1948: folds 
kervyrx7: calls $0.05
Hemmi191: calls $0.05
*** FLOP *** [Td Qd Jh]
kervyrx7: checks 
Hemmi191: checks 
dizzylizh51: checks 
CashMatteo: bets $0.20
kervyrx7: calls $0.20
Hemmi191: calls $0.20
dizzylizh51: folds 
*** TURN *** [Td Qd Jh] [Kh]
kervyrx7: checks 
Hemmi191: checks 
CashMatteo: checks 
*** RIVER *** [Td Qd Jh Kh] [4s]
kervyrx7: checks 
Hemmi191: checks 
CashMatteo: checks 
*** SHOW DOWN ***
kervyrx7: shows [7d Jd] (a pair of Jacks)
Hemmi191: shows [Kc 5h] (a pair of Kings)
CashMatteo: shows [Qc Ks] (two pair, Kings and Queens)
CashMatteo collected $0.98 from pot
*** SUMMARY ***
Total pot $1.02 | Rake $0.04 
Board [Td Qd Jh Kh 4s]
Seat 1: kervyrx7 (big blind) showed [7d Jd] and lost with a pair of Jacks
Seat 2: Hemmi191 showed [Kc 5h] and lost with a pair of Kings
Seat 3: TheKaKaMann folded before Flop (didn't bet)
Seat 4: dizzylizh51 folded on the Flop
Seat 5: CashMatteo (button) showed [Qc Ks] and won ($0.98) with two pair, Kings and Queens
Seat 6: stugatz1948 (small blind) folded before Flop

Hand #966: 

PokerStars Hand #246358323301:  Hold'em No Limit ($0.02/$0.05 CAD) - 2023/10/05 0:33:03 ET
Table 'Geographos' 6-max Seat #6 is the button
Seat 1: kervyrx7 ($5 in chips) 
Seat 2: Hemmi191 ($4.37 in chips) 
Seat 3: TheKaKaMann ($5.42 in chips) 
Seat 4: dizzylizh51 ($5 in chips) 
Seat 5: CashMatteo ($6.12 in chips) 
Seat 6: stugatz1948 ($6.63 in chips) 
kervyrx7: posts small blind $0.02
Hemmi191: posts big blind $0.05
*** HOLE CARDS ***
Dealt to CashMatteo [6h 7c]
TheKaKaMann: calls $0.05
dizzylizh51: folds 
CashMatteo: folds 
stugatz1948: calls $0.05
kervyrx7: calls $0.03
Hemmi191: checks 
*** FLOP *** [Kc 9s 4c]
kervyrx7: checks 
Hemmi191: checks 
TheKaKaMann: checks 
stugatz1948: bets $0.19
kervyrx7: folds 
Hemmi191: folds 
TheKaKaMann: folds 
Uncalled bet ($0.19) returned to stugatz1948
stugatz1948 collected $0.19 from pot
stugatz1948: doesn't show hand 
*** SUMMARY ***
Total pot $0.20 | Rake $0.01 
Board [Kc 9s 4c]
Seat 1: kervyrx7 (small blind) folded on the Flop
Seat 2: Hemmi191 (big blind) folded on the Flop
Seat 3: TheKaKaMann folded on the Flop
Seat 4: dizzylizh51 folded before Flop (didn't bet)
Seat 5: CashMatteo folded before Flop (didn't bet)
Seat 6: stugatz1948 (button) collected ($0.19)

Hand #967: 

PokerStars Hand #246358326443:  Hold'em No Limit ($0.02/$0.05 CAD) - 2023/10/05 0:33:32 ET
Table 'Geographos' 6-max Seat #1 is the button
Seat 1: kervyrx7 ($5 in chips) 
Seat 2: Hemmi191 ($4.32 in chips) 
Seat 3: TheKaKaMann ($5.37 in chips) 
Seat 4: dizzylizh51 ($5 in chips) 
Seat 5: CashMatteo ($6.12 in chips) 
Seat 6: stugatz1948 ($6.77 in chips) 
Hemmi191: posts small blind $0.02
TheKaKaMann: posts big blind $0.05
*** HOLE CARDS ***
Dealt to CashMatteo [3d As]
dizzylizh51: calls $0.05
CashMatteo: calls $0.05
stugatz1948: calls $0.05
kervyrx7: folds 
Hemmi191: folds 
TheKaKaMann: checks 
*** FLOP *** [Jh Qh 7h]
TheKaKaMann: checks 
dizzylizh51: checks 
CashMatteo: checks 
stugatz1948: checks 
*** TURN *** [Jh Qh 7h] [Js]
TheKaKaMann: checks 
dizzylizh51: checks 
CashMatteo: checks 
stugatz1948: checks 
*** RIVER *** [Jh Qh 7h Js] [2s]
TheKaKaMann: checks 
dizzylizh51: bets $0.05
CashMatteo: folds 
stugatz1948: folds 
TheKaKaMann: folds 
Uncalled bet ($0.05) returned to dizzylizh51
dizzylizh51 collected $0.21 from pot
dizzylizh51: doesn't show hand 
*** SUMMARY ***
Total pot $0.22 | Rake $0.01 
Board [Jh Qh 7h Js 2s]
Seat 1: kervyrx7 (button) folded before Flop (didn't bet)
Seat 2: Hemmi191 (small blind) folded before Flop
Seat 3: TheKaKaMann (big blind) folded on the River
Seat 4: dizzylizh51 collected ($0.21)
Seat 5: CashMatteo folded on the River
Seat 6: stugatz1948 folded on the River

Hand #968: 

PokerStars Hand #246358332379:  Hold'em No Limit ($0.02/$0.05 CAD) - 2023/10/05 0:34:26 ET
Table 'Geographos' 6-max Seat #2 is the button
Seat 1: kervyrx7 ($5 in chips) 
Seat 2: Hemmi191 ($4.30 in chips) 
Seat 3: TheKaKaMann ($5.32 in chips) 
Seat 4: dizzylizh51 ($5.16 in chips) 
Seat 5: CashMatteo ($6.07 in chips) 
Seat 6: stugatz1948 ($6.72 in chips) 
TheKaKaMann: posts small blind $0.02
dizzylizh51: posts big blind $0.05
*** HOLE CARDS ***
Dealt to CashMatteo [6s Qd]
CashMatteo: folds 
stugatz1948: folds 
kervyrx7: folds 
Hemmi191: calls $0.05
TheKaKaMann: folds 
dizzylizh51: checks 
*** FLOP *** [5h Ah 4h]
dizzylizh51: checks 
Hemmi191: checks 
*** TURN *** [5h Ah 4h] [2h]
dizzylizh51: checks 
Hemmi191: checks 
*** RIVER *** [5h Ah 4h 2h] [8h]
dizzylizh51: checks 
Hemmi191: checks 
*** SHOW DOWN ***
dizzylizh51: shows [7c 3d] (a flush, Ace high)
Hemmi191: shows [As Jd] (a flush, Ace high)
dizzylizh51 collected $0.06 from pot
Hemmi191 collected $0.06 from pot
*** SUMMARY ***
Total pot $0.12 | Rake $0 
Board [5h Ah 4h 2h 8h]
Seat 1: kervyrx7 folded before Flop (didn't bet)
Seat 2: Hemmi191 (button) showed [As Jd] and won ($0.06) with a flush, Ace high
Seat 3: TheKaKaMann (small blind) folded before Flop
Seat 4: dizzylizh51 (big blind) showed [7c 3d] and won ($0.06) with a flush, Ace high
Seat 5: CashMatteo folded before Flop (didn't bet)
Seat 6: stugatz1948 folded before Flop (didn't bet)

Hand #969: 

PokerStars Hand #246358336273:  Hold'em No Limit ($0.02/$0.05 CAD) - 2023/10/05 0:35:00 ET
Table 'Geographos' 6-max Seat #3 is the button
Seat 1: kervyrx7 ($5 in chips) 
Seat 2: Hemmi191 ($4.31 in chips) 
Seat 3: TheKaKaMann ($5.30 in chips) 
Seat 4: dizzylizh51 ($5.17 in chips) 
Seat 5: CashMatteo ($6.07 in chips) 
Seat 6: stugatz1948 ($6.72 in chips) 
dizzylizh51: posts small blind $0.02
CashMatteo: posts big blind $0.05
*** HOLE CARDS ***
Dealt to CashMatteo [Jh 9s]
stugatz1948: folds 
kervyrx7: folds 
Hemmi191: folds 
TheKaKaMann: calls $0.05
dizzylizh51: raises $0.05 to $0.10
CashMatteo: calls $0.05
TheKaKaMann: calls $0.05
*** FLOP *** [8h Ks 9c]
dizzylizh51: bets $0.25
CashMatteo: folds 
TheKaKaMann: raises $0.61 to $0.86
dizzylizh51: calls $0.61
*** TURN *** [8h Ks 9c] [Kd]
dizzylizh51: checks 
TheKaKaMann: checks 
*** RIVER *** [8h Ks 9c Kd] [4d]
dizzylizh51: bets $0.97
TheKaKaMann: raises $1.45 to $2.42
dizzylizh51: calls $1.45
*** SHOW DOWN ***
TheKaKaMann: shows [Kh 7h] (three of a kind, Kings)
dizzylizh51: shows [Ah Kc] (three of a kind, Kings - Ace kicker)
dizzylizh51 collected $6.58 from pot
*** SUMMARY ***
Total pot $6.86 | Rake $0.28 
Board [8h Ks 9c Kd 4d]
Seat 1: kervyrx7 folded before Flop (didn't bet)
Seat 2: Hemmi191 folded before Flop (didn't bet)
Seat 3: TheKaKaMann (button) showed [Kh 7h] and lost with three of a kind, Kings
Seat 4: dizzylizh51 (small blind) showed [Ah Kc] and won ($6.58) with three of a kind, Kings
Seat 5: CashMatteo (big blind) folded on the Flop
Seat 6: stugatz1948 folded before Flop (didn't bet)

Hand #970: 

PokerStars Hand #246358343960:  Hold'em No Limit ($0.02/$0.05 CAD) - 2023/10/05 0:36:12 ET
Table 'Geographos' 6-max Seat #4 is the button
Seat 1: kervyrx7 ($5 in chips) 
Seat 2: Hemmi191 ($4.31 in chips) 
Seat 3: TheKaKaMann ($1.92 in chips) 
Seat 4: dizzylizh51 ($8.37 in chips) 
Seat 5: CashMatteo ($5.97 in chips) 
Seat 6: stugatz1948 ($6.72 in chips) 
CashMatteo: posts small blind $0.02
stugatz1948: posts big blind $0.05
*** HOLE CARDS ***
Dealt to CashMatteo [3c 8c]
kervyrx7: folds 
Hemmi191: calls $0.05
TheKaKaMann: calls $0.05
dizzylizh51: calls $0.05
CashMatteo: folds 
stugatz1948: checks 
*** FLOP *** [7d 5c 2c]
stugatz1948: checks 
Hemmi191: checks 
TheKaKaMann: bets $0.17
dizzylizh51: calls $0.17
stugatz1948: folds 
Hemmi191: folds 
*** TURN *** [7d 5c 2c] [2s]
TheKaKaMann: bets $0.36
dizzylizh51: folds 
Uncalled bet ($0.36) returned to TheKaKaMann
TheKaKaMann collected $0.54 from pot
TheKaKaMann: doesn't show hand 
*** SUMMARY ***
Total pot $0.56 | Rake $0.02 
Board [7d 5c 2c 2s]
Seat 1: kervyrx7 folded before Flop (didn't bet)
Seat 2: Hemmi191 folded on the Flop
Seat 3: TheKaKaMann collected ($0.54)
Seat 4: dizzylizh51 (button) folded on the Turn
Seat 5: CashMatteo (small blind) folded before Flop
Seat 6: stugatz1948 (big blind) folded on the Flop

Hand #971: 

PokerStars Hand #246358347862:  Hold'em No Limit ($0.02/$0.05 CAD) - 2023/10/05 0:36:48 ET
Table 'Geographos' 6-max Seat #5 is the button
Seat 1: kervyrx7 ($5 in chips) 
Seat 2: Hemmi191 ($4.26 in chips) 
Seat 3: TheKaKaMann ($2.24 in chips) 
Seat 4: dizzylizh51 ($8.15 in chips) 
Seat 5: CashMatteo ($5.95 in chips) 
Seat 6: stugatz1948 ($6.67 in chips) 
stugatz1948: posts small blind $0.02
kervyrx7: posts big blind $0.05
*** HOLE CARDS ***
Dealt to CashMatteo [2d 7s]
Hemmi191: calls $0.05
TheKaKaMann: calls $0.05
dizzylizh51: folds 
CashMatteo: folds 
stugatz1948: calls $0.03
kervyrx7: checks 
*** FLOP *** [Kd 9d Js]
stugatz1948: checks 
kervyrx7: checks 
Hemmi191: checks 
TheKaKaMann: bets $0.14
stugatz1948: folds 
kervyrx7: folds 
Hemmi191: folds 
Uncalled bet ($0.14) returned to TheKaKaMann
TheKaKaMann collected $0.19 from pot
*** SUMMARY ***
Total pot $0.20 | Rake $0.01 
Board [Kd 9d Js]
Seat 1: kervyrx7 (big blind) folded on the Flop
Seat 2: Hemmi191 folded on the Flop
Seat 3: TheKaKaMann collected ($0.19)
Seat 4: dizzylizh51 folded before Flop (didn't bet)
Seat 5: CashMatteo (button) folded before Flop (didn't bet)
Seat 6: stugatz1948 (small blind) folded on the Flop

Hand #972: 

PokerStars Hand #246358352145:  Hold'em No Limit ($0.02/$0.05 CAD) - 2023/10/05 0:37:28 ET
Table 'Geographos' 6-max Seat #6 is the button
Seat 1: kervyrx7 ($5 in chips) 
Seat 2: Hemmi191 ($4.21 in chips) 
Seat 3: TheKaKaMann ($2.38 in chips) 
Seat 4: dizzylizh51 ($8.15 in chips) 
Seat 5: CashMatteo ($5.95 in chips) 
Seat 6: stugatz1948 ($6.62 in chips) 
kervyrx7: posts small blind $0.02
Hemmi191: posts big blind $0.05
*** HOLE CARDS ***
Dealt to CashMatteo [6h 3h]
TheKaKaMann: folds 
dizzylizh51: calls $0.05
CashMatteo: folds 
stugatz1948: folds 
kervyrx7: folds 
Hemmi191: raises $0.10 to $0.15
dizzylizh51: calls $0.10
*** FLOP *** [As 5c 4h]
Hemmi191: checks 
dizzylizh51: checks 
*** TURN *** [As 5c 4h] [8h]
Hemmi191: checks 
dizzylizh51: checks 
*** RIVER *** [As 5c 4h 8h] [3c]
Hemmi191: checks 
dizzylizh51: checks 
*** SHOW DOWN ***
Hemmi191: shows [Qh 7h] (high card Ace)
dizzylizh51: shows [Th Qc] (high card Ace - Queen+Ten kicker)
dizzylizh51 collected $0.31 from pot
*** SUMMARY ***
Total pot $0.32 | Rake $0.01 
Board [As 5c 4h 8h 3c]
Seat 1: kervyrx7 (small blind) folded before Flop
Seat 2: Hemmi191 (big blind) showed [Qh 7h] and lost with high card Ace
Seat 3: TheKaKaMann folded before Flop (didn't bet)
Seat 4: dizzylizh51 showed [Th Qc] and won ($0.31) with high card Ace
Seat 5: CashMatteo folded before Flop (didn't bet)
Seat 6: stugatz1948 (button) folded before Flop (didn't bet)

Hand #973: 

PokerStars Hand #246358356749:  Hold'em No Limit ($0.02/$0.05 CAD) - 2023/10/05 0:38:10 ET
Table 'Geographos' 6-max Seat #1 is the button
Seat 1: kervyrx7 ($5 in chips) 
Seat 2: Hemmi191 ($4.06 in chips) 
Seat 3: TheKaKaMann ($2.38 in chips) 
Seat 4: dizzylizh51 ($8.31 in chips) 
Seat 5: CashMatteo ($5.95 in chips) 
Seat 6: stugatz1948 ($6.62 in chips) 
Hemmi191: posts small blind $0.02
TheKaKaMann: posts big blind $0.05
*** HOLE CARDS ***
Dealt to CashMatteo [4c 6d]
dizzylizh51: raises $0.12 to $0.17
CashMatteo: folds 
stugatz1948: folds 
kervyrx7: folds 
Hemmi191: folds 
TheKaKaMann: calls $0.12
*** FLOP *** [8s 4s 5d]
TheKaKaMann: checks 
dizzylizh51: bets $0.18
TheKaKaMann: raises $0.38 to $0.56
dizzylizh51: calls $0.38
*** TURN *** [8s 4s 5d] [5c]
TheKaKaMann: bets $1.65 and is all-in
dizzylizh51: calls $1.65
*** RIVER *** [8s 4s 5d 5c] [3d]
*** SHOW DOWN ***
TheKaKaMann: shows [As 7c] (a pair of Fives)
dizzylizh51: shows [Qs Qh] (two pair, Queens and Fives)
dizzylizh51 collected $4.58 from pot
*** SUMMARY ***
Total pot $4.78 | Rake $0.20 
Board [8s 4s 5d 5c 3d]
Seat 1: kervyrx7 (button) folded before Flop (didn't bet)
Seat 2: Hemmi191 (small blind) folded before Flop
Seat 3: TheKaKaMann (big blind) showed [As 7c] and lost with a pair of Fives
Seat 4: dizzylizh51 showed [Qs Qh] and won ($4.58) with two pair, Queens and Fives
Seat 5: CashMatteo folded before Flop (didn't bet)
Seat 6: stugatz1948 folded before Flop (didn't bet)

Hand #974: 

PokerStars Hand #246358361714:  Hold'em No Limit ($0.02/$0.05 CAD) - 2023/10/05 0:38:55 ET
Table 'Geographos' 6-max Seat #2 is the button
Seat 1: kervyrx7 ($5 in chips) 
Seat 2: Hemmi191 ($4.04 in chips) 
Seat 4: dizzylizh51 ($10.51 in chips) 
Seat 5: CashMatteo ($5.95 in chips) 
Seat 6: stugatz1948 ($6.62 in chips) 
dizzylizh51: posts small blind $0.02
CashMatteo: posts big blind $0.05
*** HOLE CARDS ***
Dealt to CashMatteo [4s 8c]
stugatz1948: folds 
kervyrx7: folds 
Hemmi191: folds 
dizzylizh51: folds 
Uncalled bet ($0.03) returned to CashMatteo
CashMatteo collected $0.04 from pot
CashMatteo: doesn't show hand 
*** SUMMARY ***
Total pot $0.04 | Rake $0 
Seat 1: kervyrx7 folded before Flop (didn't bet)
Seat 2: Hemmi191 (button) folded before Flop (didn't bet)
Seat 4: dizzylizh51 (small blind) folded before Flop
Seat 5: CashMatteo (big blind) collected ($0.04)
Seat 6: stugatz1948 folded before Flop (didn't bet)

Hand #975: 

PokerStars Hand #246358363401:  Hold'em No Limit ($0.02/$0.05 CAD) - 2023/10/05 0:39:10 ET
Table 'Geographos' 6-max Seat #4 is the button
Seat 1: kervyrx7 ($5 in chips) 
Seat 2: Hemmi191 ($4.04 in chips) 
Seat 4: dizzylizh51 ($10.49 in chips) 
Seat 5: CashMatteo ($5.97 in chips) 
Seat 6: stugatz1948 ($6.62 in chips) 
CashMatteo: posts small blind $0.02
stugatz1948: posts big blind $0.05
*** HOLE CARDS ***
Dealt to CashMatteo [9s Td]
kervyrx7: folds 
Hemmi191: calls $0.05
dizzylizh51: calls $0.05
CashMatteo: folds 
stugatz1948: checks 
*** FLOP *** [3h Qh Jc]
stugatz1948: checks 
Hemmi191: bets $0.16
rich1717 joins the table at seat #3 
dizzylizh51: folds 
stugatz1948: folds 
Uncalled bet ($0.16) returned to Hemmi191
Hemmi191 collected $0.16 from pot
*** SUMMARY ***
Total pot $0.17 | Rake $0.01 
Board [3h Qh Jc]
Seat 1: kervyrx7 folded before Flop (didn't bet)
Seat 2: Hemmi191 collected ($0.16)
Seat 4: dizzylizh51 (button) folded on the Flop
Seat 5: CashMatteo (small blind) folded before Flop
Seat 6: stugatz1948 (big blind) folded on the Flop

Hand #976: 

PokerStars Hand #246358366795:  Hold'em No Limit ($0.02/$0.05 CAD) - 2023/10/05 0:39:41 ET
Table 'Geographos' 6-max Seat #5 is the button
Seat 1: kervyrx7 ($5 in chips) 
Seat 2: Hemmi191 ($4.15 in chips) 
Seat 4: dizzylizh51 ($10.44 in chips) 
Seat 5: CashMatteo ($5.95 in chips) 
Seat 6: stugatz1948 ($6.57 in chips) 
stugatz1948: posts small blind $0.02
kervyrx7: posts big blind $0.05
rich1717: sits out 
*** HOLE CARDS ***
Dealt to CashMatteo [6h Ad]
Hemmi191: folds 
dizzylizh51: folds 
CashMatteo: calls $0.05
stugatz1948: folds 
kervyrx7: checks 
*** FLOP *** [Th 5c 7d]
kervyrx7: checks 
CashMatteo: bets $0.06
kervyrx7: folds 
Uncalled bet ($0.06) returned to CashMatteo
dizzylizh51 leaves the table
CashMatteo collected $0.12 from pot
CashMatteo: doesn't show hand 
*** SUMMARY ***
Total pot $0.12 | Rake $0 
Board [Th 5c 7d]
Seat 1: kervyrx7 (big blind) folded on the Flop
Seat 2: Hemmi191 folded before Flop (didn't bet)
Seat 4: dizzylizh51 folded before Flop (didn't bet)
Seat 5: CashMatteo (button) collected ($0.12)
Seat 6: stugatz1948 (small blind) folded before Flop

Hand #977: 

PokerStars Hand #246358369191:  Hold'em No Limit ($0.02/$0.05 CAD) - 2023/10/05 0:40:03 ET
Table 'Geographos' 6-max Seat #6 is the button
Seat 1: kervyrx7 ($5 in chips) 
Seat 2: Hemmi191 ($4.15 in chips) 
Seat 5: CashMatteo ($6.02 in chips) 
Seat 6: stugatz1948 ($6.55 in chips) 
kervyrx7: posts small blind $0.02
Hemmi191: posts big blind $0.05
rich1717: sits out 
*** HOLE CARDS ***
Dealt to CashMatteo [Tc Qc]
CashMatteo: raises $0.07 to $0.12
stugatz1948: folds 
kervyrx7: folds 
Hemmi191: calls $0.07
*** FLOP *** [Ac 5h 5c]
Hemmi191: checks 
CashMatteo: bets $0.13
Hemmi191: calls $0.13
*** TURN *** [Ac 5h 5c] [5s]
Hemmi191: bets $0.50
CashMatteo: calls $0.50
*** RIVER *** [Ac 5h 5c 5s] [Th]
Hemmi191: bets $0.73
CashMatteo: calls $0.73
*** SHOW DOWN ***
Hemmi191: shows [7s 7d] (a full house, Fives full of Sevens)
CashMatteo: shows [Tc Qc] (a full house, Fives full of Tens)
CashMatteo collected $2.86 from pot
*** SUMMARY ***
Total pot $2.98 | Rake $0.12 
Board [Ac 5h 5c 5s Th]
Seat 1: kervyrx7 (small blind) folded before Flop
Seat 2: Hemmi191 (big blind) showed [7s 7d] and lost with a full house, Fives full of Sevens
Seat 5: CashMatteo showed [Tc Qc] and won ($2.86) with a full house, Fives full of Tens
Seat 6: stugatz1948 (button) folded before Flop (didn't bet)

Hand #978: 

PokerStars Hand #246358374007:  Hold'em No Limit ($0.02/$0.05 CAD) - 2023/10/05 0:40:47 ET
Table 'Geographos' 6-max Seat #1 is the button
Seat 1: kervyrx7 ($5 in chips) 
Seat 2: Hemmi191 ($2.67 in chips) 
Seat 3: rich1717 ($2 in chips) 
Seat 5: CashMatteo ($7.40 in chips) 
Seat 6: stugatz1948 ($6.55 in chips) 
Hemmi191: posts small blind $0.02
rich1717: posts big blind $0.05
*** HOLE CARDS ***
Dealt to CashMatteo [5d 8c]
CashMatteo: folds 
stugatz1948: folds 
kervyrx7: folds 
Hemmi191: folds 
Uncalled bet ($0.03) returned to rich1717
rich1717 collected $0.04 from pot
*** SUMMARY ***
Total pot $0.04 | Rake $0 
Seat 1: kervyrx7 (button) folded before Flop (didn't bet)
Seat 2: Hemmi191 (small blind) folded before Flop
Seat 3: rich1717 (big blind) collected ($0.04)
Seat 5: CashMatteo folded before Flop (didn't bet)
Seat 6: stugatz1948 folded before Flop (didn't bet)

Hand #979: 

PokerStars Hand #246358375075:  Hold'em No Limit ($0.02/$0.05 CAD) - 2023/10/05 0:40:57 ET
Table 'Geographos' 6-max Seat #2 is the button
Seat 1: kervyrx7 ($5 in chips) 
Seat 2: Hemmi191 ($2.65 in chips) 
Seat 3: rich1717 ($2.02 in chips) 
Seat 5: CashMatteo ($7.40 in chips) 
Seat 6: stugatz1948 ($6.55 in chips) 
rich1717: posts small blind $0.02
CashMatteo: posts big blind $0.05
*** HOLE CARDS ***
Dealt to CashMatteo [4c 9c]
stugatz1948: folds 
kervyrx7: folds 
Hemmi191: folds 
rich1717: folds 
Uncalled bet ($0.03) returned to CashMatteo
CashMatteo collected $0.04 from pot
CashMatteo: doesn't show hand 
*** SUMMARY ***
Total pot $0.04 | Rake $0 
Seat 1: kervyrx7 folded before Flop (didn't bet)
Seat 2: Hemmi191 (button) folded before Flop (didn't bet)
Seat 3: rich1717 (small blind) folded before Flop
Seat 5: CashMatteo (big blind) collected ($0.04)
Seat 6: stugatz1948 folded before Flop (didn't bet)

Hand #980: 

PokerStars Hand #246358376618:  Hold'em No Limit ($0.02/$0.05 CAD) - 2023/10/05 0:41:11 ET
Table 'Geographos' 6-max Seat #3 is the button
Seat 1: kervyrx7 ($5 in chips) 
Seat 2: Hemmi191 ($2.65 in chips) 
Seat 3: rich1717 ($2 in chips) 
Seat 5: CashMatteo ($7.42 in chips) 
Seat 6: stugatz1948 ($6.55 in chips) 
CashMatteo: posts small blind $0.02
stugatz1948: posts big blind $0.05
*** HOLE CARDS ***
Dealt to CashMatteo [9d 8h]
kervyrx7: folds 
Hemmi191: calls $0.05
rich1717: folds 
CashMatteo: folds 
stugatz1948: checks 
*** FLOP *** [4h 6c 9c]
stugatz1948: checks 
Hemmi191: bets $0.05
stugatz1948: calls $0.05
*** TURN *** [4h 6c 9c] [Qd]
stugatz1948: checks 
Hemmi191: checks 
*** RIVER *** [4h 6c 9c Qd] [Qc]
stugatz1948: checks 
Hemmi191: checks 
*** SHOW DOWN ***
stugatz1948: shows [6d Jh] (two pair, Queens and Sixes)
Hemmi191: mucks hand 
stugatz1948 collected $0.21 from pot
*** SUMMARY ***
Total pot $0.22 | Rake $0.01 
Board [4h 6c 9c Qd Qc]
Seat 1: kervyrx7 folded before Flop (didn't bet)
Seat 2: Hemmi191 mucked [5c 7s]
Seat 3: rich1717 (button) folded before Flop (didn't bet)
Seat 5: CashMatteo (small blind) folded before Flop
Seat 6: stugatz1948 (big blind) showed [6d Jh] and won ($0.21) with two pair, Queens and Sixes

Hand #981: 

PokerStars Hand #246358382068:  Hold'em No Limit ($0.02/$0.05 CAD) - 2023/10/05 0:42:01 ET
Table 'Geographos' 6-max Seat #5 is the button
Seat 1: kervyrx7 ($5 in chips) 
Seat 2: Hemmi191 ($2.55 in chips) 
Seat 3: rich1717 ($2 in chips) 
Seat 5: CashMatteo ($7.40 in chips) 
Seat 6: stugatz1948 ($6.66 in chips) 
stugatz1948: posts small blind $0.02
kervyrx7: posts big blind $0.05
*** HOLE CARDS ***
Dealt to CashMatteo [Js 2c]
Hemmi191: calls $0.05
rich1717 has timed out
rich1717: folds 
CashMatteo: folds 
stugatz1948: calls $0.03
kervyrx7: checks 
*** FLOP *** [Ks Kc 5h]
stugatz1948: checks 
kervyrx7: checks 
Hemmi191: checks 
*** TURN *** [Ks Kc 5h] [9c]
stugatz1948: checks 
kervyrx7: checks 
Hemmi191: bets $0.24
stugatz1948: folds 
kervyrx7: folds 
Uncalled bet ($0.24) returned to Hemmi191
Hemmi191 collected $0.14 from pot
*** SUMMARY ***
Total pot $0.15 | Rake $0.01 
Board [Ks Kc 5h 9c]
Seat 1: kervyrx7 (big blind) folded on the Turn
Seat 2: Hemmi191 collected ($0.14)
Seat 3: rich1717 folded before Flop (didn't bet)
Seat 5: CashMatteo (button) folded before Flop (didn't bet)
Seat 6: stugatz1948 (small blind) folded on the Turn

Hand #982: 

PokerStars Hand #246358387511:  Hold'em No Limit ($0.02/$0.05 CAD) - 2023/10/05 0:42:51 ET
Table 'Geographos' 6-max Seat #6 is the button
Seat 1: kervyrx7 ($5 in chips) 
Seat 2: Hemmi191 ($2.64 in chips) 
Seat 3: rich1717 ($2 in chips) 
Seat 5: CashMatteo ($7.40 in chips) 
Seat 6: stugatz1948 ($6.61 in chips) 
kervyrx7: posts small blind $0.02
Hemmi191: posts big blind $0.05
*** HOLE CARDS ***
Dealt to CashMatteo [Jd 7d]
rich1717: raises $0.05 to $0.10
CashMatteo: folds 
stugatz1948: calls $0.10
kervyrx7: folds 
Hemmi191: calls $0.05
*** FLOP *** [3c 2h 6s]
Hemmi191: checks 
rich1717: checks 
stugatz1948: checks 
*** TURN *** [3c 2h 6s] [6d]
Hemmi191: bets $0.31
rich1717: folds 
stugatz1948: folds 
Uncalled bet ($0.31) returned to Hemmi191
Hemmi191 collected $0.31 from pot
*** SUMMARY ***
Total pot $0.32 | Rake $0.01 
Board [3c 2h 6s 6d]
Seat 1: kervyrx7 (small blind) folded before Flop
Seat 2: Hemmi191 (big blind) collected ($0.31)
Seat 3: rich1717 folded on the Turn
Seat 5: CashMatteo folded before Flop (didn't bet)
Seat 6: stugatz1948 (button) folded on the Turn

Hand #983: 

PokerStars Hand #246358392568:  Hold'em No Limit ($0.02/$0.05 CAD) - 2023/10/05 0:43:37 ET
Table 'Geographos' 6-max Seat #1 is the button
Seat 1: kervyrx7 ($5 in chips) 
Seat 2: Hemmi191 ($2.85 in chips) 
Seat 3: rich1717 ($1.90 in chips) 
Seat 5: CashMatteo ($7.40 in chips) 
Seat 6: stugatz1948 ($6.51 in chips) 
Hemmi191: posts small blind $0.02
rich1717: posts big blind $0.05
*** HOLE CARDS ***
Dealt to CashMatteo [3h Jh]
CashMatteo: folds 
stugatz1948: folds 
kervyrx7: raises $0.09 to $0.14
Hemmi191: calls $0.12
rich1717: calls $0.09
*** FLOP *** [8d Jd Js]
Hemmi191: checks 
rich1717: checks 
kervyrx7: checks 
*** TURN *** [8d Jd Js] [6c]
Hemmi191: checks 
rich1717: checks 
kervyrx7: checks 
*** RIVER *** [8d Jd Js 6c] [Td]
Hemmi191: checks 
rich1717: checks 
kervyrx7: checks 
*** SHOW DOWN ***
Hemmi191: shows [Ac 5s] (a pair of Jacks)
rich1717: shows [Qs Tc] (two pair, Jacks and Tens)
kervyrx7: mucks hand 
rich1717 collected $0.40 from pot
*** SUMMARY ***
Total pot $0.42 | Rake $0.02 
Board [8d Jd Js 6c Td]
Seat 1: kervyrx7 (button) mucked [4c Ah]
Seat 2: Hemmi191 (small blind) showed [Ac 5s] and lost with a pair of Jacks
Seat 3: rich1717 (big blind) showed [Qs Tc] and won ($0.40) with two pair, Jacks and Tens
Seat 5: CashMatteo folded before Flop (didn't bet)
Seat 6: stugatz1948 folded before Flop (didn't bet)

Hand #984: 

PokerStars Hand #246358396787:  Hold'em No Limit ($0.02/$0.05 CAD) - 2023/10/05 0:44:15 ET
Table 'Geographos' 6-max Seat #2 is the button
Seat 1: kervyrx7 ($5 in chips) 
Seat 2: Hemmi191 ($2.71 in chips) 
Seat 3: rich1717 ($2.16 in chips) 
Seat 5: CashMatteo ($7.40 in chips) 
Seat 6: stugatz1948 ($6.51 in chips) 
rich1717: posts small blind $0.02
CashMatteo: posts big blind $0.05
*** HOLE CARDS ***
Dealt to CashMatteo [8c Kh]
stugatz1948: raises $0.12 to $0.17
kervyrx7: folds 
Hemmi191: folds 
rich1717: calls $0.15
CashMatteo: folds 
*** FLOP *** [9c 5c 9s]
rich1717: checks 
stugatz1948: bets $6.34 and is all-in
rich1717: folds 
Uncalled bet ($6.34) returned to stugatz1948
stugatz1948 collected $0.37 from pot
stugatz1948: doesn't show hand 
*** SUMMARY ***
Total pot $0.39 | Rake $0.02 
Board [9c 5c 9s]
Seat 1: kervyrx7 folded before Flop (didn't bet)
Seat 2: Hemmi191 (button) folded before Flop (didn't bet)
Seat 3: rich1717 (small blind) folded on the Flop
Seat 5: CashMatteo (big blind) folded before Flop
Seat 6: stugatz1948 collected ($0.37)

Hand #985: 

PokerStars Hand #246358400576:  Hold'em No Limit ($0.02/$0.05 CAD) - 2023/10/05 0:44:50 ET
Table 'Geographos' 6-max Seat #3 is the button
Seat 1: kervyrx7 ($5 in chips) 
Seat 2: Hemmi191 ($2.71 in chips) 
Seat 3: rich1717 ($1.99 in chips) 
Seat 5: CashMatteo ($7.35 in chips) 
Seat 6: stugatz1948 ($6.71 in chips) 
CashMatteo: posts small blind $0.02
stugatz1948: posts big blind $0.05
*** HOLE CARDS ***
Dealt to CashMatteo [4s 3d]
kervyrx7: folds 
Hemmi191: calls $0.05
rich1717: calls $0.05
CashMatteo: folds 
stugatz1948: checks 
*** FLOP *** [3s Jc 5h]
stugatz1948: checks 
Hemmi191: checks 
rich1717: checks 
*** TURN *** [3s Jc 5h] [2s]
stugatz1948: checks 
Hemmi191: checks 
rich1717: bets $0.05
stugatz1948: folds 
Hemmi191: folds 
Uncalled bet ($0.05) returned to rich1717
rich1717 collected $0.16 from pot
*** SUMMARY ***
Total pot $0.17 | Rake $0.01 
Board [3s Jc 5h 2s]
Seat 1: kervyrx7 folded before Flop (didn't bet)
Seat 2: Hemmi191 folded on the Turn
Seat 3: rich1717 (button) collected ($0.16)
Seat 5: CashMatteo (small blind) folded before Flop
Seat 6: stugatz1948 (big blind) folded on the Turn

Hand #986: 

PokerStars Hand #246358404892:  Hold'em No Limit ($0.02/$0.05 CAD) - 2023/10/05 0:45:30 ET
Table 'Geographos' 6-max Seat #5 is the button
Seat 1: kervyrx7 ($5 in chips) 
Seat 2: Hemmi191 ($2.66 in chips) 
Seat 3: rich1717 ($2.10 in chips) 
Seat 5: CashMatteo ($7.33 in chips) 
Seat 6: stugatz1948 ($6.66 in chips) 
stugatz1948: posts small blind $0.02
kervyrx7: posts big blind $0.05
*** HOLE CARDS ***
Dealt to CashMatteo [6h 9d]
Hemmi191: calls $0.05
rich1717: folds 
CashMatteo: folds 
stugatz1948: folds 
kervyrx7: checks 
*** FLOP *** [5s 9s Kd]
kervyrx7: checks 
Hemmi191: bets $0.12
kervyrx7: folds 
Uncalled bet ($0.12) returned to Hemmi191
Hemmi191 collected $0.12 from pot
*** SUMMARY ***
Total pot $0.12 | Rake $0 
Board [5s 9s Kd]
Seat 1: kervyrx7 (big blind) folded on the Flop
Seat 2: Hemmi191 collected ($0.12)
Seat 3: rich1717 folded before Flop (didn't bet)
Seat 5: CashMatteo (button) folded before Flop (didn't bet)
Seat 6: stugatz1948 (small blind) folded before Flop

Hand #987: 

PokerStars Hand #246358407195:  Hold'em No Limit ($0.02/$0.05 CAD) - 2023/10/05 0:45:51 ET
Table 'Geographos' 6-max Seat #6 is the button
Seat 1: kervyrx7 ($5 in chips) 
Seat 2: Hemmi191 ($2.73 in chips) 
Seat 3: rich1717 ($2.10 in chips) 
Seat 5: CashMatteo ($7.33 in chips) 
Seat 6: stugatz1948 ($6.64 in chips) 
kervyrx7: posts small blind $0.02
Hemmi191: posts big blind $0.05
*** HOLE CARDS ***
Dealt to CashMatteo [7c 8c]
rich1717: calls $0.05
CashMatteo: calls $0.05
stugatz1948: folds 
kervyrx7: calls $0.03
Hemmi191: checks 
*** FLOP *** [Qd 9c 9h]
kervyrx7: bets $0.11
tarvis77 joins the table at seat #4 
Hemmi191: folds 
rich1717: calls $0.11
CashMatteo: folds 
*** TURN *** [Qd 9c 9h] [Jd]
kervyrx7: checks 
rich1717: bets $0.05
kervyrx7: calls $0.05
*** RIVER *** [Qd 9c 9h Jd] [3s]
kervyrx7: checks 
rich1717: bets $0.15
kervyrx7: calls $0.15
*** SHOW DOWN ***
rich1717: shows [Js Qc] (two pair, Queens and Jacks)
kervyrx7: shows [Qs Jc] (two pair, Queens and Jacks)
kervyrx7 collected $0.40 from pot
rich1717 collected $0.39 from pot
*** SUMMARY ***
Total pot $0.82 | Rake $0.03 
Board [Qd 9c 9h Jd 3s]
Seat 1: kervyrx7 (small blind) showed [Qs Jc] and won ($0.40) with two pair, Queens and Jacks
Seat 2: Hemmi191 (big blind) folded on the Flop
Seat 3: rich1717 showed [Js Qc] and won ($0.39) with two pair, Queens and Jacks
Seat 5: CashMatteo folded on the Flop
Seat 6: stugatz1948 (button) folded before Flop (didn't bet)

Hand #988: 

PokerStars Hand #246358415640:  Hold'em No Limit ($0.02/$0.05 CAD) - 2023/10/05 0:47:11 ET
Table 'Geographos' 6-max Seat #1 is the button
Seat 1: kervyrx7 ($5.04 in chips) 
Seat 2: Hemmi191 ($2.68 in chips) 
Seat 3: rich1717 ($2.13 in chips) 
Seat 4: tarvis77 ($4 in chips) 
Seat 5: CashMatteo ($7.28 in chips) 
Seat 6: stugatz1948 ($6.64 in chips) 
Hemmi191: posts small blind $0.02
rich1717: posts big blind $0.05
tarvis77: posts big blind $0.05
*** HOLE CARDS ***
Dealt to CashMatteo [7h 4c]
tarvis77: checks 
CashMatteo: folds 
stugatz1948: folds 
kervyrx7: raises $0.15 to $0.20
Hemmi191: calls $0.18
rich1717: folds 
tarvis77: calls $0.15
*** FLOP *** [9h Jh 5h]
Hemmi191: checks 
tarvis77: checks 
kervyrx7: bets $0.37
Hemmi191: folds 
tarvis77: folds 
Uncalled bet ($0.37) returned to kervyrx7
kervyrx7 collected $0.62 from pot
kervyrx7: doesn't show hand 
*** SUMMARY ***
Total pot $0.65 | Rake $0.03 
Board [9h Jh 5h]
Seat 1: kervyrx7 (button) collected ($0.62)
Seat 2: Hemmi191 (small blind) folded on the Flop
Seat 3: rich1717 (big blind) folded before Flop
Seat 4: tarvis77 folded on the Flop
Seat 5: CashMatteo folded before Flop (didn't bet)
Seat 6: stugatz1948 folded before Flop (didn't bet)

Hand #989: 

PokerStars Hand #246358420087:  Hold'em No Limit ($0.02/$0.05 CAD) - 2023/10/05 0:47:52 ET
Table 'Geographos' 6-max Seat #2 is the button
Seat 1: kervyrx7 ($5.46 in chips) 
Seat 2: Hemmi191 ($2.48 in chips) 
Seat 3: rich1717 ($2.08 in chips) 
Seat 4: tarvis77 ($3.80 in chips) 
Seat 5: CashMatteo ($7.28 in chips) 
Seat 6: stugatz1948 ($6.64 in chips) 
rich1717: posts small blind $0.02
tarvis77: posts big blind $0.05
*** HOLE CARDS ***
Dealt to CashMatteo [7h 9c]
CashMatteo: folds 
CashMatteo leaves the table
stugatz1948: folds 
kervyrx7: folds 
Hemmi191: calls $0.05
rich1717: calls $0.03
tarvis77: checks 
*** FLOP *** [Js 6d 3s]
rich1717: checks 
tarvis77: checks 
Hemmi191: checks 
*** TURN *** [Js 6d 3s] [3d]
rich1717: checks 
tarvis77: checks 
Hemmi191: checks 
*** RIVER *** [Js 6d 3s 3d] [Jc]
rich1717: checks 
tarvis77: checks 
Hemmi191: bets $0.05
rich1717: folds 
tarvis77: folds 
Uncalled bet ($0.05) returned to Hemmi191
Hemmi191 collected $0.14 from pot
*** SUMMARY ***
Total pot $0.15 | Rake $0.01 
Board [Js 6d 3s 3d Jc]
Seat 1: kervyrx7 folded before Flop (didn't bet)
Seat 2: Hemmi191 (button) collected ($0.14)
Seat 3: rich1717 (small blind) folded on the River
Seat 4: tarvis77 (big blind) folded on the River
Seat 5: CashMatteo folded before Flop (didn't bet)
Seat 6: stugatz1948 folded before Flop (didn't bet)

Hand #990: 

PokerStars Hand #246358443692: Tournament #3653119701, $1.88+$0.12 CAD Hold'em No Limit - Level III (30/60) - 2023/10/05 0:51:35 ET
Table '3653119701 5' 6-max Seat #5 is the button
Seat 1: BurningNN (3467 in chips) 
Seat 2: CashMatteo (3000 in chips) 
Seat 3: Madehand1987 (2990 in chips) 
Seat 4: 1981Travis1981 (3492 in chips) 
Seat 5: brownshope (1888 in chips) 
Seat 6: avancal (2522 in chips) 
BurningNN: posts the ante 15
CashMatteo: posts the ante 15
Madehand1987: posts the ante 15
1981Travis1981: posts the ante 15
brownshope: posts the ante 15
avancal: posts the ante 15
avancal: posts small blind 30
BurningNN: posts big blind 60
*** HOLE CARDS ***
Dealt to CashMatteo [6s As]
CashMatteo: raises 90 to 150
Madehand1987: folds 
1981Travis1981: calls 150
brownshope: calls 150
avancal: folds 
BurningNN: calls 90
*** FLOP *** [6d 9c 8h]
BurningNN: checks 
CashMatteo: checks 
1981Travis1981: bets 300
brownshope: raises 300 to 600
BurningNN: folds 
CashMatteo: folds 
1981Travis1981: calls 300
*** TURN *** [6d 9c 8h] [2d]
1981Travis1981: checks 
brownshope: bets 300
1981Travis1981: raises 2427 to 2727 and is all-in
brownshope: calls 823 and is all-in
Uncalled bet (1604) returned to 1981Travis1981
*** RIVER *** [6d 9c 8h 2d] [Qh]
*** SHOW DOWN ***
1981Travis1981: shows [8d Tc] (a pair of Eights)
brownshope: shows [7d 8s] (a pair of Eights - lower kicker)
1981Travis1981 collected 4166 from pot
brownshope finished the tournament in 66th place
*** SUMMARY ***
Total pot 4166 | Rake 0 
Board [6d 9c 8h 2d Qh]
Seat 1: BurningNN (big blind) folded on the Flop
Seat 2: CashMatteo folded on the Flop
Seat 3: Madehand1987 folded before Flop (didn't bet)
Seat 4: 1981Travis1981 showed [8d Tc] and won (4166) with a pair of Eights
Seat 5: brownshope (button) showed [7d 8s] and lost with a pair of Eights
Seat 6: avancal (small blind) folded before Flop

Hand #991: 

PokerStars Hand #246358452346: Tournament #3653119701, $1.88+$0.12 CAD Hold'em No Limit - Level III (30/60) - 2023/10/05 0:53:00 ET
Table '3653119701 5' 6-max Seat #6 is the button
Seat 1: BurningNN (3302 in chips) 
Seat 2: CashMatteo (2835 in chips) 
Seat 3: Madehand1987 (2975 in chips) 
Seat 4: 1981Travis1981 (5770 in chips) 
Seat 6: avancal (2477 in chips) 
BurningNN: posts the ante 15
CashMatteo: posts the ante 15
Madehand1987: posts the ante 15
1981Travis1981: posts the ante 15
avancal: posts the ante 15
BurningNN: posts small blind 30
CashMatteo: posts big blind 60
*** HOLE CARDS ***
Dealt to CashMatteo [2d 8d]
Madehand1987: raises 225 to 285
1981Travis1981: calls 285
avancal: calls 285
BurningNN: calls 255
CashMatteo: folds 
*** FLOP *** [8h Kc 4d]
BurningNN: checks 
Madehand1987: checks 
1981Travis1981: bets 300
avancal: calls 300
BurningNN: folds 
Madehand1987: folds 
*** TURN *** [8h Kc 4d] [6h]
1981Travis1981: bets 938
avancal: folds 
Uncalled bet (938) returned to 1981Travis1981
1981Travis1981 collected 1875 from pot
*** SUMMARY ***
Total pot 1875 | Rake 0 
Board [8h Kc 4d 6h]
Seat 1: BurningNN (small blind) folded on the Flop
Seat 2: CashMatteo (big blind) folded before Flop
Seat 3: Madehand1987 folded on the Flop
Seat 4: 1981Travis1981 collected (1875)
Seat 6: avancal (button) folded on the Turn

Hand #992: 

PokerStars Hand #246358457807: Tournament #3653119701, $1.88+$0.12 CAD Hold'em No Limit - Level III (30/60) - 2023/10/05 0:53:54 ET
Table '3653119701 5' 6-max Seat #1 is the button
Seat 1: BurningNN (3002 in chips) 
Seat 2: CashMatteo (2760 in chips) 
Seat 3: Madehand1987 (2675 in chips) 
Seat 4: 1981Travis1981 (7045 in chips) 
Seat 6: avancal (1877 in chips) 
BurningNN: posts the ante 15
CashMatteo: posts the ante 15
Madehand1987: posts the ante 15
1981Travis1981: posts the ante 15
avancal: posts the ante 15
CashMatteo: posts small blind 30
Madehand1987: posts big blind 60
*** HOLE CARDS ***
Dealt to CashMatteo [8h Ks]
1981Travis1981: calls 60
avancal: folds 
BurningNN: folds 
CashMatteo: calls 30
Madehand1987: checks 
*** FLOP *** [5d Qc Qs]
CashMatteo: checks 
Madehand1987: checks 
1981Travis1981: checks 
*** TURN *** [5d Qc Qs] [9h]
CashMatteo: checks 
Madehand1987: checks 
1981Travis1981: checks 
*** RIVER *** [5d Qc Qs 9h] [Jh]
CashMatteo: checks 
Madehand1987: bets 120
1981Travis1981: folds 
CashMatteo: folds 
Uncalled bet (120) returned to Madehand1987
Madehand1987 collected 255 from pot
Madehand1987: doesn't show hand 
*** SUMMARY ***
Total pot 255 | Rake 0 
Board [5d Qc Qs 9h Jh]
Seat 1: BurningNN (button) folded before Flop (didn't bet)
Seat 2: CashMatteo (small blind) folded on the River
Seat 3: Madehand1987 (big blind) collected (255)
Seat 4: 1981Travis1981 folded on the River
Seat 6: avancal folded before Flop (didn't bet)

Hand #993: 

PokerStars Hand #246358465612: Tournament #3653119701, $1.88+$0.12 CAD Hold'em No Limit - Level IV (40/80) - 2023/10/05 0:55:12 ET
Table '3653119701 5' 6-max Seat #2 is the button
Seat 1: BurningNN (2987 in chips) 
Seat 2: CashMatteo (2685 in chips) 
Seat 3: Madehand1987 (2855 in chips) 
Seat 4: 1981Travis1981 (6970 in chips) 
Seat 6: avancal (1862 in chips) 
BurningNN: posts the ante 20
CashMatteo: posts the ante 20
Madehand1987: posts the ante 20
1981Travis1981: posts the ante 20
avancal: posts the ante 20
Madehand1987: posts small blind 40
1981Travis1981: posts big blind 80
*** HOLE CARDS ***
Dealt to CashMatteo [Qd Kh]
avancal: folds 
BurningNN: raises 120 to 200
CashMatteo: calls 200
Madehand1987: folds 
1981Travis1981: folds 
*** FLOP *** [2d 8s 7h]
BurningNN: bets 205
CashMatteo: calls 205
*** TURN *** [2d 8s 7h] [6d]
BurningNN: checks 
CashMatteo: bets 515
BurningNN: calls 515
*** RIVER *** [2d 8s 7h 6d] [Ah]
BurningNN: checks 
CashMatteo: checks 
*** SHOW DOWN ***
BurningNN: shows [Qs Qh] (a pair of Queens)
CashMatteo: mucks hand 
BurningNN collected 2060 from pot
*** SUMMARY ***
Total pot 2060 | Rake 0 
Board [2d 8s 7h 6d Ah]
Seat 1: BurningNN showed [Qs Qh] and won (2060) with a pair of Queens
Seat 2: CashMatteo (button) mucked [Qd Kh]
Seat 3: Madehand1987 (small blind) folded before Flop
Seat 4: 1981Travis1981 (big blind) folded before Flop
Seat 6: avancal folded before Flop (didn't bet)

Hand #994: 

PokerStars Hand #246358497107: Tournament #3653119701, $1.88+$0.12 CAD Hold'em No Limit - Level IV (40/80) - 2023/10/05 1:01:08 ET
Table '3653119701 5' 6-max Seat #4 is the button
Seat 1: BurningNN (4107 in chips) 
Seat 2: CashMatteo (1745 in chips) 
Seat 4: 1981Travis1981 (6870 in chips) is sitting out
Seat 5: Bhandsome69 (3000 in chips) out of hand (moved from another table into small blind)
Seat 6: Ookpik1969 (3000 in chips) out of hand (moved from another table into small blind)
Bhandsome69 will be allowed to play after the button
Ookpik1969 will be allowed to play after the button
BurningNN: posts the ante 20
CashMatteo: posts the ante 20
1981Travis1981: posts the ante 20
BurningNN: posts small blind 40
CashMatteo: posts big blind 80
*** HOLE CARDS ***
Dealt to CashMatteo [4d Tc]
1981Travis1981: folds 
BurningNN: raises 120 to 200
CashMatteo: folds 
Uncalled bet (120) returned to BurningNN
BurningNN collected 220 from pot
BurningNN: doesn't show hand 
*** SUMMARY ***
Total pot 220 | Rake 0 
Seat 1: BurningNN (small blind) collected (220)
Seat 2: CashMatteo (big blind) folded before Flop
Seat 4: 1981Travis1981 (button) folded before Flop (didn't bet)

Hand #995: 

PokerStars Hand #246358498363: Tournament #3653119701, $1.88+$0.12 CAD Hold'em No Limit - Level IV (40/80) - 2023/10/05 1:01:20 ET
Table '3653119701 5' 6-max Seat #1 is the button
Seat 1: BurningNN (4227 in chips) 
Seat 2: CashMatteo (1645 in chips) 
Seat 4: 1981Travis1981 (6850 in chips) is sitting out
Seat 5: Bhandsome69 (3000 in chips) 
Seat 6: Ookpik1969 (3000 in chips) 
BurningNN: posts the ante 20
CashMatteo: posts the ante 20
1981Travis1981: posts the ante 20
Bhandsome69: posts the ante 20
Ookpik1969: posts the ante 20
CashMatteo: posts small blind 40
1981Travis1981: posts big blind 80
*** HOLE CARDS ***
Dealt to CashMatteo [2s Tc]
Bhandsome69: folds 
Ookpik1969: raises 160 to 240
BurningNN: folds 
CashMatteo is disconnected 
CashMatteo is connected 
CashMatteo is connected 
CashMatteo has timed out
CashMatteo: folds 
CashMatteo is sitting out
1981Travis1981: folds 
Uncalled bet (160) returned to Ookpik1969
Ookpik1969 collected 300 from pot
Ookpik1969: doesn't show hand 
*** SUMMARY ***
Total pot 300 | Rake 0 
Seat 1: BurningNN (button) folded before Flop (didn't bet)
Seat 2: CashMatteo (small blind) folded before Flop
Seat 4: 1981Travis1981 (big blind) folded before Flop
Seat 5: Bhandsome69 folded before Flop (didn't bet)
Seat 6: Ookpik1969 collected (300)

Hand #996: 

PokerStars Hand #246358503977: Tournament #3653119701, $1.88+$0.12 CAD Hold'em No Limit - Level IV (40/80) - 2023/10/05 1:02:18 ET
Table '3653119701 5' 6-max Seat #2 is the button
Seat 1: BurningNN (4207 in chips) 
Seat 2: CashMatteo (1585 in chips) is sitting out
Seat 4: 1981Travis1981 (6750 in chips) is sitting out
Seat 5: Bhandsome69 (2980 in chips) 
Seat 6: Ookpik1969 (3200 in chips) 
BurningNN: posts the ante 20
CashMatteo: posts the ante 20
1981Travis1981: posts the ante 20
Bhandsome69: posts the ante 20
Ookpik1969: posts the ante 20
1981Travis1981: posts small blind 40
Bhandsome69: posts big blind 80
*** HOLE CARDS ***
Dealt to CashMatteo [6d 7h]
Ookpik1969: raises 80 to 160
BurningNN: folds 
CashMatteo: folds 
1981Travis1981: folds 
Bhandsome69: calls 80
*** FLOP *** [4h 2d 5c]
CashMatteo has returned
Bhandsome69: checks 
Ookpik1969: bets 320
Bhandsome69: folds 
Uncalled bet (320) returned to Ookpik1969
Ookpik1969 collected 460 from pot
Ookpik1969: doesn't show hand 
*** SUMMARY ***
Total pot 460 | Rake 0 
Board [4h 2d 5c]
Seat 1: BurningNN folded before Flop (didn't bet)
Seat 2: CashMatteo (button) folded before Flop (didn't bet)
Seat 4: 1981Travis1981 (small blind) folded before Flop
Seat 5: Bhandsome69 (big blind) folded on the Flop
Seat 6: Ookpik1969 collected (460)

Hand #997: 

PokerStars Hand #246358505813: Tournament #3653119701, $1.88+$0.12 CAD Hold'em No Limit - Level IV (40/80) - 2023/10/05 1:02:37 ET
Table '3653119701 5' 6-max Seat #4 is the button
Seat 1: BurningNN (4187 in chips) 
Seat 2: CashMatteo (1565 in chips) 
Seat 4: 1981Travis1981 (6690 in chips) is sitting out
Seat 5: Bhandsome69 (2800 in chips) 
Seat 6: Ookpik1969 (3480 in chips) 
BurningNN: posts the ante 20
CashMatteo: posts the ante 20
1981Travis1981: posts the ante 20
Bhandsome69: posts the ante 20
Ookpik1969: posts the ante 20
Bhandsome69: posts small blind 40
Ookpik1969: posts big blind 80
*** HOLE CARDS ***
Dealt to CashMatteo [8s 3s]
BurningNN: folds 
CashMatteo: folds 
1981Travis1981: folds 
Bhandsome69: calls 40
Ookpik1969: checks 
*** FLOP *** [Ah 8d 7s]
Bhandsome69: checks 
Ookpik1969: bets 320
Bhandsome69: folds 
Uncalled bet (320) returned to Ookpik1969
Ookpik1969 collected 260 from pot
Ookpik1969: doesn't show hand 
*** SUMMARY ***
Total pot 260 | Rake 0 
Board [Ah 8d 7s]
Seat 1: BurningNN folded before Flop (didn't bet)
Seat 2: CashMatteo folded before Flop (didn't bet)
Seat 4: 1981Travis1981 (button) folded before Flop (didn't bet)
Seat 5: Bhandsome69 (small blind) folded on the Flop
Seat 6: Ookpik1969 (big blind) collected (260)

Hand #998: 

PokerStars Hand #246358507661: Tournament #3653119701, $1.88+$0.12 CAD Hold'em No Limit - Level IV (40/80) - 2023/10/05 1:02:56 ET
Table '3653119701 5' 6-max Seat #5 is the button
Seat 1: BurningNN (4167 in chips) 
Seat 2: CashMatteo (1545 in chips) 
Seat 3: damohughjude (3000 in chips) 
Seat 4: 1981Travis1981 (6670 in chips) is sitting out
Seat 5: Bhandsome69 (2700 in chips) 
Seat 6: Ookpik1969 (3640 in chips) 
BurningNN: posts the ante 20
CashMatteo: posts the ante 20
damohughjude: posts the ante 20
1981Travis1981: posts the ante 20
Bhandsome69: posts the ante 20
Ookpik1969: posts the ante 20
Ookpik1969: posts small blind 40
BurningNN: posts big blind 80
*** HOLE CARDS ***
Dealt to CashMatteo [9d 5d]
CashMatteo: folds 
damohughjude: raises 80 to 160
1981Travis1981: folds 
Bhandsome69: calls 160
Ookpik1969: folds 
BurningNN: calls 80
*** FLOP *** [6c Jh 5c]
BurningNN: checks 
damohughjude: bets 640
Bhandsome69: folds 
BurningNN: folds 
Uncalled bet (640) returned to damohughjude
damohughjude collected 640 from pot
*** SUMMARY ***
Total pot 640 | Rake 0 
Board [6c Jh 5c]
Seat 1: BurningNN (big blind) folded on the Flop
Seat 2: CashMatteo folded before Flop (didn't bet)
Seat 3: damohughjude collected (640)
Seat 4: 1981Travis1981 folded before Flop (didn't bet)
Seat 5: Bhandsome69 (button) folded on the Flop
Seat 6: Ookpik1969 (small blind) folded before Flop

Hand #999: 

PokerStars Hand #246358509936: Tournament #3653119701, $1.88+$0.12 CAD Hold'em No Limit - Level V (50/100) - 2023/10/05 1:03:19 ET
Table '3653119701 5' 6-max Seat #6 is the button
Seat 1: BurningNN (3987 in chips) 
Seat 2: CashMatteo (1525 in chips) 
Seat 3: damohughjude (3460 in chips) 
Seat 4: 1981Travis1981 (6650 in chips) is sitting out
Seat 5: Bhandsome69 (2520 in chips) 
Seat 6: Ookpik1969 (3580 in chips) 
BurningNN: posts the ante 25
CashMatteo: posts the ante 25
damohughjude: posts the ante 25
1981Travis1981: posts the ante 25
Bhandsome69: posts the ante 25
Ookpik1969: posts the ante 25
BurningNN: posts small blind 50
CashMatteo: posts big blind 100
*** HOLE CARDS ***
Dealt to CashMatteo [3s 2s]
damohughjude: folds 
1981Travis1981: folds 
Bhandsome69: folds 
Ookpik1969: raises 200 to 300
BurningNN: folds 
CashMatteo: folds 
Uncalled bet (200) returned to Ookpik1969
Ookpik1969 collected 400 from pot
Ookpik1969: doesn't show hand 
*** SUMMARY ***
Total pot 400 | Rake 0 
Seat 1: BurningNN (small blind) folded before Flop
Seat 2: CashMatteo (big blind) folded before Flop
Seat 3: damohughjude folded before Flop (didn't bet)
Seat 4: 1981Travis1981 folded before Flop (didn't bet)
Seat 5: Bhandsome69 folded before Flop (didn't bet)
Seat 6: Ookpik1969 (button) collected (400)

Hand #1000: 

PokerStars Hand #246358511362: Tournament #3653119701, $1.88+$0.12 CAD Hold'em No Limit - Level V (50/100) - 2023/10/05 1:03:33 ET
Table '3653119701 5' 6-max Seat #1 is the button
Seat 1: BurningNN (3912 in chips) 
Seat 2: CashMatteo (1400 in chips) 
Seat 3: damohughjude (3435 in chips) 
Seat 4: 1981Travis1981 (6625 in chips) is sitting out
Seat 5: Bhandsome69 (2495 in chips) 
Seat 6: Ookpik1969 (3855 in chips) 
BurningNN: posts the ante 25
CashMatteo: posts the ante 25
damohughjude: posts the ante 25
1981Travis1981: posts the ante 25
Bhandsome69: posts the ante 25
Ookpik1969: posts the ante 25
CashMatteo: posts small blind 50
damohughjude: posts big blind 100
*** HOLE CARDS ***
Dealt to CashMatteo [As 5d]
1981Travis1981: folds 
Bhandsome69: calls 100
Ookpik1969: calls 100
BurningNN: folds 
CashMatteo: raises 150 to 250
damohughjude: calls 150
Bhandsome69: calls 150
Ookpik1969: calls 150
*** FLOP *** [Td Js Kh]
CashMatteo: checks 
damohughjude: bets 575
Bhandsome69: raises 575 to 1150
Ookpik1969: calls 1150
CashMatteo: calls 1125 and is all-in
damohughjude: calls 575
*** TURN *** [Td Js Kh] [5c]
damohughjude: bets 2010 and is all-in
Bhandsome69: calls 1070 and is all-in
Ookpik1969: folds 
Uncalled bet (940) returned to damohughjude
*** RIVER *** [Td Js Kh 5c] [Qh]
*** SHOW DOWN ***
damohughjude: shows [Jh Ts] (two pair, Jacks and Tens)
Bhandsome69: shows [Tc Qs] (two pair, Queens and Tens)
Bhandsome69 collected 2215 from side pot
CashMatteo: shows [As 5d] (a straight, Ten to Ace)
CashMatteo collected 5650 from main pot
*** SUMMARY ***
Total pot 7865 Main pot 5650. Side pot 2215. | Rake 0 
Board [Td Js Kh 5c Qh]
Seat 1: BurningNN (button) folded before Flop (didn't bet)
Seat 2: CashMatteo (small blind) showed [As 5d] and won (5650) with a straight, Ten to Ace
Seat 3: damohughjude (big blind) showed [Jh Ts] and lost with two pair, Jacks and Tens
Seat 4: 1981Travis1981 folded before Flop (didn't bet)
Seat 5: Bhandsome69 showed [Tc Qs] and won (2215) with two pair, Queens and Tens
Seat 6: Ookpik1969 folded on the Turn

Hand #1001: 

PokerStars Hand #246358515511: Tournament #3653119701, $1.88+$0.12 CAD Hold'em No Limit - Level V (50/100) - 2023/10/05 1:04:14 ET
Table '3653119701 5' 6-max Seat #2 is the button
Seat 1: BurningNN (3887 in chips) 
Seat 2: CashMatteo (5650 in chips) 
Seat 3: damohughjude (940 in chips) 
Seat 4: 1981Travis1981 (6600 in chips) is sitting out
Seat 5: Bhandsome69 (2215 in chips) 
Seat 6: Ookpik1969 (2430 in chips) 
BurningNN: posts the ante 25
CashMatteo: posts the ante 25
damohughjude: posts the ante 25
1981Travis1981: posts the ante 25
Bhandsome69: posts the ante 25
Ookpik1969: posts the ante 25
damohughjude: posts small blind 50
1981Travis1981: posts big blind 100
*** HOLE CARDS ***
Dealt to CashMatteo [Kd 4d]
Bhandsome69: folds 
Ookpik1969: raises 200 to 300
BurningNN: folds 
CashMatteo: folds 
damohughjude: calls 250
1981Travis1981: folds 
*** FLOP *** [As 7c 7h]
damohughjude: checks 
Ookpik1969: bets 2105 and is all-in
damohughjude: folds 
Uncalled bet (2105) returned to Ookpik1969
Ookpik1969 collected 850 from pot
Ookpik1969: doesn't show hand 
*** SUMMARY ***
Total pot 850 | Rake 0 
Board [As 7c 7h]
Seat 1: BurningNN folded before Flop (didn't bet)
Seat 2: CashMatteo (button) folded before Flop (didn't bet)
Seat 3: damohughjude (small blind) folded on the Flop
Seat 4: 1981Travis1981 (big blind) folded before Flop
Seat 5: Bhandsome69 folded before Flop (didn't bet)
Seat 6: Ookpik1969 collected (850)

Hand #1002: 

PokerStars Hand #246358517632: Tournament #3653119701, $1.88+$0.12 CAD Hold'em No Limit - Level V (50/100) - 2023/10/05 1:04:36 ET
Table '3653119701 5' 6-max Seat #3 is the button
Seat 1: BurningNN (3862 in chips) 
Seat 2: CashMatteo (5625 in chips) 
Seat 3: damohughjude (615 in chips) 
Seat 4: 1981Travis1981 (6475 in chips) is sitting out
Seat 5: Bhandsome69 (2190 in chips) 
Seat 6: Ookpik1969 (2955 in chips) 
BurningNN: posts the ante 25
CashMatteo: posts the ante 25
damohughjude: posts the ante 25
1981Travis1981: posts the ante 25
Bhandsome69: posts the ante 25
Ookpik1969: posts the ante 25
1981Travis1981: posts small blind 50
Bhandsome69: posts big blind 100
*** HOLE CARDS ***
Dealt to CashMatteo [6s 2c]
Ookpik1969: folds 
BurningNN: raises 150 to 250
CashMatteo: folds 
damohughjude: calls 250
1981Travis1981: folds 
Bhandsome69: raises 1915 to 2165 and is all-in
BurningNN: calls 1915
damohughjude: calls 340 and is all-in
*** FLOP *** [8h 4d Kh]
*** TURN *** [8h 4d Kh] [Tc]
*** RIVER *** [8h 4d Kh Tc] [As]
*** SHOW DOWN ***
Bhandsome69: shows [7s 7c] (a pair of Sevens)
BurningNN: shows [6h 6c] (a pair of Sixes)
Bhandsome69 collected 3150 from side pot
damohughjude: shows [9h Ks] (a pair of Kings)
damohughjude collected 1970 from main pot
*** SUMMARY ***
Total pot 5120 Main pot 1970. Side pot 3150. | Rake 0 
Board [8h 4d Kh Tc As]
Seat 1: BurningNN showed [6h 6c] and lost with a pair of Sixes
Seat 2: CashMatteo folded before Flop (didn't bet)
Seat 3: damohughjude (button) showed [9h Ks] and won (1970) with a pair of Kings
Seat 4: 1981Travis1981 (small blind) folded before Flop
Seat 5: Bhandsome69 (big blind) showed [7s 7c] and won (3150) with a pair of Sevens
Seat 6: Ookpik1969 folded before Flop (didn't bet)

Hand #1003: 

PokerStars Hand #246358520617: Tournament #3653119701, $1.88+$0.12 CAD Hold'em No Limit - Level V (50/100) - 2023/10/05 1:05:05 ET
Table '3653119701 5' 6-max Seat #4 is the button
Seat 1: BurningNN (1672 in chips) 
Seat 2: CashMatteo (5600 in chips) 
Seat 3: damohughjude (1970 in chips) 
Seat 4: 1981Travis1981 (6400 in chips) is sitting out
Seat 5: Bhandsome69 (3150 in chips) 
Seat 6: Ookpik1969 (2930 in chips) 
BurningNN: posts the ante 25
CashMatteo: posts the ante 25
damohughjude: posts the ante 25
1981Travis1981: posts the ante 25
Bhandsome69: posts the ante 25
Ookpik1969: posts the ante 25
Bhandsome69: posts small blind 50
Ookpik1969: posts big blind 100
*** HOLE CARDS ***
Dealt to CashMatteo [4s 8h]
BurningNN: folds 
CashMatteo: folds 
damohughjude: raises 200 to 300
1981Travis1981: folds 
Bhandsome69: folds 
Ookpik1969: raises 2605 to 2905 and is all-in
damohughjude: calls 1645 and is all-in
Uncalled bet (960) returned to Ookpik1969
*** FLOP *** [2h 3h 3s]
*** TURN *** [2h 3h 3s] [Ad]
*** RIVER *** [2h 3h 3s Ad] [4d]
*** SHOW DOWN ***
Ookpik1969: shows [Ks Kc] (two pair, Kings and Threes)
damohughjude: shows [Qc Td] (a pair of Threes)
Ookpik1969 collected 4090 from pot
damohughjude finished the tournament in 56th place
*** SUMMARY ***
Total pot 4090 | Rake 0 
Board [2h 3h 3s Ad 4d]
Seat 1: BurningNN folded before Flop (didn't bet)
Seat 2: CashMatteo folded before Flop (didn't bet)
Seat 3: damohughjude showed [Qc Td] and lost with a pair of Threes
Seat 4: 1981Travis1981 (button) folded before Flop (didn't bet)
Seat 5: Bhandsome69 (small blind) folded before Flop
Seat 6: Ookpik1969 (big blind) showed [Ks Kc] and won (4090) with two pair, Kings and Threes

Hand #1004: 

PokerStars Hand #246358522733: Tournament #3653119701, $1.88+$0.12 CAD Hold'em No Limit - Level V (50/100) - 2023/10/05 1:05:26 ET
Table '3653119701 5' 6-max Seat #5 is the button
Seat 1: BurningNN (1647 in chips) 
Seat 2: CashMatteo (5575 in chips) 
Seat 4: 1981Travis1981 (6375 in chips) is sitting out
Seat 5: Bhandsome69 (3075 in chips) 
Seat 6: Ookpik1969 (5050 in chips) 
BurningNN: posts the ante 25
CashMatteo: posts the ante 25
1981Travis1981: posts the ante 25
Bhandsome69: posts the ante 25
Ookpik1969: posts the ante 25
Ookpik1969: posts small blind 50
BurningNN: posts big blind 100
*** HOLE CARDS ***
Dealt to CashMatteo [4c 5c]
CashMatteo: folds 
1981Travis1981: folds 
Bhandsome69: folds 
Ookpik1969: folds 
Uncalled bet (50) returned to BurningNN
BurningNN collected 225 from pot
BurningNN: doesn't show hand 
*** SUMMARY ***
Total pot 225 | Rake 0 
Seat 1: BurningNN (big blind) collected (225)
Seat 2: CashMatteo folded before Flop (didn't bet)
Seat 4: 1981Travis1981 folded before Flop (didn't bet)
Seat 5: Bhandsome69 (button) folded before Flop (didn't bet)
Seat 6: Ookpik1969 (small blind) folded before Flop

Hand #1005: 

PokerStars Hand #246358526243: Tournament #3653119701, $1.88+$0.12 CAD Hold'em No Limit - Level V (50/100) - 2023/10/05 1:06:01 ET
Table '3653119701 5' 6-max Seat #6 is the button
Seat 1: BurningNN (1797 in chips) 
Seat 2: CashMatteo (5550 in chips) 
Seat 4: 1981Travis1981 (6350 in chips) is sitting out
Seat 5: Bhandsome69 (3050 in chips) 
Seat 6: Ookpik1969 (4975 in chips) 
BurningNN: posts the ante 25
CashMatteo: posts the ante 25
1981Travis1981: posts the ante 25
Bhandsome69: posts the ante 25
Ookpik1969: posts the ante 25
BurningNN: posts small blind 50
CashMatteo: posts big blind 100
*** HOLE CARDS ***
Dealt to CashMatteo [9d Th]
1981Travis1981: folds 
Bhandsome69: calls 100
Ookpik1969: folds 
1981Travis1981 has returned
BurningNN: raises 1672 to 1772 and is all-in
CashMatteo: folds 
Bhandsome69: calls 1672
*** FLOP *** [6c Qc 8h]
*** TURN *** [6c Qc 8h] [2d]
*** RIVER *** [6c Qc 8h 2d] [4c]
*** SHOW DOWN ***
BurningNN: shows [Ad Qs] (a pair of Queens)
Bhandsome69: shows [As 2s] (a pair of Deuces)
BurningNN collected 3769 from pot
*** SUMMARY ***
Total pot 3769 | Rake 0 
Board [6c Qc 8h 2d 4c]
Seat 1: BurningNN (small blind) showed [Ad Qs] and won (3769) with a pair of Queens
Seat 2: CashMatteo (big blind) folded before Flop
Seat 4: 1981Travis1981 folded before Flop (didn't bet)
Seat 5: Bhandsome69 showed [As 2s] and lost with a pair of Deuces
Seat 6: Ookpik1969 (button) folded before Flop (didn't bet)

Hand #1006: 

PokerStars Hand #246358528654: Tournament #3653119701, $1.88+$0.12 CAD Hold'em No Limit - Level VI (60/120) - 2023/10/05 1:06:25 ET
Table '3653119701 5' 6-max Seat #1 is the button
Seat 1: BurningNN (3769 in chips) 
Seat 2: CashMatteo (5425 in chips) 
Seat 3: BlackandRed666 (3000 in chips) 
Seat 4: 1981Travis1981 (6325 in chips) 
Seat 5: Bhandsome69 (1253 in chips) 
Seat 6: Ookpik1969 (4950 in chips) 
BurningNN: posts the ante 30
CashMatteo: posts the ante 30
BlackandRed666: posts the ante 30
1981Travis1981: posts the ante 30
Bhandsome69: posts the ante 30
Ookpik1969: posts the ante 30
CashMatteo: posts small blind 60
BlackandRed666: posts big blind 120
*** HOLE CARDS ***
Dealt to CashMatteo [7c 5c]
1981Travis1981: calls 120
Bhandsome69: raises 240 to 360
Ookpik1969: folds 
BurningNN: folds 
CashMatteo: folds 
BlackandRed666: calls 240
1981Travis1981: raises 5935 to 6295 and is all-in
Bhandsome69: calls 863 and is all-in
BlackandRed666: calls 2610 and is all-in
Uncalled bet (3325) returned to 1981Travis1981
*** FLOP *** [8c Kc Ts]
*** TURN *** [8c Kc Ts] [6s]
*** RIVER *** [8c Kc Ts 6s] [6c]
*** SHOW DOWN ***
BlackandRed666: shows [Ac 3d] (a pair of Sixes)
1981Travis1981: shows [Th Td] (a full house, Tens full of Sixes)
1981Travis1981 collected 3494 from side pot
Bhandsome69: shows [Ah Jd] (a pair of Sixes)
1981Travis1981 collected 3909 from main pot
BlackandRed666 finished the tournament in 50th place
Bhandsome69 finished the tournament in 51st place
flushmedown is disconnected 
*** SUMMARY ***
Total pot 7403 Main pot 3909. Side pot 3494. | Rake 0 
Board [8c Kc Ts 6s 6c]
Seat 1: BurningNN (button) folded before Flop (didn't bet)
Seat 2: CashMatteo (small blind) folded before Flop
Seat 3: BlackandRed666 (big blind) showed [Ac 3d] and lost with a pair of Sixes
Seat 4: 1981Travis1981 showed [Th Td] and won (7403) with a full house, Tens full of Sixes
Seat 5: Bhandsome69 showed [Ah Jd] and lost with a pair of Sixes
Seat 6: Ookpik1969 folded before Flop (didn't bet)

Hand #1007: 

PokerStars Hand #246358532486: Tournament #3653119701, $1.88+$0.12 CAD Hold'em No Limit - Level VI (60/120) - 2023/10/05 1:07:03 ET
Table '3653119701 5' 6-max Seat #2 is the button
Seat 1: BurningNN (3739 in chips) 
Seat 2: CashMatteo (5335 in chips) 
Seat 4: 1981Travis1981 (10728 in chips) 
Seat 5: flushmedown (3000 in chips) 
Seat 6: Ookpik1969 (4920 in chips) 
BurningNN: posts the ante 30
CashMatteo: posts the ante 30
1981Travis1981: posts the ante 30
flushmedown: posts the ante 30
Ookpik1969: posts the ante 30
1981Travis1981: posts small blind 60
flushmedown: posts big blind 120
*** HOLE CARDS ***
Dealt to CashMatteo [Qh 9c]
Ookpik1969: folds 
BurningNN: raises 180 to 300
CashMatteo: calls 300
1981Travis1981: raises 180 to 480
flushmedown: folds 
BurningNN: calls 180
CashMatteo: calls 180
*** FLOP *** [4c 7s 5d]
1981Travis1981: bets 360
BurningNN: calls 360
CashMatteo: folds 
*** TURN *** [4c 7s 5d] [7h]
1981Travis1981: bets 600
BurningNN: calls 600
*** RIVER *** [4c 7s 5d 7h] [Th]
1981Travis1981: bets 1080
BurningNN: calls 1080
*** SHOW DOWN ***
1981Travis1981: shows [Qc Qd] (two pair, Queens and Sevens)
BurningNN: mucks hand 
1981Travis1981 collected 5790 from pot
*** SUMMARY ***
Total pot 5790 | Rake 0 
Board [4c 7s 5d 7h Th]
Seat 1: BurningNN mucked [9h Ah]
Seat 2: CashMatteo (button) folded on the Flop
Seat 4: 1981Travis1981 (small blind) showed [Qc Qd] and won (5790) with two pair, Queens and Sevens
Seat 5: flushmedown (big blind) folded before Flop
Seat 6: Ookpik1969 folded before Flop (didn't bet)

Hand #1008: 

PokerStars Hand #246358539384: Tournament #3653119701, $1.88+$0.12 CAD Hold'em No Limit - Level VI (60/120) - 2023/10/05 1:08:12 ET
Table '3653119701 5' 6-max Seat #4 is the button
Seat 1: BurningNN (1189 in chips) 
Seat 2: CashMatteo (4825 in chips) 
Seat 4: 1981Travis1981 (13968 in chips) 
Seat 5: flushmedown (2850 in chips) 
Seat 6: Ookpik1969 (4890 in chips) 
BurningNN: posts the ante 30
CashMatteo: posts the ante 30
1981Travis1981: posts the ante 30
flushmedown: posts the ante 30
Ookpik1969: posts the ante 30
flushmedown: posts small blind 60
Ookpik1969: posts big blind 120
*** HOLE CARDS ***
Dealt to CashMatteo [6h 8s]
BurningNN: folds 
CashMatteo: folds 
1981Travis1981: calls 120
flushmedown: calls 60
Ookpik1969: raises 240 to 360
1981Travis1981: calls 240
flushmedown: calls 240
*** FLOP *** [7d 6d Kh]
flushmedown: bets 615
Ookpik1969: raises 1065 to 1680
1981Travis1981 has timed out
1981Travis1981: folds 
1981Travis1981 is sitting out
flushmedown: calls 1065
*** TURN *** [7d 6d Kh] [3d]
flushmedown: bets 780 and is all-in
Ookpik1969: calls 780
*** RIVER *** [7d 6d Kh 3d] [As]
1981Travis1981 has returned
*** SHOW DOWN ***
flushmedown: shows [Ah 7c] (two pair, Aces and Sevens)
Ookpik1969: shows [Ks 8d] (a pair of Kings)
flushmedown collected 6150 from pot
*** SUMMARY ***
Total pot 6150 | Rake 0 
Board [7d 6d Kh 3d As]
Seat 1: BurningNN folded before Flop (didn't bet)
Seat 2: CashMatteo folded before Flop (didn't bet)
Seat 4: 1981Travis1981 (button) folded on the Flop
Seat 5: flushmedown (small blind) showed [Ah 7c] and won (6150) with two pair, Aces and Sevens
Seat 6: Ookpik1969 (big blind) showed [Ks 8d] and lost with a pair of Kings

Hand #1009: 

PokerStars Hand #246358551241: Tournament #3653119701, $1.88+$0.12 CAD Hold'em No Limit - Level VII (80/160) - 2023/10/05 1:10:11 ET
Table '3653119701 5' 6-max Seat #5 is the button
Seat 1: BurningNN (1159 in chips) 
Seat 2: CashMatteo (4795 in chips) 
Seat 4: 1981Travis1981 (13578 in chips) 
Seat 5: flushmedown (6150 in chips) 
Seat 6: Ookpik1969 (2040 in chips) 
BurningNN: posts the ante 40
CashMatteo: posts the ante 40
1981Travis1981: posts the ante 40
flushmedown: posts the ante 40
Ookpik1969: posts the ante 40
Ookpik1969: posts small blind 80
BurningNN: posts big blind 160
*** HOLE CARDS ***
Dealt to CashMatteo [Jd Ks]
CashMatteo: raises 240 to 400
1981Travis1981: folds 
kervyrx7 is disconnected 
flushmedown: folds 
Ookpik1969: calls 320
BurningNN: calls 240
*** FLOP *** [5s 7d 5c]
Ookpik1969: checks 
BurningNN: bets 719 and is all-in
CashMatteo: calls 719
Ookpik1969: folds 
*** TURN *** [5s 7d 5c] [Tc]
*** RIVER *** [5s 7d 5c Tc] [Kh]
*** SHOW DOWN ***
BurningNN: shows [7s Td] (two pair, Tens and Sevens)
CashMatteo: shows [Jd Ks] (two pair, Kings and Fives)
CashMatteo collected 2838 from pot
BurningNN finished the tournament in 42nd place
*** SUMMARY ***
Total pot 2838 | Rake 0 
Board [5s 7d 5c Tc Kh]
Seat 1: BurningNN (big blind) showed [7s Td] and lost with two pair, Tens and Sevens
Seat 2: CashMatteo showed [Jd Ks] and won (2838) with two pair, Kings and Fives
Seat 4: 1981Travis1981 folded before Flop (didn't bet)
Seat 5: flushmedown (button) folded before Flop (didn't bet)
Seat 6: Ookpik1969 (small blind) folded on the Flop

Hand #1010: 

PokerStars Hand #246358555283: Tournament #3653119701, $1.88+$0.12 CAD Hold'em No Limit - Level VII (80/160) - 2023/10/05 1:10:51 ET
Table '3653119701 5' 6-max Seat #6 is the button
Seat 2: CashMatteo (6474 in chips) 
Seat 3: kervyrx7 (3000 in chips) 
Seat 4: 1981Travis1981 (13538 in chips) 
Seat 5: flushmedown (6110 in chips) 
Seat 6: Ookpik1969 (1600 in chips) 
CashMatteo: posts the ante 40
kervyrx7: posts the ante 40
1981Travis1981: posts the ante 40
flushmedown: posts the ante 40
Ookpik1969: posts the ante 40
CashMatteo: posts small blind 80
kervyrx7: posts big blind 160
*** HOLE CARDS ***
Dealt to CashMatteo [3s Kh]
1981Travis1981: folds 
flushmedown: raises 160 to 320
Ookpik1969: folds 
CashMatteo: folds 
kervyrx7: calls 160
*** FLOP *** [Js 6d 4s]
kervyrx7: checks 
flushmedown: bets 960
kervyrx7: folds 
Uncalled bet (960) returned to flushmedown
flushmedown collected 920 from pot
flushmedown: doesn't show hand 
*** SUMMARY ***
Total pot 920 | Rake 0 
Board [Js 6d 4s]
Seat 2: CashMatteo (small blind) folded before Flop
Seat 3: kervyrx7 (big blind) folded on the Flop
Seat 4: 1981Travis1981 folded before Flop (didn't bet)
Seat 5: flushmedown collected (920)
Seat 6: Ookpik1969 (button) folded before Flop (didn't bet)

Hand #1011: 

PokerStars Hand #246358561079: Tournament #3653119701, $1.88+$0.12 CAD Hold'em No Limit - Level VII (80/160) - 2023/10/05 1:11:49 ET
Table '3653119701 5' 6-max Seat #2 is the button
Seat 2: CashMatteo (6354 in chips) 
Seat 3: kervyrx7 (2640 in chips) 
Seat 4: 1981Travis1981 (13498 in chips) 
Seat 5: flushmedown (6670 in chips) 
Seat 6: Ookpik1969 (1560 in chips) 
CashMatteo: posts the ante 40
kervyrx7: posts the ante 40
1981Travis1981: posts the ante 40
flushmedown: posts the ante 40
Ookpik1969: posts the ante 40
kervyrx7: posts small blind 80
1981Travis1981: posts big blind 160
*** HOLE CARDS ***
Dealt to CashMatteo [9s Th]
flushmedown: folds 
Ookpik1969: folds 
CashMatteo: folds 
kervyrx7: calls 80
1981Travis1981: raises 800 to 960
kervyrx7: folds 
Uncalled bet (800) returned to 1981Travis1981
1981Travis1981 collected 520 from pot
*** SUMMARY ***
Total pot 520 | Rake 0 
Seat 2: CashMatteo (button) folded before Flop (didn't bet)
Seat 3: kervyrx7 (small blind) folded before Flop
Seat 4: 1981Travis1981 (big blind) collected (520)
Seat 5: flushmedown folded before Flop (didn't bet)
Seat 6: Ookpik1969 folded before Flop (didn't bet)

Hand #1012: 

PokerStars Hand #246358564480: Tournament #3653119701, $1.88+$0.12 CAD Hold'em No Limit - Level VIII (100/200) - 2023/10/05 1:12:23 ET
Table '3653119701 5' 6-max Seat #3 is the button
Seat 2: CashMatteo (6314 in chips) 
Seat 3: kervyrx7 (2440 in chips) 
Seat 4: 1981Travis1981 (13818 in chips) 
Seat 5: flushmedown (6630 in chips) 
Seat 6: Ookpik1969 (1520 in chips) 
CashMatteo: posts the ante 50
kervyrx7: posts the ante 50
1981Travis1981: posts the ante 50
flushmedown: posts the ante 50
Ookpik1969: posts the ante 50
1981Travis1981: posts small blind 100
flushmedown: posts big blind 200
*** HOLE CARDS ***
Dealt to CashMatteo [5c 3d]
Ookpik1969: raises 1270 to 1470 and is all-in
CashMatteo: folds 
kervyrx7: folds 
1981Travis1981: calls 1370
flushmedown has timed out
flushmedown: folds 
flushmedown is sitting out
*** FLOP *** [8d 4d 8h]
*** TURN *** [8d 4d 8h] [Jc]
*** RIVER *** [8d 4d 8h Jc] [5s]
*** SHOW DOWN ***
1981Travis1981: shows [Qh Ac] (a pair of Eights)
Ookpik1969: shows [2c 2h] (two pair, Eights and Deuces)
Ookpik1969 collected 3390 from pot
*** SUMMARY ***
Total pot 3390 | Rake 0 
Board [8d 4d 8h Jc 5s]
Seat 2: CashMatteo folded before Flop (didn't bet)
Seat 3: kervyrx7 (button) folded before Flop (didn't bet)
Seat 4: 1981Travis1981 (small blind) showed [Qh Ac] and lost with a pair of Eights
Seat 5: flushmedown (big blind) folded before Flop
Seat 6: Ookpik1969 showed [2c 2h] and won (3390) with two pair, Eights and Deuces

Hand #1013: 

PokerStars Hand #246358568692: Tournament #3653119701, $1.88+$0.12 CAD Hold'em No Limit - Level VIII (100/200) - 2023/10/05 1:13:05 ET
Table '3653119701 5' 6-max Seat #4 is the button
Seat 2: CashMatteo (6264 in chips) 
Seat 3: kervyrx7 (2390 in chips) 
Seat 4: 1981Travis1981 (12298 in chips) 
Seat 5: flushmedown (6380 in chips) is sitting out
Seat 6: Ookpik1969 (3390 in chips) 
CashMatteo: posts the ante 50
kervyrx7: posts the ante 50
1981Travis1981: posts the ante 50
flushmedown: posts the ante 50
Ookpik1969: posts the ante 50
flushmedown: posts small blind 100
Ookpik1969: posts big blind 200
*** HOLE CARDS ***
Dealt to CashMatteo [Ts 4s]
CashMatteo: folds 
kervyrx7: folds 
1981Travis1981: folds 
flushmedown: folds 
Uncalled bet (100) returned to Ookpik1969
flushmedown has returned
Ookpik1969 collected 450 from pot
Ookpik1969: doesn't show hand 
*** SUMMARY ***
Total pot 450 | Rake 0 
Seat 2: CashMatteo folded before Flop (didn't bet)
Seat 3: kervyrx7 folded before Flop (didn't bet)
Seat 4: 1981Travis1981 (button) folded before Flop (didn't bet)
Seat 5: flushmedown (small blind) folded before Flop
Seat 6: Ookpik1969 (big blind) collected (450)

Hand #1014: 

PokerStars Hand #246358569347: Tournament #3653119701, $1.88+$0.12 CAD Hold'em No Limit - Level VIII (100/200) - 2023/10/05 1:13:11 ET
Table '3653119701 5' 6-max Seat #5 is the button
Seat 2: CashMatteo (6214 in chips) 
Seat 3: kervyrx7 (2340 in chips) 
Seat 4: 1981Travis1981 (12248 in chips) 
Seat 5: flushmedown (6230 in chips) 
Seat 6: Ookpik1969 (3690 in chips) 
CashMatteo: posts the ante 50
kervyrx7: posts the ante 50
1981Travis1981: posts the ante 50
flushmedown: posts the ante 50
Ookpik1969: posts the ante 50
Ookpik1969: posts small blind 100
CashMatteo: posts big blind 200
*** HOLE CARDS ***
Dealt to CashMatteo [3h 7d]
kervyrx7: folds 
1981Travis1981: calls 200
flushmedown: folds 
Ookpik1969: folds 
CashMatteo: checks 
*** FLOP *** [Ah Ad Jc]
CashMatteo: checks 
1981Travis1981: checks 
*** TURN *** [Ah Ad Jc] [9d]
CashMatteo: bets 375
1981Travis1981: calls 375
*** RIVER *** [Ah Ad Jc 9d] [Jh]
CashMatteo: checks 
1981Travis1981: checks 
*** SHOW DOWN ***
CashMatteo: shows [3h 7d] (two pair, Aces and Jacks)
1981Travis1981: shows [9c 5c] (two pair, Aces and Jacks)
CashMatteo collected 750 from pot
1981Travis1981 collected 750 from pot
*** SUMMARY ***
Total pot 1500 | Rake 0 
Board [Ah Ad Jc 9d Jh]
Seat 2: CashMatteo (big blind) showed [3h 7d] and won (750) with two pair, Aces and Jacks
Seat 3: kervyrx7 folded before Flop (didn't bet)
Seat 4: 1981Travis1981 showed [9c 5c] and won (750) with two pair, Aces and Jacks
Seat 5: flushmedown (button) folded before Flop (didn't bet)
Seat 6: Ookpik1969 (small blind) folded before Flop

Hand #1015: 

PokerStars Hand #246358573490: Tournament #3653119701, $1.88+$0.12 CAD Hold'em No Limit - Level VIII (100/200) - 2023/10/05 1:13:53 ET
Table '3653119701 5' 6-max Seat #6 is the button
Seat 2: CashMatteo (6339 in chips) 
Seat 3: kervyrx7 (2290 in chips) 
Seat 4: 1981Travis1981 (12373 in chips) 
Seat 5: flushmedown (6180 in chips) 
Seat 6: Ookpik1969 (3540 in chips) 
CashMatteo: posts the ante 50
kervyrx7: posts the ante 50
1981Travis1981: posts the ante 50
flushmedown: posts the ante 50
Ookpik1969: posts the ante 50
CashMatteo: posts small blind 100
kervyrx7: posts big blind 200
*** HOLE CARDS ***
Dealt to CashMatteo [Qc 7h]
1981Travis1981 has timed out
1981Travis1981: folds 
1981Travis1981 is sitting out
1981Travis1981 has returned
flushmedown has timed out
flushmedown: folds 
flushmedown is sitting out
Ookpik1969: folds 
CashMatteo: calls 100
kervyrx7: raises 2040 to 2240 and is all-in
CashMatteo: folds 
Uncalled bet (2040) returned to kervyrx7
kervyrx7 collected 650 from pot
kervyrx7: doesn't show hand 
*** SUMMARY ***
Total pot 650 | Rake 0 
Seat 2: CashMatteo (small blind) folded before Flop
Seat 3: kervyrx7 (big blind) collected (650)
Seat 4: 1981Travis1981 folded before Flop (didn't bet)
Seat 5: flushmedown folded before Flop (didn't bet)
Seat 6: Ookpik1969 (button) folded before Flop (didn't bet)

Hand #1016: 

PokerStars Hand #246358576901: Tournament #3653119701, $1.88+$0.12 CAD Hold'em No Limit - Level VIII (100/200) - 2023/10/05 1:14:27 ET
Table '3653119701 5' 6-max Seat #2 is the button
Seat 2: CashMatteo (6089 in chips) 
Seat 3: kervyrx7 (2690 in chips) 
Seat 4: 1981Travis1981 (12323 in chips) 
Seat 5: flushmedown (6130 in chips) is sitting out
Seat 6: Ookpik1969 (3490 in chips) 
CashMatteo: posts the ante 50
kervyrx7: posts the ante 50
1981Travis1981: posts the ante 50
flushmedown: posts the ante 50
Ookpik1969: posts the ante 50
kervyrx7: posts small blind 100
1981Travis1981: posts big blind 200
*** HOLE CARDS ***
Dealt to CashMatteo [Jc Qs]
flushmedown: folds 
Ookpik1969: folds 
CashMatteo: raises 300 to 500
kervyrx7: folds 
1981Travis1981: calls 300
*** FLOP *** [Ad As 3s]
1981Travis1981: checks 
urnutznpoket is disconnected 
CashMatteo: checks 
*** TURN *** [Ad As 3s] [8s]
1981Travis1981: checks 
CashMatteo: bets 675
1981Travis1981: calls 675
*** RIVER *** [Ad As 3s 8s] [4d]
1981Travis1981: checks 
flushmedown has returned
CashMatteo: checks 
*** SHOW DOWN ***
1981Travis1981: shows [Ks Jd] (a pair of Aces)
CashMatteo: mucks hand 
1981Travis1981 collected 2700 from pot
*** SUMMARY ***
Total pot 2700 | Rake 0 
Board [Ad As 3s 8s 4d]
Seat 2: CashMatteo (button) mucked [Jc Qs]
Seat 3: kervyrx7 (small blind) folded before Flop
Seat 4: 1981Travis1981 (big blind) showed [Ks Jd] and won (2700) with a pair of Aces
Seat 5: flushmedown folded before Flop (didn't bet)
Seat 6: Ookpik1969 folded before Flop (didn't bet)

Hand #1017: 

PokerStars Hand #246358581314: Tournament #3653119701, $1.88+$0.12 CAD Hold'em No Limit - Level IX (125/250) - 2023/10/05 1:15:12 ET
Table '3653119701 5' 6-max Seat #3 is the button
Seat 1: urnutznpoket (3000 in chips) 
Seat 2: CashMatteo (4864 in chips) 
Seat 3: kervyrx7 (2540 in chips) 
Seat 4: 1981Travis1981 (13798 in chips) 
Seat 5: flushmedown (6080 in chips) 
Seat 6: Ookpik1969 (3440 in chips) 
urnutznpoket: posts the ante 60
CashMatteo: posts the ante 60
kervyrx7: posts the ante 60
1981Travis1981: posts the ante 60
flushmedown: posts the ante 60
Ookpik1969: posts the ante 60
1981Travis1981: posts small blind 125
flushmedown: posts big blind 250
*** HOLE CARDS ***
Dealt to CashMatteo [5c Qh]
Ookpik1969: raises 3130 to 3380 and is all-in
urnutznpoket: folds 
CashMatteo: folds 
kervyrx7: folds 
1981Travis1981: folds 
flushmedown: calls 3130
*** FLOP *** [5d 7c Tc]
*** TURN *** [5d 7c Tc] [7s]
*** RIVER *** [5d 7c Tc 7s] [As]
*** SHOW DOWN ***
flushmedown: shows [8h 9d] (a pair of Sevens)
Ookpik1969: shows [Ks Ad] (two pair, Aces and Sevens)
Ookpik1969 collected 7245 from pot
*** SUMMARY ***
Total pot 7245 | Rake 0 
Board [5d 7c Tc 7s As]
Seat 1: urnutznpoket folded before Flop (didn't bet)
Seat 2: CashMatteo folded before Flop (didn't bet)
Seat 3: kervyrx7 (button) folded before Flop (didn't bet)
Seat 4: 1981Travis1981 (small blind) folded before Flop
Seat 5: flushmedown (big blind) showed [8h 9d] and lost with a pair of Sevens
Seat 6: Ookpik1969 showed [Ks Ad] and won (7245) with two pair, Aces and Sevens

Hand #1018: 

PokerStars Hand #246358585435: Tournament #3653119701, $1.88+$0.12 CAD Hold'em No Limit - Level IX (125/250) - 2023/10/05 1:15:55 ET
Table '3653119701 5' 6-max Seat #4 is the button
Seat 1: urnutznpoket (2940 in chips) 
Seat 2: CashMatteo (4804 in chips) 
Seat 3: kervyrx7 (2480 in chips) 
Seat 4: 1981Travis1981 (13613 in chips) 
Seat 5: flushmedown (2640 in chips) 
Seat 6: Ookpik1969 (7245 in chips) 
urnutznpoket: posts the ante 60
CashMatteo: posts the ante 60
kervyrx7: posts the ante 60
1981Travis1981: posts the ante 60
flushmedown: posts the ante 60
Ookpik1969: posts the ante 60
flushmedown: posts small blind 125
Ookpik1969: posts big blind 250
*** HOLE CARDS ***
Dealt to CashMatteo [Jc 6s]
urnutznpoket: folds 
CashMatteo: folds 
kervyrx7: folds 
1981Travis1981: folds 
flushmedown has timed out
flushmedown: folds 
flushmedown is sitting out
Uncalled bet (125) returned to Ookpik1969
Ookpik1969 collected 610 from pot
Ookpik1969: doesn't show hand 
*** SUMMARY ***
Total pot 610 | Rake 0 
Seat 1: urnutznpoket folded before Flop (didn't bet)
Seat 2: CashMatteo folded before Flop (didn't bet)
Seat 3: kervyrx7 folded before Flop (didn't bet)
Seat 4: 1981Travis1981 (button) folded before Flop (didn't bet)
Seat 5: flushmedown (small blind) folded before Flop
Seat 6: Ookpik1969 (big blind) collected (610)

Hand #1019: 

PokerStars Hand #246358587917: Tournament #3653119701, $1.88+$0.12 CAD Hold'em No Limit - Level IX (125/250) - 2023/10/05 1:16:21 ET
Table '3653119701 5' 6-max Seat #5 is the button
Seat 1: urnutznpoket (2880 in chips) 
Seat 2: CashMatteo (4744 in chips) 
Seat 3: kervyrx7 (2420 in chips) 
Seat 4: 1981Travis1981 (13553 in chips) 
Seat 5: flushmedown (2455 in chips) is sitting out
Seat 6: Ookpik1969 (7670 in chips) 
urnutznpoket: posts the ante 60
CashMatteo: posts the ante 60
kervyrx7: posts the ante 60
1981Travis1981: posts the ante 60
flushmedown: posts the ante 60
Ookpik1969: posts the ante 60
Ookpik1969: posts small blind 125
urnutznpoket: posts big blind 250
*** HOLE CARDS ***
Dealt to CashMatteo [3s Qh]
flushmedown has returned
CashMatteo: folds 
kervyrx7: raises 2110 to 2360 and is all-in
1981Travis1981: calls 2360
flushmedown has timed out
flushmedown: folds 
flushmedown is sitting out
Ookpik1969: folds 
urnutznpoket: folds 
*** FLOP *** [8s Ad 6h]
flushmedown has returned
*** TURN *** [8s Ad 6h] [Td]
*** RIVER *** [8s Ad 6h Td] [2d]
*** SHOW DOWN ***
kervyrx7: shows [Jd Js] (a pair of Jacks)
1981Travis1981: shows [Kh Qd] (high card Ace)
kervyrx7 collected 5455 from pot
*** SUMMARY ***
Total pot 5455 | Rake 0 
Board [8s Ad 6h Td 2d]
Seat 1: urnutznpoket (big blind) folded before Flop
Seat 2: CashMatteo folded before Flop (didn't bet)
Seat 3: kervyrx7 showed [Jd Js] and won (5455) with a pair of Jacks
Seat 4: 1981Travis1981 showed [Kh Qd] and lost with high card Ace
Seat 5: flushmedown (button) folded before Flop (didn't bet)
Seat 6: Ookpik1969 (small blind) folded before Flop

Hand #1020: 

PokerStars Hand #246358591224: Tournament #3653119701, $1.88+$0.12 CAD Hold'em No Limit - Level IX (125/250) - 2023/10/05 1:16:55 ET
Table '3653119701 5' 6-max Seat #6 is the button
Seat 1: urnutznpoket (2570 in chips) 
Seat 2: CashMatteo (4684 in chips) 
Seat 3: kervyrx7 (5455 in chips) 
Seat 4: 1981Travis1981 (11133 in chips) 
Seat 5: flushmedown (2395 in chips) 
Seat 6: Ookpik1969 (7485 in chips) 
urnutznpoket: posts the ante 60
CashMatteo: posts the ante 60
kervyrx7: posts the ante 60
1981Travis1981: posts the ante 60
flushmedown: posts the ante 60
Ookpik1969: posts the ante 60
urnutznpoket: posts small blind 125
CashMatteo: posts big blind 250
*** HOLE CARDS ***
Dealt to CashMatteo [9c Kd]
kervyrx7: folds 
1981Travis1981: folds 
flushmedown: raises 2085 to 2335 and is all-in
Ookpik1969: folds 
urnutznpoket: folds 
CashMatteo: calls 2085
*** FLOP *** [3d 5h Ah]
*** TURN *** [3d 5h Ah] [6d]
*** RIVER *** [3d 5h Ah 6d] [6h]
*** SHOW DOWN ***
CashMatteo: shows [9c Kd] (a pair of Sixes)
flushmedown: shows [Qh Th] (a flush, Ace high)
flushmedown collected 5155 from pot
*** SUMMARY ***
Total pot 5155 | Rake 0 
Board [3d 5h Ah 6d 6h]
Seat 1: urnutznpoket (small blind) folded before Flop
Seat 2: CashMatteo (big blind) showed [9c Kd] and lost with a pair of Sixes
Seat 3: kervyrx7 folded before Flop (didn't bet)
Seat 4: 1981Travis1981 folded before Flop (didn't bet)
Seat 5: flushmedown showed [Qh Th] and won (5155) with a flush, Ace high
Seat 6: Ookpik1969 (button) folded before Flop (didn't bet)

Hand #1021: 

PokerStars Hand #246358594583: Tournament #3653119701, $1.88+$0.12 CAD Hold'em No Limit - Level IX (125/250) - 2023/10/05 1:17:28 ET
Table '3653119701 5' 6-max Seat #1 is the button
Seat 1: urnutznpoket (2385 in chips) 
Seat 2: CashMatteo (2289 in chips) 
Seat 3: kervyrx7 (5395 in chips) 
Seat 4: 1981Travis1981 (11073 in chips) 
Seat 5: flushmedown (5155 in chips) 
Seat 6: Ookpik1969 (7425 in chips) 
urnutznpoket: posts the ante 60
CashMatteo: posts the ante 60
kervyrx7: posts the ante 60
1981Travis1981: posts the ante 60
flushmedown: posts the ante 60
Ookpik1969: posts the ante 60
CashMatteo: posts small blind 125
kervyrx7: posts big blind 250
*** HOLE CARDS ***
Dealt to CashMatteo [2d 9c]
1981Travis1981: folds 
flushmedown has timed out
flushmedown: folds 
flushmedown is sitting out
Ookpik1969: raises 500 to 750
urnutznpoket: folds 
CashMatteo: folds 
kervyrx7: folds 
Uncalled bet (500) returned to Ookpik1969
Ookpik1969 collected 985 from pot
Ookpik1969: doesn't show hand 
*** SUMMARY ***
Total pot 985 | Rake 0 
Seat 1: urnutznpoket (button) folded before Flop (didn't bet)
Seat 2: CashMatteo (small blind) folded before Flop
Seat 3: kervyrx7 (big blind) folded before Flop
Seat 4: 1981Travis1981 folded before Flop (didn't bet)
Seat 5: flushmedown folded before Flop (didn't bet)
Seat 6: Ookpik1969 collected (985)

Hand #1022: 

PokerStars Hand #246358597201: Tournament #3653119701, $1.88+$0.12 CAD Hold'em No Limit - Level IX (125/250) - 2023/10/05 1:17:54 ET
Table '3653119701 5' 6-max Seat #2 is the button
Seat 1: urnutznpoket (2325 in chips) 
Seat 2: CashMatteo (2104 in chips) 
Seat 3: kervyrx7 (5085 in chips) 
Seat 5: flushmedown (5095 in chips) is sitting out
Seat 6: Ookpik1969 (8100 in chips) 
urnutznpoket: posts the ante 60
CashMatteo: posts the ante 60
kervyrx7: posts the ante 60
flushmedown: posts the ante 60
Ookpik1969: posts the ante 60
kervyrx7: posts small blind 125
flushmedown: posts big blind 250
*** HOLE CARDS ***
Dealt to CashMatteo [Tc 4d]
Ookpik1969: folds 
urnutznpoket: folds 
CashMatteo: folds 
kervyrx7: raises 250 to 500
flushmedown: folds 
Uncalled bet (250) returned to kervyrx7
kervyrx7 collected 800 from pot
kervyrx7: doesn't show hand 
*** SUMMARY ***
Total pot 800 | Rake 0 
Seat 1: urnutznpoket folded before Flop (didn't bet)
Seat 2: CashMatteo (button) folded before Flop (didn't bet)
Seat 3: kervyrx7 (small blind) collected (800)
Seat 5: flushmedown (big blind) folded before Flop
Seat 6: Ookpik1969 folded before Flop (didn't bet)

Hand #1023: 

PokerStars Hand #246358598053: Tournament #3653119701, $1.88+$0.12 CAD Hold'em No Limit - Level IX (125/250) - 2023/10/05 1:18:03 ET
Table '3653119701 5' 6-max Seat #3 is the button
Seat 1: urnutznpoket (2265 in chips) 
Seat 2: CashMatteo (2044 in chips) 
Seat 3: kervyrx7 (5575 in chips) 
Seat 5: flushmedown (4785 in chips) is sitting out
Seat 6: Ookpik1969 (8040 in chips) 
urnutznpoket: posts the ante 60
CashMatteo: posts the ante 60
kervyrx7: posts the ante 60
flushmedown: posts the ante 60
Ookpik1969: posts the ante 60
flushmedown: posts small blind 125
Ookpik1969: posts big blind 250
*** HOLE CARDS ***
Dealt to CashMatteo [5h 4c]
urnutznpoket: raises 1955 to 2205 and is all-in
CashMatteo: folds 
kervyrx7: folds 
flushmedown: folds 
Ookpik1969: calls 1955
*** FLOP *** [4d 7s 6s]
flushmedown has returned
*** TURN *** [4d 7s 6s] [4h]
*** RIVER *** [4d 7s 6s 4h] [2s]
*** SHOW DOWN ***
Ookpik1969: shows [Ad 9d] (a pair of Fours)
urnutznpoket: shows [Jh Qs] (a pair of Fours - lower kicker)
Ookpik1969 collected 4835 from pot
urnutznpoket finished the tournament in 31st place
*** SUMMARY ***
Total pot 4835 | Rake 0 
Board [4d 7s 6s 4h 2s]
Seat 1: urnutznpoket showed [Jh Qs] and lost with a pair of Fours
Seat 2: CashMatteo folded before Flop (didn't bet)
Seat 3: kervyrx7 (button) folded before Flop (didn't bet)
Seat 5: flushmedown (small blind) folded before Flop
Seat 6: Ookpik1969 (big blind) showed [Ad 9d] and won (4835) with a pair of Fours

Hand #1024: 

PokerStars Hand #246358601533: Tournament #3653119701, $1.88+$0.12 CAD Hold'em No Limit - Level X (150/300) - 2023/10/05 1:18:38 ET
Table '3653119701 7' 6-max Seat #4 is the button
Seat 1: canadain416 (3858 in chips) 
Seat 3: CashMatteo (1984 in chips) 
Seat 4: avancal (7295 in chips) 
Seat 5: 00Ispy00 (5624 in chips) 
Seat 6: GQUEUE (3523 in chips) 
canadain416: posts the ante 75
CashMatteo: posts the ante 75
avancal: posts the ante 75
00Ispy00: posts the ante 75
GQUEUE: posts the ante 75
00Ispy00: posts small blind 150
GQUEUE: posts big blind 300
*** HOLE CARDS ***
Dealt to CashMatteo [6c 7d]
canadain416: folds 
CashMatteo: folds 
avancal: folds 
00Ispy00: folds 
Uncalled bet (150) returned to GQUEUE
GQUEUE collected 675 from pot
*** SUMMARY ***
Total pot 675 | Rake 0 
Seat 1: canadain416 folded before Flop (didn't bet)
Seat 3: CashMatteo folded before Flop (didn't bet)
Seat 4: avancal (button) folded before Flop (didn't bet)
Seat 5: 00Ispy00 (small blind) folded before Flop
Seat 6: GQUEUE (big blind) collected (675)

Hand #1025: 

PokerStars Hand #246358602541: Tournament #3653119701, $1.88+$0.12 CAD Hold'em No Limit - Level X (150/300) - 2023/10/05 1:18:48 ET
Table '3653119701 7' 6-max Seat #5 is the button
Seat 1: canadain416 (3783 in chips) 
Seat 3: CashMatteo (1909 in chips) 
Seat 4: avancal (7220 in chips) 
Seat 5: 00Ispy00 (5399 in chips) 
Seat 6: GQUEUE (3973 in chips) 
canadain416: posts the ante 75
CashMatteo: posts the ante 75
avancal: posts the ante 75
00Ispy00: posts the ante 75
GQUEUE: posts the ante 75
GQUEUE: posts small blind 150
canadain416: posts big blind 300
*** HOLE CARDS ***
Dealt to CashMatteo [Jh 2h]
CashMatteo: folds 
avancal: folds 
00Ispy00: raises 300 to 600
GQUEUE: raises 3298 to 3898 and is all-in
canadain416: folds 
00Ispy00: folds 
Uncalled bet (3298) returned to GQUEUE
GQUEUE collected 1875 from pot
*** SUMMARY ***
Total pot 1875 | Rake 0 
Seat 1: canadain416 (big blind) folded before Flop
Seat 3: CashMatteo folded before Flop (didn't bet)
Seat 4: avancal folded before Flop (didn't bet)
Seat 5: 00Ispy00 (button) folded before Flop
Seat 6: GQUEUE (small blind) collected (1875)

Hand #1026: 

PokerStars Hand #246358604671: Tournament #3653119701, $1.88+$0.12 CAD Hold'em No Limit - Level X (150/300) - 2023/10/05 1:19:10 ET
Table '3653119701 7' 6-max Seat #6 is the button
Seat 1: canadain416 (3408 in chips) 
Seat 3: CashMatteo (1834 in chips) 
Seat 4: avancal (7145 in chips) 
Seat 5: 00Ispy00 (4724 in chips) 
Seat 6: GQUEUE (5173 in chips) 
canadain416: posts the ante 75
CashMatteo: posts the ante 75
avancal: posts the ante 75
00Ispy00: posts the ante 75
GQUEUE: posts the ante 75
canadain416: posts small blind 150
CashMatteo: posts big blind 300
*** HOLE CARDS ***
Dealt to CashMatteo [As Qh]
avancal: raises 300 to 600
00Ispy00: folds 
GQUEUE: folds 
canadain416: folds 
CashMatteo: raises 1159 to 1759 and is all-in
avancal: calls 1159
*** FLOP *** [9s 6h 7s]
*** TURN *** [9s 6h 7s] [2d]
*** RIVER *** [9s 6h 7s 2d] [5s]
*** SHOW DOWN ***
CashMatteo: shows [As Qh] (high card Ace)
avancal: shows [Ah 5h] (a pair of Fives)
avancal collected 4043 from pot
CashMatteo finished the tournament in 29th place
*** SUMMARY ***
Total pot 4043 | Rake 0 
Board [9s 6h 7s 2d 5s]
Seat 1: canadain416 (small blind) folded before Flop
Seat 3: CashMatteo (big blind) showed [As Qh] and lost with high card Ace
Seat 4: avancal showed [Ah 5h] and won (4043) with a pair of Fives
Seat 5: 00Ispy00 folded before Flop (didn't bet)
Seat 6: GQUEUE (button) folded before Flop (didn't bet)

Hand #1027: 

PokerStars Hand #246617854173:  Hold'em No Limit ($0.05/$0.10 CAD) - 2023/10/19 4:22:33 ET
Table 'Zita' 6-max Seat #3 is the button
Seat 1: Spankorama ($19.08 in chips) 
Seat 2: Talmin84 ($8.35 in chips) 
Seat 3: Dr.Smokealot ($9.70 in chips) 
Seat 4: Hulk201 ($7.81 in chips) 
Seat 5: CashMatteo ($8 in chips) 
Seat 6: Ray Jep ($11.54 in chips) 
Hulk201: posts small blind $0.05
CashMatteo: posts big blind $0.10
*** HOLE CARDS ***
Dealt to CashMatteo [9s 5c]
Ray Jep: raises $0.10 to $0.20
Spankorama: folds 
Talmin84: folds 
Dr.Smokealot: folds 
Hulk201: folds 
CashMatteo: calls $0.10
*** FLOP *** [Ac 6h Tc]
CashMatteo: checks 
Ray Jep: bets $0.22
CashMatteo: folds 
Uncalled bet ($0.22) returned to Ray Jep
Ray Jep collected $0.43 from pot
*** SUMMARY ***
Total pot $0.45 | Rake $0.02 
Board [Ac 6h Tc]
Seat 1: Spankorama folded before Flop (didn't bet)
Seat 2: Talmin84 folded before Flop (didn't bet)
Seat 3: Dr.Smokealot (button) folded before Flop (didn't bet)
Seat 4: Hulk201 (small blind) folded before Flop
Seat 5: CashMatteo (big blind) folded on the Flop
Seat 6: Ray Jep collected ($0.43)

Hand #1028: 

PokerStars Hand #246617856250:  Hold'em No Limit ($0.05/$0.10 CAD) - 2023/10/19 4:22:54 ET
Table 'Zita' 6-max Seat #4 is the button
Seat 1: Spankorama ($19.08 in chips) 
Seat 2: Talmin84 ($8.35 in chips) 
Seat 3: Dr.Smokealot ($9.70 in chips) 
Seat 4: Hulk201 ($7.76 in chips) 
Seat 5: CashMatteo ($7.80 in chips) 
Seat 6: Ray Jep ($11.77 in chips) 
CashMatteo: posts small blind $0.05
Ray Jep: posts big blind $0.10
*** HOLE CARDS ***
Dealt to CashMatteo [Ks 4s]
Spankorama: folds 
Talmin84: calls $0.10
Dr.Smokealot: calls $0.10
Hulk201: calls $0.10
CashMatteo: calls $0.05
Ray Jep: checks 
*** FLOP *** [Kh Qc 2c]
CashMatteo: bets $0.24
Ray Jep: calls $0.24
Talmin84: folds 
Dr.Smokealot: calls $0.24
Hulk201: calls $0.24
*** TURN *** [Kh Qc 2c] [3d]
CashMatteo: checks 
Ray Jep: checks 
Dr.Smokealot: checks 
Hulk201: checks 
*** RIVER *** [Kh Qc 2c 3d] [7c]
CashMatteo: bets $0.70
Ray Jep: calls $0.70
Dr.Smokealot: folds 
Hulk201: folds 
*** SHOW DOWN ***
CashMatteo: shows [Ks 4s] (a pair of Kings)
Ray Jep: shows [7h Kd] (two pair, Kings and Sevens)
Ray Jep collected $2.73 from pot
*** SUMMARY ***
Total pot $2.86 | Rake $0.13 
Board [Kh Qc 2c 3d 7c]
Seat 1: Spankorama folded before Flop (didn't bet)
Seat 2: Talmin84 folded on the Flop
Seat 3: Dr.Smokealot folded on the River
Seat 4: Hulk201 (button) folded on the River
Seat 5: CashMatteo (small blind) showed [Ks 4s] and lost with a pair of Kings
Seat 6: Ray Jep (big blind) showed [7h Kd] and won ($2.73) with two pair, Kings and Sevens

Hand #1029: 

PokerStars Hand #246617860401:  Hold'em No Limit ($0.05/$0.10 CAD) - 2023/10/19 4:23:37 ET
Table 'Zita' 6-max Seat #5 is the button
Seat 1: Spankorama ($19.08 in chips) 
Seat 2: Talmin84 ($8.25 in chips) 
Seat 3: Dr.Smokealot ($9.36 in chips) 
Seat 4: Hulk201 ($7.42 in chips) 
Seat 5: CashMatteo ($6.76 in chips) 
Seat 6: Ray Jep ($13.46 in chips) 
Ray Jep: posts small blind $0.05
Spankorama: posts big blind $0.10
*** HOLE CARDS ***
Dealt to CashMatteo [Ah Td]
Talmin84: folds 
Dr.Smokealot: folds 
Hulk201: folds 
CashMatteo: raises $0.15 to $0.25
Ray Jep: folds 
Spankorama: calls $0.15
*** FLOP *** [3s Ad Kh]
Spankorama: checks 
CashMatteo: checks 
*** TURN *** [3s Ad Kh] [6h]
Spankorama: checks 
CashMatteo: bets $0.10
Spankorama: calls $0.10
*** RIVER *** [3s Ad Kh 6h] [Js]
Spankorama: checks 
CashMatteo: bets $0.36
Spankorama: raises $0.72 to $1.08
CashMatteo: calls $0.72
*** SHOW DOWN ***
Spankorama: shows [5s 2s] (high card Ace)
CashMatteo: shows [Ah Td] (a pair of Aces)
CashMatteo collected $2.78 from pot
*** SUMMARY ***
Total pot $2.91 | Rake $0.13 
Board [3s Ad Kh 6h Js]
Seat 1: Spankorama (big blind) showed [5s 2s] and lost with high card Ace
Seat 2: Talmin84 folded before Flop (didn't bet)
Seat 3: Dr.Smokealot folded before Flop (didn't bet)
Seat 4: Hulk201 folded before Flop (didn't bet)
Seat 5: CashMatteo (button) showed [Ah Td] and won ($2.78) with a pair of Aces
Seat 6: Ray Jep (small blind) folded before Flop

Hand #1030: 

PokerStars Hand #246617863937:  Hold'em No Limit ($0.05/$0.10 CAD) - 2023/10/19 4:24:14 ET
Table 'Zita' 6-max Seat #6 is the button
Seat 1: Spankorama ($17.65 in chips) 
Seat 2: Talmin84 ($8.25 in chips) 
Seat 3: Dr.Smokealot ($10 in chips) 
Seat 4: Hulk201 ($7.42 in chips) 
Seat 5: CashMatteo ($8.11 in chips) 
Seat 6: Ray Jep ($13.41 in chips) 
Spankorama: posts small blind $0.05
Talmin84: posts big blind $0.10
*** HOLE CARDS ***
Dealt to CashMatteo [5d Th]
Dr.Smokealot: folds 
Hulk201: calls $0.10
CashMatteo: folds 
Ray Jep: folds 
Spankorama: calls $0.05
Talmin84: checks 
*** FLOP *** [Ks Qc Kc]
Spankorama: checks 
Talmin84: bets $0.10
Hulk201: folds 
Spankorama: folds 
Uncalled bet ($0.10) returned to Talmin84
Talmin84 collected $0.29 from pot
*** SUMMARY ***
Total pot $0.30 | Rake $0.01 
Board [Ks Qc Kc]
Seat 1: Spankorama (small blind) folded on the Flop
Seat 2: Talmin84 (big blind) collected ($0.29)
Seat 3: Dr.Smokealot folded before Flop (didn't bet)
Seat 4: Hulk201 folded on the Flop
Seat 5: CashMatteo folded before Flop (didn't bet)
Seat 6: Ray Jep (button) folded before Flop (didn't bet)

Hand #1031: 

PokerStars Hand #246617866312:  Hold'em No Limit ($0.05/$0.10 CAD) - 2023/10/19 4:24:38 ET
Table 'Zita' 6-max Seat #1 is the button
Seat 1: Spankorama ($17.55 in chips) 
Seat 2: Talmin84 ($8.44 in chips) 
Seat 3: Dr.Smokealot ($10 in chips) 
Seat 4: Hulk201 ($7.32 in chips) 
Seat 5: CashMatteo ($8.11 in chips) 
Seat 6: Ray Jep ($13.41 in chips) 
Talmin84: posts small blind $0.05
Dr.Smokealot: posts big blind $0.10
*** HOLE CARDS ***
Dealt to CashMatteo [8s 3c]
Hulk201: calls $0.10
CashMatteo: folds 
Ray Jep: folds 
Spankorama: folds 
Talmin84: calls $0.05
Dr.Smokealot: checks 
*** FLOP *** [Jd Kc Ah]
Talmin84: checks 
Dr.Smokealot: checks 
Hulk201: bets $0.10
Talmin84: folds 
Dr.Smokealot: calls $0.10
*** TURN *** [Jd Kc Ah] [6d]
Dr.Smokealot: checks 
Hulk201: bets $0.20
Dr.Smokealot: calls $0.20
*** RIVER *** [Jd Kc Ah 6d] [6s]
Dr.Smokealot: checks 
Hulk201: bets $0.30
Dr.Smokealot: folds 
Uncalled bet ($0.30) returned to Hulk201
Hulk201 collected $0.86 from pot
Hulk201: doesn't show hand 
*** SUMMARY ***
Total pot $0.90 | Rake $0.04 
Board [Jd Kc Ah 6d 6s]
Seat 1: Spankorama (button) folded before Flop (didn't bet)
Seat 2: Talmin84 (small blind) folded on the Flop
Seat 3: Dr.Smokealot (big blind) folded on the River
Seat 4: Hulk201 collected ($0.86)
Seat 5: CashMatteo folded before Flop (didn't bet)
Seat 6: Ray Jep folded before Flop (didn't bet)

Hand #1032: 

PokerStars Hand #246617869529:  Hold'em No Limit ($0.05/$0.10 CAD) - 2023/10/19 4:25:11 ET
Table 'Zita' 6-max Seat #2 is the button
Seat 1: Spankorama ($17.55 in chips) 
Seat 2: Talmin84 ($8.34 in chips) 
Seat 3: Dr.Smokealot ($9.60 in chips) 
Seat 4: Hulk201 ($7.78 in chips) 
Seat 5: CashMatteo ($8.11 in chips) 
Seat 6: Ray Jep ($13.41 in chips) 
Dr.Smokealot: posts small blind $0.05
Hulk201: posts big blind $0.10
*** HOLE CARDS ***
Dealt to CashMatteo [Th 4h]
CashMatteo: folds 
Ray Jep: calls $0.10
Spankorama: calls $0.10
Talmin84: folds 
Dr.Smokealot: folds 
Hulk201: checks 
*** FLOP *** [Tc 9c 8d]
Hulk201: checks 
Ray Jep: bets $0.10
Spankorama: calls $0.10
Hulk201: calls $0.10
*** TURN *** [Tc 9c 8d] [7d]
Hulk201: checks 
Ray Jep: bets $0.10
Spankorama: folds 
Hulk201: calls $0.10
*** RIVER *** [Tc 9c 8d 7d] [Js]
Hulk201: bets $0.41
Ray Jep: calls $0.41
*** SHOW DOWN ***
Hulk201: shows [Qc 8c] (a straight, Eight to Queen)
Ray Jep: mucks hand 
Hulk201 collected $1.59 from pot
*** SUMMARY ***
Total pot $1.67 | Rake $0.08 
Board [Tc 9c 8d 7d Js]
Seat 1: Spankorama folded on the Turn
Seat 2: Talmin84 (button) folded before Flop (didn't bet)
Seat 3: Dr.Smokealot (small blind) folded before Flop
Seat 4: Hulk201 (big blind) showed [Qc 8c] and won ($1.59) with a straight, Eight to Queen
Seat 5: CashMatteo folded before Flop (didn't bet)
Seat 6: Ray Jep mucked [9d Jd]

Hand #1033: 

PokerStars Hand #246617874896:  Hold'em No Limit ($0.05/$0.10 CAD) - 2023/10/19 4:26:07 ET
Table 'Zita' 6-max Seat #3 is the button
Seat 1: Spankorama ($17.35 in chips) 
Seat 2: Talmin84 ($8.34 in chips) 
Seat 3: Dr.Smokealot ($10 in chips) 
Seat 4: Hulk201 ($8.66 in chips) 
Seat 5: CashMatteo ($8.11 in chips) 
Seat 6: Ray Jep ($12.70 in chips) 
Hulk201: posts small blind $0.05
CashMatteo: posts big blind $0.10
*** HOLE CARDS ***
Dealt to CashMatteo [Ac 5s]
Ray Jep: folds 
Spankorama: raises $0.25 to $0.35
Talmin84: folds 
Dr.Smokealot: folds 
Hulk201: calls $0.30
CashMatteo: calls $0.25
*** FLOP *** [3c 6d 3h]
Hulk201: bets $0.10
CashMatteo: calls $0.10
Spankorama: calls $0.10
*** TURN *** [3c 6d 3h] [8s]
Hulk201: bets $0.20
CashMatteo: raises $0.85 to $1.05
Spankorama: folds 
Hulk201: calls $0.85
*** RIVER *** [3c 6d 3h 8s] [Kh]
Hulk201: bets $0.60
CashMatteo: calls $0.60
*** SHOW DOWN ***
Hulk201: shows [8h 8c] (a full house, Eights full of Threes)
CashMatteo: mucks hand 
Hulk201 collected $4.44 from pot
*** SUMMARY ***
Total pot $4.65 | Rake $0.21 
Board [3c 6d 3h 8s Kh]
Seat 1: Spankorama folded on the Turn
Seat 2: Talmin84 folded before Flop (didn't bet)
Seat 3: Dr.Smokealot (button) folded before Flop (didn't bet)
Seat 4: Hulk201 (small blind) showed [8h 8c] and won ($4.44) with a full house, Eights full of Threes
Seat 5: CashMatteo (big blind) mucked [Ac 5s]
Seat 6: Ray Jep folded before Flop (didn't bet)

Hand #1034: 

PokerStars Hand #246617880159:  Hold'em No Limit ($0.05/$0.10 CAD) - 2023/10/19 4:27:02 ET
Table 'Zita' 6-max Seat #4 is the button
Seat 1: Spankorama ($16.90 in chips) 
Seat 2: Talmin84 ($8.34 in chips) 
Seat 3: Dr.Smokealot ($10 in chips) 
Seat 4: Hulk201 ($11 in chips) 
Seat 5: CashMatteo ($6.01 in chips) 
Seat 6: Ray Jep ($12.70 in chips) 
CashMatteo: posts small blind $0.05
Ray Jep: posts big blind $0.10
*** HOLE CARDS ***
Dealt to CashMatteo [5d Kh]
Spankorama: raises $0.25 to $0.35
Talmin84: folds 
Dr.Smokealot: folds 
Hulk201: calls $0.35
CashMatteo: folds 
Ray Jep: folds 
*** FLOP *** [8s 4h Tc]
Spankorama: checks 
Hulk201: bets $0.20
Spankorama: calls $0.20
*** TURN *** [8s 4h Tc] [2c]
Spankorama: bets $0.60
Hulk201: calls $0.60
*** RIVER *** [8s 4h Tc 2c] [Ac]
Spankorama: bets $0.80
Hulk201: folds 
Uncalled bet ($0.80) returned to Spankorama
Spankorama collected $2.34 from pot
*** SUMMARY ***
Total pot $2.45 | Rake $0.11 
Board [8s 4h Tc 2c Ac]
Seat 1: Spankorama collected ($2.34)
Seat 2: Talmin84 folded before Flop (didn't bet)
Seat 3: Dr.Smokealot folded before Flop (didn't bet)
Seat 4: Hulk201 (button) folded on the River
Seat 5: CashMatteo (small blind) folded before Flop
Seat 6: Ray Jep (big blind) folded before Flop

Hand #1035: 

PokerStars Hand #246617883646:  Hold'em No Limit ($0.05/$0.10 CAD) - 2023/10/19 4:27:37 ET
Table 'Zita' 6-max Seat #5 is the button
Seat 1: Spankorama ($18.09 in chips) 
Seat 2: Talmin84 ($8.34 in chips) 
Seat 3: Dr.Smokealot ($10 in chips) 
Seat 4: Hulk201 ($9.85 in chips) 
Seat 5: CashMatteo ($5.96 in chips) 
Spankorama: posts small blind $0.05
Talmin84: posts big blind $0.10
*** HOLE CARDS ***
Dealt to CashMatteo [5h Ah]
Dr.Smokealot: folds 
Hulk201: folds 
CashMatteo: raises $0.15 to $0.25
Spankorama: folds 
Talmin84: calls $0.15
*** FLOP *** [9d 5d 9c]
Talmin84: bets $0.20
CashMatteo: raises $0.47 to $0.67
Talmin84: calls $0.47
*** TURN *** [9d 5d 9c] [Qd]
Talmin84: bets $0.90
CashMatteo: folds 
Uncalled bet ($0.90) returned to Talmin84
Talmin84 collected $1.80 from pot
*** SUMMARY ***
Total pot $1.89 | Rake $0.09 
Board [9d 5d 9c Qd]
Seat 1: Spankorama (small blind) folded before Flop
Seat 2: Talmin84 (big blind) collected ($1.80)
Seat 3: Dr.Smokealot folded before Flop (didn't bet)
Seat 4: Hulk201 folded before Flop (didn't bet)
Seat 5: CashMatteo (button) folded on the Turn

Hand #1036: 

PokerStars Hand #246617888149:  Hold'em No Limit ($0.05/$0.10 CAD) - 2023/10/19 4:28:23 ET
Table 'Zita' 6-max Seat #1 is the button
Seat 1: Spankorama ($18.04 in chips) 
Seat 2: Talmin84 ($9.22 in chips) 
Seat 3: Dr.Smokealot ($10 in chips) 
Seat 4: Hulk201 ($9.85 in chips) 
Seat 5: CashMatteo ($5.04 in chips) 
Talmin84: posts small blind $0.05
Dr.Smokealot: posts big blind $0.10
*** HOLE CARDS ***
Dealt to CashMatteo [9s Qc]
Hulk201: calls $0.10
CashMatteo: calls $0.10
Spankorama: folds 
Talmin84: folds 
Dr.Smokealot: checks 
*** FLOP *** [2d Kh Js]
Dr.Smokealot: checks 
Hulk201: bets $0.10
CashMatteo: calls $0.10
Dr.Smokealot: folds 
*** TURN *** [2d Kh Js] [Jh]
Hulk201: bets $0.20
CashMatteo: calls $0.20
*** RIVER *** [2d Kh Js Jh] [7d]
Hulk201: bets $0.30
CashMatteo: folds 
Uncalled bet ($0.30) returned to Hulk201
Hulk201 collected $0.91 from pot
Hulk201: doesn't show hand 
*** SUMMARY ***
Total pot $0.95 | Rake $0.04 
Board [2d Kh Js Jh 7d]
Seat 1: Spankorama (button) folded before Flop (didn't bet)
Seat 2: Talmin84 (small blind) folded before Flop
Seat 3: Dr.Smokealot (big blind) folded on the Flop
Seat 4: Hulk201 collected ($0.91)
Seat 5: CashMatteo folded on the River

Hand #1037: 

PokerStars Hand #246617893378:  Hold'em No Limit ($0.05/$0.10 CAD) - 2023/10/19 4:29:17 ET
Table 'Zita' 6-max Seat #2 is the button
Seat 1: Spankorama ($18.04 in chips) 
Seat 2: Talmin84 ($9.17 in chips) 
Seat 3: Dr.Smokealot ($9.90 in chips) 
Seat 4: Hulk201 ($10.36 in chips) 
Seat 5: CashMatteo ($4.64 in chips) 
Seat 6: Ray Jep ($12.60 in chips) 
Dr.Smokealot: posts small blind $0.05
Hulk201: posts big blind $0.10
Ray Jep: posts small blind $0.05
*** HOLE CARDS ***
Dealt to CashMatteo [Jd 5d]
CashMatteo: calls $0.10
Ray Jep: folds 
Spankorama: raises $0.70 to $0.80
Talmin84: folds 
Dr.Smokealot: folds 
Hulk201: folds 
CashMatteo: folds 
Uncalled bet ($0.70) returned to Spankorama
Spankorama collected $0.40 from pot
*** SUMMARY ***
Total pot $0.40 | Rake $0 
Seat 1: Spankorama collected ($0.40)
Seat 2: Talmin84 (button) folded before Flop (didn't bet)
Seat 3: Dr.Smokealot (small blind) folded before Flop
Seat 4: Hulk201 (big blind) folded before Flop
Seat 5: CashMatteo folded before Flop
Seat 6: Ray Jep folded before Flop (didn't bet)

Hand #1038: 

PokerStars Hand #246617895062:  Hold'em No Limit ($0.05/$0.10 CAD) - 2023/10/19 4:29:35 ET
Table 'Zita' 6-max Seat #3 is the button
Seat 1: Spankorama ($18.34 in chips) 
Seat 2: Talmin84 ($9.17 in chips) 
Seat 3: Dr.Smokealot ($9.85 in chips) 
Seat 4: Hulk201 ($10.26 in chips) 
Seat 5: CashMatteo ($4.54 in chips) 
Seat 6: Ray Jep ($12.55 in chips) 
Hulk201: posts small blind $0.05
CashMatteo: posts big blind $0.10
*** HOLE CARDS ***
Dealt to CashMatteo [9h Ah]
Ray Jep: folds 
Spankorama: raises $0.20 to $0.30
Talmin84: folds 
Dr.Smokealot: folds 
Hulk201: folds 
CashMatteo: calls $0.20
*** FLOP *** [3c Ac Kh]
CashMatteo: checks 
Spankorama: bets $0.31
CashMatteo: calls $0.31
*** TURN *** [3c Ac Kh] [8c]
CashMatteo: checks 
Spankorama: checks 
*** RIVER *** [3c Ac Kh 8c] [Kd]
CashMatteo: bets $0.61
Spankorama: folds 
Uncalled bet ($0.61) returned to CashMatteo
CashMatteo collected $1.21 from pot
CashMatteo: doesn't show hand 
*** SUMMARY ***
Total pot $1.27 | Rake $0.06 
Board [3c Ac Kh 8c Kd]
Seat 1: Spankorama folded on the River
Seat 2: Talmin84 folded before Flop (didn't bet)
Seat 3: Dr.Smokealot (button) folded before Flop (didn't bet)
Seat 4: Hulk201 (small blind) folded before Flop
Seat 5: CashMatteo (big blind) collected ($1.21)
Seat 6: Ray Jep folded before Flop (didn't bet)

Hand #1039: 

PokerStars Hand #246617899191:  Hold'em No Limit ($0.05/$0.10 CAD) - 2023/10/19 4:30:17 ET
Table 'Zita' 6-max Seat #4 is the button
Seat 1: Spankorama ($17.73 in chips) 
Seat 2: Talmin84 ($9.17 in chips) 
Seat 3: Dr.Smokealot ($9.85 in chips) 
Seat 4: Hulk201 ($10.21 in chips) 
Seat 5: CashMatteo ($5.14 in chips) 
Seat 6: Ray Jep ($12.55 in chips) 
CashMatteo: posts small blind $0.05
Ray Jep: posts big blind $0.10
*** HOLE CARDS ***
Dealt to CashMatteo [8h Ah]
Spankorama: calls $0.10
Talmin84: calls $0.10
Dr.Smokealot: folds 
Hulk201: calls $0.10
CashMatteo: raises $0.15 to $0.25
Ray Jep: folds 
Spankorama: calls $0.15
Talmin84: calls $0.15
Hulk201: calls $0.15
*** FLOP *** [2h 4h 3d]
CashMatteo: checks 
Spankorama: checks 
Talmin84: bets $0.10
Hulk201: folds 
CashMatteo: calls $0.10
Spankorama: calls $0.10
*** TURN *** [2h 4h 3d] [5h]
CashMatteo: checks 
Spankorama: bets $0.67
Talmin84: calls $0.67
CashMatteo: raises $1.38 to $2.05
Spankorama: calls $1.38
Talmin84: folds 
*** RIVER *** [2h 4h 3d 5h] [Kc]
CashMatteo: bets $2.74 and is all-in
Spankorama: calls $2.74
*** SHOW DOWN ***
CashMatteo: shows [8h Ah] (a flush, Ace high)
Spankorama: shows [Ac 6h] (a straight, Deuce to Six)
CashMatteo collected $11.13 from pot
*** SUMMARY ***
Total pot $11.65 | Rake $0.52 
Board [2h 4h 3d 5h Kc]
Seat 1: Spankorama showed [Ac 6h] and lost with a straight, Deuce to Six
Seat 2: Talmin84 folded on the Turn
Seat 3: Dr.Smokealot folded before Flop (didn't bet)
Seat 4: Hulk201 (button) folded on the Flop
Seat 5: CashMatteo (small blind) showed [8h Ah] and won ($11.13) with a flush, Ace high
Seat 6: Ray Jep (big blind) folded before Flop

Hand #1040: 

PokerStars Hand #246617906504:  Hold'em No Limit ($0.05/$0.10 CAD) - 2023/10/19 4:31:32 ET
Table 'Zita' 6-max Seat #5 is the button
Seat 2: Talmin84 ($8.15 in chips) 
Seat 3: Dr.Smokealot ($9.85 in chips) 
Seat 4: Hulk201 ($9.96 in chips) 
Seat 5: CashMatteo ($11.13 in chips) 
Seat 6: Ray Jep ($12.45 in chips) 
Ray Jep: posts small blind $0.05
Spankorama: is sitting out 
Talmin84: posts big blind $0.10
*** HOLE CARDS ***
Dealt to CashMatteo [5c Qh]
Spankorama leaves the table
Dr.Smokealot: folds 
Hulk201: folds 
CashMatteo: folds 
Ray Jep: folds 
Uncalled bet ($0.05) returned to Talmin84
Talmin84 collected $0.10 from pot
*** SUMMARY ***
Total pot $0.10 | Rake $0 
Seat 2: Talmin84 (big blind) collected ($0.10)
Seat 3: Dr.Smokealot folded before Flop (didn't bet)
Seat 4: Hulk201 folded before Flop (didn't bet)
Seat 5: CashMatteo (button) folded before Flop (didn't bet)
Seat 6: Ray Jep (small blind) folded before Flop

Hand #1041: 

PokerStars Hand #246617907440:  Hold'em No Limit ($0.05/$0.10 CAD) - 2023/10/19 4:31:42 ET
Table 'Zita' 6-max Seat #6 is the button
Seat 2: Talmin84 ($8.20 in chips) 
Seat 3: Dr.Smokealot ($9.85 in chips) 
Seat 4: Hulk201 ($9.96 in chips) 
Seat 5: CashMatteo ($11.13 in chips) 
Seat 6: Ray Jep ($12.40 in chips) 
embrun02 joins the table at seat #1 
Talmin84: posts small blind $0.05
Dr.Smokealot: posts big blind $0.10
*** HOLE CARDS ***
Dealt to CashMatteo [2s Js]
Hulk201: calls $0.10
CashMatteo: calls $0.10
Ray Jep: folds 
Talmin84: calls $0.05
Dr.Smokealot: checks 
*** FLOP *** [3d Ah 9s]
Talmin84: checks 
Dr.Smokealot: checks 
Hulk201: bets $0.10
CashMatteo: folds 
Talmin84: folds 
Dr.Smokealot: raises $0.10 to $0.20
Hulk201: calls $0.10
*** TURN *** [3d Ah 9s] [8s]
Dr.Smokealot: bets $1.06
Hulk201: folds 
Uncalled bet ($1.06) returned to Dr.Smokealot
Dr.Smokealot collected $0.76 from pot
Dr.Smokealot: doesn't show hand 
*** SUMMARY ***
Total pot $0.80 | Rake $0.04 
Board [3d Ah 9s 8s]
Seat 2: Talmin84 (small blind) folded on the Flop
Seat 3: Dr.Smokealot (big blind) collected ($0.76)
Seat 4: Hulk201 folded on the Turn
Seat 5: CashMatteo folded on the Flop
Seat 6: Ray Jep (button) folded before Flop (didn't bet)

Hand #1042: 

PokerStars Hand #246617911104:  Hold'em No Limit ($0.05/$0.10 CAD) - 2023/10/19 4:32:19 ET
Table 'Zita' 6-max Seat #2 is the button
Seat 2: Talmin84 ($8.10 in chips) 
Seat 3: Dr.Smokealot ($10.31 in chips) 
Seat 4: Hulk201 ($9.66 in chips) 
Seat 5: CashMatteo ($11.03 in chips) 
Seat 6: Ray Jep ($12.40 in chips) 
Dr.Smokealot: posts small blind $0.05
Hulk201: posts big blind $0.10
embrun02: sits out 
*** HOLE CARDS ***
Dealt to CashMatteo [Ah 2h]
CashMatteo: raises $0.15 to $0.25
Ray Jep: calls $0.25
Talmin84: folds 
Dr.Smokealot: calls $0.20
Hulk201: folds 
*** FLOP *** [4c Kh 9c]
Dr.Smokealot: checks 
CashMatteo: checks 
Ray Jep: checks 
*** TURN *** [4c Kh 9c] [8s]
Dr.Smokealot: checks 
CashMatteo: checks 
Ray Jep: checks 
*** RIVER *** [4c Kh 9c 8s] [Th]
Dr.Smokealot: bets $1.51
CashMatteo: folds 
Ray Jep: folds 
Uncalled bet ($1.51) returned to Dr.Smokealot
Dr.Smokealot collected $0.81 from pot
Dr.Smokealot: doesn't show hand 
*** SUMMARY ***
Total pot $0.85 | Rake $0.04 
Board [4c Kh 9c 8s Th]
Seat 2: Talmin84 (button) folded before Flop (didn't bet)
Seat 3: Dr.Smokealot (small blind) collected ($0.81)
Seat 4: Hulk201 (big blind) folded before Flop
Seat 5: CashMatteo folded on the River
Seat 6: Ray Jep folded on the River

Hand #1043: 

PokerStars Hand #246617915419:  Hold'em No Limit ($0.05/$0.10 CAD) - 2023/10/19 4:33:03 ET
Table 'Zita' 6-max Seat #3 is the button
Seat 2: Talmin84 ($8.10 in chips) 
Seat 3: Dr.Smokealot ($10.87 in chips) 
Seat 4: Hulk201 ($9.56 in chips) 
Seat 5: CashMatteo ($10.78 in chips) 
Seat 6: Ray Jep ($12.15 in chips) 
Hulk201: posts small blind $0.05
CashMatteo: posts big blind $0.10
embrun02: sits out 
*** HOLE CARDS ***
Dealt to CashMatteo [6d Ad]
Ray Jep: folds 
Talmin84: calls $0.10
Dr.Smokealot: folds 
Hulk201: calls $0.05
Ray Jep leaves the table
CashMatteo: raises $0.15 to $0.25
Talmin84: calls $0.15
Hulk201: calls $0.15
*** FLOP *** [9s 9c 6s]
Hulk201: checks 
CashMatteo: bets $0.36
Talmin84: folds 
Hulk201: calls $0.36
*** TURN *** [9s 9c 6s] [Jh]
Hulk201: checks 
CashMatteo: checks 
*** RIVER *** [9s 9c 6s Jh] [Kh]
Hulk201: checks 
CashMatteo: checks 
*** SHOW DOWN ***
Hulk201: shows [7s Ks] (two pair, Kings and Nines)
CashMatteo: mucks hand 
Hulk201 collected $1.40 from pot
*** SUMMARY ***
Total pot $1.47 | Rake $0.07 
Board [9s 9c 6s Jh Kh]
Seat 2: Talmin84 folded on the Flop
Seat 3: Dr.Smokealot (button) folded before Flop (didn't bet)
Seat 4: Hulk201 (small blind) showed [7s Ks] and won ($1.40) with two pair, Kings and Nines
Seat 5: CashMatteo (big blind) mucked [6d Ad]
Seat 6: Ray Jep folded before Flop (didn't bet)

Hand #1044: 

PokerStars Hand #246617919345:  Hold'em No Limit ($0.05/$0.10 CAD) - 2023/10/19 4:33:43 ET
Table 'Zita' 6-max Seat #4 is the button
Seat 1: embrun02 ($8 in chips) 
Seat 2: Talmin84 ($7.85 in chips) 
Seat 3: Dr.Smokealot ($10.87 in chips) 
Seat 4: Hulk201 ($10.35 in chips) 
Seat 5: CashMatteo ($10.17 in chips) 
CashMatteo: posts small blind $0.05
embrun02: posts big blind $0.10
*** HOLE CARDS ***
Dealt to CashMatteo [2d Ac]
Talmin84: folds 
Dr.Smokealot: calls $0.10
Hulk201: calls $0.10
CashMatteo: calls $0.05
embrun02: checks 
*** FLOP *** [3h 7s Td]
CashMatteo: checks 
embrun02: checks 
Dr.Smokealot: checks 
Hulk201: bets $0.10
CashMatteo: folds 
embrun02: folds 
Dr.Smokealot: folds 
Uncalled bet ($0.10) returned to Hulk201
Hulk201 collected $0.38 from pot
Hulk201: doesn't show hand 
*** SUMMARY ***
Total pot $0.40 | Rake $0.02 
Board [3h 7s Td]
Seat 1: embrun02 (big blind) folded on the Flop
Seat 2: Talmin84 folded before Flop (didn't bet)
Seat 3: Dr.Smokealot folded on the Flop
Seat 4: Hulk201 (button) collected ($0.38)
Seat 5: CashMatteo (small blind) folded on the Flop

Hand #1045: 

PokerStars Hand #246617922480:  Hold'em No Limit ($0.05/$0.10 CAD) - 2023/10/19 4:34:16 ET
Table 'Zita' 6-max Seat #5 is the button
Seat 1: embrun02 ($7.90 in chips) 
Seat 2: Talmin84 ($7.85 in chips) 
Seat 3: Dr.Smokealot ($10.77 in chips) 
Seat 4: Hulk201 ($10.63 in chips) 
Seat 5: CashMatteo ($10.07 in chips) 
embrun02: posts small blind $0.05
Talmin84: posts big blind $0.10
*** HOLE CARDS ***
Dealt to CashMatteo [2c 5h]
Dr.Smokealot: folds 
Hulk201: calls $0.10
CashMatteo: folds 
embrun02: calls $0.05
Talmin84: checks 
*** FLOP *** [Qc 6h 4d]
embrun02: checks 
Talmin84: checks 
Hulk201: checks 
*** TURN *** [Qc 6h 4d] [2d]
embrun02: checks 
Talmin84: bets $0.10
Hulk201: folds 
embrun02: folds 
Uncalled bet ($0.10) returned to Talmin84
Talmin84 collected $0.29 from pot
*** SUMMARY ***
Total pot $0.30 | Rake $0.01 
Board [Qc 6h 4d 2d]
Seat 1: embrun02 (small blind) folded on the Turn
Seat 2: Talmin84 (big blind) collected ($0.29)
Seat 3: Dr.Smokealot folded before Flop (didn't bet)
Seat 4: Hulk201 folded on the Turn
Seat 5: CashMatteo (button) folded before Flop (didn't bet)

Hand #1046: 

PokerStars Hand #246617925080:  Hold'em No Limit ($0.05/$0.10 CAD) - 2023/10/19 4:34:42 ET
Table 'Zita' 6-max Seat #1 is the button
Seat 1: embrun02 ($7.80 in chips) 
Seat 2: Talmin84 ($8.04 in chips) 
Seat 3: Dr.Smokealot ($10.77 in chips) 
Seat 4: Hulk201 ($10.53 in chips) 
Seat 5: CashMatteo ($10.07 in chips) 
Talmin84: posts small blind $0.05
Dr.Smokealot: posts big blind $0.10
*** HOLE CARDS ***
Dealt to CashMatteo [6d Kd]
Hulk201: calls $0.10
CashMatteo: calls $0.10
embrun02: raises $0.70 to $0.80
Talmin84: folds 
Dr.Smokealot: folds 
Hulk201: folds 
CashMatteo: folds 
Uncalled bet ($0.70) returned to embrun02
embrun02 collected $0.45 from pot
embrun02: doesn't show hand 
*** SUMMARY ***
Total pot $0.45 | Rake $0 
Seat 1: embrun02 (button) collected ($0.45)
Seat 2: Talmin84 (small blind) folded before Flop
Seat 3: Dr.Smokealot (big blind) folded before Flop
Seat 4: Hulk201 folded before Flop
Seat 5: CashMatteo folded before Flop

Hand #1047: 

PokerStars Hand #246617927267:  Hold'em No Limit ($0.05/$0.10 CAD) - 2023/10/19 4:35:05 ET
Table 'Zita' 6-max Seat #2 is the button
Seat 1: embrun02 ($8.15 in chips) 
Seat 2: Talmin84 ($7.99 in chips) 
Seat 3: Dr.Smokealot ($10.67 in chips) 
Seat 4: Hulk201 ($10.43 in chips) 
Seat 5: CashMatteo ($9.97 in chips) 
Dr.Smokealot: posts small blind $0.05
Hulk201: posts big blind $0.10
*** HOLE CARDS ***
Dealt to CashMatteo [7c 4s]
CashMatteo: folds 
embrun02: raises $0.20 to $0.30
CashMatteo leaves the table
Talmin84: folds 
Dr.Smokealot: calls $0.25
Hulk201: calls $0.20
*** FLOP *** [5c 3d 4h]
Dr.Smokealot: checks 
Hulk201: checks 
embrun02: checks 
*** TURN *** [5c 3d 4h] [5s]
Dr.Smokealot: checks 
Hulk201: checks 
embrun02: checks 
*** RIVER *** [5c 3d 4h 5s] [Js]
captbacc joins the table at seat #5 
Dr.Smokealot: checks 
Hulk201: checks 
embrun02: checks 
*** SHOW DOWN ***
Dr.Smokealot: shows [7d Ad] (a pair of Fives)
Hulk201: shows [Ac 9d] (a pair of Fives - Ace+Jack+Nine kicker)
embrun02: shows [Ks Jd] (two pair, Jacks and Fives)
embrun02 collected $0.86 from pot
*** SUMMARY ***
Total pot $0.90 | Rake $0.04 
Board [5c 3d 4h 5s Js]
Seat 1: embrun02 showed [Ks Jd] and won ($0.86) with two pair, Jacks and Fives
Seat 2: Talmin84 (button) folded before Flop (didn't bet)
Seat 3: Dr.Smokealot (small blind) showed [7d Ad] and lost with a pair of Fives
Seat 4: Hulk201 (big blind) showed [Ac 9d] and lost with a pair of Fives
Seat 5: CashMatteo folded before Flop (didn't bet)

Hand #1048: 

PokerStars Hand #246652770186: Tournament #3661817423, $0.23+$0.02 CAD Hold'em No Limit - Level I (10/20) - 2023/10/20 22:56:49 ET
Table '3661817423 1' 3-max Seat #1 is the button
Seat 1: BenjaminClub (500 in chips) 
Seat 2: 3Suzanne1966 (500 in chips) 
Seat 3: CashMatteo (500 in chips) 
3Suzanne1966: posts small blind 10
CashMatteo: posts big blind 20
*** HOLE CARDS ***
Dealt to CashMatteo [7s 2c]
BenjaminClub: raises 20 to 40
3Suzanne1966: calls 30
CashMatteo: folds 
*** FLOP *** [Td 5d 7d]
3Suzanne1966: checks 
BenjaminClub: checks 
*** TURN *** [Td 5d 7d] [7c]
3Suzanne1966: checks 
BenjaminClub: checks 
*** RIVER *** [Td 5d 7d 7c] [8h]
3Suzanne1966: bets 100
BenjaminClub: folds 
Uncalled bet (100) returned to 3Suzanne1966
3Suzanne1966 collected 100 from pot
3Suzanne1966: doesn't show hand 
*** SUMMARY ***
Total pot 100 | Rake 0 
Board [Td 5d 7d 7c 8h]
Seat 1: BenjaminClub (button) folded on the River
Seat 2: 3Suzanne1966 (small blind) collected (100)
Seat 3: CashMatteo (big blind) folded before Flop

Hand #1049: 

PokerStars Hand #246652772995: Tournament #3661817423, $0.23+$0.02 CAD Hold'em No Limit - Level I (10/20) - 2023/10/20 22:57:11 ET
Table '3661817423 1' 3-max Seat #2 is the button
Seat 1: BenjaminClub (460 in chips) 
Seat 2: 3Suzanne1966 (560 in chips) 
Seat 3: CashMatteo (480 in chips) 
CashMatteo: posts small blind 10
BenjaminClub: posts big blind 20
*** HOLE CARDS ***
Dealt to CashMatteo [3h 5d]
3Suzanne1966 has timed out
3Suzanne1966: folds 
3Suzanne1966 is sitting out
CashMatteo: folds 
Uncalled bet (10) returned to BenjaminClub
3Suzanne1966 has returned
BenjaminClub collected 20 from pot
BenjaminClub: doesn't show hand 
*** SUMMARY ***
Total pot 20 | Rake 0 
Seat 1: BenjaminClub (big blind) collected (20)
Seat 2: 3Suzanne1966 (button) folded before Flop (didn't bet)
Seat 3: CashMatteo (small blind) folded before Flop

Hand #1050: 

PokerStars Hand #246652775204: Tournament #3661817423, $0.23+$0.02 CAD Hold'em No Limit - Level I (10/20) - 2023/10/20 22:57:27 ET
Table '3661817423 1' 3-max Seat #3 is the button
Seat 1: BenjaminClub (470 in chips) 
Seat 2: 3Suzanne1966 (560 in chips) 
Seat 3: CashMatteo (470 in chips) 
BenjaminClub: posts small blind 10
3Suzanne1966: posts big blind 20
*** HOLE CARDS ***
Dealt to CashMatteo [Kh 6d]
CashMatteo: calls 20
BenjaminClub: calls 10
3Suzanne1966: checks 
*** FLOP *** [9d Qs 2s]
BenjaminClub: checks 
3Suzanne1966: bets 20
CashMatteo: folds 
BenjaminClub: folds 
Uncalled bet (20) returned to 3Suzanne1966
3Suzanne1966 collected 60 from pot
3Suzanne1966: doesn't show hand 
*** SUMMARY ***
Total pot 60 | Rake 0 
Board [9d Qs 2s]
Seat 1: BenjaminClub (small blind) folded on the Flop
Seat 2: 3Suzanne1966 (big blind) collected (60)
Seat 3: CashMatteo (button) folded on the Flop

Hand #1051: 

PokerStars Hand #246652778078: Tournament #3661817423, $0.23+$0.02 CAD Hold'em No Limit - Level I (10/20) - 2023/10/20 22:57:49 ET
Table '3661817423 1' 3-max Seat #1 is the button
Seat 1: BenjaminClub (450 in chips) 
Seat 2: 3Suzanne1966 (600 in chips) 
Seat 3: CashMatteo (450 in chips) 
3Suzanne1966: posts small blind 10
CashMatteo: posts big blind 20
*** HOLE CARDS ***
Dealt to CashMatteo [3d 3s]
BenjaminClub: folds 
3Suzanne1966: calls 10
CashMatteo: raises 30 to 50
3Suzanne1966: calls 30
*** FLOP *** [6s Qd Ts]
3Suzanne1966: bets 20
CashMatteo: calls 20
*** TURN *** [6s Qd Ts] [7s]
3Suzanne1966: bets 20
CashMatteo: calls 20
*** RIVER *** [6s Qd Ts 7s] [As]
3Suzanne1966: bets 20
CashMatteo: calls 20
*** SHOW DOWN ***
3Suzanne1966: shows [Jd Qh] (a pair of Queens)
CashMatteo: shows [3d 3s] (a flush, Ace high)
CashMatteo collected 220 from pot
*** SUMMARY ***
Total pot 220 | Rake 0 
Board [6s Qd Ts 7s As]
Seat 1: BenjaminClub (button) folded before Flop (didn't bet)
Seat 2: 3Suzanne1966 (small blind) showed [Jd Qh] and lost with a pair of Queens
Seat 3: CashMatteo (big blind) showed [3d 3s] and won (220) with a flush, Ace high

Hand #1052: 

PokerStars Hand #246652780973: Tournament #3661817423, $0.23+$0.02 CAD Hold'em No Limit - Level I (10/20) - 2023/10/20 22:58:11 ET
Table '3661817423 1' 3-max Seat #2 is the button
Seat 1: BenjaminClub (450 in chips) 
Seat 2: 3Suzanne1966 (490 in chips) 
Seat 3: CashMatteo (560 in chips) 
CashMatteo: posts small blind 10
BenjaminClub: posts big blind 20
*** HOLE CARDS ***
Dealt to CashMatteo [9s 8s]
3Suzanne1966: calls 20
CashMatteo: raises 30 to 50
BenjaminClub: calls 30
3Suzanne1966: calls 30
*** FLOP *** [Qc Ks Ah]
CashMatteo: checks 
BenjaminClub: checks 
3Suzanne1966: bets 20
CashMatteo: folds 
BenjaminClub: folds 
Uncalled bet (20) returned to 3Suzanne1966
3Suzanne1966 collected 150 from pot
3Suzanne1966: doesn't show hand 
*** SUMMARY ***
Total pot 150 | Rake 0 
Board [Qc Ks Ah]
Seat 1: BenjaminClub (big blind) folded on the Flop
Seat 2: 3Suzanne1966 (button) collected (150)
Seat 3: CashMatteo (small blind) folded on the Flop

Hand #1053: 

PokerStars Hand #246652784105: Tournament #3661817423, $0.23+$0.02 CAD Hold'em No Limit - Level I (10/20) - 2023/10/20 22:58:34 ET
Table '3661817423 1' 3-max Seat #3 is the button
Seat 1: BenjaminClub (400 in chips) 
Seat 2: 3Suzanne1966 (590 in chips) 
Seat 3: CashMatteo (510 in chips) 
BenjaminClub: posts small blind 10
3Suzanne1966: posts big blind 20
*** HOLE CARDS ***
Dealt to CashMatteo [6s Js]
CashMatteo: raises 30 to 50
BenjaminClub: calls 40
3Suzanne1966: calls 30
*** FLOP *** [Kc Kd Ks]
BenjaminClub: checks 
3Suzanne1966: bets 60
CashMatteo: folds 
BenjaminClub: folds 
Uncalled bet (60) returned to 3Suzanne1966
3Suzanne1966 collected 150 from pot
3Suzanne1966: doesn't show hand 
*** SUMMARY ***
Total pot 150 | Rake 0 
Board [Kc Kd Ks]
Seat 1: BenjaminClub (small blind) folded on the Flop
Seat 2: 3Suzanne1966 (big blind) collected (150)
Seat 3: CashMatteo (button) folded on the Flop

Hand #1054: 

PokerStars Hand #246652787049: Tournament #3661817423, $0.23+$0.02 CAD Hold'em No Limit - Level II (15/30) - 2023/10/20 22:58:56 ET
Table '3661817423 1' 3-max Seat #1 is the button
Seat 1: BenjaminClub (350 in chips) 
Seat 2: 3Suzanne1966 (690 in chips) 
Seat 3: CashMatteo (460 in chips) 
3Suzanne1966: posts small blind 15
CashMatteo: posts big blind 30
*** HOLE CARDS ***
Dealt to CashMatteo [Jh 5s]
BenjaminClub: calls 30
3Suzanne1966: folds 
CashMatteo: checks 
*** FLOP *** [Ad Tc Td]
CashMatteo: checks 
BenjaminClub: checks 
*** TURN *** [Ad Tc Td] [3s]
CashMatteo: bets 38
BenjaminClub: calls 38
*** RIVER *** [Ad Tc Td 3s] [Js]
CashMatteo: bets 151
BenjaminClub: calls 151
*** SHOW DOWN ***
CashMatteo: shows [Jh 5s] (two pair, Jacks and Tens)
BenjaminClub: shows [Ks As] (two pair, Aces and Tens)
BenjaminClub collected 453 from pot
*** SUMMARY ***
Total pot 453 | Rake 0 
Board [Ad Tc Td 3s Js]
Seat 1: BenjaminClub (button) showed [Ks As] and won (453) with two pair, Aces and Tens
Seat 2: 3Suzanne1966 (small blind) folded before Flop
Seat 3: CashMatteo (big blind) showed [Jh 5s] and lost with two pair, Jacks and Tens

Hand #1055: 

PokerStars Hand #246652789866: Tournament #3661817423, $0.23+$0.02 CAD Hold'em No Limit - Level II (15/30) - 2023/10/20 22:59:17 ET
Table '3661817423 1' 3-max Seat #2 is the button
Seat 1: BenjaminClub (584 in chips) 
Seat 2: 3Suzanne1966 (675 in chips) 
Seat 3: CashMatteo (241 in chips) 
CashMatteo: posts small blind 15
BenjaminClub: posts big blind 30
*** HOLE CARDS ***
Dealt to CashMatteo [Jh 2d]
3Suzanne1966: folds 
CashMatteo: folds 
Uncalled bet (15) returned to BenjaminClub
BenjaminClub collected 30 from pot
BenjaminClub: doesn't show hand 
*** SUMMARY ***
Total pot 30 | Rake 0 
Seat 1: BenjaminClub (big blind) collected (30)
Seat 2: 3Suzanne1966 (button) folded before Flop (didn't bet)
Seat 3: CashMatteo (small blind) folded before Flop

Hand #1056: 

PokerStars Hand #246652790509: Tournament #3661817423, $0.23+$0.02 CAD Hold'em No Limit - Level II (15/30) - 2023/10/20 22:59:22 ET
Table '3661817423 1' 3-max Seat #3 is the button
Seat 1: BenjaminClub (599 in chips) 
Seat 2: 3Suzanne1966 (675 in chips) 
Seat 3: CashMatteo (226 in chips) 
BenjaminClub: posts small blind 15
3Suzanne1966: posts big blind 30
*** HOLE CARDS ***
Dealt to CashMatteo [Qc 5s]
CashMatteo: folds 
BenjaminClub: raises 120 to 150
3Suzanne1966: raises 525 to 675 and is all-in
BenjaminClub: calls 449 and is all-in
Uncalled bet (76) returned to 3Suzanne1966
*** FLOP *** [4d 7c 9d]
*** TURN *** [4d 7c 9d] [3s]
*** RIVER *** [4d 7c 9d 3s] [6h]
*** SHOW DOWN ***
BenjaminClub: shows [Ts Ac] (high card Ace)
3Suzanne1966: shows [Jc Jh] (a pair of Jacks)
3Suzanne1966 collected 1198 from pot
BenjaminClub finished the tournament in 3rd place
*** SUMMARY ***
Total pot 1198 | Rake 0 
Board [4d 7c 9d 3s 6h]
Seat 1: BenjaminClub (small blind) showed [Ts Ac] and lost with high card Ace
Seat 2: 3Suzanne1966 (big blind) showed [Jc Jh] and won (1198) with a pair of Jacks
Seat 3: CashMatteo (button) folded before Flop (didn't bet)

Hand #1057: 

PokerStars Hand #246652793440: Tournament #3661817423, $0.23+$0.02 CAD Hold'em No Limit - Level II (15/30) - 2023/10/20 22:59:45 ET
Table '3661817423 1' 3-max Seat #2 is the button
Seat 2: 3Suzanne1966 (1274 in chips) 
Seat 3: CashMatteo (226 in chips) 
3Suzanne1966: posts small blind 15
CashMatteo: posts big blind 30
*** HOLE CARDS ***
Dealt to CashMatteo [Ts 9c]
3Suzanne1966: calls 15
CashMatteo: checks 
*** FLOP *** [5s 2d 8c]
CashMatteo: checks 
3Suzanne1966: checks 
*** TURN *** [5s 2d 8c] [Jh]
CashMatteo: checks 
3Suzanne1966: checks 
*** RIVER *** [5s 2d 8c Jh] [Qc]
CashMatteo: bets 60
3Suzanne1966: folds 
Uncalled bet (60) returned to CashMatteo
CashMatteo collected 60 from pot
CashMatteo: doesn't show hand 
*** SUMMARY ***
Total pot 60 | Rake 0 
Board [5s 2d 8c Jh Qc]
Seat 2: 3Suzanne1966 (button) (small blind) folded on the River
Seat 3: CashMatteo (big blind) collected (60)

Hand #1058: 

PokerStars Hand #246652796349: Tournament #3661817423, $0.23+$0.02 CAD Hold'em No Limit - Level II (15/30) - 2023/10/20 23:00:06 ET
Table '3661817423 1' 3-max Seat #3 is the button
Seat 2: 3Suzanne1966 (1244 in chips) 
Seat 3: CashMatteo (256 in chips) 
CashMatteo: posts small blind 15
3Suzanne1966: posts big blind 30
*** HOLE CARDS ***
Dealt to CashMatteo [8c 4h]
CashMatteo: folds 
Uncalled bet (15) returned to 3Suzanne1966
3Suzanne1966 collected 30 from pot
3Suzanne1966: doesn't show hand 
*** SUMMARY ***
Total pot 30 | Rake 0 
Seat 2: 3Suzanne1966 (big blind) collected (30)
Seat 3: CashMatteo (button) (small blind) folded before Flop

Hand #1059: 

PokerStars Hand #246652796916: Tournament #3661817423, $0.23+$0.02 CAD Hold'em No Limit - Level II (15/30) - 2023/10/20 23:00:10 ET
Table '3661817423 1' 3-max Seat #2 is the button
Seat 2: 3Suzanne1966 (1259 in chips) 
Seat 3: CashMatteo (241 in chips) 
3Suzanne1966: posts small blind 15
CashMatteo: posts big blind 30
*** HOLE CARDS ***
Dealt to CashMatteo [8h 5c]
3Suzanne1966: folds 
Uncalled bet (15) returned to CashMatteo
CashMatteo collected 30 from pot
CashMatteo: doesn't show hand 
*** SUMMARY ***
Total pot 30 | Rake 0 
Seat 2: 3Suzanne1966 (button) (small blind) folded before Flop
Seat 3: CashMatteo (big blind) collected (30)

Hand #1060: 

PokerStars Hand #246652797551: Tournament #3661817423, $0.23+$0.02 CAD Hold'em No Limit - Level II (15/30) - 2023/10/20 23:00:14 ET
Table '3661817423 1' 3-max Seat #3 is the button
Seat 2: 3Suzanne1966 (1244 in chips) 
Seat 3: CashMatteo (256 in chips) 
CashMatteo: posts small blind 15
3Suzanne1966: posts big blind 30
*** HOLE CARDS ***
Dealt to CashMatteo [Js As]
CashMatteo: raises 45 to 75
3Suzanne1966: calls 45
*** FLOP *** [Kc 8s 5c]
3Suzanne1966: bets 30
CashMatteo: raises 151 to 181 and is all-in
3Suzanne1966: calls 151
*** TURN *** [Kc 8s 5c] [5h]
*** RIVER *** [Kc 8s 5c 5h] [6s]
*** SHOW DOWN ***
3Suzanne1966: shows [8c 3c] (two pair, Eights and Fives)
CashMatteo: shows [Js As] (a pair of Fives)
3Suzanne1966 collected 512 from pot
CashMatteo finished the tournament in 2nd place
3Suzanne1966 wins the tournament and receives $0.50 - congratulations!
*** SUMMARY ***
Total pot 512 | Rake 0 
Board [Kc 8s 5c 5h 6s]
Seat 2: 3Suzanne1966 (big blind) showed [8c 3c] and won (512) with two pair, Eights and Fives
Seat 3: CashMatteo (button) (small blind) showed [Js As] and lost with a pair of Fives

Hand #1061: 

PokerStars Hand #246652803274: Tournament #3661818371, $0.23+$0.02 CAD Hold'em No Limit - Level I (10/20) - 2023/10/20 23:00:53 ET
Table '3661818371 1' 3-max Seat #1 is the button
Seat 1: CashMatteo (500 in chips) 
Seat 2: 3Suzanne1966 (500 in chips) 
Seat 3: ThisOrThat2001 (500 in chips) 
3Suzanne1966: posts small blind 10
ThisOrThat2001: posts big blind 20
*** HOLE CARDS ***
Dealt to CashMatteo [Qd 3d]
CashMatteo: calls 20
3Suzanne1966: calls 10
ThisOrThat2001: checks 
*** FLOP *** [Ks 8s 6d]
3Suzanne1966: checks 
ThisOrThat2001: checks 
CashMatteo: bets 30
3Suzanne1966: calls 30
ThisOrThat2001: folds 
*** TURN *** [Ks 8s 6d] [7c]
3Suzanne1966: bets 450 and is all-in
CashMatteo: folds 
Uncalled bet (450) returned to 3Suzanne1966
3Suzanne1966 collected 120 from pot
3Suzanne1966: doesn't show hand 
*** SUMMARY ***
Total pot 120 | Rake 0 
Board [Ks 8s 6d 7c]
Seat 1: CashMatteo (button) folded on the Turn
Seat 2: 3Suzanne1966 (small blind) collected (120)
Seat 3: ThisOrThat2001 (big blind) folded on the Flop

Hand #1062: 

PokerStars Hand #246652808068: Tournament #3661818371, $0.23+$0.02 CAD Hold'em No Limit - Level I (10/20) - 2023/10/20 23:01:25 ET
Table '3661818371 1' 3-max Seat #2 is the button
Seat 1: CashMatteo (450 in chips) 
Seat 2: 3Suzanne1966 (570 in chips) 
Seat 3: ThisOrThat2001 (480 in chips) 
ThisOrThat2001: posts small blind 10
CashMatteo: posts big blind 20
*** HOLE CARDS ***
Dealt to CashMatteo [2h Qs]
3Suzanne1966: folds 
ThisOrThat2001: folds 
Uncalled bet (10) returned to CashMatteo
CashMatteo collected 20 from pot
CashMatteo: doesn't show hand 
*** SUMMARY ***
Total pot 20 | Rake 0 
Seat 1: CashMatteo (big blind) collected (20)
Seat 2: 3Suzanne1966 (button) folded before Flop (didn't bet)
Seat 3: ThisOrThat2001 (small blind) folded before Flop

Hand #1063: 

PokerStars Hand #246652809093: Tournament #3661818371, $0.23+$0.02 CAD Hold'em No Limit - Level I (10/20) - 2023/10/20 23:01:31 ET
Table '3661818371 1' 3-max Seat #3 is the button
Seat 1: CashMatteo (460 in chips) 
Seat 2: 3Suzanne1966 (570 in chips) 
Seat 3: ThisOrThat2001 (470 in chips) 
CashMatteo: posts small blind 10
3Suzanne1966: posts big blind 20
*** HOLE CARDS ***
Dealt to CashMatteo [9c Ah]
ThisOrThat2001: raises 80 to 100
CashMatteo: calls 90
3Suzanne1966: folds 
*** FLOP *** [5d 6c 2s]
CashMatteo: checks 
ThisOrThat2001: bets 370 and is all-in
CashMatteo: folds 
Uncalled bet (370) returned to ThisOrThat2001
ThisOrThat2001 collected 220 from pot
ThisOrThat2001: doesn't show hand 
*** SUMMARY ***
Total pot 220 | Rake 0 
Board [5d 6c 2s]
Seat 1: CashMatteo (small blind) folded on the Flop
Seat 2: 3Suzanne1966 (big blind) folded before Flop
Seat 3: ThisOrThat2001 (button) collected (220)

Hand #1064: 

PokerStars Hand #246652812824: Tournament #3661818371, $0.23+$0.02 CAD Hold'em No Limit - Level I (10/20) - 2023/10/20 23:01:55 ET
Table '3661818371 1' 3-max Seat #1 is the button
Seat 1: CashMatteo (360 in chips) 
Seat 2: 3Suzanne1966 (550 in chips) 
Seat 3: ThisOrThat2001 (590 in chips) 
3Suzanne1966: posts small blind 10
ThisOrThat2001: posts big blind 20
*** HOLE CARDS ***
Dealt to CashMatteo [4d 7s]
CashMatteo: folds 
3Suzanne1966: raises 60 to 80
ThisOrThat2001: raises 510 to 590 and is all-in
3Suzanne1966: calls 470 and is all-in
Uncalled bet (40) returned to ThisOrThat2001
*** FLOP *** [Ts Qs 2c]
*** TURN *** [Ts Qs 2c] [5s]
*** RIVER *** [Ts Qs 2c 5s] [Jc]
*** SHOW DOWN ***
3Suzanne1966: shows [Ah 2d] (a pair of Deuces)
ThisOrThat2001: shows [7h Ad] (high card Ace)
3Suzanne1966 collected 1100 from pot
*** SUMMARY ***
Total pot 1100 | Rake 0 
Board [Ts Qs 2c 5s Jc]
Seat 1: CashMatteo (button) folded before Flop (didn't bet)
Seat 2: 3Suzanne1966 (small blind) showed [Ah 2d] and won (1100) with a pair of Deuces
Seat 3: ThisOrThat2001 (big blind) showed [7h Ad] and lost with high card Ace

Hand #1065: 

PokerStars Hand #246652815779: Tournament #3661818371, $0.23+$0.02 CAD Hold'em No Limit - Level I (10/20) - 2023/10/20 23:02:14 ET
Table '3661818371 1' 3-max Seat #2 is the button
Seat 1: CashMatteo (360 in chips) 
Seat 2: 3Suzanne1966 (1100 in chips) 
Seat 3: ThisOrThat2001 (40 in chips) 
ThisOrThat2001: posts small blind 10
CashMatteo: posts big blind 20
*** HOLE CARDS ***
Dealt to CashMatteo [2h 3s]
3Suzanne1966: raises 1080 to 1100 and is all-in
ThisOrThat2001: folds 
CashMatteo: folds 
Uncalled bet (1080) returned to 3Suzanne1966
3Suzanne1966 collected 50 from pot
3Suzanne1966: doesn't show hand 
*** SUMMARY ***
Total pot 50 | Rake 0 
Seat 1: CashMatteo (big blind) folded before Flop
Seat 2: 3Suzanne1966 (button) collected (50)
Seat 3: ThisOrThat2001 (small blind) folded before Flop

Hand #1066: 

PokerStars Hand #246652817748: Tournament #3661818371, $0.23+$0.02 CAD Hold'em No Limit - Level I (10/20) - 2023/10/20 23:02:27 ET
Table '3661818371 1' 3-max Seat #3 is the button
Seat 1: CashMatteo (340 in chips) 
Seat 2: 3Suzanne1966 (1130 in chips) 
Seat 3: ThisOrThat2001 (30 in chips) 
CashMatteo: posts small blind 10
3Suzanne1966: posts big blind 20
*** HOLE CARDS ***
Dealt to CashMatteo [Ks 4c]
ThisOrThat2001 said, "#ScamAlert"
ThisOrThat2001: folds 
CashMatteo: calls 10
3Suzanne1966: raises 20 to 40
CashMatteo: calls 20
*** FLOP *** [6h Jh Qd]
CashMatteo: checks 
3Suzanne1966: bets 20
CashMatteo: raises 60 to 80
ThisOrThat2001 said, ""i hope your dogs die" joke by Redd Foxx"
3Suzanne1966 said, "u poor sore ;lose lol"
3Suzanne1966: calls 60
*** TURN *** [6h Jh Qd] [3d]
CashMatteo: checks 
3Suzanne1966: checks 
*** RIVER *** [6h Jh Qd 3d] [6c]
ThisOrThat2001 said, "scammers deserve cancer"
CashMatteo: checks 
ThisOrThat2001 said, "A2o is fold to an open jam"
3Suzanne1966 said, "i scammer stfu my guy"
3Suzanne1966: checks 
*** SHOW DOWN ***
CashMatteo: shows [Ks 4c] (a pair of Sixes)
3Suzanne1966: mucks hand 
CashMatteo collected 240 from pot
*** SUMMARY ***
Total pot 240 | Rake 0 
Board [6h Jh Qd 3d 6c]
Seat 1: CashMatteo (small blind) showed [Ks 4c] and won (240) with a pair of Sixes
Seat 2: 3Suzanne1966 (big blind) mucked [9h 5h]
Seat 3: ThisOrThat2001 (button) folded before Flop (didn't bet)

Hand #1067: 

PokerStars Hand #246652825126: Tournament #3661818371, $0.23+$0.02 CAD Hold'em No Limit - Level I (10/20) - 2023/10/20 23:03:14 ET
Table '3661818371 1' 3-max Seat #1 is the button
Seat 1: CashMatteo (460 in chips) 
Seat 2: 3Suzanne1966 (1010 in chips) 
Seat 3: ThisOrThat2001 (30 in chips) 
3Suzanne1966: posts small blind 10
ThisOrThat2001: posts big blind 20
*** HOLE CARDS ***
Dealt to CashMatteo [6d Qh]
CashMatteo: raises 30 to 50
3Suzanne1966 said, "bye scammer"
3Suzanne1966: calls 40
3Suzanne1966 said, "^^"
ThisOrThat2001: calls 10 and is all-in
*** FLOP *** [Jc 7h 6h]
3Suzanne1966: bets 20
CashMatteo: raises 85 to 105
3Suzanne1966 said, "u lose now"
3Suzanne1966: raises 855 to 960 and is all-in
CashMatteo: calls 305 and is all-in
Uncalled bet (550) returned to 3Suzanne1966
*** TURN *** [Jc 7h 6h] [5s]
*** RIVER *** [Jc 7h 6h 5s] [8d]
*** SHOW DOWN ***
3Suzanne1966: shows [6s Jh] (two pair, Jacks and Sixes)
CashMatteo: shows [6d Qh] (a pair of Sixes)
3Suzanne1966 collected 860 from side pot
ThisOrThat2001: shows [Ac Qd] (high card Ace)
3Suzanne1966 collected 90 from main pot
CashMatteo finished the tournament in 2nd place
ThisOrThat2001 finished the tournament in 3rd place
3Suzanne1966 wins the tournament and receives $0.75 - congratulations!
*** SUMMARY ***
Total pot 950 Main pot 90. Side pot 860. | Rake 0 
Board [Jc 7h 6h 5s 8d]
Seat 1: CashMatteo (button) showed [6d Qh] and lost with a pair of Sixes
Seat 2: 3Suzanne1966 (small blind) showed [6s Jh] and won (950) with two pair, Jacks and Sixes
Seat 3: ThisOrThat2001 (big blind) showed [Ac Qd] and lost with high card Ace

Hand #1068: 

PokerStars Hand #246652837629:  Hold'em No Limit ($0.05/$0.10 CAD) - 2023/10/20 23:04:36 ET
Table 'Scabiosa' 6-max Seat #5 is the button
Seat 1: yunggun31 ($7.83 in chips) 
Seat 2: CashMatteo ($10 in chips) 
Seat 3: conman899 ($9.90 in chips) 
Seat 4: Villa0722 ($8.28 in chips) 
Seat 5: northpike14 ($11.50 in chips) 
Seat 6: popperstoic ($4.27 in chips) 
popperstoic: posts small blind $0.05
yunggun31: posts big blind $0.10
CashMatteo: posts big blind $0.10
*** HOLE CARDS ***
Dealt to CashMatteo [8h Jd]
CashMatteo: checks 
conman899: raises $0.35 to $0.45
Villa0722: folds 
northpike14: folds 
popperstoic: folds 
yunggun31: calls $0.35
CashMatteo: folds 
*** FLOP *** [Ks Ad 5c]
yunggun31: checks 
conman899: checks 
*** TURN *** [Ks Ad 5c] [Ah]
yunggun31: bets $0.30
conman899: calls $0.30
*** RIVER *** [Ks Ad 5c Ah] [Jh]
yunggun31: checks 
conman899: checks 
*** SHOW DOWN ***
yunggun31: shows [6c Kh] (two pair, Aces and Kings)
conman899: shows [Qh Kc] (two pair, Aces and Kings - Queen kicker)
conman899 collected $1.58 from pot
*** SUMMARY ***
Total pot $1.65 | Rake $0.07 
Board [Ks Ad 5c Ah Jh]
Seat 1: yunggun31 (big blind) showed [6c Kh] and lost with two pair, Aces and Kings
Seat 2: CashMatteo folded before Flop (didn't bet)
Seat 3: conman899 showed [Qh Kc] and won ($1.58) with two pair, Aces and Kings
Seat 4: Villa0722 folded before Flop (didn't bet)
Seat 5: northpike14 (button) folded before Flop (didn't bet)
Seat 6: popperstoic (small blind) folded before Flop

Hand #1069: 

PokerStars Hand #246652842723:  Hold'em No Limit ($0.05/$0.10 CAD) - 2023/10/20 23:05:09 ET
Table 'Scabiosa' 6-max Seat #6 is the button
Seat 1: yunggun31 ($7.08 in chips) 
Seat 2: CashMatteo ($9.90 in chips) 
Seat 3: conman899 ($10.73 in chips) 
Seat 4: Villa0722 ($8.28 in chips) 
Seat 5: northpike14 ($11.50 in chips) 
Seat 6: popperstoic ($4.22 in chips) 
yunggun31: posts small blind $0.05
CashMatteo: posts big blind $0.10
*** HOLE CARDS ***
Dealt to CashMatteo [8c 3d]
conman899: raises $0.25 to $0.35
Villa0722: calls $0.35
northpike14: folds 
popperstoic: folds 
yunggun31: calls $0.30
CashMatteo: folds 
*** FLOP *** [Ah Th 8d]
yunggun31: checks 
conman899: bets $1.10
Villa0722: calls $1.10
yunggun31: folds 
*** TURN *** [Ah Th 8d] [6h]
conman899: checks 
Villa0722: bets $0.96
conman899: raises $0.96 to $1.92
Villa0722: calls $0.96
*** RIVER *** [Ah Th 8d 6h] [2c]
conman899: bets $3.44
Villa0722: calls $3.44
*** SHOW DOWN ***
conman899: shows [7h Qh] (a flush, Ace high)
Villa0722: mucks hand 
conman899 collected $13.44 from pot
*** SUMMARY ***
Total pot $14.07 | Rake $0.63 
Board [Ah Th 8d 6h 2c]
Seat 1: yunggun31 (small blind) folded on the Flop
Seat 2: CashMatteo (big blind) folded before Flop
Seat 3: conman899 showed [7h Qh] and won ($13.44) with a flush, Ace high
Seat 4: Villa0722 mucked [Ts As]
Seat 5: northpike14 folded before Flop (didn't bet)
Seat 6: popperstoic (button) folded before Flop (didn't bet)

Hand #1070: 

PokerStars Hand #246652851777:  Hold'em No Limit ($0.05/$0.10 CAD) - 2023/10/20 23:06:07 ET
Table 'Scabiosa' 6-max Seat #1 is the button
Seat 1: yunggun31 ($6.73 in chips) 
Seat 2: CashMatteo ($9.80 in chips) 
Seat 3: conman899 ($17.36 in chips) 
Seat 4: Villa0722 ($1.47 in chips) 
Seat 5: northpike14 ($11.50 in chips) 
Seat 6: popperstoic ($4.22 in chips) 
CashMatteo: posts small blind $0.05
conman899: posts big blind $0.10
*** HOLE CARDS ***
Dealt to CashMatteo [Qh 8c]
Villa0722: calls $0.10
northpike14: calls $0.10
popperstoic: folds 
yunggun31: raises $0.20 to $0.30
CashMatteo: calls $0.25
conman899: calls $0.20
Villa0722: folds 
northpike14: calls $0.20
*** FLOP *** [Ad Kc Ah]
CashMatteo: checks 
conman899: checks 
northpike14: checks 
yunggun31: checks 
*** TURN *** [Ad Kc Ah] [5c]
CashMatteo: checks 
conman899: checks 
northpike14: bets $0.70
yunggun31: calls $0.70
CashMatteo: folds 
conman899: folds 
*** RIVER *** [Ad Kc Ah 5c] [Qs]
northpike14: bets $0.90
yunggun31: raises $2.10 to $3
northpike14: folds 
Uncalled bet ($2.10) returned to yunggun31
yunggun31 collected $4.30 from pot
*** SUMMARY ***
Total pot $4.50 | Rake $0.20 
Board [Ad Kc Ah 5c Qs]
Seat 1: yunggun31 (button) collected ($4.30)
Seat 2: CashMatteo (small blind) folded on the Turn
Seat 3: conman899 (big blind) folded on the Turn
Seat 4: Villa0722 folded before Flop
Seat 5: northpike14 folded on the River
Seat 6: popperstoic folded before Flop (didn't bet)

Hand #1071: 

PokerStars Hand #246652862875:  Hold'em No Limit ($0.05/$0.10 CAD) - 2023/10/20 23:07:20 ET
Table 'Scabiosa' 6-max Seat #2 is the button
Seat 1: yunggun31 ($9.13 in chips) 
Seat 2: CashMatteo ($9.50 in chips) 
Seat 3: conman899 ($17.06 in chips) 
Seat 4: Villa0722 ($10 in chips) 
Seat 5: northpike14 ($9.60 in chips) 
Seat 6: popperstoic ($4.22 in chips) 
conman899: posts small blind $0.05
Villa0722: posts big blind $0.10
*** HOLE CARDS ***
Dealt to CashMatteo [Jd Ad]
northpike14: calls $0.10
popperstoic: folds 
yunggun31: calls $0.10
CashMatteo: raises $0.15 to $0.25
conman899: folds 
Villa0722: calls $0.15
northpike14: calls $0.15
yunggun31: calls $0.15
*** FLOP *** [2h 3s Qc]
Villa0722: checks 
northpike14: checks 
yunggun31: bets $0.50
CashMatteo: calls $0.50
Villa0722: calls $0.50
northpike14: folds 
*** TURN *** [2h 3s Qc] [5d]
Villa0722: checks 
yunggun31: bets $0.80
CashMatteo: folds 
Villa0722: calls $0.80
*** RIVER *** [2h 3s Qc 5d] [2c]
Villa0722: checks 
yunggun31: checks 
*** SHOW DOWN ***
Villa0722: shows [4s 5s] (two pair, Fives and Deuces)
yunggun31: shows [5h Qd] (two pair, Queens and Fives)
yunggun31 collected $3.96 from pot
*** SUMMARY ***
Total pot $4.15 | Rake $0.19 
Board [2h 3s Qc 5d 2c]
Seat 1: yunggun31 showed [5h Qd] and won ($3.96) with two pair, Queens and Fives
Seat 2: CashMatteo (button) folded on the Turn
Seat 3: conman899 (small blind) folded before Flop
Seat 4: Villa0722 (big blind) showed [4s 5s] and lost with two pair, Fives and Deuces
Seat 5: northpike14 folded on the Flop
Seat 6: popperstoic folded before Flop (didn't bet)

Hand #1072: 

PokerStars Hand #246652870299:  Hold'em No Limit ($0.05/$0.10 CAD) - 2023/10/20 23:08:10 ET
Table 'Scabiosa' 6-max Seat #3 is the button
Seat 1: yunggun31 ($11.54 in chips) 
Seat 2: CashMatteo ($8.75 in chips) 
Seat 3: conman899 ($17.01 in chips) 
Seat 4: Villa0722 ($8.45 in chips) 
Seat 5: northpike14 ($9.35 in chips) 
Seat 6: popperstoic ($4.22 in chips) 
Villa0722: posts small blind $0.05
northpike14: posts big blind $0.10
*** HOLE CARDS ***
Dealt to CashMatteo [8c Qh]
popperstoic: calls $0.10
yunggun31: calls $0.10
CashMatteo: calls $0.10
conman899: raises $0.55 to $0.65
Villa0722: folds 
northpike14: folds 
popperstoic: calls $0.55
yunggun31: folds 
CashMatteo: folds 
*** FLOP *** [2h As Ac]
popperstoic: checks 
conman899: bets $0.79
popperstoic: folds 
Uncalled bet ($0.79) returned to conman899
conman899 collected $1.58 from pot
*** SUMMARY ***
Total pot $1.65 | Rake $0.07 
Board [2h As Ac]
Seat 1: yunggun31 folded before Flop
Seat 2: CashMatteo folded before Flop
Seat 3: conman899 (button) collected ($1.58)
Seat 4: Villa0722 (small blind) folded before Flop
Seat 5: northpike14 (big blind) folded before Flop
Seat 6: popperstoic folded on the Flop

Hand #1073: 

PokerStars Hand #246652874554:  Hold'em No Limit ($0.05/$0.10 CAD) - 2023/10/20 23:08:38 ET
Table 'Scabiosa' 6-max Seat #4 is the button
Seat 1: yunggun31 ($11.44 in chips) 
Seat 2: CashMatteo ($8.65 in chips) 
Seat 3: conman899 ($17.94 in chips) 
Seat 4: Villa0722 ($8.40 in chips) 
Seat 5: northpike14 ($9.25 in chips) 
Seat 6: popperstoic ($3.57 in chips) 
northpike14: posts small blind $0.05
popperstoic: posts big blind $0.10
*** HOLE CARDS ***
Dealt to CashMatteo [5s Kd]
yunggun31: folds 
CashMatteo: calls $0.10
conman899: folds 
Villa0722 has timed out
Villa0722: folds 
northpike14: calls $0.05
popperstoic: checks 
*** FLOP *** [Qh Ts 5h]
northpike14: checks 
popperstoic: checks 
CashMatteo: bets $0.15
northpike14: calls $0.15
popperstoic: calls $0.15
*** TURN *** [Qh Ts 5h] [6s]
northpike14: checks 
popperstoic: bets $0.36
CashMatteo: calls $0.36
northpike14: calls $0.36
*** RIVER *** [Qh Ts 5h 6s] [5d]
northpike14: checks 
popperstoic: checks 
CashMatteo: bets $0.88
northpike14: folds 
popperstoic: folds 
Uncalled bet ($0.88) returned to CashMatteo
CashMatteo collected $1.75 from pot
CashMatteo: doesn't show hand 
*** SUMMARY ***
Total pot $1.83 | Rake $0.08 
Board [Qh Ts 5h 6s 5d]
Seat 1: yunggun31 folded before Flop (didn't bet)
Seat 2: CashMatteo collected ($1.75)
Seat 3: conman899 folded before Flop (didn't bet)
Seat 4: Villa0722 (button) folded before Flop (didn't bet)
Seat 5: northpike14 (small blind) folded on the River
Seat 6: popperstoic (big blind) folded on the River

Hand #1074: 

PokerStars Hand #246652883725:  Hold'em No Limit ($0.05/$0.10 CAD) - 2023/10/20 23:09:40 ET
Table 'Scabiosa' 6-max Seat #5 is the button
Seat 1: yunggun31 ($11.44 in chips) 
Seat 2: CashMatteo ($9.79 in chips) 
Seat 3: conman899 ($17.94 in chips) 
Seat 4: Villa0722 ($10 in chips) 
Seat 5: northpike14 ($8.64 in chips) 
Seat 6: popperstoic ($2.96 in chips) 
popperstoic: posts small blind $0.05
yunggun31: posts big blind $0.10
*** HOLE CARDS ***
Dealt to CashMatteo [6d Jc]
CashMatteo: folds 
conman899: raises $0.25 to $0.35
Villa0722: raises $0.55 to $0.90
northpike14: folds 
popperstoic: calls $0.85
yunggun31: calls $0.80
conman899: calls $0.55
*** FLOP *** [9s 9c Js]
popperstoic: bets $2.06 and is all-in
yunggun31: folds 
conman899: folds 
Villa0722: calls $2.06
*** TURN *** [9s 9c Js] [9d]
*** RIVER *** [9s 9c Js 9d] [2h]
*** SHOW DOWN ***
popperstoic: shows [3c 3s] (a full house, Nines full of Threes)
Villa0722: shows [Ac Kc] (three of a kind, Nines)
popperstoic collected $7.37 from pot
*** SUMMARY ***
Total pot $7.72 | Rake $0.35 
Board [9s 9c Js 9d 2h]
Seat 1: yunggun31 (big blind) folded on the Flop
Seat 2: CashMatteo folded before Flop (didn't bet)
Seat 3: conman899 folded on the Flop
Seat 4: Villa0722 showed [Ac Kc] and lost with three of a kind, Nines
Seat 5: northpike14 (button) folded before Flop (didn't bet)
Seat 6: popperstoic (small blind) showed [3c 3s] and won ($7.37) with a full house, Nines full of Threes

Hand #1075: 

PokerStars Hand #246652891238:  Hold'em No Limit ($0.05/$0.10 CAD) - 2023/10/20 23:10:30 ET
Table 'Scabiosa' 6-max Seat #6 is the button
Seat 1: yunggun31 ($10.54 in chips) 
Seat 2: CashMatteo ($9.79 in chips) 
Seat 3: conman899 ($17.04 in chips) 
Seat 4: Villa0722 ($7.04 in chips) 
Seat 5: northpike14 ($8.64 in chips) 
Seat 6: popperstoic ($7.37 in chips) 
yunggun31: posts small blind $0.05
CashMatteo: posts big blind $0.10
*** HOLE CARDS ***
Dealt to CashMatteo [Th 9c]
conman899: folds 
Villa0722: folds 
northpike14: calls $0.10
popperstoic: folds 
yunggun31: calls $0.05
CashMatteo: checks 
*** FLOP *** [Qs 5h 2d]
yunggun31: checks 
CashMatteo: checks 
northpike14: bets $0.20
yunggun31: folds 
CashMatteo: folds 
Uncalled bet ($0.20) returned to northpike14
northpike14 collected $0.29 from pot
*** SUMMARY ***
Total pot $0.30 | Rake $0.01 
Board [Qs 5h 2d]
Seat 1: yunggun31 (small blind) folded on the Flop
Seat 2: CashMatteo (big blind) folded on the Flop
Seat 3: conman899 folded before Flop (didn't bet)
Seat 4: Villa0722 folded before Flop (didn't bet)
Seat 5: northpike14 collected ($0.29)
Seat 6: popperstoic (button) folded before Flop (didn't bet)

Hand #1076: 

PokerStars Hand #246652895829:  Hold'em No Limit ($0.05/$0.10 CAD) - 2023/10/20 23:11:01 ET
Table 'Scabiosa' 6-max Seat #1 is the button
Seat 1: yunggun31 ($10.44 in chips) 
Seat 2: CashMatteo ($9.69 in chips) 
Seat 3: conman899 ($17.04 in chips) 
Seat 4: Villa0722 ($10 in chips) 
Seat 5: northpike14 ($8.83 in chips) 
Seat 6: popperstoic ($7.37 in chips) 
CashMatteo: posts small blind $0.05
conman899: posts big blind $0.10
*** HOLE CARDS ***
Dealt to CashMatteo [As 7d]
Villa0722: raises $0.20 to $0.30
northpike14: calls $0.30
popperstoic: folds 
yunggun31: calls $0.30
CashMatteo: calls $0.25
conman899: raises $1.50 to $1.80
Villa0722: folds 
northpike14: calls $1.50
yunggun31: calls $1.50
CashMatteo: calls $1.50
*** FLOP *** [3s 2s Ks]
CashMatteo: checks 
conman899: bets $3.58
northpike14: folds 
yunggun31: folds 
CashMatteo: raises $4.31 to $7.89 and is all-in
conman899: calls $4.31
*** TURN *** [3s 2s Ks] [2d]
*** RIVER *** [3s 2s Ks 2d] [2c]
*** SHOW DOWN ***
CashMatteo: shows [As 7d] (three of a kind, Deuces)
conman899: shows [Js Ac] (three of a kind, Deuces)
CashMatteo collected $11.12 from pot
conman899 collected $11.11 from pot
*** SUMMARY ***
Total pot $23.28 | Rake $1.05 
Board [3s 2s Ks 2d 2c]
Seat 1: yunggun31 (button) folded on the Flop
Seat 2: CashMatteo (small blind) showed [As 7d] and won ($11.12) with three of a kind, Deuces
Seat 3: conman899 (big blind) showed [Js Ac] and won ($11.11) with three of a kind, Deuces
Seat 4: Villa0722 folded before Flop
Seat 5: northpike14 folded on the Flop
Seat 6: popperstoic folded before Flop (didn't bet)

Hand #1077: 

PokerStars Hand #246652907989:  Hold'em No Limit ($0.05/$0.10 CAD) - 2023/10/20 23:12:23 ET
Table 'Scabiosa' 6-max Seat #2 is the button
Seat 1: yunggun31 ($8.64 in chips) 
Seat 2: CashMatteo ($11.12 in chips) 
Seat 3: conman899 ($18.46 in chips) 
Seat 4: Villa0722 ($9.70 in chips) 
Seat 5: northpike14 ($7.03 in chips) 
Seat 6: popperstoic ($7.37 in chips) 
conman899: posts small blind $0.05
Villa0722: posts big blind $0.10
*** HOLE CARDS ***
Dealt to CashMatteo [Ks 8c]
northpike14: calls $0.10
popperstoic: calls $0.10
yunggun31: calls $0.10
CashMatteo: calls $0.10
conman899: folds 
Villa0722: checks 
*** FLOP *** [9h 3h 7c]
Villa0722: bets $0.27
northpike14: folds 
popperstoic: calls $0.27
yunggun31: folds 
CashMatteo: folds 
*** TURN *** [9h 3h 7c] [Kh]
Villa0722: bets $0.52
popperstoic: calls $0.52
*** RIVER *** [9h 3h 7c Kh] [7h]
Villa0722: bets $8.81 and is all-in
popperstoic: calls $6.48 and is all-in
Uncalled bet ($2.33) returned to Villa0722
*** SHOW DOWN ***
Villa0722: shows [Kd 7s] (a full house, Sevens full of Kings)
popperstoic: shows [2h Th] (a flush, King high)
Villa0722 collected $14.41 from pot
*** SUMMARY ***
Total pot $15.09 | Rake $0.68 
Board [9h 3h 7c Kh 7h]
Seat 1: yunggun31 folded on the Flop
Seat 2: CashMatteo (button) folded on the Flop
Seat 3: conman899 (small blind) folded before Flop
Seat 4: Villa0722 (big blind) showed [Kd 7s] and won ($14.41) with a full house, Sevens full of Kings
Seat 5: northpike14 folded on the Flop
Seat 6: popperstoic showed [2h Th] and lost with a flush, King high

Hand #1078: 

PokerStars Hand #246652917769:  Hold'em No Limit ($0.05/$0.10 CAD) - 2023/10/20 23:13:28 ET
Table 'Scabiosa' 6-max Seat #3 is the button
Seat 1: yunggun31 ($8.54 in chips) 
Seat 2: CashMatteo ($11.02 in chips) 
Seat 3: conman899 ($18.41 in chips) 
Seat 4: Villa0722 ($16.74 in chips) 
Seat 5: northpike14 ($6.93 in chips) 
Villa0722: posts small blind $0.05
northpike14: posts big blind $0.10
*** HOLE CARDS ***
Dealt to CashMatteo [Js 7c]
yunggun31: folds 
CashMatteo: calls $0.10
conman899: raises $0.35 to $0.45
popperstoic leaves the table
Villa0722: calls $0.40
northpike14: calls $0.35
CashMatteo: calls $0.35
*** FLOP *** [Kc 4h 8h]
Villa0722: checks 
northpike14: checks 
CashMatteo: checks 
conman899: checks 
*** TURN *** [Kc 4h 8h] [4c]
Villa0722: bets $0.10
northpike14: raises $0.50 to $0.60
CashMatteo: folds 
conman899: folds 
Villa0722: raises $1.46 to $2.06
northpike14: raises $1.76 to $3.82
Villa0722: raises $12.47 to $16.29 and is all-in
northpike14: calls $2.66 and is all-in
Uncalled bet ($9.81) returned to Villa0722
*** RIVER *** [Kc 4h 8h 4c] [8c]
*** SHOW DOWN ***
Villa0722: shows [5s 4s] (a full house, Fours full of Eights)
northpike14: shows [Ad Kh] (two pair, Kings and Eights)
Villa0722 collected $14.10 from pot
*** SUMMARY ***
Total pot $14.76 | Rake $0.66 
Board [Kc 4h 8h 4c 8c]
Seat 1: yunggun31 folded before Flop (didn't bet)
Seat 2: CashMatteo folded on the Turn
Seat 3: conman899 (button) folded on the Turn
Seat 4: Villa0722 (small blind) showed [5s 4s] and won ($14.10) with a full house, Fours full of Eights
Seat 5: northpike14 (big blind) showed [Ad Kh] and lost with two pair, Kings and Eights

Hand #1079: 

PokerStars Hand #246652927065:  Hold'em No Limit ($0.05/$0.10 CAD) - 2023/10/20 23:14:31 ET
Table 'Scabiosa' 6-max Seat #4 is the button
Seat 1: yunggun31 ($8.54 in chips) 
Seat 2: CashMatteo ($10.57 in chips) 
Seat 3: conman899 ($17.96 in chips) 
Seat 4: Villa0722 ($23.91 in chips) 
yunggun31: posts small blind $0.05
CashMatteo: posts big blind $0.10
*** HOLE CARDS ***
Dealt to CashMatteo [5c 6s]
conman899: raises $0.25 to $0.35
northpike14 leaves the table
Villa0722: folds 
yunggun31: calls $0.30
CashMatteo: folds 
*** FLOP *** [7s 6h 2c]
yunggun31: checks 
conman899: checks 
*** TURN *** [7s 6h 2c] [Tc]
yunggun31: bets $0.50
conman899: folds 
Uncalled bet ($0.50) returned to yunggun31
yunggun31 collected $0.76 from pot
LoCoSi joins the table at seat #5 
*** SUMMARY ***
Total pot $0.80 | Rake $0.04 
Board [7s 6h 2c Tc]
Seat 1: yunggun31 (small blind) collected ($0.76)
Seat 2: CashMatteo (big blind) folded before Flop
Seat 3: conman899 folded on the Turn
Seat 4: Villa0722 (button) folded before Flop (didn't bet)

Hand #1080: 

PokerStars Hand #246652931235:  Hold'em No Limit ($0.05/$0.10 CAD) - 2023/10/20 23:15:00 ET
Table 'Scabiosa' 6-max Seat #1 is the button
Seat 1: yunggun31 ($8.95 in chips) 
Seat 2: CashMatteo ($10.47 in chips) 
Seat 3: conman899 ($17.61 in chips) 
Seat 4: Villa0722 ($23.91 in chips) 
CashMatteo: posts small blind $0.05
conman899: posts big blind $0.10
LoCoSi is connected 
LoCoSi: sits out 
*** HOLE CARDS ***
Dealt to CashMatteo [2c 8s]
Villa0722: raises $0.10 to $0.20
yunggun31: calls $0.20
CashMatteo: folds 
conman899: folds 
*** FLOP *** [9h 2d 6d]
Oldman192 joins the table at seat #6 
Villa0722: checks 
yunggun31: checks 
*** TURN *** [9h 2d 6d] [Ks]
Villa0722: bets $0.27
yunggun31: folds 
Uncalled bet ($0.27) returned to Villa0722
Villa0722 collected $0.53 from pot
Villa0722: doesn't show hand 
*** SUMMARY ***
Total pot $0.55 | Rake $0.02 
Board [9h 2d 6d Ks]
Seat 1: yunggun31 (button) folded on the Turn
Seat 2: CashMatteo (small blind) folded before Flop
Seat 3: conman899 (big blind) folded before Flop
Seat 4: Villa0722 collected ($0.53)

Hand #1081: 

PokerStars Hand #246652935365:  Hold'em No Limit ($0.05/$0.10 CAD) - 2023/10/20 23:15:28 ET
Table 'Scabiosa' 6-max Seat #2 is the button
Seat 1: yunggun31 ($8.75 in chips) 
Seat 2: CashMatteo ($10.42 in chips) 
Seat 3: conman899 ($17.51 in chips) 
Seat 4: Villa0722 ($24.24 in chips) 
conman899: posts small blind $0.05
Villa0722: posts big blind $0.10
LoCoSi: sits out 
Oldman192: sits out 
*** HOLE CARDS ***
Dealt to CashMatteo [Qc 6c]
yunggun31: calls $0.10
CashMatteo: calls $0.10
conman899: raises $0.40 to $0.50
Villa0722: calls $0.40
yunggun31: calls $0.40
CashMatteo: calls $0.40
*** FLOP *** [5h 2c 4h]
conman899: bets $0.96
Villa0722: folds 
yunggun31: calls $0.96
CashMatteo: calls $0.96
*** TURN *** [5h 2c 4h] [3c]
conman899: bets $4.66
yunggun31: folds 
CashMatteo: raises $4.30 to $8.96 and is all-in
conman899: calls $4.30
*** RIVER *** [5h 2c 4h 3c] [5c]
*** SHOW DOWN ***
conman899: shows [8c Ac] (a flush, Ace high)
CashMatteo: shows [Qc 6c] (a flush, Queen high)
conman899 collected $21.77 from pot
*** SUMMARY ***
Total pot $22.80 | Rake $1.03 
Board [5h 2c 4h 3c 5c]
Seat 1: yunggun31 folded on the Turn
Seat 2: CashMatteo (button) showed [Qc 6c] and lost with a flush, Queen high
Seat 3: conman899 (small blind) showed [8c Ac] and won ($21.77) with a flush, Ace high
Seat 4: Villa0722 (big blind) folded on the Flop

Hand #1082: 

PokerStars Hand #246652946880:  Hold'em No Limit ($0.05/$0.10 CAD) - 2023/10/20 23:16:47 ET
Table 'Scabiosa' 6-max Seat #4 is the button
Seat 1: yunggun31 ($7.29 in chips) 
Seat 2: CashMatteo ($10 in chips) 
Seat 3: conman899 ($28.86 in chips) 
Seat 4: Villa0722 ($23.92 in chips) 
Seat 5: LoCoSi ($10 in chips) 
Seat 6: Oldman192 ($5.35 in chips) 
LoCoSi: posts small blind $0.05
Oldman192: posts big blind $0.10
*** HOLE CARDS ***
Dealt to CashMatteo [8c 2d]
yunggun31: raises $0.10 to $0.20
CashMatteo: folds 
conman899: folds 
Villa0722: folds 
LoCoSi: calls $0.15
Oldman192: calls $0.10
*** FLOP *** [9c Th 4h]
LoCoSi: checks 
Oldman192: checks 
yunggun31: checks 
*** TURN *** [9c Th 4h] [Qh]
LoCoSi: checks 
Oldman192: checks 
yunggun31: bets $0.50
LoCoSi: folds 
Oldman192: calls $0.50
*** RIVER *** [9c Th 4h Qh] [As]
Oldman192: checks 
yunggun31: checks 
*** SHOW DOWN ***
Oldman192: shows [Ts Jc] (a pair of Tens)
yunggun31: shows [Jd Kd] (a straight, Ten to Ace)
yunggun31 collected $1.53 from pot
*** SUMMARY ***
Total pot $1.60 | Rake $0.07 
Board [9c Th 4h Qh As]
Seat 1: yunggun31 showed [Jd Kd] and won ($1.53) with a straight, Ten to Ace
Seat 2: CashMatteo folded before Flop (didn't bet)
Seat 3: conman899 folded before Flop (didn't bet)
Seat 4: Villa0722 (button) folded before Flop (didn't bet)
Seat 5: LoCoSi (small blind) folded on the Turn
Seat 6: Oldman192 (big blind) showed [Ts Jc] and lost with a pair of Tens

Hand #1083: 

PokerStars Hand #246652953535:  Hold'em No Limit ($0.05/$0.10 CAD) - 2023/10/20 23:17:32 ET
Table 'Scabiosa' 6-max Seat #5 is the button
Seat 1: yunggun31 ($8.12 in chips) 
Seat 2: CashMatteo ($10 in chips) 
Seat 3: conman899 ($28.86 in chips) 
Seat 4: Villa0722 ($23.92 in chips) 
Seat 5: LoCoSi ($10 in chips) 
Seat 6: Oldman192 ($4.65 in chips) 
Oldman192: posts small blind $0.05
yunggun31: posts big blind $0.10
*** HOLE CARDS ***
Dealt to CashMatteo [3h 5c]
CashMatteo: folds 
conman899: folds 
Villa0722: folds 
LoCoSi: raises $0.20 to $0.30
Oldman192: calls $0.25
yunggun31: calls $0.20
*** FLOP *** [2s 7h 9s]
Oldman192: checks 
yunggun31: checks 
LoCoSi: checks 
*** TURN *** [2s 7h 9s] [Ts]
Oldman192: checks 
yunggun31: bets $0.30
LoCoSi: folds 
Oldman192: folds 
Uncalled bet ($0.30) returned to yunggun31
yunggun31 collected $0.86 from pot
*** SUMMARY ***
Total pot $0.90 | Rake $0.04 
Board [2s 7h 9s Ts]
Seat 1: yunggun31 (big blind) collected ($0.86)
Seat 2: CashMatteo folded before Flop (didn't bet)
Seat 3: conman899 folded before Flop (didn't bet)
Seat 4: Villa0722 folded before Flop (didn't bet)
Seat 5: LoCoSi (button) folded on the Turn
Seat 6: Oldman192 (small blind) folded on the Turn

Hand #1084: 

PokerStars Hand #246652957881:  Hold'em No Limit ($0.05/$0.10 CAD) - 2023/10/20 23:18:01 ET
Table 'Scabiosa' 6-max Seat #6 is the button
Seat 1: yunggun31 ($8.68 in chips) 
Seat 2: CashMatteo ($10 in chips) 
Seat 3: conman899 ($28.86 in chips) 
Seat 4: Villa0722 ($23.92 in chips) 
Seat 5: LoCoSi ($10 in chips) 
Seat 6: Oldman192 ($4.35 in chips) 
yunggun31: posts small blind $0.05
CashMatteo: posts big blind $0.10
*** HOLE CARDS ***
Dealt to CashMatteo [Js Ks]
conman899: folds 
Villa0722: folds 
LoCoSi: folds 
Oldman192: calls $0.10
yunggun31: calls $0.05
CashMatteo: raises $0.15 to $0.25
Oldman192: folds 
yunggun31: folds 
Uncalled bet ($0.15) returned to CashMatteo
CashMatteo collected $0.30 from pot
CashMatteo: doesn't show hand 
*** SUMMARY ***
Total pot $0.30 | Rake $0 
Seat 1: yunggun31 (small blind) folded before Flop
Seat 2: CashMatteo (big blind) collected ($0.30)
Seat 3: conman899 folded before Flop (didn't bet)
Seat 4: Villa0722 folded before Flop (didn't bet)
Seat 5: LoCoSi folded before Flop (didn't bet)
Seat 6: Oldman192 (button) folded before Flop

Hand #1085: 

PokerStars Hand #246652961105:  Hold'em No Limit ($0.05/$0.10 CAD) - 2023/10/20 23:18:24 ET
Table 'Scabiosa' 6-max Seat #1 is the button
Seat 1: yunggun31 ($8.58 in chips) 
Seat 2: CashMatteo ($10.20 in chips) 
Seat 3: conman899 ($28.86 in chips) 
Seat 4: Villa0722 ($23.92 in chips) 
Seat 5: LoCoSi ($10 in chips) 
Seat 6: Oldman192 ($4.25 in chips) 
CashMatteo: posts small blind $0.05
conman899: posts big blind $0.10
*** HOLE CARDS ***
Dealt to CashMatteo [Td 4s]
Villa0722: raises $0.20 to $0.30
LoCoSi: folds 
Oldman192: calls $0.30
yunggun31: calls $0.30
CashMatteo: folds 
conman899: calls $0.20
*** FLOP *** [8c Jc Qh]
conman899: bets $1.19
Villa0722: folds 
Oldman192: raises $2.76 to $3.95 and is all-in
yunggun31: calls $3.95
conman899: raises $24.61 to $28.56 and is all-in
yunggun31: calls $4.33 and is all-in
Uncalled bet ($20.28) returned to conman899
*** TURN *** [8c Jc Qh] [6s]
*** RIVER *** [8c Jc Qh 6s] [Ah]
*** SHOW DOWN ***
conman899: shows [9s Th] (a straight, Eight to Queen)
yunggun31: shows [Kc 5c] (high card Ace)
conman899 collected $8.27 from side pot
Oldman192: shows [Ac Qd] (two pair, Aces and Queens)
conman899 collected $12.51 from main pot
*** SUMMARY ***
Total pot $21.76 Main pot $12.51. Side pot $8.27. | Rake $0.98 
Board [8c Jc Qh 6s Ah]
Seat 1: yunggun31 (button) showed [Kc 5c] and lost with high card Ace
Seat 2: CashMatteo (small blind) folded before Flop
Seat 3: conman899 (big blind) showed [9s Th] and won ($20.78) with a straight, Eight to Queen
Seat 4: Villa0722 folded on the Flop
Seat 5: LoCoSi folded before Flop (didn't bet)
Seat 6: Oldman192 showed [Ac Qd] and lost with two pair, Aces and Queens

Hand #1086: 

PokerStars Hand #246652967703:  Hold'em No Limit ($0.05/$0.10 CAD) - 2023/10/20 23:19:09 ET
Table 'Scabiosa' 6-max Seat #2 is the button
Seat 2: CashMatteo ($10.15 in chips) 
Seat 3: conman899 ($41.06 in chips) 
Seat 4: Villa0722 ($23.62 in chips) 
Seat 5: LoCoSi ($10 in chips) 
conman899: posts small blind $0.05
Villa0722: posts big blind $0.10
*** HOLE CARDS ***
Dealt to CashMatteo [8c 9s]
LoCoSi: folds 
CashMatteo: calls $0.10
conman899: raises $0.30 to $0.40
Villa0722: folds 
CashMatteo: calls $0.30
*** FLOP *** [Jc 7h 3s]
Oldman192 leaves the table
conman899: bets $0.86
yunggun31 leaves the table
CashMatteo: calls $0.86
*** TURN *** [Jc 7h 3s] [4c]
conman899: bets $2.50
CashMatteo: folds 
Uncalled bet ($2.50) returned to conman899
conman899 collected $2.50 from pot
*** SUMMARY ***
Total pot $2.62 | Rake $0.12 
Board [Jc 7h 3s 4c]
Seat 2: CashMatteo (button) folded on the Turn
Seat 3: conman899 (small blind) collected ($2.50)
Seat 4: Villa0722 (big blind) folded before Flop
Seat 5: LoCoSi folded before Flop (didn't bet)

Hand #1087: 

PokerStars Hand #246652972879:  Hold'em No Limit ($0.05/$0.10 CAD) - 2023/10/20 23:19:45 ET
Table 'Scabiosa' 6-max Seat #3 is the button
Seat 2: CashMatteo ($8.89 in chips) 
Seat 3: conman899 ($42.30 in chips) 
Seat 4: Villa0722 ($23.52 in chips) 
Seat 5: LoCoSi ($10 in chips) 
Villa0722: posts small blind $0.05
LoCoSi: posts big blind $0.10
*** HOLE CARDS ***
Dealt to CashMatteo [Kd Qc]
CashMatteo: raises $0.25 to $0.35
conman899: calls $0.35
Villa0722: folds 
LoCoSi: folds 
*** FLOP *** [As 2s 3h]
CashMatteo: bets $0.41
conman899: folds 
Uncalled bet ($0.41) returned to CashMatteo
CashMatteo collected $0.81 from pot
CashMatteo: doesn't show hand 
*** SUMMARY ***
Total pot $0.85 | Rake $0.04 
Board [As 2s 3h]
Seat 2: CashMatteo collected ($0.81)
Seat 3: conman899 (button) folded on the Flop
Seat 4: Villa0722 (small blind) folded before Flop
Seat 5: LoCoSi (big blind) folded before Flop

Hand #1088: 

PokerStars Hand #246652975187:  Hold'em No Limit ($0.05/$0.10 CAD) - 2023/10/20 23:20:00 ET
Table 'Scabiosa' 6-max Seat #4 is the button
Seat 2: CashMatteo ($9.35 in chips) 
Seat 3: conman899 ($41.95 in chips) 
Seat 4: Villa0722 ($23.47 in chips) 
Seat 5: LoCoSi ($10 in chips) 
LoCoSi: posts small blind $0.05
CashMatteo: posts big blind $0.10
*** HOLE CARDS ***
Dealt to CashMatteo [3c 2d]
conman899: folds 
Villa0722: folds 
LoCoSi: folds 
Uncalled bet ($0.05) returned to CashMatteo
CashMatteo collected $0.10 from pot
CashMatteo: doesn't show hand 
*** SUMMARY ***
Total pot $0.10 | Rake $0 
Seat 2: CashMatteo (big blind) collected ($0.10)
Seat 3: conman899 folded before Flop (didn't bet)
Seat 4: Villa0722 (button) folded before Flop (didn't bet)
Seat 5: LoCoSi (small blind) folded before Flop

Hand #1089: 

PokerStars Hand #246652976352:  Hold'em No Limit ($0.05/$0.10 CAD) - 2023/10/20 23:20:08 ET
Table 'Scabiosa' 6-max Seat #5 is the button
Seat 2: CashMatteo ($9.40 in chips) 
Seat 3: conman899 ($41.95 in chips) 
Seat 4: Villa0722 ($23.47 in chips) 
Seat 5: LoCoSi ($10 in chips) 
CashMatteo: posts small blind $0.05
conman899: posts big blind $0.10
*** HOLE CARDS ***
Dealt to CashMatteo [7d 3d]
Villa0722: folds 
LoCoSi: calls $0.10
CashMatteo: calls $0.05
conman899: checks 
*** FLOP *** [9d 5h 9c]
CashMatteo: checks 
conman899: checks 
LoCoSi: checks 
*** TURN *** [9d 5h 9c] [Tc]
CashMatteo: checks 
conman899: bets $0.29
LoCoSi: folds 
CashMatteo: folds 
Uncalled bet ($0.29) returned to conman899
conman899 collected $0.29 from pot
*** SUMMARY ***
Total pot $0.30 | Rake $0.01 
Board [9d 5h 9c Tc]
Seat 2: CashMatteo (small blind) folded on the Turn
Seat 3: conman899 (big blind) collected ($0.29)
Seat 4: Villa0722 folded before Flop (didn't bet)
Seat 5: LoCoSi (button) folded on the Turn

Hand #1090: 

PokerStars Hand #246652980208:  Hold'em No Limit ($0.05/$0.10 CAD) - 2023/10/20 23:20:34 ET
Table 'Scabiosa' 6-max Seat #2 is the button
Seat 2: CashMatteo ($9.30 in chips) 
Seat 3: conman899 ($42.14 in chips) 
Seat 4: Villa0722 ($23.47 in chips) 
Seat 5: LoCoSi ($10 in chips) 
conman899: posts small blind $0.05
Villa0722: posts big blind $0.10
*** HOLE CARDS ***
Dealt to CashMatteo [3c Th]
LoCoSi: calls $0.10
CashMatteo: folds 
conman899: raises $0.30 to $0.40
Villa0722: folds 
LoCoSi: folds 
Uncalled bet ($0.30) returned to conman899
conman899 collected $0.30 from pot
*** SUMMARY ***
Total pot $0.30 | Rake $0 
Seat 2: CashMatteo (button) folded before Flop (didn't bet)
Seat 3: conman899 (small blind) collected ($0.30)
Seat 4: Villa0722 (big blind) folded before Flop
Seat 5: LoCoSi folded before Flop

Hand #1091: 

PokerStars Hand #246652982075:  Hold'em No Limit ($0.05/$0.10 CAD) - 2023/10/20 23:20:46 ET
Table 'Scabiosa' 6-max Seat #3 is the button
Seat 2: CashMatteo ($9.30 in chips) 
Seat 3: conman899 ($42.34 in chips) 
Seat 4: Villa0722 ($23.37 in chips) 
Seat 5: LoCoSi ($10 in chips) 
Villa0722: posts small blind $0.05
LoCoSi: posts big blind $0.10
*** HOLE CARDS ***
Dealt to CashMatteo [Ah Ac]
CashMatteo: raises $0.15 to $0.25
conman899: folds 
Villa0722: folds 
LoCoSi: folds 
Uncalled bet ($0.15) returned to CashMatteo
CashMatteo collected $0.25 from pot
CashMatteo: doesn't show hand 
*** SUMMARY ***
Total pot $0.25 | Rake $0 
Seat 2: CashMatteo collected ($0.25)
Seat 3: conman899 (button) folded before Flop (didn't bet)
Seat 4: Villa0722 (small blind) folded before Flop
Seat 5: LoCoSi (big blind) folded before Flop

Hand #1092: 

PokerStars Hand #246652984100:  Hold'em No Limit ($0.05/$0.10 CAD) - 2023/10/20 23:21:00 ET
Table 'Scabiosa' 6-max Seat #4 is the button
Seat 2: CashMatteo ($9.45 in chips) 
Seat 3: conman899 ($42.34 in chips) 
Seat 4: Villa0722 ($23.32 in chips) 
Seat 5: LoCoSi ($10 in chips) 
LoCoSi: posts small blind $0.05
CashMatteo: posts big blind $0.10
*** HOLE CARDS ***
Dealt to CashMatteo [3s Ks]
conman899: raises $0.25 to $0.35
Villa0722: raises $0.65 to $1
LoCoSi: folds 
CashMatteo: folds 
conman899: calls $0.65
*** FLOP *** [6c Ah Kh]
conman899: checks 
Villa0722: checks 
*** TURN *** [6c Ah Kh] [5c]
conman899: bets $2.05
Villa0722: calls $2.05
*** RIVER *** [6c Ah Kh 5c] [Tc]
conman899: checks 
Villa0722: checks 
*** SHOW DOWN ***
conman899: shows [6s 5s] (two pair, Sixes and Fives)
Villa0722: mucks hand 
conman899 collected $5.97 from pot
*** SUMMARY ***
Total pot $6.25 | Rake $0.28 
Board [6c Ah Kh 5c Tc]
Seat 2: CashMatteo (big blind) folded before Flop
Seat 3: conman899 showed [6s 5s] and won ($5.97) with two pair, Sixes and Fives
Seat 4: Villa0722 (button) mucked [Ad Qh]
Seat 5: LoCoSi (small blind) folded before Flop

Hand #1093: 

PokerStars Hand #246652990770:  Hold'em No Limit ($0.05/$0.10 CAD) - 2023/10/20 23:21:46 ET
Table 'Scabiosa' 6-max Seat #5 is the button
Seat 2: CashMatteo ($9.35 in chips) 
Seat 3: conman899 ($45.26 in chips) 
Seat 4: Villa0722 ($20.27 in chips) 
Seat 5: LoCoSi ($10 in chips) 
CashMatteo: posts small blind $0.05
conman899: posts big blind $0.10
*** HOLE CARDS ***
Dealt to CashMatteo [Td 2s]
Villa0722: raises $0.10 to $0.20
LoCoSi: folds 
CashMatteo: folds 
conman899: folds 
Uncalled bet ($0.10) returned to Villa0722
Villa0722 collected $0.25 from pot
Villa0722: doesn't show hand 
*** SUMMARY ***
Total pot $0.25 | Rake $0 
Seat 2: CashMatteo (small blind) folded before Flop
Seat 3: conman899 (big blind) folded before Flop
Seat 4: Villa0722 collected ($0.25)
Seat 5: LoCoSi (button) folded before Flop (didn't bet)

Hand #1094: 

PokerStars Hand #246652992325:  Hold'em No Limit ($0.05/$0.10 CAD) - 2023/10/20 23:21:56 ET
Table 'Scabiosa' 6-max Seat #2 is the button
Seat 2: CashMatteo ($9.30 in chips) 
Seat 3: conman899 ($45.16 in chips) 
Seat 4: Villa0722 ($20.42 in chips) 
Seat 5: LoCoSi ($10 in chips) 
conman899: posts small blind $0.05
Villa0722: posts big blind $0.10
*** HOLE CARDS ***
Dealt to CashMatteo [Ks 9c]
LoCoSi: folds 
CashMatteo: calls $0.10
conman899: raises $0.30 to $0.40
Villa0722: folds 
CashMatteo: calls $0.30
*** FLOP *** [6c 2s Jc]
conman899: bets $0.10
CashMatteo: raises $0.53 to $0.63
conman899: calls $0.53
*** TURN *** [6c 2s Jc] [Th]
conman899: bets $2.06
CashMatteo: calls $2.06
*** RIVER *** [6c 2s Jc Th] [6h]
conman899: bets $3
CashMatteo: folds 
Uncalled bet ($3) returned to conman899
conman899 collected $6 from pot
*** SUMMARY ***
Total pot $6.28 | Rake $0.28 
Board [6c 2s Jc Th 6h]
Seat 2: CashMatteo (button) folded on the River
Seat 3: conman899 (small blind) collected ($6)
Seat 4: Villa0722 (big blind) folded before Flop
Seat 5: LoCoSi folded before Flop (didn't bet)

Hand #1095: 

PokerStars Hand #246652997510:  Hold'em No Limit ($0.05/$0.10 CAD) - 2023/10/20 23:22:32 ET
Table 'Scabiosa' 6-max Seat #3 is the button
Seat 2: CashMatteo ($6.21 in chips) 
Seat 3: conman899 ($48.07 in chips) 
Seat 4: Villa0722 ($20.32 in chips) 
Seat 5: LoCoSi ($10 in chips) 
Villa0722: posts small blind $0.05
LoCoSi: posts big blind $0.10
*** HOLE CARDS ***
Dealt to CashMatteo [6s 5c]
CashMatteo: folds 
conman899: raises $0.25 to $0.35
Villa0722: folds 
LoCoSi: folds 
Uncalled bet ($0.25) returned to conman899
conman899 collected $0.25 from pot
*** SUMMARY ***
Total pot $0.25 | Rake $0 
Seat 2: CashMatteo folded before Flop (didn't bet)
Seat 3: conman899 (button) collected ($0.25)
Seat 4: Villa0722 (small blind) folded before Flop
Seat 5: LoCoSi (big blind) folded before Flop

Hand #1096: 

PokerStars Hand #246652999348:  Hold'em No Limit ($0.05/$0.10 CAD) - 2023/10/20 23:22:45 ET
Table 'Scabiosa' 6-max Seat #4 is the button
Seat 2: CashMatteo ($6.21 in chips) 
Seat 3: conman899 ($48.22 in chips) 
Seat 4: Villa0722 ($20.27 in chips) 
Seat 5: LoCoSi ($10 in chips) 
LoCoSi: posts small blind $0.05
CashMatteo: posts big blind $0.10
*** HOLE CARDS ***
Dealt to CashMatteo [6h Qc]
conman899: calls $0.10
Villa0722: folds 
LoCoSi: calls $0.05
CashMatteo: checks 
*** FLOP *** [2c 7h 6c]
LoCoSi: bets $0.20
CashMatteo: calls $0.20
conman899: folds 
*** TURN *** [2c 7h 6c] [Ac]
LoCoSi: checks 
CashMatteo: checks 
*** RIVER *** [2c 7h 6c Ac] [6d]
LoCoSi: bets $0.40
CashMatteo: raises $1.47 to $1.87
LoCoSi: calls $1.47
*** SHOW DOWN ***
CashMatteo: shows [6h Qc] (three of a kind, Sixes)
LoCoSi: shows [Kc 4c] (a flush, Ace high)
LoCoSi collected $4.24 from pot
*** SUMMARY ***
Total pot $4.44 | Rake $0.20 
Board [2c 7h 6c Ac 6d]
Seat 2: CashMatteo (big blind) showed [6h Qc] and lost with three of a kind, Sixes
Seat 3: conman899 folded on the Flop
Seat 4: Villa0722 (button) folded before Flop (didn't bet)
Seat 5: LoCoSi (small blind) showed [Kc 4c] and won ($4.24) with a flush, Ace high

Hand #1097: 

PokerStars Hand #246653003113:  Hold'em No Limit ($0.05/$0.10 CAD) - 2023/10/20 23:23:11 ET
Table 'Scabiosa' 6-max Seat #5 is the button
Seat 2: CashMatteo ($4.04 in chips) 
Seat 3: conman899 ($48.12 in chips) 
Seat 4: Villa0722 ($20.27 in chips) 
Seat 5: LoCoSi ($12.07 in chips) 
CashMatteo: posts small blind $0.05
conman899: posts big blind $0.10
*** HOLE CARDS ***
Dealt to CashMatteo [7s Ah]
Villa0722: folds 
LoCoSi: folds 
CashMatteo: raises $0.15 to $0.25
conman899: folds 
Uncalled bet ($0.15) returned to CashMatteo
CashMatteo collected $0.20 from pot
CashMatteo: doesn't show hand 
*** SUMMARY ***
Total pot $0.20 | Rake $0 
Seat 2: CashMatteo (small blind) collected ($0.20)
Seat 3: conman899 (big blind) folded before Flop
Seat 4: Villa0722 folded before Flop (didn't bet)
Seat 5: LoCoSi (button) folded before Flop (didn't bet)

Hand #1098: 

PokerStars Hand #246653005117:  Hold'em No Limit ($0.05/$0.10 CAD) - 2023/10/20 23:23:25 ET
Table 'Scabiosa' 6-max Seat #2 is the button
Seat 2: CashMatteo ($4.14 in chips) 
Seat 3: conman899 ($48.02 in chips) 
Seat 4: Villa0722 ($20.27 in chips) 
Seat 5: LoCoSi ($12.07 in chips) 
conman899: posts small blind $0.05
Villa0722: posts big blind $0.10
*** HOLE CARDS ***
Dealt to CashMatteo [Th 9h]
LoCoSi: folds 
CashMatteo: raises $0.25 to $0.35
conman899: calls $0.30
Villa0722: calls $0.25
*** FLOP *** [7h 2d Qd]
conman899: bets $1
Villa0722: folds 
CashMatteo: folds 
Uncalled bet ($1) returned to conman899
conman899 collected $1 from pot
*** SUMMARY ***
Total pot $1.05 | Rake $0.05 
Board [7h 2d Qd]
Seat 2: CashMatteo (button) folded on the Flop
Seat 3: conman899 (small blind) collected ($1)
Seat 4: Villa0722 (big blind) folded on the Flop
Seat 5: LoCoSi folded before Flop (didn't bet)

Hand #1099: 

PokerStars Hand #246653008970:  Hold'em No Limit ($0.05/$0.10 CAD) - 2023/10/20 23:23:52 ET
Table 'Scabiosa' 6-max Seat #3 is the button
Seat 2: CashMatteo ($3.79 in chips) 
Seat 3: conman899 ($48.67 in chips) 
Seat 4: Villa0722 ($19.92 in chips) 
Seat 5: LoCoSi ($12.07 in chips) 
Villa0722: posts small blind $0.05
LoCoSi: posts big blind $0.10
*** HOLE CARDS ***
Dealt to CashMatteo [5d 5h]
CashMatteo: raises $0.15 to $0.25
conman899: raises $0.65 to $0.90
Villa0722: folds 
LoCoSi: folds 
CashMatteo: calls $0.65
*** FLOP *** [Ah 6c 2s]
CashMatteo: checks 
conman899: bets $0.93
CashMatteo: calls $0.93
*** TURN *** [Ah 6c 2s] [2c]
CashMatteo: checks 
conman899: checks 
*** RIVER *** [Ah 6c 2s 2c] [Kd]
CashMatteo: bets $1.96 and is all-in
conman899: folds 
Uncalled bet ($1.96) returned to CashMatteo
CashMatteo collected $3.64 from pot
CashMatteo: doesn't show hand 
*** SUMMARY ***
Total pot $3.81 | Rake $0.17 
Board [Ah 6c 2s 2c Kd]
Seat 2: CashMatteo collected ($3.64)
Seat 3: conman899 (button) folded on the River
Seat 4: Villa0722 (small blind) folded before Flop
Seat 5: LoCoSi (big blind) folded before Flop

Hand #1100: 

PokerStars Hand #246653014125:  Hold'em No Limit ($0.05/$0.10 CAD) - 2023/10/20 23:24:29 ET
Table 'Scabiosa' 6-max Seat #4 is the button
Seat 2: CashMatteo ($5.60 in chips) 
Seat 3: conman899 ($46.84 in chips) 
Seat 4: Villa0722 ($19.87 in chips) 
Seat 5: LoCoSi ($11.97 in chips) 
LoCoSi: posts small blind $0.05
CashMatteo: posts big blind $0.10
*** HOLE CARDS ***
Dealt to CashMatteo [3c 8c]
conman899: folds 
Villa0722: folds 
LoCoSi: folds 
Uncalled bet ($0.05) returned to CashMatteo
CashMatteo collected $0.10 from pot
CashMatteo: doesn't show hand 
*** SUMMARY ***
Total pot $0.10 | Rake $0 
Seat 2: CashMatteo (big blind) collected ($0.10)
Seat 3: conman899 folded before Flop (didn't bet)
Seat 4: Villa0722 (button) folded before Flop (didn't bet)
Seat 5: LoCoSi (small blind) folded before Flop

Hand #1101: 

PokerStars Hand #246653015876:  Hold'em No Limit ($0.05/$0.10 CAD) - 2023/10/20 23:24:40 ET
Table 'Scabiosa' 6-max Seat #5 is the button
Seat 2: CashMatteo ($5.65 in chips) 
Seat 3: conman899 ($46.84 in chips) 
Seat 4: Villa0722 ($19.87 in chips) 
Seat 5: LoCoSi ($11.92 in chips) 
CashMatteo: posts small blind $0.05
conman899: posts big blind $0.10
*** HOLE CARDS ***
Dealt to CashMatteo [Qs As]
Villa0722: folds 
LoCoSi: folds 
CashMatteo: raises $0.30 to $0.40
conman899: calls $0.30
*** FLOP *** [5s 5h Jc]
CashMatteo: bets $0.38
conman899: folds 
Uncalled bet ($0.38) returned to CashMatteo
CashMatteo collected $0.76 from pot
CashMatteo: doesn't show hand 
*** SUMMARY ***
Total pot $0.80 | Rake $0.04 
Board [5s 5h Jc]
Seat 2: CashMatteo (small blind) collected ($0.76)
Seat 3: conman899 (big blind) folded on the Flop
Seat 4: Villa0722 folded before Flop (didn't bet)
Seat 5: LoCoSi (button) folded before Flop (didn't bet)

Hand #1102: 

PokerStars Hand #246653019559:  Hold'em No Limit ($0.05/$0.10 CAD) - 2023/10/20 23:25:07 ET
Table 'Scabiosa' 6-max Seat #2 is the button
Seat 2: CashMatteo ($6.01 in chips) 
Seat 3: conman899 ($46.44 in chips) 
Seat 4: Villa0722 ($19.87 in chips) 
Seat 5: LoCoSi ($11.92 in chips) 
conman899: posts small blind $0.05
Villa0722: posts big blind $0.10
*** HOLE CARDS ***
Dealt to CashMatteo [Ks Kh]
LoCoSi: raises $0.20 to $0.30
CashMatteo: raises $0.75 to $1.05
conman899: calls $1
Villa0722: folds 
LoCoSi: calls $0.75
*** FLOP *** [Qc 5h 8c]
conman899: checks 
LoCoSi: checks 
CashMatteo: bets $1.85
AspiringCan joins the table at seat #6 
conman899: folds 
AspiringCan leaves the table
LoCoSi: folds 
Uncalled bet ($1.85) returned to CashMatteo
CashMatteo collected $3.10 from pot
CashMatteo: doesn't show hand 
*** SUMMARY ***
Total pot $3.25 | Rake $0.15 
Board [Qc 5h 8c]
Seat 2: CashMatteo (button) collected ($3.10)
Seat 3: conman899 (small blind) folded on the Flop
Seat 4: Villa0722 (big blind) folded before Flop
Seat 5: LoCoSi folded on the Flop

Hand #1103: 

PokerStars Hand #246653025350:  Hold'em No Limit ($0.05/$0.10 CAD) - 2023/10/20 23:25:47 ET
Table 'Scabiosa' 6-max Seat #3 is the button
Seat 2: CashMatteo ($8.06 in chips) 
Seat 3: conman899 ($45.39 in chips) 
Seat 4: Villa0722 ($19.77 in chips) 
Seat 5: LoCoSi ($10.87 in chips) 
Villa0722: posts small blind $0.05
LoCoSi: posts big blind $0.10
*** HOLE CARDS ***
Dealt to CashMatteo [Ad 5d]
CashMatteo: raises $0.15 to $0.25
conman899: folds 
Villa0722: folds 
LoCoSi: folds 
Uncalled bet ($0.15) returned to CashMatteo
CashMatteo collected $0.25 from pot
CashMatteo: doesn't show hand 
*** SUMMARY ***
Total pot $0.25 | Rake $0 
Seat 2: CashMatteo collected ($0.25)
Seat 3: conman899 (button) folded before Flop (didn't bet)
Seat 4: Villa0722 (small blind) folded before Flop
Seat 5: LoCoSi (big blind) folded before Flop

Hand #1104: 

PokerStars Hand #246653027037:  Hold'em No Limit ($0.05/$0.10 CAD) - 2023/10/20 23:25:59 ET
Table 'Scabiosa' 6-max Seat #4 is the button
Seat 2: CashMatteo ($8.21 in chips) 
Seat 3: conman899 ($45.39 in chips) 
Seat 4: Villa0722 ($19.72 in chips) 
Seat 5: LoCoSi ($10.77 in chips) 
LoCoSi: posts small blind $0.05
CashMatteo: posts big blind $0.10
*** HOLE CARDS ***
Dealt to CashMatteo [Qs Ad]
conman899: raises $0.25 to $0.35
Villa0722: folds 
LoCoSi: folds 
CashMatteo: raises $0.75 to $1.10
conman899: calls $0.75
*** FLOP *** [Ks 3s Ah]
CashMatteo: bets $2.15
conman899: calls $2.15
*** TURN *** [Ks 3s Ah] [Ts]
CashMatteo: checks 
conman899: checks 
*** RIVER *** [Ks 3s Ah Ts] [8h]
CashMatteo: checks 
conman899: bets $6.26
CashMatteo: calls $4.96 and is all-in
Uncalled bet ($1.30) returned to conman899
*** SHOW DOWN ***
conman899: shows [Qh 3h] (a pair of Threes)
CashMatteo: shows [Qs Ad] (a pair of Aces)
CashMatteo collected $15.73 from pot
*** SUMMARY ***
Total pot $16.47 | Rake $0.74 
Board [Ks 3s Ah Ts 8h]
Seat 2: CashMatteo (big blind) showed [Qs Ad] and won ($15.73) with a pair of Aces
Seat 3: conman899 showed [Qh 3h] and lost with a pair of Threes
Seat 4: Villa0722 (button) folded before Flop (didn't bet)
Seat 5: LoCoSi (small blind) folded before Flop

Hand #1105: 

PokerStars Hand #246653033751:  Hold'em No Limit ($0.05/$0.10 CAD) - 2023/10/20 23:26:47 ET
Table 'Scabiosa' 6-max Seat #5 is the button
Seat 2: CashMatteo ($15.73 in chips) 
Seat 3: conman899 ($37.18 in chips) 
Seat 4: Villa0722 ($19.72 in chips) 
Seat 5: LoCoSi ($10.72 in chips) 
CashMatteo: posts small blind $0.05
conman899: posts big blind $0.10
*** HOLE CARDS ***
Dealt to CashMatteo [3h 3c]
l3lackhammer joins the table at seat #6 
Villa0722: folds 
LoCoSi: folds 
CashMatteo: raises $0.15 to $0.25
Burnins joins the table at seat #1 
conman899: calls $0.15
*** FLOP *** [7h 2c 2h]
CashMatteo: bets $0.24
conman899: folds 
Uncalled bet ($0.24) returned to CashMatteo
CashMatteo collected $0.48 from pot
CashMatteo: doesn't show hand 
*** SUMMARY ***
Total pot $0.50 | Rake $0.02 
Board [7h 2c 2h]
Seat 2: CashMatteo (small blind) collected ($0.48)
Seat 3: conman899 (big blind) folded on the Flop
Seat 4: Villa0722 folded before Flop (didn't bet)
Seat 5: LoCoSi (button) folded before Flop (didn't bet)

Hand #1106: 

PokerStars Hand #246653036500:  Hold'em No Limit ($0.05/$0.10 CAD) - 2023/10/20 23:27:06 ET
Table 'Scabiosa' 6-max Seat #2 is the button
Seat 1: Burnins ($8 in chips) 
Seat 2: CashMatteo ($15.96 in chips) 
Seat 3: conman899 ($36.93 in chips) 
Seat 4: Villa0722 ($19.72 in chips) 
Seat 5: LoCoSi ($10.72 in chips) 
conman899: posts small blind $0.05
Villa0722: posts big blind $0.10
l3lackhammer: sits out 
Burnins: posts big blind $0.10
*** HOLE CARDS ***
Dealt to CashMatteo [9c 2s]
LoCoSi: folds 
Burnins: raises $0.30 to $0.40
CashMatteo: folds 
conman899: calls $0.35
Villa0722: folds 
*** FLOP *** [6d 6h 4h]
conman899: checks 
Burnins: bets $0.50
conman899: calls $0.50
*** TURN *** [6d 6h 4h] [Kc]
conman899: checks 
Burnins: checks 
*** RIVER *** [6d 6h 4h Kc] [9d]
conman899: bets $0.91
Burnins: folds 
Uncalled bet ($0.91) returned to conman899
conman899 collected $1.81 from pot
*** SUMMARY ***
Total pot $1.90 | Rake $0.09 
Board [6d 6h 4h Kc 9d]
Seat 1: Burnins folded on the River
Seat 2: CashMatteo (button) folded before Flop (didn't bet)
Seat 3: conman899 (small blind) collected ($1.81)
Seat 4: Villa0722 (big blind) folded before Flop
Seat 5: LoCoSi folded before Flop (didn't bet)

Hand #1107: 

PokerStars Hand #246653042494:  Hold'em No Limit ($0.05/$0.10 CAD) - 2023/10/20 23:27:48 ET
Table 'Scabiosa' 6-max Seat #3 is the button
Seat 1: Burnins ($7.10 in chips) 
Seat 2: CashMatteo ($15.96 in chips) 
Seat 3: conman899 ($37.84 in chips) 
Seat 4: Villa0722 ($19.62 in chips) 
Seat 5: LoCoSi ($10.72 in chips) 
Villa0722: posts small blind $0.05
LoCoSi: posts big blind $0.10
l3lackhammer: sits out 
*** HOLE CARDS ***
Dealt to CashMatteo [Ad 6h]
Burnins: raises $0.30 to $0.40
CashMatteo: calls $0.40
conman899: calls $0.40
Villa0722: folds 
LoCoSi: folds 
*** FLOP *** [Kc 3c 8d]
Burnins: checks 
CashMatteo: checks 
conman899: bets $1.29
Burnins: folds 
CashMatteo: folds 
Uncalled bet ($1.29) returned to conman899
conman899 collected $1.29 from pot
*** SUMMARY ***
Total pot $1.35 | Rake $0.06 
Board [Kc 3c 8d]
Seat 1: Burnins folded on the Flop
Seat 2: CashMatteo folded on the Flop
Seat 3: conman899 (button) collected ($1.29)
Seat 4: Villa0722 (small blind) folded before Flop
Seat 5: LoCoSi (big blind) folded before Flop

Hand #1108: 

PokerStars Hand #246653046488:  Hold'em No Limit ($0.05/$0.10 CAD) - 2023/10/20 23:28:16 ET
Table 'Scabiosa' 6-max Seat #4 is the button
Seat 1: Burnins ($6.70 in chips) 
Seat 2: CashMatteo ($15.56 in chips) 
Seat 3: conman899 ($38.73 in chips) 
Seat 4: Villa0722 ($19.57 in chips) 
Seat 5: LoCoSi ($10.62 in chips) 
Seat 6: l3lackhammer ($10 in chips) 
LoCoSi: posts small blind $0.05
l3lackhammer: posts big blind $0.10
*** HOLE CARDS ***
Dealt to CashMatteo [4h 2c]
Burnins: folds 
CashMatteo: folds 
conman899: raises $0.25 to $0.35
Villa0722: folds 
LoCoSi: calls $0.30
l3lackhammer: folds 
*** FLOP *** [4d Kh Js]
LoCoSi: checks 
conman899: bets $0.76
LoCoSi: folds 
Uncalled bet ($0.76) returned to conman899
conman899 collected $0.76 from pot
*** SUMMARY ***
Total pot $0.80 | Rake $0.04 
Board [4d Kh Js]
Seat 1: Burnins folded before Flop (didn't bet)
Seat 2: CashMatteo folded before Flop (didn't bet)
Seat 3: conman899 collected ($0.76)
Seat 4: Villa0722 (button) folded before Flop (didn't bet)
Seat 5: LoCoSi (small blind) folded on the Flop
Seat 6: l3lackhammer (big blind) folded before Flop

Hand #1109: 

PokerStars Hand #246653050385:  Hold'em No Limit ($0.05/$0.10 CAD) - 2023/10/20 23:28:44 ET
Table 'Scabiosa' 6-max Seat #5 is the button
Seat 1: Burnins ($6.70 in chips) 
Seat 2: CashMatteo ($15.56 in chips) 
Seat 3: conman899 ($39.14 in chips) 
Seat 4: Villa0722 ($19.57 in chips) 
Seat 5: LoCoSi ($10.27 in chips) 
Seat 6: l3lackhammer ($10 in chips) 
l3lackhammer: posts small blind $0.05
Burnins: posts big blind $0.10
*** HOLE CARDS ***
Dealt to CashMatteo [8s 4h]
CashMatteo: folds 
conman899: raises $0.25 to $0.35
Villa0722: calls $0.35
LoCoSi: folds 
l3lackhammer: folds 
Burnins: calls $0.25
*** FLOP *** [Kh 4s 5h]
Burnins: bets $0.53
conman899: calls $0.53
Villa0722: folds 
*** TURN *** [Kh 4s 5h] [8c]
Burnins: bets $2.06
conman899: raises $36.20 to $38.26 and is all-in
Burnins: calls $3.76 and is all-in
Uncalled bet ($32.44) returned to conman899
*** RIVER *** [Kh 4s 5h 8c] [Ts]
*** SHOW DOWN ***
Burnins: shows [9h 6h] (high card King)
conman899: shows [Ac Kc] (a pair of Kings)
conman899 collected $13.18 from pot
*** SUMMARY ***
Total pot $13.80 | Rake $0.62 
Board [Kh 4s 5h 8c Ts]
Seat 1: Burnins (big blind) showed [9h 6h] and lost with high card King
Seat 2: CashMatteo folded before Flop (didn't bet)
Seat 3: conman899 showed [Ac Kc] and won ($13.18) with a pair of Kings
Seat 4: Villa0722 folded on the Flop
Seat 5: LoCoSi (button) folded before Flop (didn't bet)
Seat 6: l3lackhammer (small blind) folded before Flop

Hand #1110: 

PokerStars Hand #246653057421:  Hold'em No Limit ($0.05/$0.10 CAD) - 2023/10/20 23:29:32 ET
Table 'Scabiosa' 6-max Seat #6 is the button
Seat 2: CashMatteo ($15.56 in chips) 
Seat 3: conman899 ($45.62 in chips) 
Seat 4: Villa0722 ($19.22 in chips) 
Seat 5: LoCoSi ($10.27 in chips) 
Seat 6: l3lackhammer ($10 in chips) 
CashMatteo: posts small blind $0.05
conman899: posts big blind $0.10
*** HOLE CARDS ***
Dealt to CashMatteo [7h 5h]
Villa0722: folds 
LoCoSi: raises $0.20 to $0.30
l3lackhammer: folds 
CashMatteo: calls $0.25
conman899: calls $0.20
*** FLOP *** [3s 8c 4d]
CashMatteo: checks 
conman899: bets $0.86
LoCoSi: folds 
CashMatteo: calls $0.86
*** TURN *** [3s 8c 4d] [7s]
CashMatteo: bets $1.25
conman899: calls $1.25
*** RIVER *** [3s 8c 4d 7s] [8d]
CashMatteo: checks 
conman899: bets $4.89
CashMatteo: folds 
Uncalled bet ($4.89) returned to conman899
conman899 collected $4.89 from pot
*** SUMMARY ***
Total pot $5.12 | Rake $0.23 
Board [3s 8c 4d 7s 8d]
Seat 2: CashMatteo (small blind) folded on the River
Seat 3: conman899 (big blind) collected ($4.89)
Seat 4: Villa0722 folded before Flop (didn't bet)
Seat 5: LoCoSi folded on the Flop
Seat 6: l3lackhammer (button) folded before Flop (didn't bet)

Hand #1111: 

PokerStars Hand #246653066236:  Hold'em No Limit ($0.05/$0.10 CAD) - 2023/10/20 23:30:34 ET
Table 'Scabiosa' 6-max Seat #2 is the button
Seat 1: Burnins ($9 in chips) 
Seat 2: CashMatteo ($13.15 in chips) 
Seat 3: conman899 ($48.10 in chips) 
Seat 4: Villa0722 ($19.22 in chips) 
Seat 5: LoCoSi ($10 in chips) 
Seat 6: l3lackhammer ($10 in chips) 
conman899: posts small blind $0.05
Villa0722: posts big blind $0.10
Burnins: posts small blind $0.05
*** HOLE CARDS ***
Dealt to CashMatteo [Js 8s]
LoCoSi: calls $0.10
l3lackhammer: folds 
Burnins: raises $0.40 to $0.50
CashMatteo: calls $0.50
conman899: calls $0.45
Villa0722: folds 
LoCoSi: calls $0.40
*** FLOP *** [3s Ts 6d]
conman899: checks 
LoCoSi: checks 
Burnins: bets $1.03
CashMatteo: calls $1.03
conman899: calls $1.03
LoCoSi: folds 
*** TURN *** [3s Ts 6d] [9h]
conman899: checks 
Burnins: bets $2.80
CashMatteo: calls $2.80
conman899: folds 
*** RIVER *** [3s Ts 6d 9h] [Kc]
Burnins: bets $4.62 and is all-in
CashMatteo: folds 
Uncalled bet ($4.62) returned to Burnins
Burnins collected $10.35 from pot
Burnins: doesn't show hand 
*** SUMMARY ***
Total pot $10.84 | Rake $0.49 
Board [3s Ts 6d 9h Kc]
Seat 1: Burnins collected ($10.35)
Seat 2: CashMatteo (button) folded on the River
Seat 3: conman899 (small blind) folded on the Turn
Seat 4: Villa0722 (big blind) folded before Flop
Seat 5: LoCoSi folded on the Flop
Seat 6: l3lackhammer folded before Flop (didn't bet)

Hand #1112: 

PokerStars Hand #246653076897:  Hold'em No Limit ($0.05/$0.10 CAD) - 2023/10/20 23:31:49 ET
Table 'Scabiosa' 6-max Seat #3 is the button
Seat 1: Burnins ($14.97 in chips) 
Seat 2: CashMatteo ($8.82 in chips) 
Seat 3: conman899 ($46.57 in chips) 
Seat 4: Villa0722 ($19.12 in chips) 
Seat 5: LoCoSi ($10 in chips) 
Seat 6: l3lackhammer ($10 in chips) 
Villa0722: posts small blind $0.05
LoCoSi: posts big blind $0.10
*** HOLE CARDS ***
Dealt to CashMatteo [Qc 6d]
l3lackhammer: folds 
Burnins: folds 
CashMatteo: folds 
conman899: raises $0.25 to $0.35
Villa0722: folds 
LoCoSi: calls $0.25
*** FLOP *** [7h 2c 9h]
LoCoSi: checks 
conman899: checks 
*** TURN *** [7h 2c 9h] [2s]
LoCoSi: checks 
conman899: bets $0.72
LoCoSi: folds 
Uncalled bet ($0.72) returned to conman899
conman899 collected $0.72 from pot
*** SUMMARY ***
Total pot $0.75 | Rake $0.03 
Board [7h 2c 9h 2s]
Seat 1: Burnins folded before Flop (didn't bet)
Seat 2: CashMatteo folded before Flop (didn't bet)
Seat 3: conman899 (button) collected ($0.72)
Seat 4: Villa0722 (small blind) folded before Flop
Seat 5: LoCoSi (big blind) folded on the Turn
Seat 6: l3lackhammer folded before Flop (didn't bet)

Hand #1113: 

PokerStars Hand #246653081803:  Hold'em No Limit ($0.05/$0.10 CAD) - 2023/10/20 23:32:23 ET
Table 'Scabiosa' 6-max Seat #4 is the button
Seat 1: Burnins ($14.97 in chips) 
Seat 2: CashMatteo ($8.82 in chips) 
Seat 3: conman899 ($46.94 in chips) 
Seat 4: Villa0722 ($19.07 in chips) 
Seat 5: LoCoSi ($10 in chips) 
Seat 6: l3lackhammer ($10 in chips) 
LoCoSi: posts small blind $0.05
l3lackhammer: posts big blind $0.10
*** HOLE CARDS ***
Dealt to CashMatteo [Jd Qc]
Burnins: folds 
CashMatteo: raises $0.15 to $0.25
conman899: calls $0.25
Villa0722: raises $0.65 to $0.90
LoCoSi: folds 
l3lackhammer: folds 
CashMatteo: calls $0.65
conman899: calls $0.65
*** FLOP *** [Kh Kd Ts]
CashMatteo: checks 
conman899: checks 
Villa0722: checks 
*** TURN *** [Kh Kd Ts] [7d]
CashMatteo: checks 
conman899: bets $1.36
Villa0722: calls $1.36
CashMatteo: calls $1.36
*** RIVER *** [Kh Kd Ts 7d] [8d]
CashMatteo: checks 
conman899: checks 
Villa0722: bets $1.09
CashMatteo: folds 
conman899: calls $1.09
*** SHOW DOWN ***
Villa0722: shows [Ad Qd] (a flush, Ace high)
conman899: mucks hand 
Villa0722 collected $8.70 from pot
*** SUMMARY ***
Total pot $9.11 | Rake $0.41 
Board [Kh Kd Ts 7d 8d]
Seat 1: Burnins folded before Flop (didn't bet)
Seat 2: CashMatteo folded on the River
Seat 3: conman899 mucked [Qs 8s]
Seat 4: Villa0722 (button) showed [Ad Qd] and won ($8.70) with a flush, Ace high
Seat 5: LoCoSi (small blind) folded before Flop
Seat 6: l3lackhammer (big blind) folded before Flop

Hand #1114: 

PokerStars Hand #246653097237:  Hold'em No Limit ($0.05/$0.10 CAD) - 2023/10/20 23:34:13 ET
Table 'Scabiosa' 6-max Seat #5 is the button
Seat 1: Burnins ($14.97 in chips) 
Seat 2: CashMatteo ($6.56 in chips) 
Seat 3: conman899 ($43.59 in chips) 
Seat 4: Villa0722 ($24.42 in chips) 
Seat 5: LoCoSi ($10 in chips) 
Seat 6: l3lackhammer ($10 in chips) 
l3lackhammer: posts small blind $0.05
Burnins: posts big blind $0.10
*** HOLE CARDS ***
Dealt to CashMatteo [4d 7h]
CashMatteo: folds 
conman899: calls $0.10
Villa0722: calls $0.10
LoCoSi: calls $0.10
l3lackhammer: folds 
Burnins: checks 
*** FLOP *** [As Qd 3c]
Burnins: checks 
conman899: bets $0.43
Villa0722: folds 
LoCoSi: calls $0.43
Burnins: calls $0.43
*** TURN *** [As Qd 3c] [2h]
Burnins: checks 
conman899: checks 
LoCoSi: checks 
*** RIVER *** [As Qd 3c 2h] [6c]
Burnins: checks 
conman899: checks 
LoCoSi: bets $0.60
Burnins: folds 
conman899: calls $0.60
*** SHOW DOWN ***
LoCoSi: shows [Ah Ts] (a pair of Aces)
conman899: mucks hand 
LoCoSi collected $2.81 from pot
*** SUMMARY ***
Total pot $2.94 | Rake $0.13 
Board [As Qd 3c 2h 6c]
Seat 1: Burnins (big blind) folded on the River
Seat 2: CashMatteo folded before Flop (didn't bet)
Seat 3: conman899 mucked [4h Ad]
Seat 4: Villa0722 folded on the Flop
Seat 5: LoCoSi (button) showed [Ah Ts] and won ($2.81) with a pair of Aces
Seat 6: l3lackhammer (small blind) folded before Flop

Hand #1115: 

PokerStars Hand #246653106973:  Hold'em No Limit ($0.05/$0.10 CAD) - 2023/10/20 23:35:22 ET
Table 'Scabiosa' 6-max Seat #6 is the button
Seat 1: Burnins ($14.44 in chips) 
Seat 2: CashMatteo ($6.56 in chips) 
Seat 3: conman899 ($42.46 in chips) 
Seat 4: Villa0722 ($24.32 in chips) 
Seat 5: LoCoSi ($11.68 in chips) 
Seat 6: l3lackhammer ($10 in chips) 
Burnins: posts small blind $0.05
CashMatteo: posts big blind $0.10
*** HOLE CARDS ***
Dealt to CashMatteo [4c Kd]
conman899: folds 
Villa0722: folds 
LoCoSi: folds 
l3lackhammer: calls $0.10
Burnins: folds 
CashMatteo: checks 
*** FLOP *** [3s Ad 7c]
CashMatteo: checks 
l3lackhammer: checks 
*** TURN *** [3s Ad 7c] [4d]
CashMatteo: checks 
l3lackhammer: checks 
*** RIVER *** [3s Ad 7c 4d] [5s]
CashMatteo: bets $0.12
l3lackhammer: folds 
Uncalled bet ($0.12) returned to CashMatteo
CashMatteo collected $0.24 from pot
CashMatteo: doesn't show hand 
*** SUMMARY ***
Total pot $0.25 | Rake $0.01 
Board [3s Ad 7c 4d 5s]
Seat 1: Burnins (small blind) folded before Flop
Seat 2: CashMatteo (big blind) collected ($0.24)
Seat 3: conman899 folded before Flop (didn't bet)
Seat 4: Villa0722 folded before Flop (didn't bet)
Seat 5: LoCoSi folded before Flop (didn't bet)
Seat 6: l3lackhammer (button) folded on the River

Hand #1116: 

PokerStars Hand #246653113368:  Hold'em No Limit ($0.05/$0.10 CAD) - 2023/10/20 23:36:08 ET
Table 'Scabiosa' 6-max Seat #1 is the button
Seat 1: Burnins ($14.39 in chips) 
Seat 2: CashMatteo ($6.70 in chips) 
Seat 3: conman899 ($42.46 in chips) 
Seat 4: Villa0722 ($24.32 in chips) 
Seat 5: LoCoSi ($11.68 in chips) 
Seat 6: l3lackhammer ($10 in chips) 
CashMatteo: posts small blind $0.05
conman899: posts big blind $0.10
*** HOLE CARDS ***
Dealt to CashMatteo [Th Ah]
Villa0722: folds 
LoCoSi: folds 
l3lackhammer: folds 
Burnins: raises $0.30 to $0.40
CashMatteo: raises $0.90 to $1.30
conman899: calls $1.20
Burnins: folds 
*** FLOP *** [5s 5h 8s]
CashMatteo: checks 
conman899: checks 
*** TURN *** [5s 5h 8s] [8c]
CashMatteo: bets $1.43
conman899: calls $1.43
*** RIVER *** [5s 5h 8s 8c] [4c]
CashMatteo: checks 
conman899: checks 
*** SHOW DOWN ***
CashMatteo: shows [Th Ah] (two pair, Eights and Fives)
conman899: mucks hand 
CashMatteo collected $5.60 from pot
*** SUMMARY ***
Total pot $5.86 | Rake $0.26 
Board [5s 5h 8s 8c 4c]
Seat 1: Burnins (button) folded before Flop
Seat 2: CashMatteo (small blind) showed [Th Ah] and won ($5.60) with two pair, Eights and Fives
Seat 3: conman899 (big blind) mucked [9c Jh]
Seat 4: Villa0722 folded before Flop (didn't bet)
Seat 5: LoCoSi folded before Flop (didn't bet)
Seat 6: l3lackhammer folded before Flop (didn't bet)

Hand #1117: 

PokerStars Hand #246653119380:  Hold'em No Limit ($0.05/$0.10 CAD) - 2023/10/20 23:36:51 ET
Table 'Scabiosa' 6-max Seat #2 is the button
Seat 1: Burnins ($13.99 in chips) 
Seat 2: CashMatteo ($9.57 in chips) 
Seat 3: conman899 ($39.73 in chips) 
Seat 4: Villa0722 ($24.32 in chips) 
Seat 5: LoCoSi ($11.68 in chips) 
Seat 6: l3lackhammer ($10 in chips) 
conman899: posts small blind $0.05
Villa0722: posts big blind $0.10
*** HOLE CARDS ***
Dealt to CashMatteo [Tc 2d]
LoCoSi: calls $0.10
l3lackhammer: folds 
Burnins: folds 
CashMatteo: folds 
conman899: raises $0.30 to $0.40
Villa0722: folds 
LoCoSi: calls $0.30
*** FLOP *** [8h 2h 9d]
conman899: bets $0.43
LoCoSi: folds 
Uncalled bet ($0.43) returned to conman899
conman899 collected $0.86 from pot
*** SUMMARY ***
Total pot $0.90 | Rake $0.04 
Board [8h 2h 9d]
Seat 1: Burnins folded before Flop (didn't bet)
Seat 2: CashMatteo (button) folded before Flop (didn't bet)
Seat 3: conman899 (small blind) collected ($0.86)
Seat 4: Villa0722 (big blind) folded before Flop
Seat 5: LoCoSi folded on the Flop
Seat 6: l3lackhammer folded before Flop (didn't bet)

Hand #1118: 

PokerStars Hand #246653123704:  Hold'em No Limit ($0.05/$0.10 CAD) - 2023/10/20 23:37:22 ET
Table 'Scabiosa' 6-max Seat #3 is the button
Seat 1: Burnins ($13.99 in chips) 
Seat 2: CashMatteo ($9.57 in chips) 
Seat 3: conman899 ($40.19 in chips) 
Seat 4: Villa0722 ($24.22 in chips) 
Seat 5: LoCoSi ($11.28 in chips) 
Seat 6: l3lackhammer ($10 in chips) 
Villa0722: posts small blind $0.05
LoCoSi: posts big blind $0.10
*** HOLE CARDS ***
Dealt to CashMatteo [3s 2h]
l3lackhammer: folds 
Burnins: raises $0.25 to $0.35
CashMatteo: folds 
conman899: calls $0.35
Villa0722: folds 
LoCoSi: folds 
*** FLOP *** [4d Jc 9d]
Burnins: bets $0.20
conman899: folds 
Uncalled bet ($0.20) returned to Burnins
Burnins collected $0.81 from pot
Burnins: doesn't show hand 
*** SUMMARY ***
Total pot $0.85 | Rake $0.04 
Board [4d Jc 9d]
Seat 1: Burnins collected ($0.81)
Seat 2: CashMatteo folded before Flop (didn't bet)
Seat 3: conman899 (button) folded on the Flop
Seat 4: Villa0722 (small blind) folded before Flop
Seat 5: LoCoSi (big blind) folded before Flop
Seat 6: l3lackhammer folded before Flop (didn't bet)

Hand #1119: 

PokerStars Hand #246653126604:  Hold'em No Limit ($0.05/$0.10 CAD) - 2023/10/20 23:37:43 ET
Table 'Scabiosa' 6-max Seat #4 is the button
Seat 1: Burnins ($14.45 in chips) 
Seat 2: CashMatteo ($9.57 in chips) 
Seat 3: conman899 ($39.84 in chips) 
Seat 4: Villa0722 ($24.17 in chips) 
Seat 5: LoCoSi ($11.18 in chips) 
Seat 6: l3lackhammer ($10 in chips) 
LoCoSi: posts small blind $0.05
l3lackhammer: posts big blind $0.10
*** HOLE CARDS ***
Dealt to CashMatteo [Jd 9d]
Burnins: folds 
CashMatteo: raises $0.15 to $0.25
conman899: folds 
Villa0722: folds 
LoCoSi: folds 
l3lackhammer: folds 
Uncalled bet ($0.15) returned to CashMatteo
CashMatteo collected $0.25 from pot
CashMatteo: doesn't show hand 
*** SUMMARY ***
Total pot $0.25 | Rake $0 
Seat 1: Burnins folded before Flop (didn't bet)
Seat 2: CashMatteo collected ($0.25)
Seat 3: conman899 folded before Flop (didn't bet)
Seat 4: Villa0722 (button) folded before Flop (didn't bet)
Seat 5: LoCoSi (small blind) folded before Flop
Seat 6: l3lackhammer (big blind) folded before Flop

Hand #1120: 

PokerStars Hand #246653129085:  Hold'em No Limit ($0.05/$0.10 CAD) - 2023/10/20 23:38:01 ET
Table 'Scabiosa' 6-max Seat #5 is the button
Seat 1: Burnins ($14.45 in chips) 
Seat 2: CashMatteo ($9.72 in chips) 
Seat 3: conman899 ($39.84 in chips) 
Seat 4: Villa0722 ($24.17 in chips) 
Seat 5: LoCoSi ($11.13 in chips) 
Seat 6: l3lackhammer ($10 in chips) 
l3lackhammer: posts small blind $0.05
Burnins: posts big blind $0.10
*** HOLE CARDS ***
Dealt to CashMatteo [Tc 3c]
CashMatteo: folds 
conman899: raises $0.45 to $0.55
Villa0722: folds 
LoCoSi: folds 
l3lackhammer: folds 
Burnins: calls $0.45
*** FLOP *** [9h 2s Kd]
Burnins: checks 
conman899: checks 
*** TURN *** [9h 2s Kd] [As]
Burnins: bets $0.40
conman899: calls $0.40
*** RIVER *** [9h 2s Kd As] [Kc]
Burnins: bets $0.50
conman899: folds 
Uncalled bet ($0.50) returned to Burnins
Burnins collected $1.86 from pot
Burnins: doesn't show hand 
*** SUMMARY ***
Total pot $1.95 | Rake $0.09 
Board [9h 2s Kd As Kc]
Seat 1: Burnins (big blind) collected ($1.86)
Seat 2: CashMatteo folded before Flop (didn't bet)
Seat 3: conman899 folded on the River
Seat 4: Villa0722 folded before Flop (didn't bet)
Seat 5: LoCoSi (button) folded before Flop (didn't bet)
Seat 6: l3lackhammer (small blind) folded before Flop

Hand #1121: 

PokerStars Hand #246653135698:  Hold'em No Limit ($0.05/$0.10 CAD) - 2023/10/20 23:38:49 ET
Table 'Scabiosa' 6-max Seat #6 is the button
Seat 1: Burnins ($15.36 in chips) 
Seat 2: CashMatteo ($9.72 in chips) 
Seat 3: conman899 ($38.89 in chips) 
Seat 4: Villa0722 ($24.17 in chips) 
Seat 5: LoCoSi ($11.13 in chips) 
Seat 6: l3lackhammer ($10 in chips) 
Burnins: posts small blind $0.05
CashMatteo: posts big blind $0.10
*** HOLE CARDS ***
Dealt to CashMatteo [4d 8c]
conman899: folds 
Villa0722: folds 
LoCoSi: folds 
l3lackhammer: raises $0.20 to $0.30
Burnins: calls $0.25
CashMatteo: folds 
*** FLOP *** [4h 5d Qh]
Burnins: checks 
l3lackhammer: bets $0.30
Burnins: calls $0.30
*** TURN *** [4h 5d Qh] [Ah]
Burnins: checks 
l3lackhammer: bets $1.22
Burnins: folds 
Uncalled bet ($1.22) returned to l3lackhammer
l3lackhammer collected $1.24 from pot
l3lackhammer: doesn't show hand 
*** SUMMARY ***
Total pot $1.30 | Rake $0.06 
Board [4h 5d Qh Ah]
Seat 1: Burnins (small blind) folded on the Turn
Seat 2: CashMatteo (big blind) folded before Flop
Seat 3: conman899 folded before Flop (didn't bet)
Seat 4: Villa0722 folded before Flop (didn't bet)
Seat 5: LoCoSi folded before Flop (didn't bet)
Seat 6: l3lackhammer (button) collected ($1.24)

Hand #1122: 

PokerStars Hand #246653142301:  Hold'em No Limit ($0.05/$0.10 CAD) - 2023/10/20 23:39:36 ET
Table 'Scabiosa' 6-max Seat #1 is the button
Seat 1: Burnins ($14.76 in chips) 
Seat 2: CashMatteo ($9.62 in chips) 
Seat 3: conman899 ($38.89 in chips) 
Seat 4: Villa0722 ($24.17 in chips) 
Seat 5: LoCoSi ($11.13 in chips) 
Seat 6: l3lackhammer ($10.64 in chips) 
CashMatteo: posts small blind $0.05
conman899: posts big blind $0.10
*** HOLE CARDS ***
Dealt to CashMatteo [2h 3s]
Villa0722: folds 
LoCoSi: calls $0.10
l3lackhammer: folds 
Burnins: folds 
CashMatteo: folds 
conman899: checks 
*** FLOP *** [7c 3c 9h]
conman899: checks 
LoCoSi: bets $0.10
conman899: folds 
Uncalled bet ($0.10) returned to LoCoSi
LoCoSi collected $0.24 from pot
LoCoSi: doesn't show hand 
*** SUMMARY ***
Total pot $0.25 | Rake $0.01 
Board [7c 3c 9h]
Seat 1: Burnins (button) folded before Flop (didn't bet)
Seat 2: CashMatteo (small blind) folded before Flop
Seat 3: conman899 (big blind) folded on the Flop
Seat 4: Villa0722 folded before Flop (didn't bet)
Seat 5: LoCoSi collected ($0.24)
Seat 6: l3lackhammer folded before Flop (didn't bet)

Hand #1123: 

PokerStars Hand #246653147223:  Hold'em No Limit ($0.05/$0.10 CAD) - 2023/10/20 23:40:12 ET
Table 'Scabiosa' 6-max Seat #2 is the button
Seat 1: Burnins ($14.76 in chips) 
Seat 2: CashMatteo ($9.57 in chips) 
Seat 3: conman899 ($38.79 in chips) 
Seat 4: Villa0722 ($24.17 in chips) 
Seat 5: LoCoSi ($11.27 in chips) 
Seat 6: l3lackhammer ($10.64 in chips) 
conman899: posts small blind $0.05
Villa0722: posts big blind $0.10
*** HOLE CARDS ***
Dealt to CashMatteo [Th 6s]
LoCoSi: folds 
l3lackhammer has timed out
l3lackhammer: folds 
Burnins: calls $0.10
CashMatteo: folds 
conman899: folds 
Villa0722: checks 
*** FLOP *** [Jh 3s 9c]
Villa0722: bets $0.24
Burnins: calls $0.24
*** TURN *** [Jh 3s 9c] [7s]
Villa0722: bets $0.35
Burnins: calls $0.35
*** RIVER *** [Jh 3s 9c 7s] [Td]
Villa0722: checks 
Burnins: bets $1.37
Villa0722: folds 
Uncalled bet ($1.37) returned to Burnins
Burnins collected $1.37 from pot
Burnins: doesn't show hand 
*** SUMMARY ***
Total pot $1.43 | Rake $0.06 
Board [Jh 3s 9c 7s Td]
Seat 1: Burnins collected ($1.37)
Seat 2: CashMatteo (button) folded before Flop (didn't bet)
Seat 3: conman899 (small blind) folded before Flop
Seat 4: Villa0722 (big blind) folded on the River
Seat 5: LoCoSi folded before Flop (didn't bet)
Seat 6: l3lackhammer folded before Flop (didn't bet)

Hand #1124: 

PokerStars Hand #246653155809:  Hold'em No Limit ($0.05/$0.10 CAD) - 2023/10/20 23:41:13 ET
Table 'Scabiosa' 6-max Seat #3 is the button
Seat 1: Burnins ($15.44 in chips) 
Seat 2: CashMatteo ($9.57 in chips) 
Seat 3: conman899 ($38.74 in chips) 
Seat 4: Villa0722 ($23.48 in chips) 
Seat 5: LoCoSi ($11.27 in chips) 
Seat 6: l3lackhammer ($10.64 in chips) 
Villa0722: posts small blind $0.05
LoCoSi: posts big blind $0.10
*** HOLE CARDS ***
Dealt to CashMatteo [Ah 8s]
l3lackhammer: folds 
Burnins: folds 
CashMatteo: raises $0.15 to $0.25
conman899: raises $0.65 to $0.90
Villa0722: folds 
LoCoSi: folds 
CashMatteo: folds 
Uncalled bet ($0.65) returned to conman899
conman899 collected $0.65 from pot
*** SUMMARY ***
Total pot $0.65 | Rake $0 
Seat 1: Burnins folded before Flop (didn't bet)
Seat 2: CashMatteo folded before Flop
Seat 3: conman899 (button) collected ($0.65)
Seat 4: Villa0722 (small blind) folded before Flop
Seat 5: LoCoSi (big blind) folded before Flop
Seat 6: l3lackhammer folded before Flop (didn't bet)

Hand #1125: 

PokerStars Hand #246653159747:  Hold'em No Limit ($0.05/$0.10 CAD) - 2023/10/20 23:41:42 ET
Table 'Scabiosa' 6-max Seat #4 is the button
Seat 1: Burnins ($15.44 in chips) 
Seat 2: CashMatteo ($9.32 in chips) 
Seat 3: conman899 ($39.14 in chips) 
Seat 4: Villa0722 ($23.43 in chips) 
Seat 5: LoCoSi ($11.17 in chips) 
Seat 6: l3lackhammer ($10.64 in chips) 
LoCoSi: posts small blind $0.05
l3lackhammer: posts big blind $0.10
*** HOLE CARDS ***
Dealt to CashMatteo [2s Jh]
Burnins: folds 
CashMatteo: folds 
conman899: raises $0.40 to $0.50
Villa0722: folds 
LoCoSi: folds 
l3lackhammer: raises $10.14 to $10.64 and is all-in
conman899: folds 
Uncalled bet ($10.14) returned to l3lackhammer
l3lackhammer collected $1.05 from pot
l3lackhammer: doesn't show hand 
*** SUMMARY ***
Total pot $1.05 | Rake $0 
Seat 1: Burnins folded before Flop (didn't bet)
Seat 2: CashMatteo folded before Flop (didn't bet)
Seat 3: conman899 folded before Flop
Seat 4: Villa0722 (button) folded before Flop (didn't bet)
Seat 5: LoCoSi (small blind) folded before Flop
Seat 6: l3lackhammer (big blind) collected ($1.05)

Hand #1126: 

PokerStars Hand #246653165044:  Hold'em No Limit ($0.05/$0.10 CAD) - 2023/10/20 23:42:19 ET
Table 'Scabiosa' 6-max Seat #5 is the button
Seat 1: Burnins ($15.44 in chips) 
Seat 2: CashMatteo ($9.32 in chips) 
Seat 3: conman899 ($38.64 in chips) 
Seat 4: Villa0722 ($23.43 in chips) 
Seat 5: LoCoSi ($11.12 in chips) 
Seat 6: l3lackhammer ($11.19 in chips) 
l3lackhammer: posts small blind $0.05
Burnins: posts big blind $0.10
*** HOLE CARDS ***
Dealt to CashMatteo [3c Qc]
CashMatteo: calls $0.10
conman899: raises $0.95 to $1.05
Villa0722: folds 
LoCoSi: folds 
l3lackhammer: folds 
Burnins: calls $0.95
CashMatteo: folds 
*** FLOP *** [8c 6c Ts]
Burnins: bets $2.15
conman899: calls $2.15
*** TURN *** [8c 6c Ts] [5h]
Burnins: bets $6.26
conman899: folds 
Uncalled bet ($6.26) returned to Burnins
Burnins collected $6.26 from pot
Burnins: doesn't show hand 
*** SUMMARY ***
Total pot $6.55 | Rake $0.29 
Board [8c 6c Ts 5h]
Seat 1: Burnins (big blind) collected ($6.26)
Seat 2: CashMatteo folded before Flop
Seat 3: conman899 folded on the Turn
Seat 4: Villa0722 folded before Flop (didn't bet)
Seat 5: LoCoSi (button) folded before Flop (didn't bet)
Seat 6: l3lackhammer (small blind) folded before Flop

Hand #1127: 

PokerStars Hand #246653175306:  Hold'em No Limit ($0.05/$0.10 CAD) - 2023/10/20 23:43:34 ET
Table 'Scabiosa' 6-max Seat #6 is the button
Seat 1: Burnins ($18.50 in chips) 
Seat 2: CashMatteo ($9.22 in chips) 
Seat 3: conman899 ($35.44 in chips) 
Seat 4: Villa0722 ($23.43 in chips) 
Seat 5: LoCoSi ($11.12 in chips) 
Seat 6: l3lackhammer ($11.14 in chips) 
Burnins: posts small blind $0.05
CashMatteo: posts big blind $0.10
*** HOLE CARDS ***
Dealt to CashMatteo [Qs 5c]
conman899: raises $0.95 to $1.05
Villa0722: folds 
LoCoSi: folds 
l3lackhammer: raises $10.09 to $11.14 and is all-in
Burnins: folds 
CashMatteo: folds 
conman899: calls $10.09
*** FLOP *** [4d Tc 2d]
*** TURN *** [4d Tc 2d] [6h]
*** RIVER *** [4d Tc 2d 6h] [Td]
*** SHOW DOWN ***
conman899: shows [Qh Qd] (two pair, Queens and Tens)
l3lackhammer: shows [Kc Ah] (a pair of Tens)
conman899 collected $21.42 from pot
*** SUMMARY ***
Total pot $22.43 | Rake $1.01 
Board [4d Tc 2d 6h Td]
Seat 1: Burnins (small blind) folded before Flop
Seat 2: CashMatteo (big blind) folded before Flop
Seat 3: conman899 showed [Qh Qd] and won ($21.42) with two pair, Queens and Tens
Seat 4: Villa0722 folded before Flop (didn't bet)
Seat 5: LoCoSi folded before Flop (didn't bet)
Seat 6: l3lackhammer (button) showed [Kc Ah] and lost with a pair of Tens

Hand #1128: 

PokerStars Hand #246653180090:  Hold'em No Limit ($0.05/$0.10 CAD) - 2023/10/20 23:44:08 ET
Table 'Scabiosa' 6-max Seat #1 is the button
Seat 1: Burnins ($18.45 in chips) 
Seat 2: CashMatteo ($9.12 in chips) 
Seat 3: conman899 ($45.72 in chips) 
Seat 4: Villa0722 ($23.43 in chips) 
Seat 5: LoCoSi ($11.12 in chips) 
Seat 6: l3lackhammer ($10 in chips) 
CashMatteo: posts small blind $0.05
conman899: posts big blind $0.10
*** HOLE CARDS ***
Dealt to CashMatteo [5c 6h]
Villa0722: folds 
LoCoSi: folds 
l3lackhammer: folds 
Burnins: raises $0.25 to $0.35
CashMatteo: folds 
conman899: calls $0.25
*** FLOP *** [2s Ts 3c]
conman899: checks 
Burnins: bets $0.72
conman899: folds 
Uncalled bet ($0.72) returned to Burnins
Burnins collected $0.72 from pot
Burnins: doesn't show hand 
*** SUMMARY ***
Total pot $0.75 | Rake $0.03 
Board [2s Ts 3c]
Seat 1: Burnins (button) collected ($0.72)
Seat 2: CashMatteo (small blind) folded before Flop
Seat 3: conman899 (big blind) folded on the Flop
Seat 4: Villa0722 folded before Flop (didn't bet)
Seat 5: LoCoSi folded before Flop (didn't bet)
Seat 6: l3lackhammer folded before Flop (didn't bet)

Hand #1129: 

PokerStars Hand #246653183183:  Hold'em No Limit ($0.05/$0.10 CAD) - 2023/10/20 23:44:31 ET
Table 'Scabiosa' 6-max Seat #2 is the button
Seat 1: Burnins ($18.82 in chips) 
Seat 2: CashMatteo ($9.07 in chips) 
Seat 3: conman899 ($45.37 in chips) 
Seat 4: Villa0722 ($23.43 in chips) 
Seat 5: LoCoSi ($11.12 in chips) 
Seat 6: l3lackhammer ($10 in chips) 
conman899: posts small blind $0.05
Villa0722: posts big blind $0.10
*** HOLE CARDS ***
Dealt to CashMatteo [6h 4d]
LoCoSi: calls $0.10
l3lackhammer has timed out
l3lackhammer: folds 
Burnins: folds 
CashMatteo: folds 
conman899: calls $0.05
Villa0722: checks 
*** FLOP *** [8h Ks 6c]
conman899: checks 
Villa0722: checks 
LoCoSi: checks 
*** TURN *** [8h Ks 6c] [Kd]
conman899: checks 
Villa0722: checks 
LoCoSi: checks 
*** RIVER *** [8h Ks 6c Kd] [5c]
conman899: checks 
Villa0722: checks 
LoCoSi: bets $0.20
conman899: folds 
Villa0722: raises $0.35 to $0.55
LoCoSi: raises $0.85 to $1.40
Villa0722: raises $1.60 to $3
LoCoSi: calls $1.60
*** SHOW DOWN ***
Villa0722: shows [7h 4c] (a straight, Four to Eight)
LoCoSi: shows [5s 5h] (a full house, Fives full of Kings)
LoCoSi collected $6.02 from pot
*** SUMMARY ***
Total pot $6.30 | Rake $0.28 
Board [8h Ks 6c Kd 5c]
Seat 1: Burnins folded before Flop (didn't bet)
Seat 2: CashMatteo (button) folded before Flop (didn't bet)
Seat 3: conman899 (small blind) folded on the River
Seat 4: Villa0722 (big blind) showed [7h 4c] and lost with a straight, Four to Eight
Seat 5: LoCoSi showed [5s 5h] and won ($6.02) with a full house, Fives full of Kings
Seat 6: l3lackhammer folded before Flop (didn't bet)

Hand #1130: 

PokerStars Hand #246653194684:  Hold'em No Limit ($0.05/$0.10 CAD) - 2023/10/20 23:45:53 ET
Table 'Scabiosa' 6-max Seat #3 is the button
Seat 1: Burnins ($18.82 in chips) 
Seat 2: CashMatteo ($9.07 in chips) 
Seat 3: conman899 ($45.27 in chips) 
Seat 4: Villa0722 ($20.33 in chips) 
Seat 5: LoCoSi ($14.04 in chips) 
Seat 6: l3lackhammer ($10 in chips) 
Villa0722: posts small blind $0.05
LoCoSi: posts big blind $0.10
*** HOLE CARDS ***
Dealt to CashMatteo [Ah 6h]
l3lackhammer: folds 
Burnins: raises $0.40 to $0.50
CashMatteo: calls $0.50
conman899: folds 
Villa0722: folds 
LoCoSi: folds 
*** FLOP *** [Jc Tc 9c]
Burnins: checks 
CashMatteo: checks 
*** TURN *** [Jc Tc 9c] [2d]
Burnins: bets $1.10
CashMatteo: folds 
Uncalled bet ($1.10) returned to Burnins
Burnins collected $1.10 from pot
Burnins: doesn't show hand 
*** SUMMARY ***
Total pot $1.15 | Rake $0.05 
Board [Jc Tc 9c 2d]
Seat 1: Burnins collected ($1.10)
Seat 2: CashMatteo folded on the Turn
Seat 3: conman899 (button) folded before Flop (didn't bet)
Seat 4: Villa0722 (small blind) folded before Flop
Seat 5: LoCoSi (big blind) folded before Flop
Seat 6: l3lackhammer folded before Flop (didn't bet)

Hand #1131: 

PokerStars Hand #246653199559:  Hold'em No Limit ($0.05/$0.10 CAD) - 2023/10/20 23:46:28 ET
Table 'Scabiosa' 6-max Seat #4 is the button
Seat 1: Burnins ($19.42 in chips) 
Seat 2: CashMatteo ($8.57 in chips) 
Seat 3: conman899 ($45.27 in chips) 
Seat 4: Villa0722 ($20.28 in chips) 
Seat 5: LoCoSi ($13.94 in chips) 
Seat 6: l3lackhammer ($10 in chips) 
LoCoSi: posts small blind $0.05
l3lackhammer: posts big blind $0.10
*** HOLE CARDS ***
Dealt to CashMatteo [8s Ts]
Burnins: folds 
CashMatteo: calls $0.10
conman899: raises $0.35 to $0.45
Villa0722: folds 
LoCoSi: folds 
l3lackhammer: folds 
Burnins leaves the table
CashMatteo: folds 
Uncalled bet ($0.35) returned to conman899
conman899 collected $0.35 from pot
*** SUMMARY ***
Total pot $0.35 | Rake $0 
Seat 1: Burnins folded before Flop (didn't bet)
Seat 2: CashMatteo folded before Flop
Seat 3: conman899 collected ($0.35)
Seat 4: Villa0722 (button) folded before Flop (didn't bet)
Seat 5: LoCoSi (small blind) folded before Flop
Seat 6: l3lackhammer (big blind) folded before Flop

Hand #1132: 

PokerStars Hand #246653203705:  Hold'em No Limit ($0.05/$0.10 CAD) - 2023/10/20 23:46:58 ET
Table 'Scabiosa' 6-max Seat #5 is the button
Seat 2: CashMatteo ($8.47 in chips) 
Seat 3: conman899 ($45.52 in chips) 
Seat 4: Villa0722 ($20.28 in chips) 
Seat 5: LoCoSi ($13.89 in chips) 
Seat 6: l3lackhammer ($10 in chips) 
l3lackhammer: posts small blind $0.05
CashMatteo: posts big blind $0.10
*** HOLE CARDS ***
Dealt to CashMatteo [9s 8d]
conman899: raises $0.25 to $0.35
dashmamad joins the table at seat #1 
Villa0722: calls $0.35
LoCoSi: folds 
l3lackhammer: folds 
CashMatteo: folds 
*** FLOP *** [As Jh 7c]
conman899: bets $0.81
Villa0722: calls $0.81
*** TURN *** [As Jh 7c] [9d]
conman899: checks 
Villa0722: bets $0.71
conman899: folds 
Uncalled bet ($0.71) returned to Villa0722
Villa0722 collected $2.36 from pot
Villa0722: doesn't show hand 
*** SUMMARY ***
Total pot $2.47 | Rake $0.11 
Board [As Jh 7c 9d]
Seat 2: CashMatteo (big blind) folded before Flop
Seat 3: conman899 folded on the Turn
Seat 4: Villa0722 collected ($2.36)
Seat 5: LoCoSi (button) folded before Flop (didn't bet)
Seat 6: l3lackhammer (small blind) folded before Flop

Hand #1133: 

PokerStars Hand #246653207962:  Hold'em No Limit ($0.05/$0.10 CAD) - 2023/10/20 23:47:28 ET
Table 'Scabiosa' 6-max Seat #6 is the button
Seat 2: CashMatteo ($8.37 in chips) 
Seat 3: conman899 ($44.36 in chips) 
Seat 4: Villa0722 ($21.48 in chips) 
Seat 5: LoCoSi ($13.89 in chips) 
Seat 6: l3lackhammer ($10 in chips) 
dashmamad will be allowed to play after the button
CashMatteo: posts small blind $0.05
conman899: posts big blind $0.10
*** HOLE CARDS ***
Dealt to CashMatteo [4d 8s]
Villa0722: folds 
LoCoSi: calls $0.10
l3lackhammer: folds 
CashMatteo: folds 
conman899: checks 
*** FLOP *** [Kh 7s 4s]
conman899: checks 
LoCoSi: checks 
*** TURN *** [Kh 7s 4s] [8h]
conman899: checks 
LoCoSi: bets $0.10
conman899: calls $0.10
*** RIVER *** [Kh 7s 4s 8h] [9s]
conman899: checks 
LoCoSi: bets $0.20
conman899: folds 
Uncalled bet ($0.20) returned to LoCoSi
LoCoSi collected $0.43 from pot
LoCoSi: doesn't show hand 
*** SUMMARY ***
Total pot $0.45 | Rake $0.02 
Board [Kh 7s 4s 8h 9s]
Seat 2: CashMatteo (small blind) folded before Flop
Seat 3: conman899 (big blind) folded on the River
Seat 4: Villa0722 folded before Flop (didn't bet)
Seat 5: LoCoSi collected ($0.43)
Seat 6: l3lackhammer (button) folded before Flop (didn't bet)

Hand #1134: 

PokerStars Hand #246653211452:  Hold'em No Limit ($0.05/$0.10 CAD) - 2023/10/20 23:47:54 ET
Table 'Scabiosa' 6-max Seat #2 is the button
Seat 2: CashMatteo ($8.32 in chips) 
Seat 3: conman899 ($44.16 in chips) 
Seat 4: Villa0722 ($21.48 in chips) 
Seat 5: LoCoSi ($14.12 in chips) 
Seat 6: l3lackhammer ($10 in chips) 
conman899: posts small blind $0.05
Villa0722: posts big blind $0.10
dashmamad: sits out 
*** HOLE CARDS ***
Dealt to CashMatteo [5s 5h]
LoCoSi: folds 
l3lackhammer: folds 
CashMatteo: raises $0.35 to $0.45
conman899: calls $0.40
Villa0722: folds 
*** FLOP *** [8d 9s Ts]
conman899: checks 
CashMatteo: checks 
*** TURN *** [8d 9s Ts] [9c]
conman899: checks 
CashMatteo: bets $0.48
conman899: raises $1.92 to $2.40
CashMatteo: calls $1.92
*** RIVER *** [8d 9s Ts 9c] [Tc]
conman899: checks 
CashMatteo: bets $5.47 and is all-in
conman899: calls $5.47
*** SHOW DOWN ***
CashMatteo: shows [5s 5h] (two pair, Tens and Nines)
conman899: shows [6c 7c] (a straight, Six to Ten)
conman899 collected $15.99 from pot
*** SUMMARY ***
Total pot $16.74 | Rake $0.75 
Board [8d 9s Ts 9c Tc]
Seat 2: CashMatteo (button) showed [5s 5h] and lost with two pair, Tens and Nines
Seat 3: conman899 (small blind) showed [6c 7c] and won ($15.99) with a straight, Six to Ten
Seat 4: Villa0722 (big blind) folded before Flop
Seat 5: LoCoSi folded before Flop (didn't bet)
Seat 6: l3lackhammer folded before Flop (didn't bet)

Hand #1135: 

PokerStars Hand #246653223374:  Hold'em No Limit ($0.05/$0.10 CAD) - 2023/10/20 23:49:21 ET
Table 'Scabiosa' 6-max Seat #4 is the button
Seat 2: CashMatteo ($10 in chips) 
Seat 3: conman899 ($51.83 in chips) 
Seat 4: Villa0722 ($21.48 in chips) 
Seat 5: LoCoSi ($14.02 in chips) 
Seat 6: l3lackhammer ($10 in chips) 
LoCoSi: posts small blind $0.05
l3lackhammer: posts big blind $0.10
dashmamad: sits out 
*** HOLE CARDS ***
Dealt to CashMatteo [Jh 2h]
CashMatteo: folds 
conman899: folds 
Villa0722 has timed out
Villa0722: folds 
LoCoSi: folds 
Uncalled bet ($0.05) returned to l3lackhammer
l3lackhammer collected $0.10 from pot
l3lackhammer: doesn't show hand 
*** SUMMARY ***
Total pot $0.10 | Rake $0 
Seat 2: CashMatteo folded before Flop (didn't bet)
Seat 3: conman899 folded before Flop (didn't bet)
Seat 4: Villa0722 (button) folded before Flop (didn't bet)
Seat 5: LoCoSi (small blind) folded before Flop
Seat 6: l3lackhammer (big blind) collected ($0.10)

Hand #1136: 

PokerStars Hand #246653226407:  Hold'em No Limit ($0.05/$0.10 CAD) - 2023/10/20 23:49:43 ET
Table 'Scabiosa' 6-max Seat #5 is the button
Seat 1: dashmamad ($10 in chips) 
Seat 2: CashMatteo ($10 in chips) 
Seat 3: conman899 ($51.83 in chips) 
Seat 4: Villa0722 ($21.48 in chips) 
Seat 5: LoCoSi ($13.97 in chips) 
Seat 6: l3lackhammer ($10.05 in chips) 
l3lackhammer: posts small blind $0.05
dashmamad: posts big blind $0.10
*** HOLE CARDS ***
Dealt to CashMatteo [8s 9c]
CashMatteo: folds 
conman899: raises $0.25 to $0.35
Villa0722: folds 
LoCoSi: folds 
l3lackhammer: folds 
dashmamad: folds 
Uncalled bet ($0.25) returned to conman899
conman899 collected $0.25 from pot
*** SUMMARY ***
Total pot $0.25 | Rake $0 
Seat 1: dashmamad (big blind) folded before Flop
Seat 2: CashMatteo folded before Flop (didn't bet)
Seat 3: conman899 collected ($0.25)
Seat 4: Villa0722 folded before Flop (didn't bet)
Seat 5: LoCoSi (button) folded before Flop (didn't bet)
Seat 6: l3lackhammer (small blind) folded before Flop

Hand #1137: 

PokerStars Hand #246653229284:  Hold'em No Limit ($0.05/$0.10 CAD) - 2023/10/20 23:50:04 ET
Table 'Scabiosa' 6-max Seat #6 is the button
Seat 1: dashmamad ($9.90 in chips) 
Seat 2: CashMatteo ($10 in chips) 
Seat 3: conman899 ($51.98 in chips) 
Seat 4: Villa0722 ($21.48 in chips) 
Seat 5: LoCoSi ($13.97 in chips) 
Seat 6: l3lackhammer ($10 in chips) 
dashmamad: posts small blind $0.05
CashMatteo: posts big blind $0.10
*** HOLE CARDS ***
Dealt to CashMatteo [3d 6s]
conman899: raises $0.10 to $0.20
Villa0722: folds 
LoCoSi: folds 
l3lackhammer: folds 
dashmamad: folds 
CashMatteo: folds 
Uncalled bet ($0.10) returned to conman899
conman899 collected $0.25 from pot
*** SUMMARY ***
Total pot $0.25 | Rake $0 
Seat 1: dashmamad (small blind) folded before Flop
Seat 2: CashMatteo (big blind) folded before Flop
Seat 3: conman899 collected ($0.25)
Seat 4: Villa0722 folded before Flop (didn't bet)
Seat 5: LoCoSi folded before Flop (didn't bet)
Seat 6: l3lackhammer (button) folded before Flop (didn't bet)

Hand #1138: 

PokerStars Hand #246653233025:  Hold'em No Limit ($0.05/$0.10 CAD) - 2023/10/20 23:50:31 ET
Table 'Scabiosa' 6-max Seat #1 is the button
Seat 1: dashmamad ($9.85 in chips) 
Seat 2: CashMatteo ($9.90 in chips) 
Seat 3: conman899 ($52.13 in chips) 
Seat 4: Villa0722 ($21.48 in chips) 
Seat 5: LoCoSi ($13.97 in chips) 
Seat 6: l3lackhammer ($10 in chips) 
CashMatteo: posts small blind $0.05
conman899: posts big blind $0.10
*** HOLE CARDS ***
Dealt to CashMatteo [5h As]
Villa0722: folds 
LoCoSi: folds 
l3lackhammer: folds 
dashmamad: folds 
CashMatteo: calls $0.05
conman899: raises $0.20 to $0.30
CashMatteo: calls $0.20
*** FLOP *** [3h Qc 4d]
CashMatteo: checks 
conman899: bets $0.57
CashMatteo: calls $0.57
*** TURN *** [3h Qc 4d] [Qs]
CashMatteo: checks 
conman899: bets $0.83
CashMatteo: calls $0.83
*** RIVER *** [3h Qc 4d Qs] [7s]
CashMatteo: checks 
conman899: checks 
*** SHOW DOWN ***
CashMatteo: shows [5h As] (a pair of Queens)
conman899: shows [4h 5s] (two pair, Queens and Fours)
conman899 collected $3.25 from pot
*** SUMMARY ***
Total pot $3.40 | Rake $0.15 
Board [3h Qc 4d Qs 7s]
Seat 1: dashmamad (button) folded before Flop (didn't bet)
Seat 2: CashMatteo (small blind) showed [5h As] and lost with a pair of Queens
Seat 3: conman899 (big blind) showed [4h 5s] and won ($3.25) with two pair, Queens and Fours
Seat 4: Villa0722 folded before Flop (didn't bet)
Seat 5: LoCoSi folded before Flop (didn't bet)
Seat 6: l3lackhammer folded before Flop (didn't bet)

Hand #1139: 

PokerStars Hand #246653239348:  Hold'em No Limit ($0.05/$0.10 CAD) - 2023/10/20 23:51:17 ET
Table 'Scabiosa' 6-max Seat #2 is the button
Seat 1: dashmamad ($9.85 in chips) 
Seat 2: CashMatteo ($8.20 in chips) 
Seat 3: conman899 ($53.68 in chips) 
Seat 4: Villa0722 ($21.48 in chips) 
Seat 5: LoCoSi ($13.97 in chips) 
Seat 6: l3lackhammer ($10 in chips) 
conman899: posts small blind $0.05
Villa0722: posts big blind $0.10
*** HOLE CARDS ***
Dealt to CashMatteo [6c 9d]
LoCoSi: calls $0.10
l3lackhammer: folds 
dashmamad: raises $0.35 to $0.45
CashMatteo: folds 
conman899: folds 
Villa0722: folds 
LoCoSi: calls $0.35
*** FLOP *** [8s 7d 4s]
LoCoSi: checks 
dashmamad: bets $0.50
LoCoSi: folds 
Uncalled bet ($0.50) returned to dashmamad
dashmamad collected $1 from pot
dashmamad: doesn't show hand 
*** SUMMARY ***
Total pot $1.05 | Rake $0.05 
Board [8s 7d 4s]
Seat 1: dashmamad collected ($1)
Seat 2: CashMatteo (button) folded before Flop (didn't bet)
Seat 3: conman899 (small blind) folded before Flop
Seat 4: Villa0722 (big blind) folded before Flop
Seat 5: LoCoSi folded on the Flop
Seat 6: l3lackhammer folded before Flop (didn't bet)

Hand #1140: 

PokerStars Hand #246653245579:  Hold'em No Limit ($0.05/$0.10 CAD) - 2023/10/20 23:52:01 ET
Table 'Scabiosa' 6-max Seat #3 is the button
Seat 1: dashmamad ($10.40 in chips) 
Seat 2: CashMatteo ($8.20 in chips) 
Seat 3: conman899 ($53.63 in chips) 
Seat 4: Villa0722 ($21.38 in chips) 
Seat 5: LoCoSi ($13.52 in chips) 
Seat 6: l3lackhammer ($10 in chips) 
Villa0722: posts small blind $0.05
LoCoSi: posts big blind $0.10
*** HOLE CARDS ***
Dealt to CashMatteo [2s Ad]
l3lackhammer: folds 
dashmamad: folds 
CashMatteo: calls $0.10
conman899: raises $0.45 to $0.55
Villa0722: folds 
LoCoSi: folds 
CashMatteo: folds 
Uncalled bet ($0.45) returned to conman899
conman899 collected $0.35 from pot
*** SUMMARY ***
Total pot $0.35 | Rake $0 
Seat 1: dashmamad folded before Flop (didn't bet)
Seat 2: CashMatteo folded before Flop
Seat 3: conman899 (button) collected ($0.35)
Seat 4: Villa0722 (small blind) folded before Flop
Seat 5: LoCoSi (big blind) folded before Flop
Seat 6: l3lackhammer folded before Flop (didn't bet)

Hand #1141: 

PokerStars Hand #246653249074:  Hold'em No Limit ($0.05/$0.10 CAD) - 2023/10/20 23:52:26 ET
Table 'Scabiosa' 6-max Seat #4 is the button
Seat 1: dashmamad ($10.40 in chips) 
Seat 2: CashMatteo ($8.10 in chips) 
Seat 3: conman899 ($53.88 in chips) 
Seat 4: Villa0722 ($21.33 in chips) 
Seat 5: LoCoSi ($13.42 in chips) 
Seat 6: l3lackhammer ($10 in chips) 
LoCoSi: posts small blind $0.05
l3lackhammer: posts big blind $0.10
*** HOLE CARDS ***
Dealt to CashMatteo [Js 7d]
dashmamad: folds 
CashMatteo: folds 
conman899: raises $0.35 to $0.45
Villa0722: folds 
LoCoSi: folds 
l3lackhammer: folds 
Uncalled bet ($0.35) returned to conman899
conman899 collected $0.25 from pot
*** SUMMARY ***
Total pot $0.25 | Rake $0 
Seat 1: dashmamad folded before Flop (didn't bet)
Seat 2: CashMatteo folded before Flop (didn't bet)
Seat 3: conman899 collected ($0.25)
Seat 4: Villa0722 (button) folded before Flop (didn't bet)
Seat 5: LoCoSi (small blind) folded before Flop
Seat 6: l3lackhammer (big blind) folded before Flop

Hand #1142: 

PokerStars Hand #246653252140:  Hold'em No Limit ($0.05/$0.10 CAD) - 2023/10/20 23:52:48 ET
Table 'Scabiosa' 6-max Seat #5 is the button
Seat 1: dashmamad ($10.40 in chips) 
Seat 2: CashMatteo ($8.10 in chips) 
Seat 3: conman899 ($54.03 in chips) 
Seat 4: Villa0722 ($21.33 in chips) 
Seat 5: LoCoSi ($13.37 in chips) 
Seat 6: l3lackhammer ($10 in chips) 
l3lackhammer: posts small blind $0.05
dashmamad: posts big blind $0.10
*** HOLE CARDS ***
Dealt to CashMatteo [9h Qs]
CashMatteo: calls $0.10
conman899: raises $0.35 to $0.45
Villa0722: folds 
LoCoSi: folds 
l3lackhammer: folds 
dashmamad: folds 
CashMatteo: calls $0.35
*** FLOP *** [4c 7s Td]
CashMatteo: checks 
conman899: checks 
*** TURN *** [4c 7s Td] [8h]
CashMatteo: checks 
conman899: bets $1
CashMatteo: calls $1
*** RIVER *** [4c 7s Td 8h] [As]
CashMatteo: checks 
conman899: bets $52.58 and is all-in
CashMatteo: folds 
Uncalled bet ($52.58) returned to conman899
conman899 collected $2.91 from pot
*** SUMMARY ***
Total pot $3.05 | Rake $0.14 
Board [4c 7s Td 8h As]
Seat 1: dashmamad (big blind) folded before Flop
Seat 2: CashMatteo folded on the River
Seat 3: conman899 collected ($2.91)
Seat 4: Villa0722 folded before Flop (didn't bet)
Seat 5: LoCoSi (button) folded before Flop (didn't bet)
Seat 6: l3lackhammer (small blind) folded before Flop

Hand #1143: 

PokerStars Hand #246653259102:  Hold'em No Limit ($0.05/$0.10 CAD) - 2023/10/20 23:53:39 ET
Table 'Scabiosa' 6-max Seat #6 is the button
Seat 1: dashmamad ($10.30 in chips) 
Seat 2: CashMatteo ($6.65 in chips) 
Seat 3: conman899 ($55.49 in chips) 
Seat 4: Villa0722 ($21.33 in chips) 
Seat 5: LoCoSi ($13.37 in chips) 
Seat 6: l3lackhammer ($10 in chips) 
dashmamad: posts small blind $0.05
CashMatteo: posts big blind $0.10
*** HOLE CARDS ***
Dealt to CashMatteo [6h 5h]
conman899: calls $0.10
Villa0722: folds 
LoCoSi: raises $0.20 to $0.30
l3lackhammer: folds 
dashmamad: calls $0.25
CashMatteo: calls $0.20
conman899: calls $0.20
*** FLOP *** [Kh Th 7s]
dashmamad: checks 
CashMatteo: checks 
conman899: checks 
LoCoSi: bets $0.50
dashmamad: folds 
CashMatteo: calls $0.50
conman899: calls $0.50
*** TURN *** [Kh Th 7s] [Tc]
CashMatteo: checks 
conman899: bets $1.29
LoCoSi: calls $1.29
CashMatteo: folds 
*** RIVER *** [Kh Th 7s Tc] [Kd]
conman899: checks 
LoCoSi: bets $2.20
conman899: folds 
Uncalled bet ($2.20) returned to LoCoSi
LoCoSi collected $5.04 from pot
LoCoSi: doesn't show hand 
*** SUMMARY ***
Total pot $5.28 | Rake $0.24 
Board [Kh Th 7s Tc Kd]
Seat 1: dashmamad (small blind) folded on the Flop
Seat 2: CashMatteo (big blind) folded on the Turn
Seat 3: conman899 folded on the River
Seat 4: Villa0722 folded before Flop (didn't bet)
Seat 5: LoCoSi collected ($5.04)
Seat 6: l3lackhammer (button) folded before Flop (didn't bet)

Hand #1144: 

PokerStars Hand #246653265816:  Hold'em No Limit ($0.05/$0.10 CAD) - 2023/10/20 23:54:28 ET
Table 'Scabiosa' 6-max Seat #1 is the button
Seat 1: dashmamad ($10 in chips) 
Seat 2: CashMatteo ($5.85 in chips) 
Seat 3: conman899 ($53.40 in chips) 
Seat 4: Villa0722 ($21.33 in chips) 
Seat 5: LoCoSi ($16.32 in chips) 
Seat 6: l3lackhammer ($10 in chips) 
CashMatteo: posts small blind $0.05
conman899: posts big blind $0.10
*** HOLE CARDS ***
Dealt to CashMatteo [Ac Qc]
Villa0722: folds 
LoCoSi: calls $0.10
l3lackhammer: folds 
dashmamad: folds 
CashMatteo: raises $0.35 to $0.45
conman899: folds 
LoCoSi: folds 
Uncalled bet ($0.35) returned to CashMatteo
CashMatteo collected $0.30 from pot
CashMatteo: doesn't show hand 
*** SUMMARY ***
Total pot $0.30 | Rake $0 
Seat 1: dashmamad (button) folded before Flop (didn't bet)
Seat 2: CashMatteo (small blind) collected ($0.30)
Seat 3: conman899 (big blind) folded before Flop
Seat 4: Villa0722 folded before Flop (didn't bet)
Seat 5: LoCoSi folded before Flop
Seat 6: l3lackhammer folded before Flop (didn't bet)

Hand #1145: 

PokerStars Hand #246653268499:  Hold'em No Limit ($0.05/$0.10 CAD) - 2023/10/20 23:54:47 ET
Table 'Scabiosa' 6-max Seat #2 is the button
Seat 1: dashmamad ($10 in chips) 
Seat 2: CashMatteo ($6.05 in chips) 
Seat 3: conman899 ($53.30 in chips) 
Seat 4: Villa0722 ($21.33 in chips) 
Seat 5: LoCoSi ($16.22 in chips) 
Seat 6: l3lackhammer ($10 in chips) 
conman899: posts small blind $0.05
Villa0722: posts big blind $0.10
*** HOLE CARDS ***
Dealt to CashMatteo [5d 9s]
LoCoSi: folds 
l3lackhammer: folds 
dashmamad: folds 
CashMatteo: folds 
conman899: raises $0.20 to $0.30
Villa0722: folds 
Uncalled bet ($0.20) returned to conman899
conman899 collected $0.20 from pot
*** SUMMARY ***
Total pot $0.20 | Rake $0 
Seat 1: dashmamad folded before Flop (didn't bet)
Seat 2: CashMatteo (button) folded before Flop (didn't bet)
Seat 3: conman899 (small blind) collected ($0.20)
Seat 4: Villa0722 (big blind) folded before Flop
Seat 5: LoCoSi folded before Flop (didn't bet)
Seat 6: l3lackhammer folded before Flop (didn't bet)

Hand #1146: 

PokerStars Hand #246653271410:  Hold'em No Limit ($0.05/$0.10 CAD) - 2023/10/20 23:55:09 ET
Table 'Scabiosa' 6-max Seat #3 is the button
Seat 1: dashmamad ($10 in chips) 
Seat 2: CashMatteo ($6.05 in chips) 
Seat 3: conman899 ($53.40 in chips) 
Seat 4: Villa0722 ($21.23 in chips) 
Seat 5: LoCoSi ($16.22 in chips) 
Seat 6: l3lackhammer ($10 in chips) 
Villa0722: posts small blind $0.05
LoCoSi: posts big blind $0.10
*** HOLE CARDS ***
Dealt to CashMatteo [7d As]
l3lackhammer has timed out
l3lackhammer: folds 
dashmamad: raises $0.20 to $0.30
CashMatteo: calls $0.30
conman899: calls $0.30
Villa0722: folds 
LoCoSi: folds 
*** FLOP *** [Ah 3d Qc]
dashmamad: bets $1
CashMatteo: calls $1
conman899: folds 
*** TURN *** [Ah 3d Qc] [6s]
dashmamad: checks 
CashMatteo: checks 
*** RIVER *** [Ah 3d Qc 6s] [5d]
dashmamad: checks 
CashMatteo: checks 
*** SHOW DOWN ***
dashmamad: shows [9d Ad] (a pair of Aces)
CashMatteo: mucks hand 
dashmamad collected $2.91 from pot
*** SUMMARY ***
Total pot $3.05 | Rake $0.14 
Board [Ah 3d Qc 6s 5d]
Seat 1: dashmamad showed [9d Ad] and won ($2.91) with a pair of Aces
Seat 2: CashMatteo mucked [7d As]
Seat 3: conman899 (button) folded on the Flop
Seat 4: Villa0722 (small blind) folded before Flop
Seat 5: LoCoSi (big blind) folded before Flop
Seat 6: l3lackhammer folded before Flop (didn't bet)

Hand #1147: 

PokerStars Hand #246653277763:  Hold'em No Limit ($0.05/$0.10 CAD) - 2023/10/20 23:56:04 ET
Table 'Scabiosa' 6-max Seat #4 is the button
Seat 1: dashmamad ($11.61 in chips) 
Seat 2: CashMatteo ($4.75 in chips) 
Seat 3: conman899 ($53.10 in chips) 
Seat 4: Villa0722 ($21.18 in chips) 
Seat 5: LoCoSi ($16.12 in chips) 
Seat 6: l3lackhammer ($10 in chips) 
LoCoSi: posts small blind $0.05
l3lackhammer: posts big blind $0.10
*** HOLE CARDS ***
Dealt to CashMatteo [Qd 3s]
dashmamad: folds 
CashMatteo: folds 
conman899: folds 
Villa0722: raises $0.10 to $0.20
LoCoSi: folds 
l3lackhammer: calls $0.10
*** FLOP *** [6d Jc 5d]
l3lackhammer: checks 
Villa0722: checks 
*** TURN *** [6d Jc 5d] [5h]
l3lackhammer: checks 
Villa0722: bets $0.22
l3lackhammer: calls $0.22
*** RIVER *** [6d Jc 5d 5h] [4d]
l3lackhammer: checks 
Villa0722: bets $0.43
l3lackhammer: calls $0.43
*** SHOW DOWN ***
Villa0722: shows [Jh Kd] (two pair, Jacks and Fives)
l3lackhammer: mucks hand 
Villa0722 collected $1.67 from pot
*** SUMMARY ***
Total pot $1.75 | Rake $0.08 
Board [6d Jc 5d 5h 4d]
Seat 1: dashmamad folded before Flop (didn't bet)
Seat 2: CashMatteo folded before Flop (didn't bet)
Seat 3: conman899 folded before Flop (didn't bet)
Seat 4: Villa0722 (button) showed [Jh Kd] and won ($1.67) with two pair, Jacks and Fives
Seat 5: LoCoSi (small blind) folded before Flop
Seat 6: l3lackhammer (big blind) mucked [As 8s]

Hand #1148: 

PokerStars Hand #246653282365:  Hold'em No Limit ($0.05/$0.10 CAD) - 2023/10/20 23:56:45 ET
Table 'Scabiosa' 6-max Seat #5 is the button
Seat 1: dashmamad ($11.61 in chips) 
Seat 2: CashMatteo ($4.75 in chips) 
Seat 3: conman899 ($53.10 in chips) 
Seat 4: Villa0722 ($22 in chips) 
Seat 5: LoCoSi ($16.07 in chips) 
Seat 6: l3lackhammer ($10 in chips) 
l3lackhammer: posts small blind $0.05
dashmamad: posts big blind $0.10
*** HOLE CARDS ***
Dealt to CashMatteo [2d 4h]
CashMatteo: folds 
conman899: raises $0.45 to $0.55
Villa0722: folds 
LoCoSi: folds 
l3lackhammer: folds 
dashmamad: folds 
Uncalled bet ($0.45) returned to conman899
conman899 collected $0.25 from pot
*** SUMMARY ***
Total pot $0.25 | Rake $0 
Seat 1: dashmamad (big blind) folded before Flop
Seat 2: CashMatteo folded before Flop (didn't bet)
Seat 3: conman899 collected ($0.25)
Seat 4: Villa0722 folded before Flop (didn't bet)
Seat 5: LoCoSi (button) folded before Flop (didn't bet)
Seat 6: l3lackhammer (small blind) folded before Flop

Hand #1149: 

PokerStars Hand #246653284666:  Hold'em No Limit ($0.05/$0.10 CAD) - 2023/10/20 23:57:06 ET
Table 'Scabiosa' 6-max Seat #6 is the button
Seat 1: dashmamad ($11.51 in chips) 
Seat 2: CashMatteo ($4.75 in chips) 
Seat 3: conman899 ($53.25 in chips) 
Seat 4: Villa0722 ($22 in chips) 
Seat 5: LoCoSi ($16.07 in chips) 
Seat 6: l3lackhammer ($10 in chips) 
dashmamad: posts small blind $0.05
CashMatteo: posts big blind $0.10
*** HOLE CARDS ***
Dealt to CashMatteo [Qh 5c]
conman899: folds 
Villa0722: folds 
LoCoSi: folds 
l3lackhammer: folds 
dashmamad: folds 
Uncalled bet ($0.05) returned to CashMatteo
CashMatteo collected $0.10 from pot
CashMatteo: doesn't show hand 
*** SUMMARY ***
Total pot $0.10 | Rake $0 
Seat 1: dashmamad (small blind) folded before Flop
Seat 2: CashMatteo (big blind) collected ($0.10)
Seat 3: conman899 folded before Flop (didn't bet)
Seat 4: Villa0722 folded before Flop (didn't bet)
Seat 5: LoCoSi folded before Flop (didn't bet)
Seat 6: l3lackhammer (button) folded before Flop (didn't bet)

Hand #1150: 

PokerStars Hand #246653287191:  Hold'em No Limit ($0.05/$0.10 CAD) - 2023/10/20 23:57:28 ET
Table 'Scabiosa' 6-max Seat #1 is the button
Seat 1: dashmamad ($11.46 in chips) 
Seat 2: CashMatteo ($4.80 in chips) 
Seat 3: conman899 ($53.25 in chips) 
Seat 4: Villa0722 ($22 in chips) 
Seat 5: LoCoSi ($16.07 in chips) 
Seat 6: l3lackhammer ($10 in chips) 
CashMatteo: posts small blind $0.05
conman899: posts big blind $0.10
*** HOLE CARDS ***
Dealt to CashMatteo [4h 2c]
Villa0722: raises $0.10 to $0.20
LoCoSi: folds 
l3lackhammer: folds 
dashmamad: folds 
CashMatteo: folds 
conman899: folds 
Uncalled bet ($0.10) returned to Villa0722
Villa0722 collected $0.25 from pot
Villa0722: doesn't show hand 
*** SUMMARY ***
Total pot $0.25 | Rake $0 
Seat 1: dashmamad (button) folded before Flop (didn't bet)
Seat 2: CashMatteo (small blind) folded before Flop
Seat 3: conman899 (big blind) folded before Flop
Seat 4: Villa0722 collected ($0.25)
Seat 5: LoCoSi folded before Flop (didn't bet)
Seat 6: l3lackhammer folded before Flop (didn't bet)

Hand #1151: 

PokerStars Hand #246653289005:  Hold'em No Limit ($0.05/$0.10 CAD) - 2023/10/20 23:57:44 ET
Table 'Scabiosa' 6-max Seat #2 is the button
Seat 1: dashmamad ($11.46 in chips) 
Seat 2: CashMatteo ($4.75 in chips) 
Seat 3: conman899 ($53.15 in chips) 
Seat 4: Villa0722 ($22.15 in chips) 
Seat 5: LoCoSi ($16.07 in chips) 
Seat 6: l3lackhammer ($10 in chips) 
conman899: posts small blind $0.05
Villa0722: posts big blind $0.10
*** HOLE CARDS ***
Dealt to CashMatteo [Tc 2s]
LoCoSi: calls $0.10
l3lackhammer: folds 
dashmamad: folds 
CashMatteo: folds 
conman899: folds 
Villa0722: checks 
*** FLOP *** [8h Qc Ac]
Villa0722: checks 
LoCoSi: bets $0.20
Villa0722: folds 
Uncalled bet ($0.20) returned to LoCoSi
LoCoSi collected $0.24 from pot
LoCoSi: doesn't show hand 
*** SUMMARY ***
Total pot $0.25 | Rake $0.01 
Board [8h Qc Ac]
Seat 1: dashmamad folded before Flop (didn't bet)
Seat 2: CashMatteo (button) folded before Flop (didn't bet)
Seat 3: conman899 (small blind) folded before Flop
Seat 4: Villa0722 (big blind) folded on the Flop
Seat 5: LoCoSi collected ($0.24)
Seat 6: l3lackhammer folded before Flop (didn't bet)

Hand #1152: 

PokerStars Hand #246653291721:  Hold'em No Limit ($0.05/$0.10 CAD) - 2023/10/20 23:58:09 ET
Table 'Scabiosa' 6-max Seat #3 is the button
Seat 1: dashmamad ($11.46 in chips) 
Seat 2: CashMatteo ($4.75 in chips) 
Seat 3: conman899 ($53.10 in chips) 
Seat 4: Villa0722 ($22.05 in chips) 
Seat 5: LoCoSi ($16.21 in chips) 
Seat 6: l3lackhammer ($10 in chips) 
Villa0722: posts small blind $0.05
LoCoSi: posts big blind $0.10
*** HOLE CARDS ***
Dealt to CashMatteo [6s Jc]
l3lackhammer: folds 
dashmamad: folds 
CashMatteo: folds 
conman899: folds 
Villa0722: raises $0.20 to $0.30
LoCoSi: folds 
Uncalled bet ($0.20) returned to Villa0722
Villa0722 collected $0.20 from pot
Villa0722: doesn't show hand 
*** SUMMARY ***
Total pot $0.20 | Rake $0 
Seat 1: dashmamad folded before Flop (didn't bet)
Seat 2: CashMatteo folded before Flop (didn't bet)
Seat 3: conman899 (button) folded before Flop (didn't bet)
Seat 4: Villa0722 (small blind) collected ($0.20)
Seat 5: LoCoSi (big blind) folded before Flop
Seat 6: l3lackhammer folded before Flop (didn't bet)

Hand #1153: 

PokerStars Hand #246653294288:  Hold'em No Limit ($0.05/$0.10 CAD) - 2023/10/20 23:58:32 ET
Table 'Scabiosa' 6-max Seat #4 is the button
Seat 1: dashmamad ($11.46 in chips) 
Seat 2: CashMatteo ($4.75 in chips) 
Seat 3: conman899 ($53.10 in chips) 
Seat 4: Villa0722 ($22.15 in chips) 
Seat 5: LoCoSi ($16.11 in chips) 
Seat 6: l3lackhammer ($10 in chips) 
LoCoSi: posts small blind $0.05
l3lackhammer: posts big blind $0.10
*** HOLE CARDS ***
Dealt to CashMatteo [Kd 2c]
dashmamad: folds 
CashMatteo: folds 
conman899: raises $0.45 to $0.55
Villa0722: folds 
LoCoSi: folds 
l3lackhammer: folds 
Uncalled bet ($0.45) returned to conman899
conman899 collected $0.25 from pot
*** SUMMARY ***
Total pot $0.25 | Rake $0 
Seat 1: dashmamad folded before Flop (didn't bet)
Seat 2: CashMatteo folded before Flop (didn't bet)
Seat 3: conman899 collected ($0.25)
Seat 4: Villa0722 (button) folded before Flop (didn't bet)
Seat 5: LoCoSi (small blind) folded before Flop
Seat 6: l3lackhammer (big blind) folded before Flop

Hand #1154: 

PokerStars Hand #246653297213:  Hold'em No Limit ($0.05/$0.10 CAD) - 2023/10/20 23:58:58 ET
Table 'Scabiosa' 6-max Seat #5 is the button
Seat 1: dashmamad ($11.46 in chips) 
Seat 2: CashMatteo ($4.75 in chips) 
Seat 3: conman899 ($53.25 in chips) 
Seat 4: Villa0722 ($22.15 in chips) 
Seat 5: LoCoSi ($16.06 in chips) 
Seat 6: l3lackhammer ($10 in chips) 
l3lackhammer: posts small blind $0.05
dashmamad: posts big blind $0.10
*** HOLE CARDS ***
Dealt to CashMatteo [8h 7s]
CashMatteo: folds 
conman899: raises $0.45 to $0.55
Villa0722: calls $0.55
LoCoSi: folds 
l3lackhammer: folds 
dashmamad: calls $0.45
*** FLOP *** [Qd As 6d]
dashmamad: checks 
conman899: checks 
Villa0722: checks 
*** TURN *** [Qd As 6d] [Ah]
dashmamad: bets $0.81
conman899: calls $0.81
Villa0722: folds 
*** RIVER *** [Qd As 6d Ah] [3c]
dashmamad: checks 
conman899: checks 
*** SHOW DOWN ***
dashmamad: shows [Js Qs] (two pair, Aces and Queens)
conman899: shows [4h Ad] (three of a kind, Aces)
conman899 collected $3.17 from pot
*** SUMMARY ***
Total pot $3.32 | Rake $0.15 
Board [Qd As 6d Ah 3c]
Seat 1: dashmamad (big blind) showed [Js Qs] and lost with two pair, Aces and Queens
Seat 2: CashMatteo folded before Flop (didn't bet)
Seat 3: conman899 showed [4h Ad] and won ($3.17) with three of a kind, Aces
Seat 4: Villa0722 folded on the Turn
Seat 5: LoCoSi (button) folded before Flop (didn't bet)
Seat 6: l3lackhammer (small blind) folded before Flop

Hand #1155: 

PokerStars Hand #246653304377:  Hold'em No Limit ($0.05/$0.10 CAD) - 2023/10/21 0:00:01 ET
Table 'Scabiosa' 6-max Seat #6 is the button
Seat 1: dashmamad ($10.10 in chips) 
Seat 2: CashMatteo ($4.75 in chips) 
Seat 3: conman899 ($55.06 in chips) 
Seat 4: Villa0722 ($21.60 in chips) 
Seat 5: LoCoSi ($16.06 in chips) 
Seat 6: l3lackhammer ($10 in chips) 
dashmamad: posts small blind $0.05
CashMatteo: posts big blind $0.10
*** HOLE CARDS ***
Dealt to CashMatteo [5d 5s]
conman899: folds 
Villa0722: folds 
LoCoSi: folds 
l3lackhammer: folds 
dashmamad: raises $0.20 to $0.30
CashMatteo: raises $0.60 to $0.90
dashmamad: calls $0.60
*** FLOP *** [Qc 9d 8s]
dashmamad: checks 
CashMatteo: checks 
*** TURN *** [Qc 9d 8s] [9c]
dashmamad: checks 
CashMatteo: checks 
*** RIVER *** [Qc 9d 8s 9c] [Kh]
dashmamad: checks 
CashMatteo: checks 
*** SHOW DOWN ***
dashmamad: shows [Kc Ah] (two pair, Kings and Nines)
CashMatteo: mucks hand 
dashmamad collected $1.72 from pot
*** SUMMARY ***
Total pot $1.80 | Rake $0.08 
Board [Qc 9d 8s 9c Kh]
Seat 1: dashmamad (small blind) showed [Kc Ah] and won ($1.72) with two pair, Kings and Nines
Seat 2: CashMatteo (big blind) mucked [5d 5s]
Seat 3: conman899 folded before Flop (didn't bet)
Seat 4: Villa0722 folded before Flop (didn't bet)
Seat 5: LoCoSi folded before Flop (didn't bet)
Seat 6: l3lackhammer (button) folded before Flop (didn't bet)

Hand #1156: 

PokerStars Hand #246653310063:  Hold'em No Limit ($0.05/$0.10 CAD) - 2023/10/21 0:00:50 ET
Table 'Scabiosa' 6-max Seat #1 is the button
Seat 1: dashmamad ($10.92 in chips) 
Seat 2: CashMatteo ($3.85 in chips) 
Seat 3: conman899 ($55.06 in chips) 
Seat 4: Villa0722 ($21.60 in chips) 
Seat 5: LoCoSi ($16.06 in chips) 
Seat 6: l3lackhammer ($10 in chips) 
CashMatteo: posts small blind $0.05
conman899: posts big blind $0.10
*** HOLE CARDS ***
Dealt to CashMatteo [5h 2c]
Villa0722: folds 
LoCoSi: folds 
l3lackhammer: raises $0.20 to $0.30
dashmamad: calls $0.30
CashMatteo: folds 
conman899: raises $1.15 to $1.45
l3lackhammer: folds 
dashmamad: folds 
Uncalled bet ($1.15) returned to conman899
conman899 collected $0.95 from pot
*** SUMMARY ***
Total pot $0.95 | Rake $0 
Seat 1: dashmamad (button) folded before Flop
Seat 2: CashMatteo (small blind) folded before Flop
Seat 3: conman899 (big blind) collected ($0.95)
Seat 4: Villa0722 folded before Flop (didn't bet)
Seat 5: LoCoSi folded before Flop (didn't bet)
Seat 6: l3lackhammer folded before Flop

Hand #1157: 

PokerStars Hand #246653314485:  Hold'em No Limit ($0.05/$0.10 CAD) - 2023/10/21 0:01:25 ET
Table 'Scabiosa' 6-max Seat #2 is the button
Seat 1: dashmamad ($10.62 in chips) 
Seat 2: CashMatteo ($3.80 in chips) 
Seat 3: conman899 ($55.71 in chips) 
Seat 4: Villa0722 ($21.60 in chips) 
Seat 5: LoCoSi ($16.06 in chips) 
Seat 6: l3lackhammer ($10 in chips) 
conman899: posts small blind $0.05
Villa0722: posts big blind $0.10
*** HOLE CARDS ***
Dealt to CashMatteo [6s 8c]
LoCoSi: folds 
l3lackhammer: folds 
dashmamad: folds 
CashMatteo: folds 
conman899: folds 
Uncalled bet ($0.05) returned to Villa0722
Villa0722 collected $0.10 from pot
Villa0722: doesn't show hand 
*** SUMMARY ***
Total pot $0.10 | Rake $0 
Seat 1: dashmamad folded before Flop (didn't bet)
Seat 2: CashMatteo (button) folded before Flop (didn't bet)
Seat 3: conman899 (small blind) folded before Flop
Seat 4: Villa0722 (big blind) collected ($0.10)
Seat 5: LoCoSi folded before Flop (didn't bet)
Seat 6: l3lackhammer folded before Flop (didn't bet)

Hand #1158: 

PokerStars Hand #246653315811:  Hold'em No Limit ($0.05/$0.10 CAD) - 2023/10/21 0:01:35 ET
Table 'Scabiosa' 6-max Seat #3 is the button
Seat 1: dashmamad ($10.62 in chips) 
Seat 2: CashMatteo ($3.80 in chips) 
Seat 3: conman899 ($55.66 in chips) 
Seat 4: Villa0722 ($21.65 in chips) 
Seat 5: LoCoSi ($16.06 in chips) 
Seat 6: l3lackhammer ($10 in chips) 
Villa0722: posts small blind $0.05
LoCoSi: posts big blind $0.10
*** HOLE CARDS ***
Dealt to CashMatteo [2s 7c]
l3lackhammer: folds 
dashmamad: raises $0.20 to $0.30
CashMatteo: folds 
conman899: folds 
Villa0722: folds 
LoCoSi: folds 
Uncalled bet ($0.20) returned to dashmamad
dashmamad collected $0.25 from pot
dashmamad: doesn't show hand 
*** SUMMARY ***
Total pot $0.25 | Rake $0 
Seat 1: dashmamad collected ($0.25)
Seat 2: CashMatteo folded before Flop (didn't bet)
Seat 3: conman899 (button) folded before Flop (didn't bet)
Seat 4: Villa0722 (small blind) folded before Flop
Seat 5: LoCoSi (big blind) folded before Flop
Seat 6: l3lackhammer folded before Flop (didn't bet)

Hand #1159: 

PokerStars Hand #246653317770:  Hold'em No Limit ($0.05/$0.10 CAD) - 2023/10/21 0:01:50 ET
Table 'Scabiosa' 6-max Seat #4 is the button
Seat 1: dashmamad ($10.77 in chips) 
Seat 2: CashMatteo ($3.80 in chips) 
Seat 3: conman899 ($55.66 in chips) 
Seat 4: Villa0722 ($21.60 in chips) 
Seat 5: LoCoSi ($15.96 in chips) 
Seat 6: l3lackhammer ($10 in chips) 
LoCoSi: posts small blind $0.05
l3lackhammer: posts big blind $0.10
*** HOLE CARDS ***
Dealt to CashMatteo [Tc 3s]
dashmamad: folds 
CashMatteo: folds 
conman899: folds 
Villa0722: raises $0.10 to $0.20
LoCoSi: folds 
l3lackhammer: folds 
Uncalled bet ($0.10) returned to Villa0722
Villa0722 collected $0.25 from pot
Villa0722: doesn't show hand 
*** SUMMARY ***
Total pot $0.25 | Rake $0 
Seat 1: dashmamad folded before Flop (didn't bet)
Seat 2: CashMatteo folded before Flop (didn't bet)
Seat 3: conman899 folded before Flop (didn't bet)
Seat 4: Villa0722 (button) collected ($0.25)
Seat 5: LoCoSi (small blind) folded before Flop
Seat 6: l3lackhammer (big blind) folded before Flop

Hand #1160: 

PokerStars Hand #246653320067:  Hold'em No Limit ($0.05/$0.10 CAD) - 2023/10/21 0:02:07 ET
Table 'Scabiosa' 6-max Seat #5 is the button
Seat 1: dashmamad ($10.77 in chips) 
Seat 2: CashMatteo ($3.80 in chips) 
Seat 3: conman899 ($55.66 in chips) 
Seat 4: Villa0722 ($21.75 in chips) 
Seat 5: LoCoSi ($15.91 in chips) 
Seat 6: l3lackhammer ($10 in chips) 
l3lackhammer: posts small blind $0.05
dashmamad: posts big blind $0.10
*** HOLE CARDS ***
Dealt to CashMatteo [2h 3h]
CashMatteo: calls $0.10
conman899: raises $0.45 to $0.55
Villa0722: folds 
LoCoSi: folds 
l3lackhammer: folds 
dashmamad: folds 
CashMatteo: folds 
Uncalled bet ($0.45) returned to conman899
conman899 collected $0.35 from pot
*** SUMMARY ***
Total pot $0.35 | Rake $0 
Seat 1: dashmamad (big blind) folded before Flop
Seat 2: CashMatteo folded before Flop
Seat 3: conman899 collected ($0.35)
Seat 4: Villa0722 folded before Flop (didn't bet)
Seat 5: LoCoSi (button) folded before Flop (didn't bet)
Seat 6: l3lackhammer (small blind) folded before Flop

Hand #1161: 

PokerStars Hand #246653323314:  Hold'em No Limit ($0.05/$0.10 CAD) - 2023/10/21 0:02:31 ET
Table 'Scabiosa' 6-max Seat #6 is the button
Seat 1: dashmamad ($10.67 in chips) 
Seat 2: CashMatteo ($3.70 in chips) 
Seat 3: conman899 ($55.91 in chips) 
Seat 4: Villa0722 ($21.75 in chips) 
Seat 5: LoCoSi ($15.91 in chips) 
Seat 6: l3lackhammer ($10 in chips) 
dashmamad: posts small blind $0.05
CashMatteo: posts big blind $0.10
*** HOLE CARDS ***
Dealt to CashMatteo [4s 3s]
conman899: folds 
Villa0722: folds 
LoCoSi: folds 
l3lackhammer has timed out
l3lackhammer: folds 
dashmamad: calls $0.05
CashMatteo: checks 
*** FLOP *** [Jd 6h Tc]
dashmamad: bets $0.10
CashMatteo: folds 
Uncalled bet ($0.10) returned to dashmamad
dashmamad collected $0.19 from pot
*** SUMMARY ***
Total pot $0.20 | Rake $0.01 
Board [Jd 6h Tc]
Seat 1: dashmamad (small blind) collected ($0.19)
Seat 2: CashMatteo (big blind) folded on the Flop
Seat 3: conman899 folded before Flop (didn't bet)
Seat 4: Villa0722 folded before Flop (didn't bet)
Seat 5: LoCoSi folded before Flop (didn't bet)
Seat 6: l3lackhammer (button) folded before Flop (didn't bet)

Hand #1162: 

PokerStars Hand #246653327823:  Hold'em No Limit ($0.05/$0.10 CAD) - 2023/10/21 0:03:05 ET
Table 'Scabiosa' 6-max Seat #1 is the button
Seat 1: dashmamad ($10.76 in chips) 
Seat 2: CashMatteo ($3.60 in chips) 
Seat 3: conman899 ($55.91 in chips) 
Seat 4: Villa0722 ($21.75 in chips) 
Seat 5: LoCoSi ($15.91 in chips) 
Seat 6: l3lackhammer ($10 in chips) 
CashMatteo: posts small blind $0.05
conman899: posts big blind $0.10
*** HOLE CARDS ***
Dealt to CashMatteo [2c 5h]
Villa0722: folds 
LoCoSi: folds 
l3lackhammer: folds 
dashmamad: folds 
CashMatteo: folds 
Uncalled bet ($0.05) returned to conman899
conman899 collected $0.10 from pot
*** SUMMARY ***
Total pot $0.10 | Rake $0 
Seat 1: dashmamad (button) folded before Flop (didn't bet)
Seat 2: CashMatteo (small blind) folded before Flop
Seat 3: conman899 (big blind) collected ($0.10)
Seat 4: Villa0722 folded before Flop (didn't bet)
Seat 5: LoCoSi folded before Flop (didn't bet)
Seat 6: l3lackhammer folded before Flop (didn't bet)

Hand #1163: 

PokerStars Hand #246653329697:  Hold'em No Limit ($0.05/$0.10 CAD) - 2023/10/21 0:03:19 ET
Table 'Scabiosa' 6-max Seat #2 is the button
Seat 1: dashmamad ($10.76 in chips) 
Seat 2: CashMatteo ($3.55 in chips) 
Seat 3: conman899 ($55.96 in chips) 
Seat 4: Villa0722 ($21.75 in chips) 
Seat 5: LoCoSi ($15.91 in chips) 
Seat 6: l3lackhammer ($10 in chips) 
conman899: posts small blind $0.05
Villa0722: posts big blind $0.10
*** HOLE CARDS ***
Dealt to CashMatteo [Kh Qc]
LoCoSi: folds 
l3lackhammer: folds 
dashmamad: folds 
CashMatteo: raises $0.15 to $0.25
conman899: calls $0.20
Villa0722: raises $0.15 to $0.40
CashMatteo: calls $0.15
conman899: calls $0.15
*** FLOP *** [3d Ts 7c]
conman899: checks 
Villa0722: bets $0.58
CashMatteo: calls $0.58
conman899: calls $0.58
*** TURN *** [3d Ts 7c] [2c]
conman899: checks 
Villa0722: checks 
CashMatteo: checks 
*** RIVER *** [3d Ts 7c 2c] [Td]
conman899: bets $1.41
Villa0722: folds 
CashMatteo: folds 
Uncalled bet ($1.41) returned to conman899
conman899 collected $2.81 from pot
*** SUMMARY ***
Total pot $2.94 | Rake $0.13 
Board [3d Ts 7c 2c Td]
Seat 1: dashmamad folded before Flop (didn't bet)
Seat 2: CashMatteo (button) folded on the River
Seat 3: conman899 (small blind) collected ($2.81)
Seat 4: Villa0722 (big blind) folded on the River
Seat 5: LoCoSi folded before Flop (didn't bet)
Seat 6: l3lackhammer folded before Flop (didn't bet)

Hand #1164: 

PokerStars Hand #246653339546:  Hold'em No Limit ($0.05/$0.10 CAD) - 2023/10/21 0:04:33 ET
Table 'Scabiosa' 6-max Seat #3 is the button
Seat 1: dashmamad ($10.76 in chips) 
Seat 2: CashMatteo ($2.57 in chips) 
Seat 3: conman899 ($57.79 in chips) 
Seat 4: Villa0722 ($20.77 in chips) 
Seat 5: LoCoSi ($15.91 in chips) 
Seat 6: l3lackhammer ($10 in chips) 
Villa0722: posts small blind $0.05
LoCoSi: posts big blind $0.10
*** HOLE CARDS ***
Dealt to CashMatteo [Qs 9d]
l3lackhammer: folds 
dashmamad: folds 
CashMatteo: folds 
conman899: raises $0.45 to $0.55
Villa0722: folds 
LoCoSi: folds 
Uncalled bet ($0.45) returned to conman899
conman899 collected $0.25 from pot
*** SUMMARY ***
Total pot $0.25 | Rake $0 
Seat 1: dashmamad folded before Flop (didn't bet)
Seat 2: CashMatteo folded before Flop (didn't bet)
Seat 3: conman899 (button) collected ($0.25)
Seat 4: Villa0722 (small blind) folded before Flop
Seat 5: LoCoSi (big blind) folded before Flop
Seat 6: l3lackhammer folded before Flop (didn't bet)

Hand #1165: 

PokerStars Hand #246653342821:  Hold'em No Limit ($0.05/$0.10 CAD) - 2023/10/21 0:04:58 ET
Table 'Scabiosa' 6-max Seat #4 is the button
Seat 1: dashmamad ($10.76 in chips) 
Seat 2: CashMatteo ($2.57 in chips) 
Seat 3: conman899 ($57.94 in chips) 
Seat 4: Villa0722 ($20.72 in chips) 
Seat 5: LoCoSi ($15.81 in chips) 
Seat 6: l3lackhammer ($10 in chips) 
LoCoSi: posts small blind $0.05
l3lackhammer: posts big blind $0.10
*** HOLE CARDS ***
Dealt to CashMatteo [3s 3h]
dashmamad: folds 
CashMatteo: raises $0.15 to $0.25
conman899: folds 
Villa0722: folds 
LoCoSi: folds 
l3lackhammer: folds 
Uncalled bet ($0.15) returned to CashMatteo
CashMatteo collected $0.25 from pot
CashMatteo: doesn't show hand 
*** SUMMARY ***
Total pot $0.25 | Rake $0 
Seat 1: dashmamad folded before Flop (didn't bet)
Seat 2: CashMatteo collected ($0.25)
Seat 3: conman899 folded before Flop (didn't bet)
Seat 4: Villa0722 (button) folded before Flop (didn't bet)
Seat 5: LoCoSi (small blind) folded before Flop
Seat 6: l3lackhammer (big blind) folded before Flop

Hand #1166: 

PokerStars Hand #246653344869:  Hold'em No Limit ($0.05/$0.10 CAD) - 2023/10/21 0:05:13 ET
Table 'Scabiosa' 6-max Seat #5 is the button
Seat 1: dashmamad ($10.76 in chips) 
Seat 2: CashMatteo ($2.72 in chips) 
Seat 3: conman899 ($57.94 in chips) 
Seat 4: Villa0722 ($20.72 in chips) 
Seat 5: LoCoSi ($15.76 in chips) 
Seat 6: l3lackhammer ($10 in chips) 
l3lackhammer: posts small blind $0.05
dashmamad: posts big blind $0.10
*** HOLE CARDS ***
Dealt to CashMatteo [6s 2c]
CashMatteo: folds 
conman899: folds 
Villa0722: folds 
LoCoSi: raises $0.20 to $0.30
l3lackhammer: folds 
dashmamad: calls $0.20
*** FLOP *** [Tc 6c 6d]
dashmamad: bets $0.62
LoCoSi: folds 
Uncalled bet ($0.62) returned to dashmamad
dashmamad collected $0.62 from pot
dashmamad: doesn't show hand 
*** SUMMARY ***
Total pot $0.65 | Rake $0.03 
Board [Tc 6c 6d]
Seat 1: dashmamad (big blind) collected ($0.62)
Seat 2: CashMatteo folded before Flop (didn't bet)
Seat 3: conman899 folded before Flop (didn't bet)
Seat 4: Villa0722 folded before Flop (didn't bet)
Seat 5: LoCoSi (button) folded on the Flop
Seat 6: l3lackhammer (small blind) folded before Flop

Hand #1167: 

PokerStars Hand #246653349454:  Hold'em No Limit ($0.05/$0.10 CAD) - 2023/10/21 0:05:47 ET
Table 'Scabiosa' 6-max Seat #6 is the button
Seat 1: dashmamad ($11.08 in chips) 
Seat 2: CashMatteo ($2.72 in chips) 
Seat 3: conman899 ($57.94 in chips) 
Seat 4: Villa0722 ($20.72 in chips) 
Seat 5: LoCoSi ($15.46 in chips) 
Seat 6: l3lackhammer ($10 in chips) 
dashmamad: posts small blind $0.05
CashMatteo: posts big blind $0.10
*** HOLE CARDS ***
Dealt to CashMatteo [5d Tc]
conman899: raises $0.25 to $0.35
Villa0722: folds 
LoCoSi: folds 
l3lackhammer: folds 
dashmamad: folds 
CashMatteo: folds 
Uncalled bet ($0.25) returned to conman899
conman899 collected $0.25 from pot
*** SUMMARY ***
Total pot $0.25 | Rake $0 
Seat 1: dashmamad (small blind) folded before Flop
Seat 2: CashMatteo (big blind) folded before Flop
Seat 3: conman899 collected ($0.25)
Seat 4: Villa0722 folded before Flop (didn't bet)
Seat 5: LoCoSi folded before Flop (didn't bet)
Seat 6: l3lackhammer (button) folded before Flop (didn't bet)

Hand #1168: 

PokerStars Hand #246653353829:  Hold'em No Limit ($0.05/$0.10 CAD) - 2023/10/21 0:06:19 ET
Table 'Scabiosa' 6-max Seat #1 is the button
Seat 1: dashmamad ($11.03 in chips) 
Seat 2: CashMatteo ($2.62 in chips) 
Seat 3: conman899 ($58.09 in chips) 
Seat 4: Villa0722 ($20.72 in chips) 
Seat 5: LoCoSi ($15.46 in chips) 
Seat 6: l3lackhammer ($10 in chips) 
CashMatteo: posts small blind $0.05
conman899: posts big blind $0.10
*** HOLE CARDS ***
Dealt to CashMatteo [Qc Qs]
Villa0722: folds 
LoCoSi: folds 
l3lackhammer: folds 
dashmamad: folds 
CashMatteo: raises $0.15 to $0.25
conman899: calls $0.15
*** FLOP *** [2s Ad Js]
CashMatteo: checks 
conman899: bets $0.48
CashMatteo: raises $1.89 to $2.37 and is all-in
conman899: folds 
Uncalled bet ($1.89) returned to CashMatteo
CashMatteo collected $1.39 from pot
CashMatteo: doesn't show hand 
*** SUMMARY ***
Total pot $1.46 | Rake $0.07 
Board [2s Ad Js]
Seat 1: dashmamad (button) folded before Flop (didn't bet)
Seat 2: CashMatteo (small blind) collected ($1.39)
Seat 3: conman899 (big blind) folded on the Flop
Seat 4: Villa0722 folded before Flop (didn't bet)
Seat 5: LoCoSi folded before Flop (didn't bet)
Seat 6: l3lackhammer folded before Flop (didn't bet)

Hand #1169: 

PokerStars Hand #246653358370:  Hold'em No Limit ($0.05/$0.10 CAD) - 2023/10/21 0:06:54 ET
Table 'Scabiosa' 6-max Seat #2 is the button
Seat 1: dashmamad ($11.03 in chips) 
Seat 2: CashMatteo ($3.28 in chips) 
Seat 3: conman899 ($57.36 in chips) 
Seat 4: Villa0722 ($20.72 in chips) 
Seat 5: LoCoSi ($15.46 in chips) 
Seat 6: l3lackhammer ($10 in chips) 
conman899: posts small blind $0.05
Villa0722: posts big blind $0.10
*** HOLE CARDS ***
Dealt to CashMatteo [7s Ah]
LoCoSi: folds 
l3lackhammer: folds 
dashmamad: folds 
CashMatteo: raises $0.15 to $0.25
conman899: raises $0.60 to $0.85
Villa0722: folds 
CashMatteo: raises $2.43 to $3.28 and is all-in
conman899: calls $2.43
*** FLOP *** [2h Td 4h]
*** TURN *** [2h Td 4h] [Ad]
*** RIVER *** [2h Td 4h Ad] [3h]
*** SHOW DOWN ***
conman899: shows [8d 8c] (a pair of Eights)
CashMatteo: shows [7s Ah] (a pair of Aces)
CashMatteo collected $6.36 from pot
*** SUMMARY ***
Total pot $6.66 | Rake $0.30 
Board [2h Td 4h Ad 3h]
Seat 1: dashmamad folded before Flop (didn't bet)
Seat 2: CashMatteo (button) showed [7s Ah] and won ($6.36) with a pair of Aces
Seat 3: conman899 (small blind) showed [8d 8c] and lost with a pair of Eights
Seat 4: Villa0722 (big blind) folded before Flop
Seat 5: LoCoSi folded before Flop (didn't bet)
Seat 6: l3lackhammer folded before Flop (didn't bet)

Hand #1170: 

PokerStars Hand #246653363236:  Hold'em No Limit ($0.05/$0.10 CAD) - 2023/10/21 0:07:30 ET
Table 'Scabiosa' 6-max Seat #3 is the button
Seat 1: dashmamad ($11.03 in chips) 
Seat 2: CashMatteo ($6.36 in chips) 
Seat 3: conman899 ($54.08 in chips) 
Seat 4: Villa0722 ($20.62 in chips) 
Seat 5: LoCoSi ($15.46 in chips) 
Seat 6: l3lackhammer ($10 in chips) 
Villa0722: posts small blind $0.05
LoCoSi: posts big blind $0.10
*** HOLE CARDS ***
Dealt to CashMatteo [5s 4d]
l3lackhammer: folds 
dashmamad: folds 
CashMatteo: folds 
conman899: raises $0.25 to $0.35
Villa0722: folds 
LoCoSi: folds 
Uncalled bet ($0.25) returned to conman899
conman899 collected $0.25 from pot
*** SUMMARY ***
Total pot $0.25 | Rake $0 
Seat 1: dashmamad folded before Flop (didn't bet)
Seat 2: CashMatteo folded before Flop (didn't bet)
Seat 3: conman899 (button) collected ($0.25)
Seat 4: Villa0722 (small blind) folded before Flop
Seat 5: LoCoSi (big blind) folded before Flop
Seat 6: l3lackhammer folded before Flop (didn't bet)

Hand #1171: 

PokerStars Hand #246653365281:  Hold'em No Limit ($0.05/$0.10 CAD) - 2023/10/21 0:07:45 ET
Table 'Scabiosa' 6-max Seat #4 is the button
Seat 1: dashmamad ($11.03 in chips) 
Seat 2: CashMatteo ($6.36 in chips) 
Seat 3: conman899 ($54.23 in chips) 
Seat 4: Villa0722 ($20.57 in chips) 
Seat 5: LoCoSi ($15.36 in chips) 
Seat 6: l3lackhammer ($10 in chips) 
LoCoSi: posts small blind $0.05
l3lackhammer: posts big blind $0.10
*** HOLE CARDS ***
Dealt to CashMatteo [Tc 5c]
dashmamad: folds 
CashMatteo: folds 
conman899: raises $0.45 to $0.55
Villa0722: folds 
LoCoSi: raises $1.75 to $2.30
l3lackhammer: folds 
conman899: calls $1.75
*** FLOP *** [6s 2d 3h]
LoCoSi: bets $2.30
conman899: folds 
Uncalled bet ($2.30) returned to LoCoSi
LoCoSi collected $4.49 from pot
LoCoSi: doesn't show hand 
*** SUMMARY ***
Total pot $4.70 | Rake $0.21 
Board [6s 2d 3h]
Seat 1: dashmamad folded before Flop (didn't bet)
Seat 2: CashMatteo folded before Flop (didn't bet)
Seat 3: conman899 folded on the Flop
Seat 4: Villa0722 (button) folded before Flop (didn't bet)
Seat 5: LoCoSi (small blind) collected ($4.49)
Seat 6: l3lackhammer (big blind) folded before Flop

Hand #1172: 

PokerStars Hand #246653369648:  Hold'em No Limit ($0.05/$0.10 CAD) - 2023/10/21 0:08:18 ET
Table 'Scabiosa' 6-max Seat #5 is the button
Seat 1: dashmamad ($11.03 in chips) 
Seat 2: CashMatteo ($6.36 in chips) 
Seat 3: conman899 ($51.93 in chips) 
Seat 4: Villa0722 ($20.57 in chips) 
Seat 5: LoCoSi ($17.55 in chips) 
Seat 6: l3lackhammer ($10 in chips) 
l3lackhammer: posts small blind $0.05
dashmamad: posts big blind $0.10
*** HOLE CARDS ***
Dealt to CashMatteo [5s As]
CashMatteo: raises $0.15 to $0.25
conman899: calls $0.25
Villa0722: folds 
LoCoSi: folds 
l3lackhammer: folds 
dashmamad: folds 
*** FLOP *** [Qc Ks 8d]
CashMatteo: bets $0.31
conman899: calls $0.31
*** TURN *** [Qc Ks 8d] [5d]
CashMatteo: bets $0.61
conman899: calls $0.61
*** RIVER *** [Qc Ks 8d 5d] [2h]
CashMatteo: checks 
conman899: checks 
*** SHOW DOWN ***
CashMatteo: shows [5s As] (a pair of Fives)
conman899: shows [9c Qs] (a pair of Queens)
conman899 collected $2.38 from pot
*** SUMMARY ***
Total pot $2.49 | Rake $0.11 
Board [Qc Ks 8d 5d 2h]
Seat 1: dashmamad (big blind) folded before Flop
Seat 2: CashMatteo showed [5s As] and lost with a pair of Fives
Seat 3: conman899 showed [9c Qs] and won ($2.38) with a pair of Queens
Seat 4: Villa0722 folded before Flop (didn't bet)
Seat 5: LoCoSi (button) folded before Flop (didn't bet)
Seat 6: l3lackhammer (small blind) folded before Flop

Hand #1173: 

PokerStars Hand #246653375308:  Hold'em No Limit ($0.05/$0.10 CAD) - 2023/10/21 0:09:01 ET
Table 'Scabiosa' 6-max Seat #6 is the button
Seat 1: dashmamad ($10.93 in chips) 
Seat 2: CashMatteo ($5.19 in chips) 
Seat 3: conman899 ($53.14 in chips) 
Seat 4: Villa0722 ($20.57 in chips) 
Seat 5: LoCoSi ($17.55 in chips) 
Seat 6: l3lackhammer ($10 in chips) 
dashmamad: posts small blind $0.05
CashMatteo: posts big blind $0.10
*** HOLE CARDS ***
Dealt to CashMatteo [Ah 8h]
conman899: folds 
Villa0722: raises $0.10 to $0.20
LoCoSi: folds 
l3lackhammer: folds 
dashmamad: folds 
CashMatteo: calls $0.10
*** FLOP *** [Qd Ad Jd]
CashMatteo: checks 
Villa0722: checks 
*** TURN *** [Qd Ad Jd] [Js]
CashMatteo: checks 
Villa0722: checks 
*** RIVER *** [Qd Ad Jd Js] [Kd]
CashMatteo: checks 
Villa0722: bets $0.22
CashMatteo: calls $0.22
*** SHOW DOWN ***
Villa0722: shows [8c Kc] (two pair, Kings and Jacks)
CashMatteo: shows [Ah 8h] (two pair, Aces and Jacks)
CashMatteo collected $0.85 from pot
*** SUMMARY ***
Total pot $0.89 | Rake $0.04 
Board [Qd Ad Jd Js Kd]
Seat 1: dashmamad (small blind) folded before Flop
Seat 2: CashMatteo (big blind) showed [Ah 8h] and won ($0.85) with two pair, Aces and Jacks
Seat 3: conman899 folded before Flop (didn't bet)
Seat 4: Villa0722 showed [8c Kc] and lost with two pair, Kings and Jacks
Seat 5: LoCoSi folded before Flop (didn't bet)
Seat 6: l3lackhammer (button) folded before Flop (didn't bet)

Hand #1174: 

PokerStars Hand #246653383064:  Hold'em No Limit ($0.05/$0.10 CAD) - 2023/10/21 0:10:00 ET
Table 'Scabiosa' 6-max Seat #1 is the button
Seat 1: dashmamad ($10.88 in chips) 
Seat 2: CashMatteo ($5.62 in chips) 
Seat 3: conman899 ($53.14 in chips) 
Seat 4: Villa0722 ($20.15 in chips) 
Seat 5: LoCoSi ($17.55 in chips) 
Seat 6: l3lackhammer ($10 in chips) 
CashMatteo: posts small blind $0.05
conman899: posts big blind $0.10
*** HOLE CARDS ***
Dealt to CashMatteo [9h Th]
Villa0722: folds 
LoCoSi: folds 
l3lackhammer: raises $0.20 to $0.30
dashmamad: folds 
CashMatteo: calls $0.25
conman899: calls $0.20
*** FLOP *** [6c 7c Tc]
CashMatteo: checks 
conman899: checks 
l3lackhammer: checks 
*** TURN *** [6c 7c Tc] [7d]
CashMatteo: checks 
conman899: bets $0.86
l3lackhammer: folds 
CashMatteo: folds 
Uncalled bet ($0.86) returned to conman899
conman899 collected $0.86 from pot
*** SUMMARY ***
Total pot $0.90 | Rake $0.04 
Board [6c 7c Tc 7d]
Seat 1: dashmamad (button) folded before Flop (didn't bet)
Seat 2: CashMatteo (small blind) folded on the Turn
Seat 3: conman899 (big blind) collected ($0.86)
Seat 4: Villa0722 folded before Flop (didn't bet)
Seat 5: LoCoSi folded before Flop (didn't bet)
Seat 6: l3lackhammer folded on the Turn

Hand #1175: 

PokerStars Hand #246653389694:  Hold'em No Limit ($0.05/$0.10 CAD) - 2023/10/21 0:10:51 ET
Table 'Scabiosa' 6-max Seat #2 is the button
Seat 1: dashmamad ($10.88 in chips) 
Seat 2: CashMatteo ($5.32 in chips) 
Seat 3: conman899 ($53.70 in chips) 
Seat 4: Villa0722 ($20.15 in chips) 
Seat 5: LoCoSi ($17.55 in chips) 
Seat 6: l3lackhammer ($10 in chips) 
conman899: posts small blind $0.05
Villa0722: posts big blind $0.10
*** HOLE CARDS ***
Dealt to CashMatteo [Tc 7d]
LoCoSi: folds 
l3lackhammer: folds 
dashmamad: folds 
CashMatteo: folds 
conman899: raises $0.20 to $0.30
Villa0722: folds 
Uncalled bet ($0.20) returned to conman899
conman899 collected $0.20 from pot
*** SUMMARY ***
Total pot $0.20 | Rake $0 
Seat 1: dashmamad folded before Flop (didn't bet)
Seat 2: CashMatteo (button) folded before Flop (didn't bet)
Seat 3: conman899 (small blind) collected ($0.20)
Seat 4: Villa0722 (big blind) folded before Flop
Seat 5: LoCoSi folded before Flop (didn't bet)
Seat 6: l3lackhammer folded before Flop (didn't bet)

Hand #1176: 

PokerStars Hand #246653391794:  Hold'em No Limit ($0.05/$0.10 CAD) - 2023/10/21 0:11:07 ET
Table 'Scabiosa' 6-max Seat #3 is the button
Seat 1: dashmamad ($10.88 in chips) 
Seat 2: CashMatteo ($5.32 in chips) 
Seat 3: conman899 ($53.80 in chips) 
Seat 4: Villa0722 ($20.05 in chips) 
Seat 5: LoCoSi ($17.55 in chips) 
Seat 6: l3lackhammer ($10 in chips) 
Villa0722: posts small blind $0.05
LoCoSi: posts big blind $0.10
*** HOLE CARDS ***
Dealt to CashMatteo [8d Ts]
l3lackhammer: raises $0.20 to $0.30
dashmamad: folds 
CashMatteo: folds 
conman899: folds 
Villa0722: calls $0.25
LoCoSi: folds 
*** FLOP *** [5h Qh Qd]
Villa0722: bets $0.20
l3lackhammer: calls $0.20
*** TURN *** [5h Qh Qd] [8c]
Villa0722: checks 
l3lackhammer: checks 
*** RIVER *** [5h Qh Qd 8c] [2d]
Villa0722: bets $0.32
l3lackhammer: raises $1.27 to $1.59
Villa0722: folds 
Uncalled bet ($1.27) returned to l3lackhammer
l3lackhammer collected $1.66 from pot
l3lackhammer: doesn't show hand 
*** SUMMARY ***
Total pot $1.74 | Rake $0.08 
Board [5h Qh Qd 8c 2d]
Seat 1: dashmamad folded before Flop (didn't bet)
Seat 2: CashMatteo folded before Flop (didn't bet)
Seat 3: conman899 (button) folded before Flop (didn't bet)
Seat 4: Villa0722 (small blind) folded on the River
Seat 5: LoCoSi (big blind) folded before Flop
Seat 6: l3lackhammer collected ($1.66)

Hand #1177: 

PokerStars Hand #246653400828:  Hold'em No Limit ($0.05/$0.10 CAD) - 2023/10/21 0:12:16 ET
Table 'Scabiosa' 6-max Seat #4 is the button
Seat 1: dashmamad ($10.88 in chips) 
Seat 2: CashMatteo ($5.32 in chips) 
Seat 3: conman899 ($53.80 in chips) 
Seat 4: Villa0722 ($19.23 in chips) 
Seat 5: LoCoSi ($17.45 in chips) 
Seat 6: l3lackhammer ($10.84 in chips) 
LoCoSi: posts small blind $0.05
l3lackhammer: posts big blind $0.10
*** HOLE CARDS ***
Dealt to CashMatteo [Ad 4c]
dashmamad: folds 
CashMatteo: calls $0.10
conman899: calls $0.10
Villa0722: folds 
LoCoSi: folds 
l3lackhammer: checks 
*** FLOP *** [6d 2d Tc]
l3lackhammer: checks 
CashMatteo: checks 
conman899: bets $0.33
l3lackhammer: folds 
CashMatteo: folds 
Uncalled bet ($0.33) returned to conman899
conman899 collected $0.33 from pot
*** SUMMARY ***
Total pot $0.35 | Rake $0.02 
Board [6d 2d Tc]
Seat 1: dashmamad folded before Flop (didn't bet)
Seat 2: CashMatteo folded on the Flop
Seat 3: conman899 collected ($0.33)
Seat 4: Villa0722 (button) folded before Flop (didn't bet)
Seat 5: LoCoSi (small blind) folded before Flop
Seat 6: l3lackhammer (big blind) folded on the Flop

Hand #1178: 

PokerStars Hand #246653405558:  Hold'em No Limit ($0.05/$0.10 CAD) - 2023/10/21 0:12:52 ET
Table 'Scabiosa' 6-max Seat #5 is the button
Seat 1: dashmamad ($10.88 in chips) 
Seat 2: CashMatteo ($5.22 in chips) 
Seat 3: conman899 ($54.03 in chips) 
Seat 4: Villa0722 ($19.23 in chips) 
Seat 5: LoCoSi ($17.40 in chips) 
Seat 6: l3lackhammer ($10.74 in chips) 
l3lackhammer: posts small blind $0.05
dashmamad: posts big blind $0.10
*** HOLE CARDS ***
Dealt to CashMatteo [5d 5h]
CashMatteo: raises $0.35 to $0.45
conman899: folds 
Villa0722: calls $0.45
LoCoSi: folds 
l3lackhammer: folds 
dashmamad: folds 
*** FLOP *** [4c Td Tc]
CashMatteo: bets $0.50
Villa0722: calls $0.50
*** TURN *** [4c Td Tc] [9h]
CashMatteo: checks 
Villa0722: bets $0.59
CashMatteo: calls $0.59
*** RIVER *** [4c Td Tc 9h] [2s]
CashMatteo: checks 
Villa0722: checks 
*** SHOW DOWN ***
CashMatteo: shows [5d 5h] (two pair, Tens and Fives)
Villa0722: mucks hand 
CashMatteo collected $3.08 from pot
*** SUMMARY ***
Total pot $3.23 | Rake $0.15 
Board [4c Td Tc 9h 2s]
Seat 1: dashmamad (big blind) folded before Flop
Seat 2: CashMatteo showed [5d 5h] and won ($3.08) with two pair, Tens and Fives
Seat 3: conman899 folded before Flop (didn't bet)
Seat 4: Villa0722 mucked [Kc Qh]
Seat 5: LoCoSi (button) folded before Flop (didn't bet)
Seat 6: l3lackhammer (small blind) folded before Flop

Hand #1179: 

PokerStars Hand #246653413698:  Hold'em No Limit ($0.05/$0.10 CAD) - 2023/10/21 0:13:56 ET
Table 'Scabiosa' 6-max Seat #6 is the button
Seat 1: dashmamad ($10.78 in chips) 
Seat 2: CashMatteo ($6.76 in chips) 
Seat 3: conman899 ($54.03 in chips) 
Seat 4: Villa0722 ($17.69 in chips) 
Seat 5: LoCoSi ($17.40 in chips) 
Seat 6: l3lackhammer ($10.69 in chips) 
dashmamad: posts small blind $0.05
CashMatteo: posts big blind $0.10
*** HOLE CARDS ***
Dealt to CashMatteo [8c 4d]
conman899: raises $0.50 to $0.60
Villa0722: calls $0.60
LoCoSi: folds 
l3lackhammer: folds 
dashmamad: folds 
CashMatteo: folds 
*** FLOP *** [7s 3c 8s]
conman899: bets $1.29
Villa0722: calls $1.29
*** TURN *** [7s 3c 8s] [Qs]
conman899: checks 
Villa0722: checks 
*** RIVER *** [7s 3c 8s Qs] [Ts]
conman899: checks 
Villa0722: bets $1.13
conman899: folds 
Uncalled bet ($1.13) returned to Villa0722
Villa0722 collected $3.75 from pot
Villa0722: doesn't show hand 
*** SUMMARY ***
Total pot $3.93 | Rake $0.18 
Board [7s 3c 8s Qs Ts]
Seat 1: dashmamad (small blind) folded before Flop
Seat 2: CashMatteo (big blind) folded before Flop
Seat 3: conman899 folded on the River
Seat 4: Villa0722 collected ($3.75)
Seat 5: LoCoSi folded before Flop (didn't bet)
Seat 6: l3lackhammer (button) folded before Flop (didn't bet)

Hand #1180: 

PokerStars Hand #246653420909:  Hold'em No Limit ($0.05/$0.10 CAD) - 2023/10/21 0:14:51 ET
Table 'Scabiosa' 6-max Seat #1 is the button
Seat 1: dashmamad ($10.73 in chips) 
Seat 2: CashMatteo ($6.66 in chips) 
Seat 3: conman899 ($52.14 in chips) 
Seat 4: Villa0722 ($19.55 in chips) 
Seat 5: LoCoSi ($17.40 in chips) 
Seat 6: l3lackhammer ($10.69 in chips) 
CashMatteo: posts small blind $0.05
conman899: posts big blind $0.10
*** HOLE CARDS ***
Dealt to CashMatteo [3c 5h]
Villa0722: folds 
LoCoSi: folds 
l3lackhammer: folds 
dashmamad: folds 
CashMatteo: folds 
Uncalled bet ($0.05) returned to conman899
conman899 collected $0.10 from pot
*** SUMMARY ***
Total pot $0.10 | Rake $0 
Seat 1: dashmamad (button) folded before Flop (didn't bet)
Seat 2: CashMatteo (small blind) folded before Flop
Seat 3: conman899 (big blind) collected ($0.10)
Seat 4: Villa0722 folded before Flop (didn't bet)
Seat 5: LoCoSi folded before Flop (didn't bet)
Seat 6: l3lackhammer folded before Flop (didn't bet)

Hand #1181: 

PokerStars Hand #246653424526:  Hold'em No Limit ($0.05/$0.10 CAD) - 2023/10/21 0:15:19 ET
Table 'Scabiosa' 6-max Seat #2 is the button
Seat 1: dashmamad ($10.73 in chips) 
Seat 2: CashMatteo ($6.61 in chips) 
Seat 3: conman899 ($52.19 in chips) 
Seat 4: Villa0722 ($19.55 in chips) 
Seat 5: LoCoSi ($17.40 in chips) 
conman899: posts small blind $0.05
Villa0722: posts big blind $0.10
*** HOLE CARDS ***
Dealt to CashMatteo [Qs Ah]
LoCoSi: folds 
dashmamad: folds 
CashMatteo: raises $0.25 to $0.35
conman899: calls $0.30
Villa0722: folds 
*** FLOP *** [8c 6s 2d]
conman899: checks 
CashMatteo: checks 
*** TURN *** [8c 6s 2d] [Ac]
conman899: bets $0.76
CashMatteo: calls $0.76
*** RIVER *** [8c 6s 2d Ac] [3d]
conman899: checks 
CashMatteo: bets $1.11
conman899: folds 
Uncalled bet ($1.11) returned to CashMatteo
CashMatteo collected $2.22 from pot
CashMatteo: doesn't show hand 
*** SUMMARY ***
Total pot $2.32 | Rake $0.10 
Board [8c 6s 2d Ac 3d]
Seat 1: dashmamad folded before Flop (didn't bet)
Seat 2: CashMatteo (button) collected ($2.22)
Seat 3: conman899 (small blind) folded on the River
Seat 4: Villa0722 (big blind) folded before Flop
Seat 5: LoCoSi folded before Flop (didn't bet)

Hand #1182: 

PokerStars Hand #246653430168:  Hold'em No Limit ($0.05/$0.10 CAD) - 2023/10/21 0:16:03 ET
Table 'Scabiosa' 6-max Seat #3 is the button
Seat 1: dashmamad ($10.73 in chips) 
Seat 2: CashMatteo ($7.72 in chips) 
Seat 3: conman899 ($51.08 in chips) 
Seat 4: Villa0722 ($19.45 in chips) 
Seat 5: LoCoSi ($17.40 in chips) 
Villa0722: posts small blind $0.05
LoCoSi: posts big blind $0.10
*** HOLE CARDS ***
Dealt to CashMatteo [Kh Ks]
dashmamad: folds 
CashMatteo: raises $0.25 to $0.35
conman899: raises $0.85 to $1.20
Villa0722: folds 
LoCoSi: folds 
CashMatteo: raises $6.52 to $7.72 and is all-in
conman899: calls $6.52
*** FLOP *** [As Jc 4h]
*** TURN *** [As Jc 4h] [Tc]
*** RIVER *** [As Jc 4h Tc] [2h]
*** SHOW DOWN ***
CashMatteo: shows [Kh Ks] (a pair of Kings)
conman899: shows [8d 7d] (high card Ace)
CashMatteo collected $14.89 from pot
*** SUMMARY ***
Total pot $15.59 | Rake $0.70 
Board [As Jc 4h Tc 2h]
Seat 1: dashmamad folded before Flop (didn't bet)
Seat 2: CashMatteo showed [Kh Ks] and won ($14.89) with a pair of Kings
Seat 3: conman899 (button) showed [8d 7d] and lost with high card Ace
Seat 4: Villa0722 (small blind) folded before Flop
Seat 5: LoCoSi (big blind) folded before Flop

Hand #1183: 

PokerStars Hand #246653435833:  Hold'em No Limit ($0.05/$0.10 CAD) - 2023/10/21 0:16:46 ET
Table 'Scabiosa' 6-max Seat #4 is the button
Seat 1: dashmamad ($10.73 in chips) 
Seat 2: CashMatteo ($14.89 in chips) 
Seat 3: conman899 ($43.36 in chips) 
Seat 4: Villa0722 ($19.40 in chips) 
Seat 5: LoCoSi ($17.30 in chips) 
LoCoSi: posts small blind $0.05
dashmamad: posts big blind $0.10
*** HOLE CARDS ***
Dealt to CashMatteo [9d 4c]
CashMatteo: folds 
conman899: calls $0.10
Villa0722: raises $0.10 to $0.20
LoCoSi: folds 
dashmamad: folds 
conman899: calls $0.10
*** FLOP *** [2d 9h 6c]
conman899: checks 
Villa0722: checks 
*** TURN *** [2d 9h 6c] [7s]
conman899: checks 
Villa0722: checks 
*** RIVER *** [2d 9h 6c 7s] [Jh]
conman899: checks 
Villa0722: checks 
*** SHOW DOWN ***
conman899: shows [3h Ac] (high card Ace)
Villa0722: mucks hand 
conman899 collected $0.53 from pot
*** SUMMARY ***
Total pot $0.55 | Rake $0.02 
Board [2d 9h 6c 7s Jh]
Seat 1: dashmamad (big blind) folded before Flop
Seat 2: CashMatteo folded before Flop (didn't bet)
Seat 3: conman899 showed [3h Ac] and won ($0.53) with high card Ace
Seat 4: Villa0722 (button) mucked [Ts Ks]
Seat 5: LoCoSi (small blind) folded before Flop

Hand #1184: 

PokerStars Hand #246653442754:  Hold'em No Limit ($0.05/$0.10 CAD) - 2023/10/21 0:17:40 ET
Table 'Scabiosa' 6-max Seat #5 is the button
Seat 1: dashmamad ($10.63 in chips) 
Seat 2: CashMatteo ($14.89 in chips) 
Seat 3: conman899 ($43.69 in chips) 
Seat 4: Villa0722 ($19.20 in chips) 
Seat 5: LoCoSi ($17.25 in chips) 
l3lackhammer will be allowed to play after the button
dashmamad: posts small blind $0.05
CashMatteo: posts big blind $0.10
*** HOLE CARDS ***
Dealt to CashMatteo [3h Kc]
conman899: folds 
Villa0722: raises $0.10 to $0.20
LoCoSi: calls $0.20
dashmamad: calls $0.15
CashMatteo: folds 
*** FLOP *** [8d 9s 8c]
dashmamad: checks 
Villa0722: checks 
LoCoSi: checks 
*** TURN *** [8d 9s 8c] [3c]
dashmamad: bets $0.40
Villa0722: calls $0.40
LoCoSi: folds 
*** RIVER *** [8d 9s 8c 3c] [2c]
dashmamad: checks 
Villa0722: bets $1.43
dashmamad: folds 
Uncalled bet ($1.43) returned to Villa0722
Villa0722 collected $1.43 from pot
Villa0722: doesn't show hand 
*** SUMMARY ***
Total pot $1.50 | Rake $0.07 
Board [8d 9s 8c 3c 2c]
Seat 1: dashmamad (small blind) folded on the River
Seat 2: CashMatteo (big blind) folded before Flop
Seat 3: conman899 folded before Flop (didn't bet)
Seat 4: Villa0722 collected ($1.43)
Seat 5: LoCoSi (button) folded on the Turn

Hand #1185: 

PokerStars Hand #246653450982:  Hold'em No Limit ($0.05/$0.10 CAD) - 2023/10/21 0:18:44 ET
Table 'Scabiosa' 6-max Seat #1 is the button
Seat 1: dashmamad ($10.03 in chips) 
Seat 2: CashMatteo ($14.79 in chips) 
Seat 3: conman899 ($43.69 in chips) 
Seat 4: Villa0722 ($20.03 in chips) 
Seat 5: LoCoSi ($17.05 in chips) 
CashMatteo: posts small blind $0.05
conman899: posts big blind $0.10
l3lackhammer: sits out 
*** HOLE CARDS ***
Dealt to CashMatteo [2c Jd]
Villa0722: folds 
LoCoSi: folds 
dashmamad: folds 
CashMatteo: folds 
Uncalled bet ($0.05) returned to conman899
conman899 collected $0.10 from pot
*** SUMMARY ***
Total pot $0.10 | Rake $0 
Seat 1: dashmamad (button) folded before Flop (didn't bet)
Seat 2: CashMatteo (small blind) folded before Flop
Seat 3: conman899 (big blind) collected ($0.10)
Seat 4: Villa0722 folded before Flop (didn't bet)
Seat 5: LoCoSi folded before Flop (didn't bet)

Hand #1186: 

PokerStars Hand #246653452693:  Hold'em No Limit ($0.05/$0.10 CAD) - 2023/10/21 0:18:57 ET
Table 'Scabiosa' 6-max Seat #2 is the button
Seat 1: dashmamad ($10.03 in chips) 
Seat 2: CashMatteo ($14.74 in chips) 
Seat 3: conman899 ($43.74 in chips) 
Seat 4: Villa0722 ($20.03 in chips) 
Seat 5: LoCoSi ($17.05 in chips) 
conman899: posts small blind $0.05
Villa0722: posts big blind $0.10
l3lackhammer: sits out 
*** HOLE CARDS ***
Dealt to CashMatteo [Jh 9s]
dashmamad said, "punk ass bi t ch"
LoCoSi: folds 
dashmamad: folds 
CashMatteo: calls $0.10
conman899: calls $0.05
Villa0722: raises $0.20 to $0.30
CashMatteo: calls $0.20
Villa0722 said, "?"
conman899: calls $0.20
*** FLOP *** [2s 5s Jd]
conman899: bets $0.86
Villa0722: calls $0.86
CashMatteo: calls $0.86
*** TURN *** [2s 5s Jd] [Kh]
conman899: bets $1.66
Villa0722: calls $1.66
CashMatteo: folds 
*** RIVER *** [2s 5s Jd Kh] [Qc]
conman899: bets $3.25
Villa0722: folds 
Uncalled bet ($3.25) returned to conman899
conman899 collected $6.49 from pot
*** SUMMARY ***
Total pot $6.80 | Rake $0.31 
Board [2s 5s Jd Kh Qc]
Seat 1: dashmamad folded before Flop (didn't bet)
Seat 2: CashMatteo (button) folded on the Turn
Seat 3: conman899 (small blind) collected ($6.49)
Seat 4: Villa0722 (big blind) folded on the River
Seat 5: LoCoSi folded before Flop (didn't bet)

Hand #1187: 

PokerStars Hand #246653461575:  Hold'em No Limit ($0.05/$0.10 CAD) - 2023/10/21 0:20:06 ET
Table 'Scabiosa' 6-max Seat #3 is the button
Seat 1: dashmamad ($10.03 in chips) 
Seat 2: CashMatteo ($13.58 in chips) 
Seat 3: conman899 ($47.41 in chips) 
Seat 4: Villa0722 ($17.21 in chips) 
Seat 6: l3lackhammer ($10.69 in chips) 
Villa0722: posts small blind $0.05
LoCoSi: is sitting out 
LoCoSi leaves the table
l3lackhammer: posts big blind $0.10
*** HOLE CARDS ***
Dealt to CashMatteo [7d 5c]
dashmamad: folds 
CashMatteo: folds 
conman899: raises $0.65 to $0.75
Villa0722: calls $0.70
l3lackhammer: folds 
*** FLOP *** [Ad 9s 8d]
Villa0722: checks 
conman899: checks 
*** TURN *** [Ad 9s 8d] [Th]
Villa0722: bets $0.46
conman899: calls $0.46
*** RIVER *** [Ad 9s 8d Th] [8c]
Villa0722: bets $0.72
conman899: calls $0.72
*** SHOW DOWN ***
Villa0722: shows [4s 4h] (two pair, Eights and Fours)
conman899: shows [Tc Qs] (two pair, Tens and Eights)
conman899 collected $3.78 from pot
*** SUMMARY ***
Total pot $3.96 | Rake $0.18 
Board [Ad 9s 8d Th 8c]
Seat 1: dashmamad folded before Flop (didn't bet)
Seat 2: CashMatteo folded before Flop (didn't bet)
Seat 3: conman899 (button) showed [Tc Qs] and won ($3.78) with two pair, Tens and Eights
Seat 4: Villa0722 (small blind) showed [4s 4h] and lost with two pair, Eights and Fours
Seat 6: l3lackhammer (big blind) folded before Flop

Hand #1188: 

PokerStars Hand #246653468814:  Hold'em No Limit ($0.05/$0.10 CAD) - 2023/10/21 0:21:03 ET
Table 'Scabiosa' 6-max Seat #4 is the button
Seat 1: dashmamad ($10.03 in chips) 
Seat 2: CashMatteo ($13.58 in chips) 
Seat 3: conman899 ($49.26 in chips) 
Seat 4: Villa0722 ($15.28 in chips) 
Seat 6: l3lackhammer ($10.59 in chips) 
l3lackhammer: posts small blind $0.05
dashmamad: posts big blind $0.10
*** HOLE CARDS ***
Dealt to CashMatteo [Ah 9s]
CashMatteo: calls $0.10
conman899: folds 
Villa0722: folds 
l3lackhammer: folds 
dashmamad: checks 
*** FLOP *** [Qd Ts 4h]
dashmamad: bets $0.30
CashMatteo: folds 
Uncalled bet ($0.30) returned to dashmamad
dashmamad collected $0.24 from pot
dashmamad: doesn't show hand 
*** SUMMARY ***
Total pot $0.25 | Rake $0.01 
Board [Qd Ts 4h]
Seat 1: dashmamad (big blind) collected ($0.24)
Seat 2: CashMatteo folded on the Flop
Seat 3: conman899 folded before Flop (didn't bet)
Seat 4: Villa0722 (button) folded before Flop (didn't bet)
Seat 6: l3lackhammer (small blind) folded before Flop

Hand #1189: 

PokerStars Hand #246653472561:  Hold'em No Limit ($0.05/$0.10 CAD) - 2023/10/21 0:21:32 ET
Table 'Scabiosa' 6-max Seat #6 is the button
Seat 1: dashmamad ($10.17 in chips) 
Seat 2: CashMatteo ($13.48 in chips) 
Seat 3: conman899 ($49.26 in chips) 
Seat 4: Villa0722 ($15.28 in chips) 
Seat 6: l3lackhammer ($10.54 in chips) 
dashmamad: posts small blind $0.05
CashMatteo: posts big blind $0.10
*** HOLE CARDS ***
Dealt to CashMatteo [As 4c]
conman899: folds 
Villa0722: raises $0.10 to $0.20
l3lackhammer: folds 
dashmamad: raises $9.97 to $10.17 and is all-in
CashMatteo: folds 
Villa0722: folds 
Uncalled bet ($9.97) returned to dashmamad
dashmamad collected $0.50 from pot
dashmamad: doesn't show hand 
*** SUMMARY ***
Total pot $0.50 | Rake $0 
Seat 1: dashmamad (small blind) collected ($0.50)
Seat 2: CashMatteo (big blind) folded before Flop
Seat 3: conman899 folded before Flop (didn't bet)
Seat 4: Villa0722 folded before Flop
Seat 6: l3lackhammer (button) folded before Flop (didn't bet)

Hand #1190: 

PokerStars Hand #246653476734:  Hold'em No Limit ($0.05/$0.10 CAD) - 2023/10/21 0:22:04 ET
Table 'Scabiosa' 6-max Seat #1 is the button
Seat 1: dashmamad ($10.47 in chips) 
Seat 2: CashMatteo ($13.38 in chips) 
Seat 3: conman899 ($49.26 in chips) 
Seat 4: Villa0722 ($15.08 in chips) 
Seat 6: l3lackhammer ($10.54 in chips) 
CashMatteo: posts small blind $0.05
conman899: posts big blind $0.10
*** HOLE CARDS ***
Dealt to CashMatteo [7s 8h]
Villa0722: folds 
l3lackhammer: raises $0.20 to $0.30
dashmamad: folds 
CashMatteo: folds 
conman899: folds 
Uncalled bet ($0.20) returned to l3lackhammer
l3lackhammer collected $0.25 from pot
l3lackhammer: doesn't show hand 
*** SUMMARY ***
Total pot $0.25 | Rake $0 
Seat 1: dashmamad (button) folded before Flop (didn't bet)
Seat 2: CashMatteo (small blind) folded before Flop
Seat 3: conman899 (big blind) folded before Flop
Seat 4: Villa0722 folded before Flop (didn't bet)
Seat 6: l3lackhammer collected ($0.25)

Hand #1191: 

PokerStars Hand #246653478734:  Hold'em No Limit ($0.05/$0.10 CAD) - 2023/10/21 0:22:20 ET
Table 'Scabiosa' 6-max Seat #2 is the button
Seat 1: dashmamad ($10.47 in chips) 
Seat 2: CashMatteo ($13.33 in chips) 
Seat 3: conman899 ($49.16 in chips) 
Seat 4: Villa0722 ($15.08 in chips) 
Seat 6: l3lackhammer ($10.69 in chips) 
conman899: posts small blind $0.05
Villa0722: posts big blind $0.10
*** HOLE CARDS ***
Dealt to CashMatteo [9d Jh]
l3lackhammer: raises $0.20 to $0.30
dashmamad: calls $0.30
CashMatteo: calls $0.30
conman899: calls $0.25
Villa0722: folds 
*** FLOP *** [6d 7c 8s]
conman899: bets $1.24
l3lackhammer: folds 
dashmamad: calls $1.24
CashMatteo: calls $1.24
*** TURN *** [6d 7c 8s] [Qh]
conman899: checks 
dashmamad: checks 
CashMatteo: checks 
*** RIVER *** [6d 7c 8s Qh] [5h]
conman899: checks 
dashmamad: checks 
CashMatteo: bets $2.40
conman899: folds 
dashmamad: folds 
Uncalled bet ($2.40) returned to CashMatteo
CashMatteo collected $4.79 from pot
CashMatteo: doesn't show hand 
*** SUMMARY ***
Total pot $5.02 | Rake $0.23 
Board [6d 7c 8s Qh 5h]
Seat 1: dashmamad folded on the River
Seat 2: CashMatteo (button) collected ($4.79)
Seat 3: conman899 (small blind) folded on the River
Seat 4: Villa0722 (big blind) folded before Flop
Seat 6: l3lackhammer folded on the Flop

Hand #1192: 

PokerStars Hand #246653487799:  Hold'em No Limit ($0.05/$0.10 CAD) - 2023/10/21 0:23:30 ET
Table 'Scabiosa' 6-max Seat #3 is the button
Seat 1: dashmamad ($8.93 in chips) 
Seat 2: CashMatteo ($16.58 in chips) 
Seat 3: conman899 ($47.62 in chips) 
Seat 4: Villa0722 ($14.98 in chips) 
Seat 6: l3lackhammer ($10.39 in chips) 
Villa0722: posts small blind $0.05
l3lackhammer: posts big blind $0.10
*** HOLE CARDS ***
Dealt to CashMatteo [5s 7d]
dashmamad: folds 
CashMatteo: folds 
conman899: raises $0.25 to $0.35
Villa0722: raises $0.25 to $0.60
l3lackhammer: folds 
conman899: calls $0.25
*** FLOP *** [Qs 6s 6d]
Villa0722: checks 
conman899: checks 
*** TURN *** [Qs 6s 6d] [4h]
Villa0722: bets $0.62
conman899: folds 
Uncalled bet ($0.62) returned to Villa0722
Villa0722 collected $1.24 from pot
Villa0722: doesn't show hand 
*** SUMMARY ***
Total pot $1.30 | Rake $0.06 
Board [Qs 6s 6d 4h]
Seat 1: dashmamad folded before Flop (didn't bet)
Seat 2: CashMatteo folded before Flop (didn't bet)
Seat 3: conman899 (button) folded on the Turn
Seat 4: Villa0722 (small blind) collected ($1.24)
Seat 6: l3lackhammer (big blind) folded before Flop

Hand #1193: 

PokerStars Hand #246653491639:  Hold'em No Limit ($0.05/$0.10 CAD) - 2023/10/21 0:24:00 ET
Table 'Scabiosa' 6-max Seat #4 is the button
Seat 1: dashmamad ($8.93 in chips) 
Seat 2: CashMatteo ($16.58 in chips) 
Seat 3: conman899 ($47.02 in chips) 
Seat 4: Villa0722 ($15.62 in chips) 
Seat 6: l3lackhammer ($10.29 in chips) 
l3lackhammer: posts small blind $0.05
dashmamad: posts big blind $0.10
*** HOLE CARDS ***
Dealt to CashMatteo [4s 7s]
CashMatteo: folds 
conman899: raises $0.35 to $0.45
Villa0722: folds 
l3lackhammer: calls $0.40
dashmamad: folds 
*** FLOP *** [9h Qh Jd]
l3lackhammer: checks 
conman899: bets $0.96
l3lackhammer: calls $0.96
*** TURN *** [9h Qh Jd] [9c]
l3lackhammer: checks 
conman899: bets $2.79
l3lackhammer: folds 
Uncalled bet ($2.79) returned to conman899
conman899 collected $2.79 from pot
*** SUMMARY ***
Total pot $2.92 | Rake $0.13 
Board [9h Qh Jd 9c]
Seat 1: dashmamad (big blind) folded before Flop
Seat 2: CashMatteo folded before Flop (didn't bet)
Seat 3: conman899 collected ($2.79)
Seat 4: Villa0722 (button) folded before Flop (didn't bet)
Seat 6: l3lackhammer (small blind) folded on the Turn

Hand #1194: 

PokerStars Hand #246653496602:  Hold'em No Limit ($0.05/$0.10 CAD) - 2023/10/21 0:24:39 ET
Table 'Scabiosa' 6-max Seat #6 is the button
Seat 1: dashmamad ($8.83 in chips) 
Seat 2: CashMatteo ($16.58 in chips) 
Seat 3: conman899 ($48.40 in chips) 
Seat 4: Villa0722 ($15.62 in chips) 
Seat 6: l3lackhammer ($10 in chips) 
dashmamad: posts small blind $0.05
CashMatteo: posts big blind $0.10
*** HOLE CARDS ***
Dealt to CashMatteo [4s 6c]
conman899: raises $0.55 to $0.65
Villa0722: folds 
l3lackhammer: folds 
dashmamad: folds 
CashMatteo: folds 
Uncalled bet ($0.55) returned to conman899
conman899 collected $0.25 from pot
*** SUMMARY ***
Total pot $0.25 | Rake $0 
Seat 1: dashmamad (small blind) folded before Flop
Seat 2: CashMatteo (big blind) folded before Flop
Seat 3: conman899 collected ($0.25)
Seat 4: Villa0722 folded before Flop (didn't bet)
Seat 6: l3lackhammer (button) folded before Flop (didn't bet)

Hand #1195: 

PokerStars Hand #246653498555:  Hold'em No Limit ($0.05/$0.10 CAD) - 2023/10/21 0:24:54 ET
Table 'Scabiosa' 6-max Seat #1 is the button
Seat 1: dashmamad ($8.78 in chips) 
Seat 2: CashMatteo ($16.48 in chips) 
Seat 3: conman899 ($48.55 in chips) 
Seat 4: Villa0722 ($15.62 in chips) 
Seat 6: l3lackhammer ($10 in chips) 
CashMatteo: posts small blind $0.05
conman899: posts big blind $0.10
*** HOLE CARDS ***
Dealt to CashMatteo [9h 5s]
Villa0722: folds 
l3lackhammer: folds 
dashmamad: folds 
CashMatteo: folds 
Uncalled bet ($0.05) returned to conman899
conman899 collected $0.10 from pot
*** SUMMARY ***
Total pot $0.10 | Rake $0 
Seat 1: dashmamad (button) folded before Flop (didn't bet)
Seat 2: CashMatteo (small blind) folded before Flop
Seat 3: conman899 (big blind) collected ($0.10)
Seat 4: Villa0722 folded before Flop (didn't bet)
Seat 6: l3lackhammer folded before Flop (didn't bet)

Hand #1196: 

PokerStars Hand #246653500647:  Hold'em No Limit ($0.05/$0.10 CAD) - 2023/10/21 0:25:11 ET
Table 'Scabiosa' 6-max Seat #2 is the button
Seat 1: dashmamad ($8.78 in chips) 
Seat 2: CashMatteo ($16.43 in chips) 
Seat 3: conman899 ($48.60 in chips) 
Seat 4: Villa0722 ($15.62 in chips) 
Seat 6: l3lackhammer ($10 in chips) 
conman899: posts small blind $0.05
Villa0722: posts big blind $0.10
*** HOLE CARDS ***
Dealt to CashMatteo [8d 5d]
l3lackhammer: folds 
dashmamad: raises $0.20 to $0.30
CashMatteo: calls $0.30
conman899: folds 
rdscott56 joins the table at seat #5 
Villa0722: calls $0.20
*** FLOP *** [5s Qs Jc]
Villa0722: bets $0.46
dashmamad: folds 
CashMatteo: folds 
Uncalled bet ($0.46) returned to Villa0722
Villa0722 collected $0.91 from pot
Villa0722: doesn't show hand 
*** SUMMARY ***
Total pot $0.95 | Rake $0.04 
Board [5s Qs Jc]
Seat 1: dashmamad folded on the Flop
Seat 2: CashMatteo (button) folded on the Flop
Seat 3: conman899 (small blind) folded before Flop
Seat 4: Villa0722 (big blind) collected ($0.91)
Seat 6: l3lackhammer folded before Flop (didn't bet)

Hand #1197: 

PokerStars Hand #246653506721:  Hold'em No Limit ($0.05/$0.10 CAD) - 2023/10/21 0:25:58 ET
Table 'Scabiosa' 6-max Seat #3 is the button
Seat 1: dashmamad ($8.48 in chips) 
Seat 2: CashMatteo ($16.13 in chips) 
Seat 3: conman899 ($48.55 in chips) 
Seat 4: Villa0722 ($16.23 in chips) 
Seat 5: rdscott56 ($10 in chips) 
Seat 6: l3lackhammer ($10 in chips) 
Villa0722: posts small blind $0.05
rdscott56: posts big blind $0.10
*** HOLE CARDS ***
Dealt to CashMatteo [7h Qc]
l3lackhammer: raises $0.20 to $0.30
dashmamad: folds 
CashMatteo: folds 
conman899: calls $0.30
Villa0722: folds 
rdscott56: folds 
*** FLOP *** [4d Ts 3s]
l3lackhammer: bets $0.54
conman899: calls $0.54
*** TURN *** [4d Ts 3s] [2h]
l3lackhammer: bets $1.31
conman899: calls $1.31
*** RIVER *** [4d Ts 3s 2h] [6s]
l3lackhammer: bets $5.23
conman899: folds 
Uncalled bet ($5.23) returned to l3lackhammer
l3lackhammer collected $4.25 from pot
l3lackhammer: doesn't show hand 
*** SUMMARY ***
Total pot $4.45 | Rake $0.20 
Board [4d Ts 3s 2h 6s]
Seat 1: dashmamad folded before Flop (didn't bet)
Seat 2: CashMatteo folded before Flop (didn't bet)
Seat 3: conman899 (button) folded on the River
Seat 4: Villa0722 (small blind) folded before Flop
Seat 5: rdscott56 (big blind) folded before Flop
Seat 6: l3lackhammer collected ($4.25)

Hand #1198: 

PokerStars Hand #246653511307:  Hold'em No Limit ($0.05/$0.10 CAD) - 2023/10/21 0:26:34 ET
Table 'Scabiosa' 6-max Seat #4 is the button
Seat 1: dashmamad ($8.48 in chips) 
Seat 2: CashMatteo ($16.13 in chips) 
Seat 3: conman899 ($46.40 in chips) 
Seat 4: Villa0722 ($16.18 in chips) 
Seat 5: rdscott56 ($9.90 in chips) 
Seat 6: l3lackhammer ($12.10 in chips) 
rdscott56: posts small blind $0.05
l3lackhammer: posts big blind $0.10
*** HOLE CARDS ***
Dealt to CashMatteo [Ah 6s]
dashmamad has timed out while being disconnected
dashmamad: folds 
CashMatteo: calls $0.10
conman899: folds 
Villa0722: raises $0.10 to $0.20
rdscott56: calls $0.15
l3lackhammer: folds 
CashMatteo: calls $0.10
*** FLOP *** [6c Ts 4h]
dashmamad is disconnected 
rdscott56: bets $0.34
CashMatteo: calls $0.34
Villa0722: folds 
*** TURN *** [6c Ts 4h] [Ac]
rdscott56: bets $0.66
CashMatteo: calls $0.66
*** RIVER *** [6c Ts 4h Ac] [8s]
rdscott56: bets $0.30
CashMatteo: raises $3.18 to $3.48
rdscott56: folds 
Uncalled bet ($3.18) returned to CashMatteo
CashMatteo collected $3.15 from pot
CashMatteo: doesn't show hand 
*** SUMMARY ***
Total pot $3.30 | Rake $0.15 
Board [6c Ts 4h Ac 8s]
Seat 1: dashmamad folded before Flop (didn't bet)
Seat 2: CashMatteo collected ($3.15)
Seat 3: conman899 folded before Flop (didn't bet)
Seat 4: Villa0722 (button) folded on the Flop
Seat 5: rdscott56 (small blind) folded on the River
Seat 6: l3lackhammer (big blind) folded before Flop

Hand #1199: 

PokerStars Hand #246653520679:  Hold'em No Limit ($0.05/$0.10 CAD) - 2023/10/21 0:27:47 ET
Table 'Scabiosa' 6-max Seat #5 is the button
Seat 2: CashMatteo ($17.78 in chips) 
Seat 3: conman899 ($46.40 in chips) 
Seat 4: Villa0722 ($15.98 in chips) 
Seat 5: rdscott56 ($8.40 in chips) 
Seat 6: l3lackhammer ($12 in chips) 
l3lackhammer: posts small blind $0.05
CashMatteo: posts big blind $0.10
*** HOLE CARDS ***
Dealt to CashMatteo [As 2h]
conman899: folds 
Villa0722: folds 
rdscott56: raises $0.10 to $0.20
l3lackhammer: folds 
CashMatteo: calls $0.10
*** FLOP *** [8h 5d Qh]
CashMatteo: checks 
rdscott56: bets $0.43
CashMatteo: folds 
Uncalled bet ($0.43) returned to rdscott56
rdscott56 collected $0.43 from pot
rdscott56: doesn't show hand 
*** SUMMARY ***
Total pot $0.45 | Rake $0.02 
Board [8h 5d Qh]
Seat 2: CashMatteo (big blind) folded on the Flop
Seat 3: conman899 folded before Flop (didn't bet)
Seat 4: Villa0722 folded before Flop (didn't bet)
Seat 5: rdscott56 (button) collected ($0.43)
Seat 6: l3lackhammer (small blind) folded before Flop

Hand #1200: 

PokerStars Hand #246653523199:  Hold'em No Limit ($0.05/$0.10 CAD) - 2023/10/21 0:28:06 ET
Table 'Scabiosa' 6-max Seat #6 is the button
Seat 2: CashMatteo ($17.58 in chips) 
Seat 3: conman899 ($46.40 in chips) 
Seat 4: Villa0722 ($15.98 in chips) 
Seat 5: rdscott56 ($8.63 in chips) 
Seat 6: l3lackhammer ($11.95 in chips) 
CashMatteo: posts small blind $0.05
conman899: posts big blind $0.10
*** HOLE CARDS ***
Dealt to CashMatteo [7h 8d]
Villa0722: calls $0.10
rdscott56: raises $0.10 to $0.20
l3lackhammer: folds 
CashMatteo: folds 
conman899: raises $0.55 to $0.75
Villa0722: folds 
rdscott56: raises $0.55 to $1.30
conman899: calls $0.55
*** FLOP *** [Kh 6s 5s]
conman899: checks 
rdscott56: bets $1.32
conman899: folds 
Uncalled bet ($1.32) returned to rdscott56
rdscott56 collected $2.63 from pot
rdscott56: doesn't show hand 
*** SUMMARY ***
Total pot $2.75 | Rake $0.12 
Board [Kh 6s 5s]
Seat 2: CashMatteo (small blind) folded before Flop
Seat 3: conman899 (big blind) folded on the Flop
Seat 4: Villa0722 folded before Flop
Seat 5: rdscott56 collected ($2.63)
Seat 6: l3lackhammer (button) folded before Flop (didn't bet)

Hand #1201: 

PokerStars Hand #246653527557:  Hold'em No Limit ($0.05/$0.10 CAD) - 2023/10/21 0:28:41 ET
Table 'Scabiosa' 6-max Seat #2 is the button
Seat 2: CashMatteo ($17.53 in chips) 
Seat 3: conman899 ($45.10 in chips) 
Seat 4: Villa0722 ($15.88 in chips) 
Seat 5: rdscott56 ($9.96 in chips) 
Seat 6: l3lackhammer ($11.95 in chips) 
conman899: posts small blind $0.05
Villa0722: posts big blind $0.10
*** HOLE CARDS ***
Dealt to CashMatteo [4d 8h]
rdscott56: raises $0.10 to $0.20
l3lackhammer: folds 
CashMatteo: folds 
conman899: calls $0.15
Villa0722: folds 
*** FLOP *** [9h Kd Qd]
conman899: checks 
rdscott56: bets $0.24
conman899: folds 
Uncalled bet ($0.24) returned to rdscott56
rdscott56 collected $0.48 from pot
rdscott56: doesn't show hand 
*** SUMMARY ***
Total pot $0.50 | Rake $0.02 
Board [9h Kd Qd]
Seat 2: CashMatteo (button) folded before Flop (didn't bet)
Seat 3: conman899 (small blind) folded on the Flop
Seat 4: Villa0722 (big blind) folded before Flop
Seat 5: rdscott56 collected ($0.48)
Seat 6: l3lackhammer folded before Flop (didn't bet)

Hand #1202: 

PokerStars Hand #246653530011:  Hold'em No Limit ($0.05/$0.10 CAD) - 2023/10/21 0:29:00 ET
Table 'Scabiosa' 6-max Seat #3 is the button
Seat 2: CashMatteo ($17.53 in chips) 
Seat 3: conman899 ($44.90 in chips) 
Seat 4: Villa0722 ($15.78 in chips) 
Seat 5: rdscott56 ($10.24 in chips) 
Seat 6: l3lackhammer ($11.95 in chips) 
Villa0722: posts small blind $0.05
rdscott56: posts big blind $0.10
*** HOLE CARDS ***
Dealt to CashMatteo [4s 9c]
l3lackhammer: folds 
CashMatteo: folds 
conman899: raises $0.25 to $0.35
Villa0722: folds 
rdscott56: calls $0.25
*** FLOP *** [As Qc 3d]
rdscott56: bets $0.10
conman899: calls $0.10
*** TURN *** [As Qc 3d] [Qh]
rdscott56: bets $0.10
conman899: raises $1.11 to $1.21
rdscott56: folds 
Uncalled bet ($1.11) returned to conman899
conman899 collected $1.10 from pot
*** SUMMARY ***
Total pot $1.15 | Rake $0.05 
Board [As Qc 3d Qh]
Seat 2: CashMatteo folded before Flop (didn't bet)
Seat 3: conman899 (button) collected ($1.10)
Seat 4: Villa0722 (small blind) folded before Flop
Seat 5: rdscott56 (big blind) folded on the Turn
Seat 6: l3lackhammer folded before Flop (didn't bet)

Hand #1203: 

PokerStars Hand #246653533571:  Hold'em No Limit ($0.05/$0.10 CAD) - 2023/10/21 0:29:28 ET
Table 'Scabiosa' 6-max Seat #4 is the button
Seat 2: CashMatteo ($17.53 in chips) 
Seat 3: conman899 ($45.45 in chips) 
Seat 4: Villa0722 ($15.73 in chips) 
Seat 5: rdscott56 ($9.69 in chips) 
Seat 6: l3lackhammer ($11.95 in chips) 
rdscott56: posts small blind $0.05
l3lackhammer: posts big blind $0.10
*** HOLE CARDS ***
Dealt to CashMatteo [7h 3s]
CashMatteo: folds 
conman899: raises $0.25 to $0.35
Villa0722: folds 
rdscott56: calls $0.30
l3lackhammer: calls $0.25
*** FLOP *** [Qh Ts 2h]
rdscott56: bets $1
l3lackhammer: folds 
conman899: raises $44.10 to $45.10 and is all-in
rdscott56: calls $8.34 and is all-in
Uncalled bet ($35.76) returned to conman899
*** TURN *** [Qh Ts 2h] [Jd]
*** RIVER *** [Qh Ts 2h Jd] [3d]
*** SHOW DOWN ***
rdscott56: shows [Qs 8s] (a pair of Queens)
conman899: shows [Ac Qc] (a pair of Queens - Ace kicker)
conman899 collected $18.84 from pot
*** SUMMARY ***
Total pot $19.73 | Rake $0.89 
Board [Qh Ts 2h Jd 3d]
Seat 2: CashMatteo folded before Flop (didn't bet)
Seat 3: conman899 showed [Ac Qc] and won ($18.84) with a pair of Queens
Seat 4: Villa0722 (button) folded before Flop (didn't bet)
Seat 5: rdscott56 (small blind) showed [Qs 8s] and lost with a pair of Queens
Seat 6: l3lackhammer (big blind) folded on the Flop

Hand #1204: 

PokerStars Hand #246653538314:  Hold'em No Limit ($0.05/$0.10 CAD) - 2023/10/21 0:30:06 ET
Table 'Scabiosa' 6-max Seat #6 is the button
Seat 2: CashMatteo ($17.53 in chips) 
Seat 3: conman899 ($54.60 in chips) 
Seat 4: Villa0722 ($15.73 in chips) 
Seat 6: l3lackhammer ($11.60 in chips) 
CashMatteo: posts small blind $0.05
conman899: posts big blind $0.10
*** HOLE CARDS ***
Dealt to CashMatteo [9c 7h]
Villa0722: folds 
l3lackhammer: folds 
CashMatteo: folds 
Uncalled bet ($0.05) returned to conman899
conman899 collected $0.10 from pot
*** SUMMARY ***
Total pot $0.10 | Rake $0 
Seat 2: CashMatteo (small blind) folded before Flop
Seat 3: conman899 (big blind) collected ($0.10)
Seat 4: Villa0722 folded before Flop (didn't bet)
Seat 6: l3lackhammer (button) folded before Flop (didn't bet)

Hand #1205: 

PokerStars Hand #246653539900:  Hold'em No Limit ($0.05/$0.10 CAD) - 2023/10/21 0:30:18 ET
Table 'Scabiosa' 6-max Seat #2 is the button
Seat 2: CashMatteo ($17.48 in chips) 
Seat 3: conman899 ($54.65 in chips) 
Seat 4: Villa0722 ($15.73 in chips) 
Seat 5: rdscott56 ($7.95 in chips) 
Seat 6: l3lackhammer ($11.60 in chips) 
conman899: posts small blind $0.05
Villa0722: posts big blind $0.10
*** HOLE CARDS ***
Dealt to CashMatteo [As 7c]
rdscott56: raises $7.85 to $7.95 and is all-in
l3lackhammer: raises $3.65 to $11.60 and is all-in
CashMatteo: folds 
conman899: folds 
Villa0722: folds 
Uncalled bet ($3.65) returned to l3lackhammer
*** FLOP *** [4s 8h 4h]
*** TURN *** [4s 8h 4h] [8d]
*** RIVER *** [4s 8h 4h 8d] [2s]
*** SHOW DOWN ***
rdscott56: shows [Kc Qd] (two pair, Eights and Fours)
l3lackhammer: shows [Ts Tc] (two pair, Tens and Eights)
l3lackhammer collected $15.33 from pot
*** SUMMARY ***
Total pot $16.05 | Rake $0.72 
Board [4s 8h 4h 8d 2s]
Seat 2: CashMatteo (button) folded before Flop (didn't bet)
Seat 3: conman899 (small blind) folded before Flop
Seat 4: Villa0722 (big blind) folded before Flop
Seat 5: rdscott56 showed [Kc Qd] and lost with two pair, Eights and Fours
Seat 6: l3lackhammer showed [Ts Tc] and won ($15.33) with two pair, Tens and Eights

Hand #1206: 

PokerStars Hand #246653544169:  Hold'em No Limit ($0.05/$0.10 CAD) - 2023/10/21 0:30:51 ET
Table 'Scabiosa' 6-max Seat #3 is the button
Seat 2: CashMatteo ($17.48 in chips) 
Seat 3: conman899 ($54.60 in chips) 
Seat 4: Villa0722 ($15.63 in chips) 
Seat 6: l3lackhammer ($18.98 in chips) 
Villa0722: posts small blind $0.05
l3lackhammer: posts big blind $0.10
*** HOLE CARDS ***
Dealt to CashMatteo [5d Qh]
rdscott56 leaves the table
CashMatteo: folds 
conman899: folds 
Villa0722: raises $0.10 to $0.20
l3lackhammer: folds 
Uncalled bet ($0.10) returned to Villa0722
Villa0722 collected $0.20 from pot
Villa0722: doesn't show hand 
*** SUMMARY ***
Total pot $0.20 | Rake $0 
Seat 2: CashMatteo folded before Flop (didn't bet)
Seat 3: conman899 (button) folded before Flop (didn't bet)
Seat 4: Villa0722 (small blind) collected ($0.20)
Seat 6: l3lackhammer (big blind) folded before Flop

Hand #1207: 

PokerStars Hand #246653546074:  Hold'em No Limit ($0.05/$0.10 CAD) - 2023/10/21 0:31:05 ET
Table 'Scabiosa' 6-max Seat #4 is the button
Seat 2: CashMatteo ($17.48 in chips) 
Seat 3: conman899 ($54.60 in chips) 
Seat 4: Villa0722 ($15.73 in chips) 
Seat 6: l3lackhammer ($18.88 in chips) 
l3lackhammer: posts small blind $0.05
CashMatteo: posts big blind $0.10
*** HOLE CARDS ***
Dealt to CashMatteo [6d 4c]
conman899: raises $0.55 to $0.65
Villa0722: folds 
l3lackhammer: folds 
CashMatteo: folds 
Uncalled bet ($0.55) returned to conman899
conman899 collected $0.25 from pot
*** SUMMARY ***
Total pot $0.25 | Rake $0 
Seat 2: CashMatteo (big blind) folded before Flop
Seat 3: conman899 collected ($0.25)
Seat 4: Villa0722 (button) folded before Flop (didn't bet)
Seat 6: l3lackhammer (small blind) folded before Flop

Hand #1208: 

PokerStars Hand #246653547856:  Hold'em No Limit ($0.05/$0.10 CAD) - 2023/10/21 0:31:19 ET
Table 'Scabiosa' 6-max Seat #6 is the button
Seat 2: CashMatteo ($17.38 in chips) 
Seat 3: conman899 ($54.75 in chips) 
Seat 4: Villa0722 ($15.73 in chips) 
Seat 6: l3lackhammer ($18.83 in chips) 
dashmamad will be allowed to play after the button
CashMatteo: posts small blind $0.05
conman899: posts big blind $0.10
*** HOLE CARDS ***
Dealt to CashMatteo [8d 3d]
Villa0722: calls $0.10
l3lackhammer: folds 
CashMatteo: folds 
conman899: raises $0.55 to $0.65
Villa0722: calls $0.55
*** FLOP *** [Td Ks Kh]
conman899: bets $1.29
Villa0722: folds 
Uncalled bet ($1.29) returned to conman899
conman899 collected $1.29 from pot
*** SUMMARY ***
Total pot $1.35 | Rake $0.06 
Board [Td Ks Kh]
Seat 2: CashMatteo (small blind) folded before Flop
Seat 3: conman899 (big blind) collected ($1.29)
Seat 4: Villa0722 folded on the Flop
Seat 6: l3lackhammer (button) folded before Flop (didn't bet)

Hand #1209: 

PokerStars Hand #246653552100:  Hold'em No Limit ($0.05/$0.10 CAD) - 2023/10/21 0:31:53 ET
Table 'Scabiosa' 6-max Seat #2 is the button
Seat 2: CashMatteo ($17.33 in chips) 
Seat 3: conman899 ($55.39 in chips) 
Seat 4: Villa0722 ($15.08 in chips) 
Seat 6: l3lackhammer ($18.83 in chips) 
conman899: posts small blind $0.05
Villa0722: posts big blind $0.10
dashmamad: sits out 
*** HOLE CARDS ***
Dealt to CashMatteo [Jd 8h]
l3lackhammer: folds 
CashMatteo: calls $0.10
conman899: calls $0.05
Villa0722: checks 
*** FLOP *** [7d 8d 9s]
conman899: bets $0.29
Villa0722: calls $0.29
CashMatteo: calls $0.29
*** TURN *** [7d 8d 9s] [Tc]
conman899: bets $1.12
Sideshow022 joins the table at seat #5 
Villa0722: calls $1.12
CashMatteo: calls $1.12
*** RIVER *** [7d 8d 9s Tc] [Ad]
conman899: checks 
Villa0722: checks 
CashMatteo: bets $2.17
conman899: folds 
Villa0722: calls $2.17
*** SHOW DOWN ***
CashMatteo: shows [Jd 8h] (a straight, Seven to Jack)
Villa0722: mucks hand 
CashMatteo collected $8.47 from pot
*** SUMMARY ***
Total pot $8.87 | Rake $0.40 
Board [7d 8d 9s Tc Ad]
Seat 2: CashMatteo (button) showed [Jd 8h] and won ($8.47) with a straight, Seven to Jack
Seat 3: conman899 (small blind) folded on the River
Seat 4: Villa0722 (big blind) mucked [4s 6h]
Seat 6: l3lackhammer folded before Flop (didn't bet)

Hand #1210: 

PokerStars Hand #246653562595:  Hold'em No Limit ($0.05/$0.10 CAD) - 2023/10/21 0:33:16 ET
Table 'Scabiosa' 6-max Seat #3 is the button
Seat 2: CashMatteo ($22.12 in chips) 
Seat 3: conman899 ($53.88 in chips) 
Seat 4: Villa0722 ($11.40 in chips) 
Seat 5: Sideshow022 ($8.89 in chips) 
Seat 6: l3lackhammer ($18.83 in chips) 
Villa0722: posts small blind $0.05
Sideshow022: posts big blind $0.10
dashmamad: sits out 
*** HOLE CARDS ***
Dealt to CashMatteo [8h Jc]
l3lackhammer: folds 
CashMatteo: calls $0.10
conman899: folds 
Villa0722: folds 
Sideshow022: checks 
*** FLOP *** [8s 4h Tc]
Sideshow022: checks 
CashMatteo: checks 
*** TURN *** [8s 4h Tc] [5h]
Sideshow022: checks 
CashMatteo: checks 
*** RIVER *** [8s 4h Tc 5h] [9c]
Sideshow022: checks 
CashMatteo: checks 
*** SHOW DOWN ***
Sideshow022: shows [Ac 6s] (high card Ace)
CashMatteo: shows [8h Jc] (a pair of Eights)
CashMatteo collected $0.24 from pot
*** SUMMARY ***
Total pot $0.25 | Rake $0.01 
Board [8s 4h Tc 5h 9c]
Seat 2: CashMatteo showed [8h Jc] and won ($0.24) with a pair of Eights
Seat 3: conman899 (button) folded before Flop (didn't bet)
Seat 4: Villa0722 (small blind) folded before Flop
Seat 5: Sideshow022 (big blind) showed [Ac 6s] and lost with high card Ace
Seat 6: l3lackhammer folded before Flop (didn't bet)

Hand #1211: 

PokerStars Hand #246653567247:  Hold'em No Limit ($0.05/$0.10 CAD) - 2023/10/21 0:33:53 ET
Table 'Scabiosa' 6-max Seat #4 is the button
Seat 2: CashMatteo ($22.26 in chips) 
Seat 3: conman899 ($53.88 in chips) 
Seat 4: Villa0722 ($11.35 in chips) 
Seat 5: Sideshow022 ($8.79 in chips) 
Seat 6: l3lackhammer ($18.83 in chips) 
Sideshow022: posts small blind $0.05
l3lackhammer: posts big blind $0.10
dashmamad: sits out 
*** HOLE CARDS ***
Dealt to CashMatteo [5h 2s]
CashMatteo: folds 
conman899: raises $0.25 to $0.35
Villa0722: folds 
Sideshow022: folds 
l3lackhammer: folds 
Uncalled bet ($0.25) returned to conman899
conman899 collected $0.25 from pot
*** SUMMARY ***
Total pot $0.25 | Rake $0 
Seat 2: CashMatteo folded before Flop (didn't bet)
Seat 3: conman899 collected ($0.25)
Seat 4: Villa0722 (button) folded before Flop (didn't bet)
Seat 5: Sideshow022 (small blind) folded before Flop
Seat 6: l3lackhammer (big blind) folded before Flop

Hand #1212: 

PokerStars Hand #246653569639:  Hold'em No Limit ($0.05/$0.10 CAD) - 2023/10/21 0:34:12 ET
Table 'Scabiosa' 6-max Seat #5 is the button
Seat 1: dashmamad ($8.48 in chips) 
Seat 2: CashMatteo ($22.26 in chips) 
Seat 3: conman899 ($54.03 in chips) 
Seat 4: Villa0722 ($11.35 in chips) 
Seat 5: Sideshow022 ($8.74 in chips) 
Seat 6: l3lackhammer ($18.73 in chips) 
l3lackhammer: posts small blind $0.05
dashmamad: posts big blind $0.10
*** HOLE CARDS ***
Dealt to CashMatteo [9d Td]
CashMatteo: raises $0.15 to $0.25
conman899: raises $0.25 to $0.50
Villa0722: folds 
Sideshow022: folds 
l3lackhammer: folds 
dashmamad: folds 
CashMatteo: calls $0.25
*** FLOP *** [Qd 7d 8h]
CashMatteo: checks 
conman899: bets $1.10
CashMatteo: raises $7.80 to $8.90
conman899: raises $44.63 to $53.53 and is all-in
CashMatteo: calls $12.86 and is all-in
Uncalled bet ($31.77) returned to conman899
*** TURN *** [Qd 7d 8h] [Tc]
*** RIVER *** [Qd 7d 8h Tc] [Ac]
*** SHOW DOWN ***
CashMatteo: shows [9d Td] (a pair of Tens)
conman899: shows [4d 6d] (high card Ace)
CashMatteo collected $42.92 from pot
*** SUMMARY ***
Total pot $44.67 | Rake $1.75 
Board [Qd 7d 8h Tc Ac]
Seat 1: dashmamad (big blind) folded before Flop
Seat 2: CashMatteo showed [9d Td] and won ($42.92) with a pair of Tens
Seat 3: conman899 showed [4d 6d] and lost with high card Ace
Seat 4: Villa0722 folded before Flop (didn't bet)
Seat 5: Sideshow022 (button) folded before Flop (didn't bet)
Seat 6: l3lackhammer (small blind) folded before Flop

Hand #1213: 

PokerStars Hand #246653577877:  Hold'em No Limit ($0.05/$0.10 CAD) - 2023/10/21 0:35:18 ET
Table 'Scabiosa' 6-max Seat #6 is the button
Seat 1: dashmamad ($8.38 in chips) 
Seat 2: CashMatteo ($42.92 in chips) 
Seat 3: conman899 ($31.77 in chips) 
Seat 4: Villa0722 ($11.35 in chips) 
Seat 5: Sideshow022 ($8.74 in chips) 
Seat 6: l3lackhammer ($18.68 in chips) 
dashmamad: posts small blind $0.05
CashMatteo: posts big blind $0.10
*** HOLE CARDS ***
Dealt to CashMatteo [7s Qd]
conman899: folds 
Villa0722: calls $0.10
Sideshow022 said, "Boom"
Sideshow022: folds 
l3lackhammer: folds 
dashmamad: folds 
CashMatteo: checks 
*** FLOP *** [Ts 4d 3h]
CashMatteo: checks 
Villa0722: checks 
*** TURN *** [Ts 4d 3h] [Qh]
CashMatteo: checks 
Villa0722: checks 
*** RIVER *** [Ts 4d 3h Qh] [9c]
CashMatteo: bets $0.12
Villa0722: calls $0.12
*** SHOW DOWN ***
CashMatteo: shows [7s Qd] (a pair of Queens)
Villa0722: shows [7c Qc] (a pair of Queens)
CashMatteo collected $0.24 from pot
Villa0722 collected $0.23 from pot
*** SUMMARY ***
Total pot $0.49 | Rake $0.02 
Board [Ts 4d 3h Qh 9c]
Seat 1: dashmamad (small blind) folded before Flop
Seat 2: CashMatteo (big blind) showed [7s Qd] and won ($0.24) with a pair of Queens
Seat 3: conman899 folded before Flop (didn't bet)
Seat 4: Villa0722 showed [7c Qc] and won ($0.23) with a pair of Queens
Seat 5: Sideshow022 folded before Flop (didn't bet)
Seat 6: l3lackhammer (button) folded before Flop (didn't bet)

Hand #1214: 

PokerStars Hand #246653584804:  Hold'em No Limit ($0.05/$0.10 CAD) - 2023/10/21 0:36:13 ET
Table 'Scabiosa' 6-max Seat #1 is the button
Seat 1: dashmamad ($8.33 in chips) 
Seat 2: CashMatteo ($42.94 in chips) 
Seat 3: conman899 ($31.77 in chips) 
Seat 4: Villa0722 ($11.36 in chips) 
Seat 5: Sideshow022 ($8.74 in chips) 
Seat 6: l3lackhammer ($18.68 in chips) 
CashMatteo: posts small blind $0.05
conman899: posts big blind $0.10
*** HOLE CARDS ***
Dealt to CashMatteo [Jd Js]
CashMatteo said, "lol nice hand"
Villa0722: folds 
Sideshow022: folds 
l3lackhammer has timed out
l3lackhammer: folds 
dashmamad: raises $0.20 to $0.30
CashMatteo: raises $0.70 to $1
conman899: calls $0.90
dashmamad: calls $0.70
*** FLOP *** [8h 4d Ts]
CashMatteo: checks 
conman899: checks 
dashmamad: checks 
*** TURN *** [8h 4d Ts] [3c]
CashMatteo: bets $1.43
conman899: raises $1.43 to $2.86
dashmamad: folds 
CashMatteo: calls $1.43
*** RIVER *** [8h 4d Ts 3c] [6d]
CashMatteo: checks 
conman899: bets $8.33
CashMatteo: calls $8.33
*** SHOW DOWN ***
conman899: shows [Tc 8d] (two pair, Tens and Eights)
CashMatteo: mucks hand 
conman899 collected $24.24 from pot
*** SUMMARY ***
Total pot $25.38 | Rake $1.14 
Board [8h 4d Ts 3c 6d]
Seat 1: dashmamad (button) folded on the Turn
Seat 2: CashMatteo (small blind) mucked [Jd Js]
Seat 3: conman899 (big blind) showed [Tc 8d] and won ($24.24) with two pair, Tens and Eights
Seat 4: Villa0722 folded before Flop (didn't bet)
Seat 5: Sideshow022 folded before Flop (didn't bet)
Seat 6: l3lackhammer folded before Flop (didn't bet)

Hand #1215: 

PokerStars Hand #246653592404:  Hold'em No Limit ($0.05/$0.10 CAD) - 2023/10/21 0:37:14 ET
Table 'Scabiosa' 6-max Seat #2 is the button
Seat 1: dashmamad ($7.33 in chips) 
Seat 2: CashMatteo ($30.75 in chips) 
Seat 3: conman899 ($43.82 in chips) 
Seat 4: Villa0722 ($11.36 in chips) 
Seat 5: Sideshow022 ($8.74 in chips) 
Seat 6: l3lackhammer ($18.68 in chips) 
conman899: posts small blind $0.05
Villa0722: posts big blind $0.10
*** HOLE CARDS ***
Dealt to CashMatteo [Ah 5s]
Sideshow022: folds 
l3lackhammer: folds 
dashmamad: folds 
CashMatteo: calls $0.10
conman899: folds 
Villa0722: checks 
*** FLOP *** [Qs 3c 4d]
Villa0722: checks 
CashMatteo: checks 
*** TURN *** [Qs 3c 4d] [2h]
Villa0722: checks 
CashMatteo: bets $0.12
Villa0722: folds 
Uncalled bet ($0.12) returned to CashMatteo
CashMatteo collected $0.24 from pot
CashMatteo: doesn't show hand 
*** SUMMARY ***
Total pot $0.25 | Rake $0.01 
Board [Qs 3c 4d 2h]
Seat 1: dashmamad folded before Flop (didn't bet)
Seat 2: CashMatteo (button) collected ($0.24)
Seat 3: conman899 (small blind) folded before Flop
Seat 4: Villa0722 (big blind) folded on the Turn
Seat 5: Sideshow022 folded before Flop (didn't bet)
Seat 6: l3lackhammer folded before Flop (didn't bet)

Hand #1216: 

PokerStars Hand #246653596322:  Hold'em No Limit ($0.05/$0.10 CAD) - 2023/10/21 0:37:46 ET
Table 'Scabiosa' 6-max Seat #3 is the button
Seat 1: dashmamad ($7.33 in chips) 
Seat 2: CashMatteo ($30.89 in chips) 
Seat 3: conman899 ($43.77 in chips) 
Seat 4: Villa0722 ($11.26 in chips) 
Seat 5: Sideshow022 ($8.74 in chips) 
Seat 6: l3lackhammer ($18.68 in chips) 
Villa0722: posts small blind $0.05
Sideshow022: posts big blind $0.10
*** HOLE CARDS ***
Dealt to CashMatteo [5c As]
l3lackhammer: folds 
dashmamad: folds 
CashMatteo: raises $0.15 to $0.25
conman899: raises $0.25 to $0.50
Villa0722: folds 
Sideshow022: folds 
CashMatteo: calls $0.25
*** FLOP *** [2c 4c 9c]
CashMatteo: checks 
conman899: checks 
*** TURN *** [2c 4c 9c] [Jh]
CashMatteo: checks 
conman899: checks 
*** RIVER *** [2c 4c 9c Jh] [Qc]
CashMatteo: checks 
conman899: bets $0.10
CashMatteo: calls $0.10
*** SHOW DOWN ***
conman899: shows [6d 3d] (high card Queen)
CashMatteo: shows [5c As] (a flush, Queen high)
CashMatteo collected $1.29 from pot
*** SUMMARY ***
Total pot $1.35 | Rake $0.06 
Board [2c 4c 9c Jh Qc]
Seat 1: dashmamad folded before Flop (didn't bet)
Seat 2: CashMatteo showed [5c As] and won ($1.29) with a flush, Queen high
Seat 3: conman899 (button) showed [6d 3d] and lost with high card Queen
Seat 4: Villa0722 (small blind) folded before Flop
Seat 5: Sideshow022 (big blind) folded before Flop
Seat 6: l3lackhammer folded before Flop (didn't bet)

Hand #1217: 

PokerStars Hand #246653601389:  Hold'em No Limit ($0.05/$0.10 CAD) - 2023/10/21 0:38:28 ET
Table 'Scabiosa' 6-max Seat #4 is the button
Seat 1: dashmamad ($7.33 in chips) 
Seat 2: CashMatteo ($31.58 in chips) 
Seat 3: conman899 ($43.17 in chips) 
Seat 4: Villa0722 ($11.21 in chips) 
Seat 5: Sideshow022 ($8.64 in chips) 
Seat 6: l3lackhammer ($18.68 in chips) 
Sideshow022: posts small blind $0.05
l3lackhammer: posts big blind $0.10
*** HOLE CARDS ***
Dealt to CashMatteo [4d Qc]
dashmamad: folds 
CashMatteo: calls $0.10
conman899: raises $0.35 to $0.45
Villa0722: folds 
Sideshow022: folds 
l3lackhammer: folds 
CashMatteo: folds 
Uncalled bet ($0.35) returned to conman899
conman899 collected $0.35 from pot
*** SUMMARY ***
Total pot $0.35 | Rake $0 
Seat 1: dashmamad folded before Flop (didn't bet)
Seat 2: CashMatteo folded before Flop
Seat 3: conman899 collected ($0.35)
Seat 4: Villa0722 (button) folded before Flop (didn't bet)
Seat 5: Sideshow022 (small blind) folded before Flop
Seat 6: l3lackhammer (big blind) folded before Flop

Hand #1218: 

PokerStars Hand #246653605703:  Hold'em No Limit ($0.05/$0.10 CAD) - 2023/10/21 0:39:02 ET
Table 'Scabiosa' 6-max Seat #5 is the button
Seat 1: dashmamad ($7.33 in chips) 
Seat 2: CashMatteo ($31.48 in chips) 
Seat 3: conman899 ($43.42 in chips) 
Seat 4: Villa0722 ($11.21 in chips) 
Seat 5: Sideshow022 ($8.59 in chips) 
Seat 6: l3lackhammer ($18.58 in chips) 
l3lackhammer: posts small blind $0.05
dashmamad: posts big blind $0.10
*** HOLE CARDS ***
Dealt to CashMatteo [5c Ts]
CashMatteo: folds 
conman899: raises $0.25 to $0.35
Villa0722: folds 
Sideshow022: folds 
l3lackhammer: folds 
dashmamad: folds 
Uncalled bet ($0.25) returned to conman899
conman899 collected $0.25 from pot
*** SUMMARY ***
Total pot $0.25 | Rake $0 
Seat 1: dashmamad (big blind) folded before Flop
Seat 2: CashMatteo folded before Flop (didn't bet)
Seat 3: conman899 collected ($0.25)
Seat 4: Villa0722 folded before Flop (didn't bet)
Seat 5: Sideshow022 (button) folded before Flop (didn't bet)
Seat 6: l3lackhammer (small blind) folded before Flop

Hand #1219: 

PokerStars Hand #246653607677:  Hold'em No Limit ($0.05/$0.10 CAD) - 2023/10/21 0:39:18 ET
Table 'Scabiosa' 6-max Seat #6 is the button
Seat 1: dashmamad ($7.23 in chips) 
Seat 2: CashMatteo ($31.48 in chips) 
Seat 3: conman899 ($43.57 in chips) 
Seat 4: Villa0722 ($11.21 in chips) 
Seat 5: Sideshow022 ($8.59 in chips) 
Seat 6: l3lackhammer ($18.53 in chips) 
dashmamad: posts small blind $0.05
CashMatteo: posts big blind $0.10
*** HOLE CARDS ***
Dealt to CashMatteo [9h 3h]
conman899: raises $0.25 to $0.35
Villa0722: folds 
Sideshow022: folds 
l3lackhammer: folds 
dashmamad: folds 
CashMatteo: calls $0.25
*** FLOP *** [Ad Ah 4h]
CashMatteo: checks 
conman899: checks 
*** TURN *** [Ad Ah 4h] [Td]
CashMatteo: bets $0.36
conman899: calls $0.36
*** RIVER *** [Ad Ah 4h Td] [8h]
CashMatteo: bets $1.40
conman899: folds 
Uncalled bet ($1.40) returned to CashMatteo
CashMatteo collected $1.40 from pot
CashMatteo: doesn't show hand 
*** SUMMARY ***
Total pot $1.47 | Rake $0.07 
Board [Ad Ah 4h Td 8h]
Seat 1: dashmamad (small blind) folded before Flop
Seat 2: CashMatteo (big blind) collected ($1.40)
Seat 3: conman899 folded on the River
Seat 4: Villa0722 folded before Flop (didn't bet)
Seat 5: Sideshow022 folded before Flop (didn't bet)
Seat 6: l3lackhammer (button) folded before Flop (didn't bet)

Hand #1220: 

PokerStars Hand #246653613326:  Hold'em No Limit ($0.05/$0.10 CAD) - 2023/10/21 0:40:04 ET
Table 'Scabiosa' 6-max Seat #1 is the button
Seat 1: dashmamad ($7.18 in chips) 
Seat 2: CashMatteo ($32.17 in chips) 
Seat 3: conman899 ($42.86 in chips) 
Seat 4: Villa0722 ($11.21 in chips) 
Seat 5: Sideshow022 ($8.59 in chips) 
Seat 6: l3lackhammer ($18.53 in chips) 
CashMatteo: posts small blind $0.05
conman899: posts big blind $0.10
*** HOLE CARDS ***
Dealt to CashMatteo [4s 4h]
Villa0722: folds 
Sideshow022: folds 
l3lackhammer: folds 
dashmamad: folds 
CashMatteo: raises $0.15 to $0.25
conman899: folds 
Uncalled bet ($0.15) returned to CashMatteo
CashMatteo collected $0.20 from pot
CashMatteo: doesn't show hand 
*** SUMMARY ***
Total pot $0.20 | Rake $0 
Seat 1: dashmamad (button) folded before Flop (didn't bet)
Seat 2: CashMatteo (small blind) collected ($0.20)
Seat 3: conman899 (big blind) folded before Flop
Seat 4: Villa0722 folded before Flop (didn't bet)
Seat 5: Sideshow022 folded before Flop (didn't bet)
Seat 6: l3lackhammer folded before Flop (didn't bet)

Hand #1221: 

PokerStars Hand #246653616212:  Hold'em No Limit ($0.05/$0.10 CAD) - 2023/10/21 0:40:27 ET
Table 'Scabiosa' 6-max Seat #2 is the button
Seat 1: dashmamad ($7.18 in chips) 
Seat 2: CashMatteo ($32.27 in chips) 
Seat 3: conman899 ($42.76 in chips) 
Seat 4: Villa0722 ($11.21 in chips) 
Seat 5: Sideshow022 ($8.59 in chips) 
Seat 6: l3lackhammer ($18.53 in chips) 
conman899: posts small blind $0.05
Villa0722: posts big blind $0.10
*** HOLE CARDS ***
Dealt to CashMatteo [9s 4h]
Sideshow022: folds 
l3lackhammer: folds 
dashmamad: folds 
CashMatteo: folds 
conman899: raises $0.20 to $0.30
Villa0722: folds 
Uncalled bet ($0.20) returned to conman899
conman899 collected $0.20 from pot
*** SUMMARY ***
Total pot $0.20 | Rake $0 
Seat 1: dashmamad folded before Flop (didn't bet)
Seat 2: CashMatteo (button) folded before Flop (didn't bet)
Seat 3: conman899 (small blind) collected ($0.20)
Seat 4: Villa0722 (big blind) folded before Flop
Seat 5: Sideshow022 folded before Flop (didn't bet)
Seat 6: l3lackhammer folded before Flop (didn't bet)

Hand #1222: 

PokerStars Hand #246653619733:  Hold'em No Limit ($0.05/$0.10 CAD) - 2023/10/21 0:40:56 ET
Table 'Scabiosa' 6-max Seat #3 is the button
Seat 1: dashmamad ($7.18 in chips) 
Seat 2: CashMatteo ($32.27 in chips) 
Seat 3: conman899 ($42.86 in chips) 
Seat 4: Villa0722 ($11.11 in chips) 
Seat 5: Sideshow022 ($8.59 in chips) 
Seat 6: l3lackhammer ($18.53 in chips) 
Villa0722: posts small blind $0.05
Sideshow022: posts big blind $0.10
*** HOLE CARDS ***
Dealt to CashMatteo [5c 2h]
l3lackhammer: folds 
dashmamad: folds 
CashMatteo: folds 
conman899: folds 
Villa0722: folds 
Uncalled bet ($0.05) returned to Sideshow022
Sideshow022 collected $0.10 from pot
*** SUMMARY ***
Total pot $0.10 | Rake $0 
Seat 1: dashmamad folded before Flop (didn't bet)
Seat 2: CashMatteo folded before Flop (didn't bet)
Seat 3: conman899 (button) folded before Flop (didn't bet)
Seat 4: Villa0722 (small blind) folded before Flop
Seat 5: Sideshow022 (big blind) collected ($0.10)
Seat 6: l3lackhammer folded before Flop (didn't bet)

Hand #1223: 

PokerStars Hand #246653621742:  Hold'em No Limit ($0.05/$0.10 CAD) - 2023/10/21 0:41:12 ET
Table 'Scabiosa' 6-max Seat #4 is the button
Seat 1: dashmamad ($7.18 in chips) 
Seat 2: CashMatteo ($32.27 in chips) 
Seat 3: conman899 ($42.86 in chips) 
Seat 4: Villa0722 ($11.06 in chips) 
Seat 5: Sideshow022 ($8.64 in chips) 
Seat 6: l3lackhammer ($18.53 in chips) 
Sideshow022: posts small blind $0.05
l3lackhammer: posts big blind $0.10
*** HOLE CARDS ***
Dealt to CashMatteo [Qh Qd]
dashmamad: folds 
CashMatteo: raises $0.15 to $0.25
conman899: raises $0.65 to $0.90
Villa0722: folds 
Sideshow022: folds 
l3lackhammer: folds 
CashMatteo: raises $2.20 to $3.10
conman899: calls $2.20
*** FLOP *** [9s Ah 2c]
CashMatteo: bets $3.03
conman899: folds 
Uncalled bet ($3.03) returned to CashMatteo
CashMatteo collected $6.06 from pot
CashMatteo: doesn't show hand 
*** SUMMARY ***
Total pot $6.35 | Rake $0.29 
Board [9s Ah 2c]
Seat 1: dashmamad folded before Flop (didn't bet)
Seat 2: CashMatteo collected ($6.06)
Seat 3: conman899 folded on the Flop
Seat 4: Villa0722 (button) folded before Flop (didn't bet)
Seat 5: Sideshow022 (small blind) folded before Flop
Seat 6: l3lackhammer (big blind) folded before Flop

Hand #1224: 

PokerStars Hand #246653627100:  Hold'em No Limit ($0.05/$0.10 CAD) - 2023/10/21 0:41:56 ET
Table 'Scabiosa' 6-max Seat #5 is the button
Seat 1: dashmamad ($7.18 in chips) 
Seat 2: CashMatteo ($35.23 in chips) 
Seat 3: conman899 ($39.76 in chips) 
Seat 4: Villa0722 ($11.06 in chips) 
Seat 5: Sideshow022 ($8.59 in chips) 
Seat 6: l3lackhammer ($18.43 in chips) 
l3lackhammer: posts small blind $0.05
dashmamad: posts big blind $0.10
*** HOLE CARDS ***
Dealt to CashMatteo [Ac Ts]
CashMatteo: calls $0.10
conman899: folds 
Villa0722: raises $0.10 to $0.20
Sideshow022: folds 
l3lackhammer: folds 
dashmamad: folds 
CashMatteo: calls $0.10
*** FLOP *** [Jd 6d 4d]
CashMatteo: checks 
Villa0722: bets $0.16
CashMatteo: folds 
Uncalled bet ($0.16) returned to Villa0722
Villa0722 collected $0.53 from pot
Villa0722: doesn't show hand 
*** SUMMARY ***
Total pot $0.55 | Rake $0.02 
Board [Jd 6d 4d]
Seat 1: dashmamad (big blind) folded before Flop
Seat 2: CashMatteo folded on the Flop
Seat 3: conman899 folded before Flop (didn't bet)
Seat 4: Villa0722 collected ($0.53)
Seat 5: Sideshow022 (button) folded before Flop (didn't bet)
Seat 6: l3lackhammer (small blind) folded before Flop

Hand #1225: 

PokerStars Hand #246653630380:  Hold'em No Limit ($0.05/$0.10 CAD) - 2023/10/21 0:42:23 ET
Table 'Scabiosa' 6-max Seat #6 is the button
Seat 1: dashmamad ($7.08 in chips) 
Seat 2: CashMatteo ($35.03 in chips) 
Seat 3: conman899 ($39.76 in chips) 
Seat 4: Villa0722 ($11.39 in chips) 
Seat 5: Sideshow022 ($8.59 in chips) 
Seat 6: l3lackhammer ($18.38 in chips) 
dashmamad: posts small blind $0.05
CashMatteo: posts big blind $0.10
*** HOLE CARDS ***
Dealt to CashMatteo [6c 7h]
conman899: folds 
Villa0722: raises $0.10 to $0.20
Sideshow022: folds 
l3lackhammer: folds 
dashmamad: folds 
CashMatteo: folds 
Uncalled bet ($0.10) returned to Villa0722
Villa0722 collected $0.25 from pot
Villa0722: doesn't show hand 
*** SUMMARY ***
Total pot $0.25 | Rake $0 
Seat 1: dashmamad (small blind) folded before Flop
Seat 2: CashMatteo (big blind) folded before Flop
Seat 3: conman899 folded before Flop (didn't bet)
Seat 4: Villa0722 collected ($0.25)
Seat 5: Sideshow022 folded before Flop (didn't bet)
Seat 6: l3lackhammer (button) folded before Flop (didn't bet)

Hand #1226: 

PokerStars Hand #246653632099:  Hold'em No Limit ($0.05/$0.10 CAD) - 2023/10/21 0:42:37 ET
Table 'Scabiosa' 6-max Seat #1 is the button
Seat 1: dashmamad ($7.03 in chips) 
Seat 2: CashMatteo ($34.93 in chips) 
Seat 3: conman899 ($39.76 in chips) 
Seat 4: Villa0722 ($11.54 in chips) 
Seat 5: Sideshow022 ($8.59 in chips) 
Seat 6: l3lackhammer ($18.38 in chips) 
CashMatteo: posts small blind $0.05
conman899: posts big blind $0.10
*** HOLE CARDS ***
Dealt to CashMatteo [4h 8h]
Villa0722: folds 
Sideshow022: folds 
l3lackhammer: folds 
dashmamad: folds 
CashMatteo: calls $0.05
conman899: raises $0.20 to $0.30
CashMatteo: folds 
Uncalled bet ($0.20) returned to conman899
conman899 collected $0.20 from pot
*** SUMMARY ***
Total pot $0.20 | Rake $0 
Seat 1: dashmamad (button) folded before Flop (didn't bet)
Seat 2: CashMatteo (small blind) folded before Flop
Seat 3: conman899 (big blind) collected ($0.20)
Seat 4: Villa0722 folded before Flop (didn't bet)
Seat 5: Sideshow022 folded before Flop (didn't bet)
Seat 6: l3lackhammer folded before Flop (didn't bet)

Hand #1227: 

PokerStars Hand #246653634521:  Hold'em No Limit ($0.05/$0.10 CAD) - 2023/10/21 0:42:57 ET
Table 'Scabiosa' 6-max Seat #2 is the button
Seat 1: dashmamad ($7.03 in chips) 
Seat 2: CashMatteo ($34.83 in chips) 
Seat 3: conman899 ($39.86 in chips) 
Seat 4: Villa0722 ($11.54 in chips) 
Seat 5: Sideshow022 ($8.59 in chips) 
Seat 6: l3lackhammer ($18.38 in chips) 
conman899: posts small blind $0.05
Villa0722: posts big blind $0.10
*** HOLE CARDS ***
Dealt to CashMatteo [7c 2c]
Sideshow022: calls $0.10
l3lackhammer: folds 
dashmamad: folds 
CashMatteo: folds 
conman899: folds 
Villa0722: checks 
*** FLOP *** [6c 5d 5c]
Villa0722: checks 
Sideshow022: checks 
*** TURN *** [6c 5d 5c] [8h]
Villa0722: bets $0.20
Sideshow022: calls $0.20
*** RIVER *** [6c 5d 5c 8h] [Kc]
Villa0722: checks 
Sideshow022: checks 
*** SHOW DOWN ***
Villa0722: shows [8d 2d] (two pair, Eights and Fives)
Sideshow022: mucks hand 
Villa0722 collected $0.62 from pot
*** SUMMARY ***
Total pot $0.65 | Rake $0.03 
Board [6c 5d 5c 8h Kc]
Seat 1: dashmamad folded before Flop (didn't bet)
Seat 2: CashMatteo (button) folded before Flop (didn't bet)
Seat 3: conman899 (small blind) folded before Flop
Seat 4: Villa0722 (big blind) showed [8d 2d] and won ($0.62) with two pair, Eights and Fives
Seat 5: Sideshow022 mucked [Qh Th]
Seat 6: l3lackhammer folded before Flop (didn't bet)

Hand #1228: 

PokerStars Hand #246653641425:  Hold'em No Limit ($0.05/$0.10 CAD) - 2023/10/21 0:43:54 ET
Table 'Scabiosa' 6-max Seat #3 is the button
Seat 1: dashmamad ($7.03 in chips) 
Seat 2: CashMatteo ($34.83 in chips) 
Seat 3: conman899 ($39.81 in chips) 
Seat 4: Villa0722 ($11.86 in chips) 
Seat 5: Sideshow022 ($8.29 in chips) 
Seat 6: l3lackhammer ($18.38 in chips) 
Villa0722: posts small blind $0.05
Sideshow022: posts big blind $0.10
*** HOLE CARDS ***
Dealt to CashMatteo [4d Td]
l3lackhammer has timed out
l3lackhammer: folds 
dashmamad: folds 
CashMatteo: calls $0.10
conman899: folds 
Villa0722: folds 
Sideshow022: checks 
*** FLOP *** [Kd Jh 9h]
Sideshow022: checks 
CashMatteo: bets $0.12
Sideshow022: calls $0.12
*** TURN *** [Kd Jh 9h] [Ac]
Sideshow022: checks 
CashMatteo: checks 
*** RIVER *** [Kd Jh 9h Ac] [6d]
Sideshow022: checks 
CashMatteo: checks 
*** SHOW DOWN ***
Sideshow022: shows [7h Qs] (high card Ace)
CashMatteo: mucks hand 
Sideshow022 collected $0.47 from pot
*** SUMMARY ***
Total pot $0.49 | Rake $0.02 
Board [Kd Jh 9h Ac 6d]
Seat 1: dashmamad folded before Flop (didn't bet)
Seat 2: CashMatteo mucked [4d Td]
Seat 3: conman899 (button) folded before Flop (didn't bet)
Seat 4: Villa0722 (small blind) folded before Flop
Seat 5: Sideshow022 (big blind) showed [7h Qs] and won ($0.47) with high card Ace
Seat 6: l3lackhammer folded before Flop (didn't bet)

Hand #1229: 

PokerStars Hand #246653646244:  Hold'em No Limit ($0.05/$0.10 CAD) - 2023/10/21 0:44:33 ET
Table 'Scabiosa' 6-max Seat #4 is the button
Seat 1: dashmamad ($7.03 in chips) 
Seat 2: CashMatteo ($34.61 in chips) 
Seat 3: conman899 ($39.81 in chips) 
Seat 4: Villa0722 ($11.81 in chips) 
Seat 5: Sideshow022 ($8.54 in chips) 
Seat 6: l3lackhammer ($18.38 in chips) 
Sideshow022: posts small blind $0.05
l3lackhammer: posts big blind $0.10
*** HOLE CARDS ***
Dealt to CashMatteo [7h 8s]
dashmamad: folds 
CashMatteo: folds 
conman899: folds 
Villa0722: raises $0.10 to $0.20
Sideshow022: folds 
l3lackhammer: folds 
Uncalled bet ($0.10) returned to Villa0722
Villa0722 collected $0.25 from pot
Villa0722: doesn't show hand 
*** SUMMARY ***
Total pot $0.25 | Rake $0 
Seat 1: dashmamad folded before Flop (didn't bet)
Seat 2: CashMatteo folded before Flop (didn't bet)
Seat 3: conman899 folded before Flop (didn't bet)
Seat 4: Villa0722 (button) collected ($0.25)
Seat 5: Sideshow022 (small blind) folded before Flop
Seat 6: l3lackhammer (big blind) folded before Flop

Hand #1230: 

PokerStars Hand #246653647753:  Hold'em No Limit ($0.05/$0.10 CAD) - 2023/10/21 0:44:45 ET
Table 'Scabiosa' 6-max Seat #5 is the button
Seat 1: dashmamad ($7.03 in chips) 
Seat 2: CashMatteo ($34.61 in chips) 
Seat 3: conman899 ($39.81 in chips) 
Seat 4: Villa0722 ($11.96 in chips) 
Seat 5: Sideshow022 ($8.49 in chips) 
Seat 6: l3lackhammer ($18.28 in chips) 
l3lackhammer: posts small blind $0.05
dashmamad: posts big blind $0.10
*** HOLE CARDS ***
Dealt to CashMatteo [Qc 9h]
CashMatteo: calls $0.10
conman899: calls $0.10
Villa0722: folds 
Sideshow022: folds 
l3lackhammer: folds 
dashmamad: checks 
*** FLOP *** [9d Th 5s]
dashmamad: checks 
CashMatteo: checks 
conman899: checks 
*** TURN *** [9d Th 5s] [5d]
dashmamad: bets $0.30
CashMatteo: calls $0.30
conman899: folds 
*** RIVER *** [9d Th 5s 5d] [Td]
dashmamad: checks 
CashMatteo: checks 
*** SHOW DOWN ***
dashmamad: shows [Kh Jd] (two pair, Tens and Fives)
CashMatteo: shows [Qc 9h] (two pair, Tens and Nines)
CashMatteo collected $0.91 from pot
*** SUMMARY ***
Total pot $0.95 | Rake $0.04 
Board [9d Th 5s 5d Td]
Seat 1: dashmamad (big blind) showed [Kh Jd] and lost with two pair, Tens and Fives
Seat 2: CashMatteo showed [Qc 9h] and won ($0.91) with two pair, Tens and Nines
Seat 3: conman899 folded on the Turn
Seat 4: Villa0722 folded before Flop (didn't bet)
Seat 5: Sideshow022 (button) folded before Flop (didn't bet)
Seat 6: l3lackhammer (small blind) folded before Flop

Hand #1231: 

PokerStars Hand #246653652791:  Hold'em No Limit ($0.05/$0.10 CAD) - 2023/10/21 0:45:26 ET
Table 'Scabiosa' 6-max Seat #6 is the button
Seat 1: dashmamad ($6.63 in chips) 
Seat 2: CashMatteo ($35.12 in chips) 
Seat 3: conman899 ($39.71 in chips) 
Seat 4: Villa0722 ($11.96 in chips) 
Seat 5: Sideshow022 ($8.49 in chips) 
Seat 6: l3lackhammer ($18.23 in chips) 
dashmamad: posts small blind $0.05
CashMatteo: posts big blind $0.10
*** HOLE CARDS ***
Dealt to CashMatteo [Kc 6d]
conman899: raises $0.25 to $0.35
Villa0722: raises $0.65 to $1
Sideshow022: folds 
l3lackhammer: folds 
dashmamad: folds 
CashMatteo: folds 
conman899: calls $0.65
*** FLOP *** [7s 4h Ks]
dashmamad leaves the table
conman899: checks 
Villa0722: bets $0.62
conman899: calls $0.62
*** TURN *** [7s 4h Ks] [Th]
conman899: bets $1.62
Villa0722: folds 
Uncalled bet ($1.62) returned to conman899
conman899 collected $3.24 from pot
*** SUMMARY ***
Total pot $3.39 | Rake $0.15 
Board [7s 4h Ks Th]
Seat 1: dashmamad (small blind) folded before Flop
Seat 2: CashMatteo (big blind) folded before Flop
Seat 3: conman899 collected ($3.24)
Seat 4: Villa0722 folded on the Turn
Seat 5: Sideshow022 folded before Flop (didn't bet)
Seat 6: l3lackhammer (button) folded before Flop (didn't bet)

Hand #1232: 

PokerStars Hand #246653658955:  Hold'em No Limit ($0.05/$0.10 CAD) - 2023/10/21 0:46:16 ET
Table 'Scabiosa' 6-max Seat #2 is the button
Seat 2: CashMatteo ($35.02 in chips) 
Seat 3: conman899 ($41.33 in chips) 
Seat 4: Villa0722 ($10.34 in chips) 
Seat 5: Sideshow022 ($8.49 in chips) 
Seat 6: l3lackhammer ($18.23 in chips) 
conman899: posts small blind $0.05
Villa0722: posts big blind $0.10
*** HOLE CARDS ***
Dealt to CashMatteo [3h 2c]
Sideshow022: raises $0.25 to $0.35
l3lackhammer: folds 
CashMatteo: folds 
conman899: folds 
Villa0722: folds 
Uncalled bet ($0.25) returned to Sideshow022
Sideshow022 collected $0.25 from pot
*** SUMMARY ***
Total pot $0.25 | Rake $0 
Seat 2: CashMatteo (button) folded before Flop (didn't bet)
Seat 3: conman899 (small blind) folded before Flop
Seat 4: Villa0722 (big blind) folded before Flop
Seat 5: Sideshow022 collected ($0.25)
Seat 6: l3lackhammer folded before Flop (didn't bet)

Hand #1233: 

PokerStars Hand #246653661349:  Hold'em No Limit ($0.05/$0.10 CAD) - 2023/10/21 0:46:35 ET
Table 'Scabiosa' 6-max Seat #3 is the button
Seat 2: CashMatteo ($35.02 in chips) 
Seat 3: conman899 ($41.28 in chips) 
Seat 4: Villa0722 ($10.24 in chips) 
Seat 5: Sideshow022 ($8.64 in chips) 
Seat 6: l3lackhammer ($18.23 in chips) 
Villa0722: posts small blind $0.05
Sideshow022: posts big blind $0.10
*** HOLE CARDS ***
Dealt to CashMatteo [Ac Qs]
l3lackhammer: folds 
CashMatteo: raises $0.15 to $0.25
conman899: folds 
Villa0722: folds 
Sideshow022: calls $0.15
*** FLOP *** [3d 8h 2h]
Sideshow022: checks 
CashMatteo: checks 
*** TURN *** [3d 8h 2h] [7d]
Sideshow022: checks 
CashMatteo: checks 
*** RIVER *** [3d 8h 2h 7d] [Qc]
Sideshow022: checks 
CashMatteo: bets $0.27
Sideshow022: folds 
Uncalled bet ($0.27) returned to CashMatteo
CashMatteo collected $0.53 from pot
CashMatteo: doesn't show hand 
*** SUMMARY ***
Total pot $0.55 | Rake $0.02 
Board [3d 8h 2h 7d Qc]
Seat 2: CashMatteo collected ($0.53)
Seat 3: conman899 (button) folded before Flop (didn't bet)
Seat 4: Villa0722 (small blind) folded before Flop
Seat 5: Sideshow022 (big blind) folded on the River
Seat 6: l3lackhammer folded before Flop (didn't bet)

Hand #1234: 

PokerStars Hand #246653665833:  Hold'em No Limit ($0.05/$0.10 CAD) - 2023/10/21 0:47:12 ET
Table 'Scabiosa' 6-max Seat #4 is the button
Seat 2: CashMatteo ($35.30 in chips) 
Seat 3: conman899 ($41.28 in chips) 
Seat 4: Villa0722 ($10.19 in chips) 
Seat 5: Sideshow022 ($8.39 in chips) 
Seat 6: l3lackhammer ($18.23 in chips) 
Sideshow022: posts small blind $0.05
l3lackhammer: posts big blind $0.10
*** HOLE CARDS ***
Dealt to CashMatteo [Qs 8d]
CashMatteo: calls $0.10
conman899: raises $0.35 to $0.45
Villa0722: folds 
Sideshow022: calls $0.40
l3lackhammer: folds 
CashMatteo: folds 
*** FLOP *** [4s 5s Qc]
Sideshow022: bets $1.40
conman899: calls $1.40
*** TURN *** [4s 5s Qc] [2d]
Sideshow022: bets $6.54 and is all-in
conman899: folds 
Uncalled bet ($6.54) returned to Sideshow022
kejickv joins the table at seat #1 
Sideshow022 collected $3.72 from pot
*** SUMMARY ***
Total pot $3.90 | Rake $0.18 
Board [4s 5s Qc 2d]
Seat 2: CashMatteo folded before Flop
Seat 3: conman899 folded on the Turn
Seat 4: Villa0722 (button) folded before Flop (didn't bet)
Seat 5: Sideshow022 (small blind) collected ($3.72)
Seat 6: l3lackhammer (big blind) folded before Flop

Hand #1235: 

PokerStars Hand #246653670991:  Hold'em No Limit ($0.05/$0.10 CAD) - 2023/10/21 0:47:55 ET
Table 'Scabiosa' 6-max Seat #5 is the button
Seat 1: kejickv ($9.68 in chips) 
Seat 2: CashMatteo ($35.20 in chips) 
Seat 3: conman899 ($39.43 in chips) 
Seat 4: Villa0722 ($10.19 in chips) 
Seat 5: Sideshow022 ($10.26 in chips) 
Seat 6: l3lackhammer ($18.13 in chips) 
l3lackhammer: posts small blind $0.05
kejickv: posts big blind $0.10
*** HOLE CARDS ***
Dealt to CashMatteo [8c Kh]
CashMatteo: calls $0.10
conman899: raises $0.35 to $0.45
Villa0722: folds 
Sideshow022: folds 
l3lackhammer: folds 
kejickv: folds 
CashMatteo: folds 
Uncalled bet ($0.35) returned to conman899
conman899 collected $0.35 from pot
*** SUMMARY ***
Total pot $0.35 | Rake $0 
Seat 1: kejickv (big blind) folded before Flop
Seat 2: CashMatteo folded before Flop
Seat 3: conman899 collected ($0.35)
Seat 4: Villa0722 folded before Flop (didn't bet)
Seat 5: Sideshow022 (button) folded before Flop (didn't bet)
Seat 6: l3lackhammer (small blind) folded before Flop

Hand #1236: 

PokerStars Hand #246653675382:  Hold'em No Limit ($0.05/$0.10 CAD) - 2023/10/21 0:48:32 ET
Table 'Scabiosa' 6-max Seat #6 is the button
Seat 1: kejickv ($9.58 in chips) 
Seat 2: CashMatteo ($35.10 in chips) 
Seat 3: conman899 ($39.68 in chips) 
Seat 4: Villa0722 ($10.19 in chips) 
Seat 5: Sideshow022 ($10.26 in chips) 
Seat 6: l3lackhammer ($18.08 in chips) 
kejickv: posts small blind $0.05
CashMatteo: posts big blind $0.10
*** HOLE CARDS ***
Dealt to CashMatteo [3h 4s]
conman899: folds 
Villa0722: folds 
Sideshow022: folds 
l3lackhammer: folds 
kejickv: calls $0.05
CashMatteo: checks 
*** FLOP *** [Th 6c 7s]
kejickv: checks 
CashMatteo: checks 
*** TURN *** [Th 6c 7s] [5s]
kejickv: checks 
CashMatteo: checks 
*** RIVER *** [Th 6c 7s 5s] [2s]
kejickv: bets $0.20
CashMatteo: calls $0.20
*** SHOW DOWN ***
kejickv: shows [Ad 2d] (a pair of Deuces)
CashMatteo: shows [3h 4s] (a straight, Three to Seven)
CashMatteo collected $0.57 from pot
*** SUMMARY ***
Total pot $0.60 | Rake $0.03 
Board [Th 6c 7s 5s 2s]
Seat 1: kejickv (small blind) showed [Ad 2d] and lost with a pair of Deuces
Seat 2: CashMatteo (big blind) showed [3h 4s] and won ($0.57) with a straight, Three to Seven
Seat 3: conman899 folded before Flop (didn't bet)
Seat 4: Villa0722 folded before Flop (didn't bet)
Seat 5: Sideshow022 folded before Flop (didn't bet)
Seat 6: l3lackhammer (button) folded before Flop (didn't bet)

Hand #1237: 

PokerStars Hand #246653680151:  Hold'em No Limit ($0.05/$0.10 CAD) - 2023/10/21 0:49:13 ET
Table 'Scabiosa' 6-max Seat #1 is the button
Seat 1: kejickv ($9.28 in chips) 
Seat 2: CashMatteo ($35.37 in chips) 
Seat 3: conman899 ($39.68 in chips) 
Seat 4: Villa0722 ($10.19 in chips) 
Seat 5: Sideshow022 ($10.26 in chips) 
Seat 6: l3lackhammer ($18.08 in chips) 
CashMatteo: posts small blind $0.05
conman899: posts big blind $0.10
*** HOLE CARDS ***
Dealt to CashMatteo [3d 6d]
Villa0722: folds 
Sideshow022: folds 
l3lackhammer: folds 
kejickv: calls $0.10
CashMatteo: calls $0.05
conman899: raises $0.90 to $1
kejickv: folds 
CashMatteo: folds 
Uncalled bet ($0.90) returned to conman899
conman899 collected $0.30 from pot
*** SUMMARY ***
Total pot $0.30 | Rake $0 
Seat 1: kejickv (button) folded before Flop
Seat 2: CashMatteo (small blind) folded before Flop
Seat 3: conman899 (big blind) collected ($0.30)
Seat 4: Villa0722 folded before Flop (didn't bet)
Seat 5: Sideshow022 folded before Flop (didn't bet)
Seat 6: l3lackhammer folded before Flop (didn't bet)

Hand #1238: 

PokerStars Hand #246653685939:  Hold'em No Limit ($0.05/$0.10 CAD) - 2023/10/21 0:50:02 ET
Table 'Scabiosa' 6-max Seat #2 is the button
Seat 1: kejickv ($9.18 in chips) 
Seat 2: CashMatteo ($35.27 in chips) 
Seat 3: conman899 ($39.88 in chips) 
Seat 4: Villa0722 ($10.19 in chips) 
Seat 5: Sideshow022 ($10.26 in chips) 
Seat 6: l3lackhammer ($18.08 in chips) 
conman899: posts small blind $0.05
Villa0722: posts big blind $0.10
*** HOLE CARDS ***
Dealt to CashMatteo [4h Qc]
Sideshow022: calls $0.10
l3lackhammer: folds 
kejickv: folds 
CashMatteo: folds 
conman899: raises $0.30 to $0.40
Villa0722: folds 
Sideshow022: calls $0.30
*** FLOP *** [Jd Td 5d]
conman899: bets $0.86
Sideshow022: calls $0.86
*** TURN *** [Jd Td 5d] [Qd]
conman899: checks 
Sideshow022: checks 
*** RIVER *** [Jd Td 5d Qd] [Qh]
conman899: checks 
Sideshow022: bets $2.50
conman899: folds 
Uncalled bet ($2.50) returned to Sideshow022
Sideshow022 collected $2.50 from pot
*** SUMMARY ***
Total pot $2.62 | Rake $0.12 
Board [Jd Td 5d Qd Qh]
Seat 1: kejickv folded before Flop (didn't bet)
Seat 2: CashMatteo (button) folded before Flop (didn't bet)
Seat 3: conman899 (small blind) folded on the River
Seat 4: Villa0722 (big blind) folded before Flop
Seat 5: Sideshow022 collected ($2.50)
Seat 6: l3lackhammer folded before Flop (didn't bet)

Hand #1239: 

PokerStars Hand #246653692397:  Hold'em No Limit ($0.05/$0.10 CAD) - 2023/10/21 0:50:56 ET
Table 'Scabiosa' 6-max Seat #3 is the button
Seat 1: kejickv ($9.18 in chips) 
Seat 2: CashMatteo ($35.27 in chips) 
Seat 3: conman899 ($38.62 in chips) 
Seat 4: Villa0722 ($10.09 in chips) 
Seat 5: Sideshow022 ($11.50 in chips) 
Seat 6: l3lackhammer ($18.08 in chips) 
Villa0722: posts small blind $0.05
Sideshow022: posts big blind $0.10
*** HOLE CARDS ***
Dealt to CashMatteo [Td Jh]
l3lackhammer: folds 
kejickv: folds 
CashMatteo: calls $0.10
conman899: calls $0.10
Villa0722: raises $0.25 to $0.35
Sideshow022: folds 
CashMatteo: calls $0.25
conman899: calls $0.25
*** FLOP *** [5c Ad 6s]
Villa0722: bets $0.33
CashMatteo: folds 
conman899: folds 
Uncalled bet ($0.33) returned to Villa0722
Villa0722 collected $1.10 from pot
Villa0722: doesn't show hand 
*** SUMMARY ***
Total pot $1.15 | Rake $0.05 
Board [5c Ad 6s]
Seat 1: kejickv folded before Flop (didn't bet)
Seat 2: CashMatteo folded on the Flop
Seat 3: conman899 (button) folded on the Flop
Seat 4: Villa0722 (small blind) collected ($1.10)
Seat 5: Sideshow022 (big blind) folded before Flop
Seat 6: l3lackhammer folded before Flop (didn't bet)

Hand #1240: 

PokerStars Hand #246653696009:  Hold'em No Limit ($0.05/$0.10 CAD) - 2023/10/21 0:51:27 ET
Table 'Scabiosa' 6-max Seat #4 is the button
Seat 1: kejickv ($9.18 in chips) 
Seat 2: CashMatteo ($34.92 in chips) 
Seat 3: conman899 ($38.27 in chips) 
Seat 4: Villa0722 ($10.84 in chips) 
Seat 5: Sideshow022 ($11.40 in chips) 
Seat 6: l3lackhammer ($18.08 in chips) 
Sideshow022: posts small blind $0.05
l3lackhammer: posts big blind $0.10
*** HOLE CARDS ***
Dealt to CashMatteo [2d 4s]
kejickv: folds 
CashMatteo: folds 
conman899: folds 
Villa0722: folds 
Sideshow022: calls $0.05
l3lackhammer: checks 
*** FLOP *** [Ts 8h Js]
Sideshow022: checks 
l3lackhammer: checks 
*** TURN *** [Ts 8h Js] [5h]
Sideshow022: checks 
l3lackhammer: bets $0.20
Sideshow022: folds 
Uncalled bet ($0.20) returned to l3lackhammer
l3lackhammer collected $0.19 from pot
l3lackhammer: doesn't show hand 
*** SUMMARY ***
Total pot $0.20 | Rake $0.01 
Board [Ts 8h Js 5h]
Seat 1: kejickv folded before Flop (didn't bet)
Seat 2: CashMatteo folded before Flop (didn't bet)
Seat 3: conman899 folded before Flop (didn't bet)
Seat 4: Villa0722 (button) folded before Flop (didn't bet)
Seat 5: Sideshow022 (small blind) folded on the Turn
Seat 6: l3lackhammer (big blind) collected ($0.19)

Hand #1241: 

PokerStars Hand #246653700860:  Hold'em No Limit ($0.05/$0.10 CAD) - 2023/10/21 0:52:07 ET
Table 'Scabiosa' 6-max Seat #5 is the button
Seat 1: kejickv ($9.18 in chips) 
Seat 2: CashMatteo ($34.92 in chips) 
Seat 3: conman899 ($38.27 in chips) 
Seat 4: Villa0722 ($10.84 in chips) 
Seat 5: Sideshow022 ($11.30 in chips) 
Seat 6: l3lackhammer ($18.17 in chips) 
l3lackhammer: posts small blind $0.05
kejickv: posts big blind $0.10
*** HOLE CARDS ***
Dealt to CashMatteo [3s Kc]
CashMatteo: folds 
conman899: folds 
Villa0722: folds 
Sideshow022: calls $0.10
l3lackhammer: folds 
kejickv: checks 
*** FLOP *** [Tc Jh Ah]
kejickv: checks 
Sideshow022: checks 
*** TURN *** [Tc Jh Ah] [2s]
kejickv: checks 
Sideshow022: checks 
*** RIVER *** [Tc Jh Ah 2s] [Qs]
kejickv: bets $0.24
Sideshow022: folds 
Uncalled bet ($0.24) returned to kejickv
kejickv collected $0.24 from pot
kejickv: doesn't show hand 
*** SUMMARY ***
Total pot $0.25 | Rake $0.01 
Board [Tc Jh Ah 2s Qs]
Seat 1: kejickv (big blind) collected ($0.24)
Seat 2: CashMatteo folded before Flop (didn't bet)
Seat 3: conman899 folded before Flop (didn't bet)
Seat 4: Villa0722 folded before Flop (didn't bet)
Seat 5: Sideshow022 (button) folded on the River
Seat 6: l3lackhammer (small blind) folded before Flop

Hand #1242: 

PokerStars Hand #246653708528:  Hold'em No Limit ($0.05/$0.10 CAD) - 2023/10/21 0:53:13 ET
Table 'Scabiosa' 6-max Seat #6 is the button
Seat 1: kejickv ($9.32 in chips) 
Seat 2: CashMatteo ($34.92 in chips) 
Seat 3: conman899 ($38.27 in chips) 
Seat 4: Villa0722 ($10.84 in chips) 
Seat 5: Sideshow022 ($11.20 in chips) 
Seat 6: l3lackhammer ($18.12 in chips) 
kejickv: posts small blind $0.05
CashMatteo: posts big blind $0.10
*** HOLE CARDS ***
Dealt to CashMatteo [6s Qs]
conman899: raises $0.10 to $0.20
Villa0722: folds 
Sideshow022: folds 
l3lackhammer: folds 
kejickv: folds 
CashMatteo: calls $0.10
*** FLOP *** [7c As Ac]
CashMatteo: checks 
conman899: bets $0.10
CashMatteo: folds 
Uncalled bet ($0.10) returned to conman899
conman899 collected $0.43 from pot
*** SUMMARY ***
Total pot $0.45 | Rake $0.02 
Board [7c As Ac]
Seat 1: kejickv (small blind) folded before Flop
Seat 2: CashMatteo (big blind) folded on the Flop
Seat 3: conman899 collected ($0.43)
Seat 4: Villa0722 folded before Flop (didn't bet)
Seat 5: Sideshow022 folded before Flop (didn't bet)
Seat 6: l3lackhammer (button) folded before Flop (didn't bet)

Hand #1243: 

PokerStars Hand #246653712044:  Hold'em No Limit ($0.05/$0.10 CAD) - 2023/10/21 0:53:43 ET
Table 'Scabiosa' 6-max Seat #1 is the button
Seat 1: kejickv ($9.27 in chips) 
Seat 2: CashMatteo ($34.72 in chips) 
Seat 3: conman899 ($38.50 in chips) 
Seat 4: Villa0722 ($10.84 in chips) 
Seat 5: Sideshow022 ($11.20 in chips) 
Seat 6: l3lackhammer ($18.12 in chips) 
CashMatteo: posts small blind $0.05
conman899: posts big blind $0.10
*** HOLE CARDS ***
Dealt to CashMatteo [Ah Td]
Villa0722: raises $0.10 to $0.20
Sideshow022: folds 
l3lackhammer: folds 
kejickv: calls $0.20
CashMatteo: calls $0.15
conman899: folds 
*** FLOP *** [7c 3s 5h]
CashMatteo: checks 
Villa0722: checks 
kejickv: bets $0.67
CashMatteo: folds 
Villa0722: folds 
Uncalled bet ($0.67) returned to kejickv
kejickv collected $0.67 from pot
kejickv: doesn't show hand 
*** SUMMARY ***
Total pot $0.70 | Rake $0.03 
Board [7c 3s 5h]
Seat 1: kejickv (button) collected ($0.67)
Seat 2: CashMatteo (small blind) folded on the Flop
Seat 3: conman899 (big blind) folded before Flop
Seat 4: Villa0722 folded on the Flop
Seat 5: Sideshow022 folded before Flop (didn't bet)
Seat 6: l3lackhammer folded before Flop (didn't bet)

Hand #1244: 

PokerStars Hand #246653717900:  Hold'em No Limit ($0.05/$0.10 CAD) - 2023/10/21 0:54:34 ET
Table 'Scabiosa' 6-max Seat #2 is the button
Seat 1: kejickv ($9.74 in chips) 
Seat 2: CashMatteo ($34.52 in chips) 
Seat 3: conman899 ($38.40 in chips) 
Seat 4: Villa0722 ($10.64 in chips) 
Seat 5: Sideshow022 ($11.20 in chips) 
Seat 6: l3lackhammer ($18.12 in chips) 
conman899: posts small blind $0.05
Villa0722: posts big blind $0.10
*** HOLE CARDS ***
Dealt to CashMatteo [Qh Ts]
Sideshow022: folds 
l3lackhammer: folds 
kejickv: folds 
CashMatteo: calls $0.10
conman899: folds 
Villa0722: checks 
*** FLOP *** [9s Ac Kc]
Villa0722: bets $0.12
CashMatteo: calls $0.12
*** TURN *** [9s Ac Kc] [6s]
Villa0722: bets $0.14
CashMatteo: calls $0.14
*** RIVER *** [9s Ac Kc 6s] [As]
Villa0722: bets $0.37
CashMatteo: folds 
Uncalled bet ($0.37) returned to Villa0722
Villa0722 collected $0.74 from pot
Villa0722: doesn't show hand 
*** SUMMARY ***
Total pot $0.77 | Rake $0.03 
Board [9s Ac Kc 6s As]
Seat 1: kejickv folded before Flop (didn't bet)
Seat 2: CashMatteo (button) folded on the River
Seat 3: conman899 (small blind) folded before Flop
Seat 4: Villa0722 (big blind) collected ($0.74)
Seat 5: Sideshow022 folded before Flop (didn't bet)
Seat 6: l3lackhammer folded before Flop (didn't bet)

Hand #1245: 

PokerStars Hand #246653723624:  Hold'em No Limit ($0.05/$0.10 CAD) - 2023/10/21 0:55:25 ET
Table 'Scabiosa' 6-max Seat #3 is the button
Seat 1: kejickv ($9.74 in chips) 
Seat 2: CashMatteo ($34.16 in chips) 
Seat 3: conman899 ($38.35 in chips) 
Seat 4: Villa0722 ($11.02 in chips) 
Seat 5: Sideshow022 ($11.20 in chips) 
Seat 6: l3lackhammer ($18.12 in chips) 
Villa0722: posts small blind $0.05
Sideshow022: posts big blind $0.10
*** HOLE CARDS ***
Dealt to CashMatteo [3d 5c]
l3lackhammer: folds 
kejickv: folds 
CashMatteo: folds 
conman899: raises $0.25 to $0.35
Villa0722: folds 
Sideshow022: folds 
Uncalled bet ($0.25) returned to conman899
conman899 collected $0.25 from pot
*** SUMMARY ***
Total pot $0.25 | Rake $0 
Seat 1: kejickv folded before Flop (didn't bet)
Seat 2: CashMatteo folded before Flop (didn't bet)
Seat 3: conman899 (button) collected ($0.25)
Seat 4: Villa0722 (small blind) folded before Flop
Seat 5: Sideshow022 (big blind) folded before Flop
Seat 6: l3lackhammer folded before Flop (didn't bet)

Hand #1246: 

PokerStars Hand #246653727060:  Hold'em No Limit ($0.05/$0.10 CAD) - 2023/10/21 0:55:59 ET
Table 'Scabiosa' 6-max Seat #4 is the button
Seat 1: kejickv ($9.74 in chips) 
Seat 2: CashMatteo ($34.16 in chips) 
Seat 3: conman899 ($38.50 in chips) 
Seat 4: Villa0722 ($10.97 in chips) 
Seat 5: Sideshow022 ($11.10 in chips) 
Seat 6: l3lackhammer ($18.12 in chips) 
Sideshow022: posts small blind $0.05
l3lackhammer: posts big blind $0.10
*** HOLE CARDS ***
Dealt to CashMatteo [6c 2c]
kejickv: raises $0.45 to $0.55
CashMatteo: folds 
conman899: folds 
Villa0722: folds 
Sideshow022: folds 
l3lackhammer: folds 
Uncalled bet ($0.45) returned to kejickv
kejickv collected $0.25 from pot
kejickv: doesn't show hand 
*** SUMMARY ***
Total pot $0.25 | Rake $0 
Seat 1: kejickv collected ($0.25)
Seat 2: CashMatteo folded before Flop (didn't bet)
Seat 3: conman899 folded before Flop (didn't bet)
Seat 4: Villa0722 (button) folded before Flop (didn't bet)
Seat 5: Sideshow022 (small blind) folded before Flop
Seat 6: l3lackhammer (big blind) folded before Flop

Hand #1247: 

PokerStars Hand #246653728532:  Hold'em No Limit ($0.05/$0.10 CAD) - 2023/10/21 0:56:14 ET
Table 'Scabiosa' 6-max Seat #5 is the button
Seat 1: kejickv ($9.89 in chips) 
Seat 2: CashMatteo ($34.16 in chips) 
Seat 3: conman899 ($38.50 in chips) 
Seat 4: Villa0722 ($10.97 in chips) 
Seat 5: Sideshow022 ($11.05 in chips) 
Seat 6: l3lackhammer ($18.02 in chips) 
l3lackhammer: posts small blind $0.05
kejickv: posts big blind $0.10
*** HOLE CARDS ***
Dealt to CashMatteo [2h 3c]
CashMatteo: folds 
conman899: raises $0.55 to $0.65
Villa0722: folds 
Sideshow022: folds 
l3lackhammer: folds 
kejickv: calls $0.55
*** FLOP *** [8s Jd 8c]
kejickv: checks 
conman899: checks 
*** TURN *** [8s Jd 8c] [2c]
kejickv: bets $1.29
conman899: folds 
Uncalled bet ($1.29) returned to kejickv
kejickv collected $1.29 from pot
kejickv: doesn't show hand 
*** SUMMARY ***
Total pot $1.35 | Rake $0.06 
Board [8s Jd 8c 2c]
Seat 1: kejickv (big blind) collected ($1.29)
Seat 2: CashMatteo folded before Flop (didn't bet)
Seat 3: conman899 folded on the Turn
Seat 4: Villa0722 folded before Flop (didn't bet)
Seat 5: Sideshow022 (button) folded before Flop (didn't bet)
Seat 6: l3lackhammer (small blind) folded before Flop

Hand #1248: 

PokerStars Hand #246653732692:  Hold'em No Limit ($0.05/$0.10 CAD) - 2023/10/21 0:56:55 ET
Table 'Scabiosa' 6-max Seat #6 is the button
Seat 1: kejickv ($10.53 in chips) 
Seat 2: CashMatteo ($34.16 in chips) 
Seat 3: conman899 ($37.85 in chips) 
Seat 4: Villa0722 ($10.97 in chips) 
Seat 5: Sideshow022 ($11.05 in chips) 
Seat 6: l3lackhammer ($17.97 in chips) 
kejickv: posts small blind $0.05
CashMatteo: posts big blind $0.10
*** HOLE CARDS ***
Dealt to CashMatteo [2c Ah]
conman899: raises $0.10 to $0.20
Villa0722: calls $0.20
Sideshow022: folds 
l3lackhammer: folds 
kejickv: calls $0.15
CashMatteo: calls $0.10
*** FLOP *** [3h 3d 7h]
kejickv: checks 
CashMatteo: checks 
conman899: checks 
Villa0722: checks 
*** TURN *** [3h 3d 7h] [Kh]
kejickv: checks 
CashMatteo: checks 
conman899: bets $0.76
Villa0722: folds 
kejickv: folds 
CashMatteo: calls $0.76
*** RIVER *** [3h 3d 7h Kh] [6h]
CashMatteo: checks 
conman899: checks 
*** SHOW DOWN ***
CashMatteo: shows [2c Ah] (a flush, Ace high)
conman899: mucks hand 
CashMatteo collected $2.22 from pot
*** SUMMARY ***
Total pot $2.32 | Rake $0.10 
Board [3h 3d 7h Kh 6h]
Seat 1: kejickv (small blind) folded on the Turn
Seat 2: CashMatteo (big blind) showed [2c Ah] and won ($2.22) with a flush, Ace high
Seat 3: conman899 mucked [2d 8d]
Seat 4: Villa0722 folded on the Turn
Seat 5: Sideshow022 folded before Flop (didn't bet)
Seat 6: l3lackhammer (button) folded before Flop (didn't bet)

Hand #1249: 

PokerStars Hand #246653738494:  Hold'em No Limit ($0.05/$0.10 CAD) - 2023/10/21 0:57:53 ET
Table 'Scabiosa' 6-max Seat #1 is the button
Seat 1: kejickv ($10.33 in chips) 
Seat 2: CashMatteo ($35.42 in chips) 
Seat 3: conman899 ($36.89 in chips) 
Seat 4: Villa0722 ($10.77 in chips) 
Seat 5: Sideshow022 ($11.05 in chips) 
Seat 6: l3lackhammer ($17.97 in chips) 
CashMatteo: posts small blind $0.05
conman899: posts big blind $0.10
*** HOLE CARDS ***
Dealt to CashMatteo [Ah 2h]
Villa0722 has timed out
Villa0722: folds 
Sideshow022: folds 
l3lackhammer: folds 
kejickv: raises $0.25 to $0.35
CashMatteo: calls $0.30
conman899: folds 
*** FLOP *** [4s 2d 5s]
CashMatteo: checks 
kejickv: bets $0.76
CashMatteo: calls $0.76
*** TURN *** [4s 2d 5s] [As]
CashMatteo: bets $1.11
kejickv: folds 
Uncalled bet ($1.11) returned to CashMatteo
CashMatteo collected $2.22 from pot
CashMatteo: doesn't show hand 
*** SUMMARY ***
Total pot $2.32 | Rake $0.10 
Board [4s 2d 5s As]
Seat 1: kejickv (button) folded on the Turn
Seat 2: CashMatteo (small blind) collected ($2.22)
Seat 3: conman899 (big blind) folded before Flop
Seat 4: Villa0722 folded before Flop (didn't bet)
Seat 5: Sideshow022 folded before Flop (didn't bet)
Seat 6: l3lackhammer folded before Flop (didn't bet)

Hand #1250: 

PokerStars Hand #246653743360:  Hold'em No Limit ($0.05/$0.10 CAD) - 2023/10/21 0:58:42 ET
Table 'Scabiosa' 6-max Seat #2 is the button
Seat 1: kejickv ($9.22 in chips) 
Seat 2: CashMatteo ($36.53 in chips) 
Seat 3: conman899 ($36.79 in chips) 
Seat 4: Villa0722 ($10.77 in chips) 
Seat 5: Sideshow022 ($11.05 in chips) 
Seat 6: l3lackhammer ($17.97 in chips) 
conman899: posts small blind $0.05
Villa0722: posts big blind $0.10
*** HOLE CARDS ***
Dealt to CashMatteo [3s Ah]
Sideshow022: folds 
l3lackhammer: folds 
kejickv: folds 
CashMatteo: calls $0.10
conman899: folds 
Villa0722: checks 
*** FLOP *** [Jh 2h Jd]
Villa0722: checks 
CashMatteo: checks 
*** TURN *** [Jh 2h Jd] [3d]
Villa0722: checks 
CashMatteo: checks 
*** RIVER *** [Jh 2h Jd 3d] [4c]
Villa0722: checks 
CashMatteo: checks 
*** SHOW DOWN ***
Villa0722: shows [9s 5d] (a pair of Jacks)
CashMatteo: shows [3s Ah] (two pair, Jacks and Threes)
CashMatteo collected $0.24 from pot
*** SUMMARY ***
Total pot $0.25 | Rake $0.01 
Board [Jh 2h Jd 3d 4c]
Seat 1: kejickv folded before Flop (didn't bet)
Seat 2: CashMatteo (button) showed [3s Ah] and won ($0.24) with two pair, Jacks and Threes
Seat 3: conman899 (small blind) folded before Flop
Seat 4: Villa0722 (big blind) showed [9s 5d] and lost with a pair of Jacks
Seat 5: Sideshow022 folded before Flop (didn't bet)
Seat 6: l3lackhammer folded before Flop (didn't bet)

Hand #1251: 

PokerStars Hand #246653747663:  Hold'em No Limit ($0.05/$0.10 CAD) - 2023/10/21 0:59:24 ET
Table 'Scabiosa' 6-max Seat #3 is the button
Seat 1: kejickv ($9.22 in chips) 
Seat 2: CashMatteo ($36.67 in chips) 
Seat 3: conman899 ($36.74 in chips) 
Seat 4: Villa0722 ($10.67 in chips) 
Seat 5: Sideshow022 ($11.05 in chips) 
Seat 6: l3lackhammer ($17.97 in chips) 
Villa0722: posts small blind $0.05
Sideshow022: posts big blind $0.10
*** HOLE CARDS ***
Dealt to CashMatteo [4d Qc]
l3lackhammer: folds 
kejickv: folds 
CashMatteo: calls $0.10
conman899: calls $0.10
Villa0722: folds 
Sideshow022: checks 
*** FLOP *** [Kd Ks 7s]
Sideshow022: checks 
CashMatteo: checks 
conman899: checks 
*** TURN *** [Kd Ks 7s] [5s]
Sideshow022: bets $0.33
CashMatteo: folds 
conman899: calls $0.33
*** RIVER *** [Kd Ks 7s 5s] [Td]
Sideshow022: bets $0.96
conman899: folds 
Uncalled bet ($0.96) returned to Sideshow022
Sideshow022 collected $0.96 from pot
*** SUMMARY ***
Total pot $1.01 | Rake $0.05 
Board [Kd Ks 7s 5s Td]
Seat 1: kejickv folded before Flop (didn't bet)
Seat 2: CashMatteo folded on the Turn
Seat 3: conman899 (button) folded on the River
Seat 4: Villa0722 (small blind) folded before Flop
Seat 5: Sideshow022 (big blind) collected ($0.96)
Seat 6: l3lackhammer folded before Flop (didn't bet)

Hand #1252: 

PokerStars Hand #246653751564:  Hold'em No Limit ($0.05/$0.10 CAD) - 2023/10/21 1:00:04 ET
Table 'Scabiosa' 6-max Seat #4 is the button
Seat 1: kejickv ($9.22 in chips) 
Seat 2: CashMatteo ($36.57 in chips) 
Seat 3: conman899 ($36.31 in chips) 
Seat 4: Villa0722 ($10.62 in chips) 
Seat 5: Sideshow022 ($11.58 in chips) 
Seat 6: l3lackhammer ($17.97 in chips) 
Sideshow022: posts small blind $0.05
l3lackhammer: posts big blind $0.10
*** HOLE CARDS ***
Dealt to CashMatteo [5c 4c]
kejickv: raises $0.20 to $0.30
CashMatteo: calls $0.30
conman899: raises $1.05 to $1.35
Villa0722: folds 
Sideshow022: folds 
l3lackhammer: folds 
kejickv: calls $1.05
CashMatteo: folds 
*** FLOP *** [3d 9d 2d]
kejickv: checks 
conman899: bets $34.96 and is all-in
kejickv: folds 
Uncalled bet ($34.96) returned to conman899
conman899 collected $3.01 from pot
*** SUMMARY ***
Total pot $3.15 | Rake $0.14 
Board [3d 9d 2d]
Seat 1: kejickv folded on the Flop
Seat 2: CashMatteo folded before Flop
Seat 3: conman899 collected ($3.01)
Seat 4: Villa0722 (button) folded before Flop (didn't bet)
Seat 5: Sideshow022 (small blind) folded before Flop
Seat 6: l3lackhammer (big blind) folded before Flop

Hand #1253: 

PokerStars Hand #246653759530:  Hold'em No Limit ($0.05/$0.10 CAD) - 2023/10/21 1:01:18 ET
Table 'Scabiosa' 6-max Seat #5 is the button
Seat 1: kejickv ($7.87 in chips) 
Seat 2: CashMatteo ($36.27 in chips) 
Seat 3: conman899 ($37.97 in chips) 
Seat 4: Villa0722 ($10.62 in chips) 
Seat 5: Sideshow022 ($11.53 in chips) 
Seat 6: l3lackhammer ($17.87 in chips) 
l3lackhammer: posts small blind $0.05
kejickv: posts big blind $0.10
*** HOLE CARDS ***
Dealt to CashMatteo [9s 8c]
CashMatteo: folds 
conman899: folds 
CashMatteo leaves the table
Villa0722: folds 
Sideshow022: folds 
l3lackhammer: raises $0.10 to $0.20
kejickv: raises $0.10 to $0.30
l3lackhammer: calls $0.10
*** FLOP *** [7d 3d 5s]
l3lackhammer: checks 
kejickv: bets $0.29
l3lackhammer: calls $0.29
*** TURN *** [7d 3d 5s] [As]
l3lackhammer: checks 
kejickv: bets $0.40
l3lackhammer: calls $0.40
*** RIVER *** [7d 3d 5s As] [4d]
l3lackhammer: checks 
kejickv: checks 
*** SHOW DOWN ***
l3lackhammer: shows [Ac 6c] (a straight, Three to Seven)
kejickv: mucks hand 
l3lackhammer collected $1.89 from pot
*** SUMMARY ***
Total pot $1.98 | Rake $0.09 
Board [7d 3d 5s As 4d]
Seat 1: kejickv (big blind) mucked [Jc Kd]
Seat 2: CashMatteo folded before Flop (didn't bet)
Seat 3: conman899 folded before Flop (didn't bet)
Seat 4: Villa0722 folded before Flop (didn't bet)
Seat 5: Sideshow022 (button) folded before Flop (didn't bet)
Seat 6: l3lackhammer (small blind) showed [Ac 6c] and won ($1.89) with a straight, Three to Seven

Hand #1254: 

PokerStars Hand #246654902505: Tournament #3661861019, Freeroll  Hold'em No Limit - Level I (10/20) - 2023/10/21 2:39:06 ET
Table '3661861019 1' 3-max Seat #1 is the button
Seat 1: NicholasW106 (500 in chips) 
Seat 2: Math MiB (500 in chips) 
Seat 3: CashMatteo (500 in chips) 
Math MiB: posts small blind 10
CashMatteo: posts big blind 20
*** HOLE CARDS ***
Dealt to CashMatteo [Qh 9d]
NicholasW106: calls 20
Math MiB: calls 10
CashMatteo: checks 
*** FLOP *** [Kd Ah 4c]
Math MiB: checks 
CashMatteo: bets 30
NicholasW106: folds 
Math MiB: calls 30
*** TURN *** [Kd Ah 4c] [2d]
Math MiB: checks 
CashMatteo: checks 
*** RIVER *** [Kd Ah 4c 2d] [2s]
Math MiB: checks 
CashMatteo: checks 
*** SHOW DOWN ***
Math MiB: shows [7d 4h] (two pair, Fours and Deuces)
CashMatteo: mucks hand 
Math MiB collected 120 from pot
*** SUMMARY ***
Total pot 120 | Rake 0 
Board [Kd Ah 4c 2d 2s]
Seat 1: NicholasW106 (button) folded on the Flop
Seat 2: Math MiB (small blind) showed [7d 4h] and won (120) with two pair, Fours and Deuces
Seat 3: CashMatteo (big blind) mucked [Qh 9d]

Hand #1255: 

PokerStars Hand #246654903302: Tournament #3661861047, Freeroll  Hold'em No Limit - Level I (10/20) - 2023/10/21 2:39:13 ET
Table '3661861047 1' 3-max Seat #1 is the button
Seat 1: 1982ref (500 in chips) 
Seat 2: fan2b (500 in chips) 
Seat 3: CashMatteo (500 in chips) 
fan2b: posts small blind 10
CashMatteo: posts big blind 20
*** HOLE CARDS ***
Dealt to CashMatteo [9c 4s]
1982ref: calls 20
fan2b: calls 10
CashMatteo: checks 
*** FLOP *** [Ad 7s 5s]
fan2b: checks 
CashMatteo: checks 
1982ref: bets 20
fan2b: folds 
CashMatteo: folds 
Uncalled bet (20) returned to 1982ref
1982ref collected 60 from pot
*** SUMMARY ***
Total pot 60 | Rake 0 
Board [Ad 7s 5s]
Seat 1: 1982ref (button) collected (60)
Seat 2: fan2b (small blind) folded on the Flop
Seat 3: CashMatteo (big blind) folded on the Flop

Hand #1256: 

PokerStars Hand #246654905058: Tournament #3661861047, Freeroll  Hold'em No Limit - Level I (10/20) - 2023/10/21 2:39:29 ET
Table '3661861047 1' 3-max Seat #2 is the button
Seat 1: 1982ref (540 in chips) 
Seat 2: fan2b (480 in chips) 
Seat 3: CashMatteo (480 in chips) 
CashMatteo: posts small blind 10
1982ref: posts big blind 20
*** HOLE CARDS ***
Dealt to CashMatteo [6c 5d]
fan2b: calls 20
CashMatteo: folds 
1982ref: checks 
*** FLOP *** [2d 4s 5h]
1982ref: bets 20
fan2b: calls 20
*** TURN *** [2d 4s 5h] [7h]
1982ref: checks 
fan2b: bets 20
1982ref: calls 20
*** RIVER *** [2d 4s 5h 7h] [Jh]
1982ref: checks 
fan2b: checks 
*** SHOW DOWN ***
1982ref: shows [2s 3h] (a pair of Deuces)
fan2b: mucks hand 
1982ref collected 130 from pot
*** SUMMARY ***
Total pot 130 | Rake 0 
Board [2d 4s 5h 7h Jh]
Seat 1: 1982ref (big blind) showed [2s 3h] and won (130) with a pair of Deuces
Seat 2: fan2b (button) mucked [Tc 6d]
Seat 3: CashMatteo (small blind) folded before Flop

Hand #1257: 

PokerStars Hand #246654906128: Tournament #3661861019, Freeroll  Hold'em No Limit - Level I (10/20) - 2023/10/21 2:39:39 ET
Table '3661861019 1' 3-max Seat #2 is the button
Seat 1: NicholasW106 (480 in chips) 
Seat 2: Math MiB (570 in chips) 
Seat 3: CashMatteo (450 in chips) 
CashMatteo: posts small blind 10
NicholasW106: posts big blind 20
*** HOLE CARDS ***
Dealt to CashMatteo [Tc 6d]
Math MiB: calls 20
CashMatteo: folds 
NicholasW106: checks 
*** FLOP *** [7d 9c 7h]
NicholasW106: checks 
Math MiB: checks 
*** TURN *** [7d 9c 7h] [Td]
NicholasW106: checks 
Math MiB: checks 
*** RIVER *** [7d 9c 7h Td] [Kh]
NicholasW106: checks 
Math MiB: checks 
*** SHOW DOWN ***
NicholasW106: shows [3d 5c] (a pair of Sevens)
Math MiB: shows [3c 2h] (a pair of Sevens)
NicholasW106 collected 25 from pot
Math MiB collected 25 from pot
*** SUMMARY ***
Total pot 50 | Rake 0 
Board [7d 9c 7h Td Kh]
Seat 1: NicholasW106 (big blind) showed [3d 5c] and won (25) with a pair of Sevens
Seat 2: Math MiB (button) showed [3c 2h] and won (25) with a pair of Sevens
Seat 3: CashMatteo (small blind) folded before Flop

Hand #1258: 

PokerStars Hand #246654907208: Tournament #3661861047, Freeroll  Hold'em No Limit - Level I (10/20) - 2023/10/21 2:39:49 ET
Table '3661861047 1' 3-max Seat #3 is the button
Seat 1: 1982ref (610 in chips) 
Seat 2: fan2b (420 in chips) 
Seat 3: CashMatteo (470 in chips) 
1982ref: posts small blind 10
fan2b: posts big blind 20
*** HOLE CARDS ***
Dealt to CashMatteo [Jc 9d]
CashMatteo: raises 30 to 50
1982ref: folds 
fan2b: calls 30
*** FLOP *** [3s 9h Qs]
fan2b: bets 20
CashMatteo: raises 75 to 95
fan2b: folds 
Uncalled bet (75) returned to CashMatteo
CashMatteo collected 150 from pot
CashMatteo: doesn't show hand 
*** SUMMARY ***
Total pot 150 | Rake 0 
Board [3s 9h Qs]
Seat 1: 1982ref (small blind) folded before Flop
Seat 2: fan2b (big blind) folded on the Flop
Seat 3: CashMatteo (button) collected (150)

Hand #1259: 

PokerStars Hand #246654909253: Tournament #3661861047, Freeroll  Hold'em No Limit - Level I (10/20) - 2023/10/21 2:40:07 ET
Table '3661861047 1' 3-max Seat #1 is the button
Seat 1: 1982ref (600 in chips) 
Seat 2: fan2b (350 in chips) 
Seat 3: CashMatteo (550 in chips) 
fan2b: posts small blind 10
CashMatteo: posts big blind 20
*** HOLE CARDS ***
Dealt to CashMatteo [5s Qs]
1982ref: calls 20
fan2b: calls 10
CashMatteo: raises 30 to 50
1982ref: calls 30
fan2b: folds 
*** FLOP *** [3h Tc Jh]
CashMatteo: checks 
1982ref: checks 
*** TURN *** [3h Tc Jh] [2c]
CashMatteo: checks 
1982ref: bets 20
CashMatteo: calls 20
*** RIVER *** [3h Tc Jh 2c] [7h]
CashMatteo: checks 
1982ref: bets 20
CashMatteo: folds 
Uncalled bet (20) returned to 1982ref
1982ref collected 160 from pot
*** SUMMARY ***
Total pot 160 | Rake 0 
Board [3h Tc Jh 2c 7h]
Seat 1: 1982ref (button) collected (160)
Seat 2: fan2b (small blind) folded before Flop
Seat 3: CashMatteo (big blind) folded on the River

Hand #1260: 

PokerStars Hand #246654909937: Tournament #3661861019, Freeroll  Hold'em No Limit - Level I (10/20) - 2023/10/21 2:40:13 ET
Table '3661861019 1' 3-max Seat #3 is the button
Seat 1: NicholasW106 (485 in chips) 
Seat 2: Math MiB (575 in chips) 
Seat 3: CashMatteo (440 in chips) 
NicholasW106: posts small blind 10
Math MiB: posts big blind 20
*** HOLE CARDS ***
Dealt to CashMatteo [9c Th]
CashMatteo: calls 20
NicholasW106: calls 10
Math MiB: checks 
*** FLOP *** [Kh 2h 3h]
NicholasW106: checks 
Math MiB: checks 
CashMatteo: bets 30
NicholasW106: folds 
Math MiB: calls 30
*** TURN *** [Kh 2h 3h] [Qs]
Math MiB: checks 
CashMatteo: bets 120
Math MiB: folds 
Uncalled bet (120) returned to CashMatteo
CashMatteo collected 120 from pot
CashMatteo: doesn't show hand 
*** SUMMARY ***
Total pot 120 | Rake 0 
Board [Kh 2h 3h Qs]
Seat 1: NicholasW106 (small blind) folded on the Flop
Seat 2: Math MiB (big blind) folded on the Turn
Seat 3: CashMatteo (button) collected (120)

Hand #1261: 

PokerStars Hand #246654913632: Tournament #3661861047, Freeroll  Hold'em No Limit - Level I (10/20) - 2023/10/21 2:40:47 ET
Table '3661861047 1' 3-max Seat #2 is the button
Seat 1: 1982ref (690 in chips) 
Seat 2: fan2b (330 in chips) 
Seat 3: CashMatteo (480 in chips) 
CashMatteo: posts small blind 10
1982ref: posts big blind 20
*** HOLE CARDS ***
Dealt to CashMatteo [4d 2s]
fan2b: calls 20
CashMatteo: folds 
1982ref: checks 
*** FLOP *** [5c 6d Qc]
1982ref: checks 
fan2b: checks 
*** TURN *** [5c 6d Qc] [3s]
1982ref: bets 20
fan2b: folds 
Uncalled bet (20) returned to 1982ref
1982ref collected 50 from pot
*** SUMMARY ***
Total pot 50 | Rake 0 
Board [5c 6d Qc 3s]
Seat 1: 1982ref (big blind) collected (50)
Seat 2: fan2b (button) folded on the Turn
Seat 3: CashMatteo (small blind) folded before Flop

Hand #1262: 

PokerStars Hand #246654913716: Tournament #3661861019, Freeroll  Hold'em No Limit - Level I (10/20) - 2023/10/21 2:40:48 ET
Table '3661861019 1' 3-max Seat #1 is the button
Seat 1: NicholasW106 (465 in chips) 
Seat 2: Math MiB (525 in chips) 
Seat 3: CashMatteo (510 in chips) 
Math MiB: posts small blind 10
CashMatteo: posts big blind 20
*** HOLE CARDS ***
Dealt to CashMatteo [8s 5h]
NicholasW106: raises 20 to 40
Math MiB: calls 30
CashMatteo: calls 20
*** FLOP *** [7c 6d 2d]
Math MiB: checks 
CashMatteo: bets 120
NicholasW106: folds 
Math MiB: calls 120
*** TURN *** [7c 6d 2d] [3c]
Math MiB: checks 
CashMatteo: checks 
*** RIVER *** [7c 6d 2d 3c] [4s]
Math MiB: bets 360
CashMatteo: calls 350 and is all-in
Uncalled bet (10) returned to Math MiB
*** SHOW DOWN ***
Math MiB: shows [5s 6c] (a straight, Three to Seven)
CashMatteo: shows [8s 5h] (a straight, Four to Eight)
CashMatteo collected 1060 from pot
*** SUMMARY ***
Total pot 1060 | Rake 0 
Board [7c 6d 2d 3c 4s]
Seat 1: NicholasW106 (button) folded on the Flop
Seat 2: Math MiB (small blind) showed [5s 6c] and lost with a straight, Three to Seven
Seat 3: CashMatteo (big blind) showed [8s 5h] and won (1060) with a straight, Four to Eight

Hand #1263: 

PokerStars Hand #246654916316: Tournament #3661861047, Freeroll  Hold'em No Limit - Level I (10/20) - 2023/10/21 2:41:12 ET
Table '3661861047 1' 3-max Seat #3 is the button
Seat 1: 1982ref (720 in chips) 
Seat 2: fan2b (310 in chips) 
Seat 3: CashMatteo (470 in chips) 
1982ref: posts small blind 10
fan2b: posts big blind 20
*** HOLE CARDS ***
Dealt to CashMatteo [7c 8s]
CashMatteo: calls 20
1982ref: calls 10
fan2b: checks 
*** FLOP *** [Qc 8h Ad]
1982ref: bets 20
fan2b: folds 
CashMatteo: raises 50 to 70
1982ref: calls 50
*** TURN *** [Qc 8h Ad] [Jd]
1982ref: checks 
CashMatteo: checks 
*** RIVER *** [Qc 8h Ad Jd] [4d]
1982ref: bets 20
CashMatteo: calls 20
*** SHOW DOWN ***
1982ref: shows [3h Qh] (a pair of Queens)
CashMatteo: mucks hand 
1982ref collected 240 from pot
*** SUMMARY ***
Total pot 240 | Rake 0 
Board [Qc 8h Ad Jd 4d]
Seat 1: 1982ref (small blind) showed [3h Qh] and won (240) with a pair of Queens
Seat 2: fan2b (big blind) folded on the Flop
Seat 3: CashMatteo (button) mucked [7c 8s]

Hand #1264: 

PokerStars Hand #246654918728: Tournament #3661861019, Freeroll  Hold'em No Limit - Level I (10/20) - 2023/10/21 2:41:35 ET
Table '3661861019 1' 3-max Seat #2 is the button
Seat 1: NicholasW106 (425 in chips) 
Seat 2: Math MiB (15 in chips) 
Seat 3: CashMatteo (1060 in chips) 
CashMatteo: posts small blind 10
NicholasW106: posts big blind 20
*** HOLE CARDS ***
Dealt to CashMatteo [4d Kc]
Math MiB: calls 15 and is all-in
CashMatteo: calls 10
NicholasW106: checks 
*** FLOP *** [5s 3s 4s]
CashMatteo: bets 28
NicholasW106: calls 28
*** TURN *** [5s 3s 4s] [7s]
CashMatteo: checks 
NicholasW106: bets 40
CashMatteo: folds 
Uncalled bet (40) returned to NicholasW106
*** RIVER *** [5s 3s 4s 7s] [Kd]
*** SHOW DOWN ***
NicholasW106: shows [Qs 7d] (a flush, Queen high)
NicholasW106 collected 66 from side pot
Math MiB: shows [2c 5d] (a pair of Fives)
NicholasW106 collected 45 from main pot
Math MiB finished the tournament in 3rd place
*** SUMMARY ***
Total pot 111 Main pot 45. Side pot 66. | Rake 0 
Board [5s 3s 4s 7s Kd]
Seat 1: NicholasW106 (big blind) showed [Qs 7d] and won (111) with a flush, Queen high
Seat 2: Math MiB (button) showed [2c 5d] and lost with a pair of Fives
Seat 3: CashMatteo (small blind) folded on the Turn

Hand #1265: 

PokerStars Hand #246654920211: Tournament #3661861047, Freeroll  Hold'em No Limit - Level I (10/20) - 2023/10/21 2:41:48 ET
Table '3661861047 1' 3-max Seat #1 is the button
Seat 1: 1982ref (850 in chips) 
Seat 2: fan2b (290 in chips) 
Seat 3: CashMatteo (360 in chips) 
fan2b: posts small blind 10
CashMatteo: posts big blind 20
*** HOLE CARDS ***
Dealt to CashMatteo [6s Qd]
1982ref: calls 20
fan2b: folds 
CashMatteo: checks 
*** FLOP *** [9s 9c 5h]
CashMatteo: checks 
1982ref: checks 
*** TURN *** [9s 9c 5h] [3c]
CashMatteo: checks 
1982ref: checks 
*** RIVER *** [9s 9c 5h 3c] [6h]
CashMatteo: checks 
1982ref: bets 20
CashMatteo: raises 45 to 65
1982ref: folds 
Uncalled bet (45) returned to CashMatteo
CashMatteo collected 90 from pot
CashMatteo: doesn't show hand 
*** SUMMARY ***
Total pot 90 | Rake 0 
Board [9s 9c 5h 3c 6h]
Seat 1: 1982ref (button) folded on the River
Seat 2: fan2b (small blind) folded before Flop
Seat 3: CashMatteo (big blind) collected (90)

Hand #1266: 

PokerStars Hand #246654921953: Tournament #3661861019, Freeroll  Hold'em No Limit - Level I (10/20) - 2023/10/21 2:42:04 ET
Table '3661861019 1' 3-max Seat #1 is the button
Seat 1: NicholasW106 (488 in chips) 
Seat 3: CashMatteo (1012 in chips) 
NicholasW106: posts small blind 10
CashMatteo: posts big blind 20
*** HOLE CARDS ***
Dealt to CashMatteo [7d Ks]
NicholasW106: calls 10
CashMatteo: raises 30 to 50
NicholasW106: calls 30
*** FLOP *** [8d 9d Ts]
CashMatteo: checks 
NicholasW106: checks 
*** TURN *** [8d 9d Ts] [As]
CashMatteo: checks 
NicholasW106: bets 60
CashMatteo: calls 60
*** RIVER *** [8d 9d Ts As] [3c]
CashMatteo: checks 
NicholasW106: checks 
*** SHOW DOWN ***
CashMatteo: shows [7d Ks] (high card Ace)
NicholasW106: shows [Jc 5c] (high card Ace - lower kicker)
CashMatteo collected 220 from pot
*** SUMMARY ***
Total pot 220 | Rake 0 
Board [8d 9d Ts As 3c]
Seat 1: NicholasW106 (button) (small blind) showed [Jc 5c] and lost with high card Ace
Seat 3: CashMatteo (big blind) showed [7d Ks] and won (220) with high card Ace

Hand #1267: 

PokerStars Hand #246654923966: Tournament #3661861047, Freeroll  Hold'em No Limit - Level II (15/30) - 2023/10/21 2:42:23 ET
Table '3661861047 1' 3-max Seat #2 is the button
Seat 1: 1982ref (810 in chips) 
Seat 2: fan2b (280 in chips) 
Seat 3: CashMatteo (410 in chips) 
CashMatteo: posts small blind 15
1982ref: posts big blind 30
*** HOLE CARDS ***
Dealt to CashMatteo [6c 9c]
fan2b: folds 
CashMatteo: calls 15
1982ref: checks 
*** FLOP *** [8c Ts 4s]
CashMatteo: checks 
1982ref: bets 30
CashMatteo: calls 30
*** TURN *** [8c Ts 4s] [9h]
CashMatteo: bets 60
1982ref: raises 60 to 120
CashMatteo: calls 60
*** RIVER *** [8c Ts 4s 9h] [8s]
CashMatteo: checks 
1982ref: bets 360
CashMatteo: folds 
Uncalled bet (360) returned to 1982ref
1982ref collected 360 from pot
*** SUMMARY ***
Total pot 360 | Rake 0 
Board [8c Ts 4s 9h 8s]
Seat 1: 1982ref (big blind) collected (360)
Seat 2: fan2b (button) folded before Flop (didn't bet)
Seat 3: CashMatteo (small blind) folded on the River

Hand #1268: 

PokerStars Hand #246654925142: Tournament #3661861019, Freeroll  Hold'em No Limit - Level II (15/30) - 2023/10/21 2:42:34 ET
Table '3661861019 1' 3-max Seat #3 is the button
Seat 1: NicholasW106 (378 in chips) 
Seat 3: CashMatteo (1122 in chips) 
CashMatteo: posts small blind 15
NicholasW106: posts big blind 30
*** HOLE CARDS ***
Dealt to CashMatteo [Qh 3d]
CashMatteo: folds 
Uncalled bet (15) returned to NicholasW106
NicholasW106 collected 30 from pot
*** SUMMARY ***
Total pot 30 | Rake 0 
Seat 1: NicholasW106 (big blind) collected (30)
Seat 3: CashMatteo (button) (small blind) folded before Flop

Hand #1269: 

PokerStars Hand #246654926429: Tournament #3661861019, Freeroll  Hold'em No Limit - Level II (15/30) - 2023/10/21 2:42:46 ET
Table '3661861019 1' 3-max Seat #1 is the button
Seat 1: NicholasW106 (393 in chips) 
Seat 3: CashMatteo (1107 in chips) 
NicholasW106: posts small blind 15
CashMatteo: posts big blind 30
*** HOLE CARDS ***
Dealt to CashMatteo [Tc 3s]
NicholasW106: calls 15
CashMatteo: checks 
*** FLOP *** [Jd Kh Jh]
CashMatteo: checks 
NicholasW106: checks 
*** TURN *** [Jd Kh Jh] [Ad]
CashMatteo: checks 
NicholasW106: checks 
*** RIVER *** [Jd Kh Jh Ad] [6c]
CashMatteo: checks 
NicholasW106: checks 
*** SHOW DOWN ***
CashMatteo: shows [Tc 3s] (a pair of Jacks)
NicholasW106: shows [9d 3c] (a pair of Jacks - lower kicker)
CashMatteo collected 60 from pot
*** SUMMARY ***
Total pot 60 | Rake 0 
Board [Jd Kh Jh Ad 6c]
Seat 1: NicholasW106 (button) (small blind) showed [9d 3c] and lost with a pair of Jacks
Seat 3: CashMatteo (big blind) showed [Tc 3s] and won (60) with a pair of Jacks

Hand #1270: 

PokerStars Hand #246654928944: Tournament #3661861047, Freeroll  Hold'em No Limit - Level II (15/30) - 2023/10/21 2:43:10 ET
Table '3661861047 1' 3-max Seat #3 is the button
Seat 1: 1982ref (990 in chips) 
Seat 2: fan2b (280 in chips) 
Seat 3: CashMatteo (230 in chips) 
1982ref: posts small blind 15
fan2b: posts big blind 30
*** HOLE CARDS ***
Dealt to CashMatteo [Js Tc]
CashMatteo: raises 45 to 75
1982ref: calls 60
fan2b: folds 
*** FLOP *** [3s Qh 7s]
1982ref: checks 
CashMatteo: bets 90
1982ref: calls 90
*** TURN *** [3s Qh 7s] [6c]
1982ref: checks 
CashMatteo: bets 65 and is all-in
1982ref: calls 65
*** RIVER *** [3s Qh 7s 6c] [3d]
*** SHOW DOWN ***
1982ref: shows [Ts Th] (two pair, Tens and Threes)
CashMatteo: shows [Js Tc] (a pair of Threes)
1982ref collected 490 from pot
CashMatteo finished the tournament in 3rd place
*** SUMMARY ***
Total pot 490 | Rake 0 
Board [3s Qh 7s 6c 3d]
Seat 1: 1982ref (small blind) showed [Ts Th] and won (490) with two pair, Tens and Threes
Seat 2: fan2b (big blind) folded before Flop
Seat 3: CashMatteo (button) showed [Js Tc] and lost with a pair of Threes

Hand #1271: 

PokerStars Hand #246654929375: Tournament #3661861019, Freeroll  Hold'em No Limit - Level II (15/30) - 2023/10/21 2:43:14 ET
Table '3661861019 1' 3-max Seat #3 is the button
Seat 1: NicholasW106 (363 in chips) 
Seat 3: CashMatteo (1137 in chips) 
CashMatteo: posts small blind 15
NicholasW106: posts big blind 30
*** HOLE CARDS ***
Dealt to CashMatteo [2h 4d]
CashMatteo: folds 
Uncalled bet (15) returned to NicholasW106
NicholasW106 collected 30 from pot
*** SUMMARY ***
Total pot 30 | Rake 0 
Seat 1: NicholasW106 (big blind) collected (30)
Seat 3: CashMatteo (button) (small blind) folded before Flop

Hand #1272: 

PokerStars Hand #246654929976: Tournament #3661861019, Freeroll  Hold'em No Limit - Level II (15/30) - 2023/10/21 2:43:19 ET
Table '3661861019 1' 3-max Seat #1 is the button
Seat 1: NicholasW106 (378 in chips) 
Seat 3: CashMatteo (1122 in chips) 
NicholasW106: posts small blind 15
CashMatteo: posts big blind 30
*** HOLE CARDS ***
Dealt to CashMatteo [5d Ad]
NicholasW106: calls 15
CashMatteo: raises 60 to 90
NicholasW106: folds 
Uncalled bet (60) returned to CashMatteo
CashMatteo collected 60 from pot
CashMatteo: doesn't show hand 
*** SUMMARY ***
Total pot 60 | Rake 0 
Seat 1: NicholasW106 (button) (small blind) folded before Flop
Seat 3: CashMatteo (big blind) collected (60)

Hand #1273: 

PokerStars Hand #246654931110: Tournament #3661861019, Freeroll  Hold'em No Limit - Level II (15/30) - 2023/10/21 2:43:30 ET
Table '3661861019 1' 3-max Seat #3 is the button
Seat 1: NicholasW106 (348 in chips) 
Seat 3: CashMatteo (1152 in chips) 
CashMatteo: posts small blind 15
NicholasW106: posts big blind 30
*** HOLE CARDS ***
Dealt to CashMatteo [3d 9h]
CashMatteo: folds 
Uncalled bet (15) returned to NicholasW106
NicholasW106 collected 30 from pot
*** SUMMARY ***
Total pot 30 | Rake 0 
Seat 1: NicholasW106 (big blind) collected (30)
Seat 3: CashMatteo (button) (small blind) folded before Flop

Hand #1274: 

PokerStars Hand #246654931692: Tournament #3661861019, Freeroll  Hold'em No Limit - Level II (15/30) - 2023/10/21 2:43:35 ET
Table '3661861019 1' 3-max Seat #1 is the button
Seat 1: NicholasW106 (363 in chips) 
Seat 3: CashMatteo (1137 in chips) 
NicholasW106: posts small blind 15
CashMatteo: posts big blind 30
*** HOLE CARDS ***
Dealt to CashMatteo [4s 9s]
NicholasW106: calls 15
CashMatteo: checks 
*** FLOP *** [9d 7h 8s]
CashMatteo: checks 
NicholasW106: bets 30
CashMatteo: calls 30
*** TURN *** [9d 7h 8s] [8d]
CashMatteo: checks 
NicholasW106: bets 60
CashMatteo: calls 60
*** RIVER *** [9d 7h 8s 8d] [Qs]
CashMatteo: checks 
NicholasW106: bets 60
CashMatteo: calls 60
*** SHOW DOWN ***
NicholasW106: shows [Js 7c] (two pair, Eights and Sevens)
CashMatteo: shows [4s 9s] (two pair, Nines and Eights)
CashMatteo collected 360 from pot
*** SUMMARY ***
Total pot 360 | Rake 0 
Board [9d 7h 8s 8d Qs]
Seat 1: NicholasW106 (button) (small blind) showed [Js 7c] and lost with two pair, Eights and Sevens
Seat 3: CashMatteo (big blind) showed [4s 9s] and won (360) with two pair, Nines and Eights

Hand #1275: 

PokerStars Hand #246654935260: Tournament #3661861019, Freeroll  Hold'em No Limit - Level II (15/30) - 2023/10/21 2:44:07 ET
Table '3661861019 1' 3-max Seat #3 is the button
Seat 1: NicholasW106 (183 in chips) 
Seat 3: CashMatteo (1317 in chips) 
CashMatteo: posts small blind 15
NicholasW106: posts big blind 30
*** HOLE CARDS ***
Dealt to CashMatteo [Ah 5c]
CashMatteo: raises 45 to 75
NicholasW106: raises 108 to 183 and is all-in
CashMatteo: calls 108
*** FLOP *** [5d 6c Kc]
*** TURN *** [5d 6c Kc] [Ad]
*** RIVER *** [5d 6c Kc Ad] [2d]
*** SHOW DOWN ***
NicholasW106: shows [Td Ac] (a pair of Aces)
CashMatteo: shows [Ah 5c] (two pair, Aces and Fives)
CashMatteo collected 366 from pot
NicholasW106 finished the tournament in 2nd place
CashMatteo wins the tournament and receives $200.00 - congratulations!
*** SUMMARY ***
Total pot 366 | Rake 0 
Board [5d 6c Kc Ad 2d]
Seat 1: NicholasW106 (big blind) showed [Td Ac] and lost with a pair of Aces
Seat 3: CashMatteo (button) (small blind) showed [Ah 5c] and won (366) with two pair, Aces and Fives

Hand #1276: 

PokerStars Hand #246654940626: Tournament #3661862093, Freeroll  Hold'em No Limit - Level I (10/20) - 2023/10/21 2:44:56 ET
Table '3661862093 1' 3-max Seat #1 is the button
Seat 1: Zinkevych_Ol (500 in chips) 
Seat 2: KaaCea43 (500 in chips) 
Seat 3: CashMatteo (500 in chips) 
KaaCea43: posts small blind 10
CashMatteo: posts big blind 20
*** HOLE CARDS ***
Dealt to CashMatteo [Ts Th]
Zinkevych_Ol: calls 20
KaaCea43: calls 10
CashMatteo: raises 60 to 80
Zinkevych_Ol: calls 60
KaaCea43: calls 60
*** FLOP *** [2h 3c Jh]
KaaCea43: checks 
CashMatteo: bets 120
Zinkevych_Ol: calls 120
KaaCea43: calls 120
*** TURN *** [2h 3c Jh] [7d]
KaaCea43: checks 
CashMatteo: checks 
Zinkevych_Ol: bets 20
KaaCea43: calls 20
CashMatteo: raises 280 to 300 and is all-in
Zinkevych_Ol: calls 280 and is all-in
KaaCea43: calls 280 and is all-in
*** RIVER *** [2h 3c Jh 7d] [7s]
*** SHOW DOWN ***
KaaCea43: shows [5h 6s] (a pair of Sevens)
CashMatteo: shows [Ts Th] (two pair, Tens and Sevens)
Zinkevych_Ol: shows [Qc Qs] (two pair, Queens and Sevens)
Zinkevych_Ol collected 1500 from pot
KaaCea43 finished the tournament in 2nd place
CashMatteo finished the tournament in 2nd place
Zinkevych_Ol wins the tournament and receives $200.00 - congratulations!
*** SUMMARY ***
Total pot 1500 | Rake 0 
Board [2h 3c Jh 7d 7s]
Seat 1: Zinkevych_Ol (button) showed [Qc Qs] and won (1500) with two pair, Queens and Sevens
Seat 2: KaaCea43 (small blind) showed [5h 6s] and lost with a pair of Sevens
Seat 3: CashMatteo (big blind) showed [Ts Th] and lost with two pair, Tens and Sevens

Hand #1277: 

PokerStars Hand #246671855478: Tournament #3659798281, $0.94+$0.06 CAD Hold'em No Limit - Level I (15/30) - 2023/10/21 22:05:10 ET
Table '3659798281 4' 8-max Seat #1 is the button
Seat 1: londong1978 (3000 in chips) 
Seat 2: Hugo5619 (3000 in chips) 
Seat 3: tuk-tuk67 (3000 in chips) 
Seat 4: ForeignSlang (3000 in chips) 
Seat 5: CashMatteo (3000 in chips) 
londong1978: posts the ante 7
Hugo5619: posts the ante 7
tuk-tuk67: posts the ante 7
ForeignSlang: posts the ante 7
CashMatteo: posts the ante 7
Hugo5619: posts small blind 15
tuk-tuk67: posts big blind 30
*** HOLE CARDS ***
Dealt to CashMatteo [2d 8d]
ForeignSlang: calls 30
CashMatteo: folds 
londong1978: folds 
Hugo5619: calls 15
tuk-tuk67: checks 
*** FLOP *** [8h Th Jd]
Hugo5619: checks 
tuk-tuk67: checks 
ForeignSlang: checks 
*** TURN *** [8h Th Jd] [9c]
Hugo5619: checks 
tuk-tuk67: checks 
ForeignSlang: checks 
*** RIVER *** [8h Th Jd 9c] [6s]
Hugo5619: bets 30
tuk-tuk67: folds 
ForeignSlang: folds 
Uncalled bet (30) returned to Hugo5619
Hugo5619 collected 125 from pot
*** SUMMARY ***
Total pot 125 | Rake 0 
Board [8h Th Jd 9c 6s]
Seat 1: londong1978 (button) folded before Flop (didn't bet)
Seat 2: Hugo5619 (small blind) collected (125)
Seat 3: tuk-tuk67 (big blind) folded on the River
Seat 4: ForeignSlang folded on the River
Seat 5: CashMatteo folded before Flop (didn't bet)

Hand #1278: 

PokerStars Hand #246671861945: Tournament #3659798281, $0.94+$0.06 CAD Hold'em No Limit - Level I (15/30) - 2023/10/21 22:05:46 ET
Table '3659798281 4' 8-max Seat #2 is the button
Seat 1: londong1978 (2993 in chips) 
Seat 2: Hugo5619 (3088 in chips) 
Seat 3: tuk-tuk67 (2963 in chips) 
Seat 4: ForeignSlang (2963 in chips) 
Seat 5: CashMatteo (2993 in chips) 
Seat 8: claudelegault (3000 in chips) 
londong1978: posts the ante 7
Hugo5619: posts the ante 7
tuk-tuk67: posts the ante 7
ForeignSlang: posts the ante 7
CashMatteo: posts the ante 7
claudelegault: posts the ante 7
tuk-tuk67: posts small blind 15
ForeignSlang: posts big blind 30
*** HOLE CARDS ***
Dealt to CashMatteo [3c As]
CashMatteo: calls 30
claudelegault: calls 30
londong1978: folds 
Hugo5619: calls 30
tuk-tuk67: folds 
ForeignSlang: checks 
*** FLOP *** [5d 7s 5s]
ForeignSlang: bets 60
CashMatteo: folds 
claudelegault: calls 60
Hugo5619: folds 
*** TURN *** [5d 7s 5s] [2c]
ForeignSlang: checks 
claudelegault: bets 30
ForeignSlang: calls 30
*** RIVER *** [5d 7s 5s 2c] [8s]
ForeignSlang: bets 120
claudelegault: calls 120
*** SHOW DOWN ***
ForeignSlang: shows [Js 6s] (a flush, Jack high)
claudelegault: mucks hand 
ForeignSlang collected 597 from pot
*** SUMMARY ***
Total pot 597 | Rake 0 
Board [5d 7s 5s 2c 8s]
Seat 1: londong1978 folded before Flop (didn't bet)
Seat 2: Hugo5619 (button) folded on the Flop
Seat 3: tuk-tuk67 (small blind) folded before Flop
Seat 4: ForeignSlang (big blind) showed [Js 6s] and won (597) with a flush, Jack high
Seat 5: CashMatteo folded on the Flop
Seat 8: claudelegault mucked [7h 9h]

Hand #1279: 

PokerStars Hand #246671870537: Tournament #3659798281, $0.94+$0.06 CAD Hold'em No Limit - Level I (15/30) - 2023/10/21 22:06:34 ET
Table '3659798281 4' 8-max Seat #3 is the button
Seat 1: londong1978 (2986 in chips) 
Seat 2: Hugo5619 (3051 in chips) 
Seat 3: tuk-tuk67 (2941 in chips) 
Seat 4: ForeignSlang (3313 in chips) 
Seat 5: CashMatteo (2956 in chips) 
Seat 7: Redman3298 (3000 in chips) 
Seat 8: claudelegault (2753 in chips) 
londong1978: posts the ante 7
Hugo5619: posts the ante 7
tuk-tuk67: posts the ante 7
ForeignSlang: posts the ante 7
CashMatteo: posts the ante 7
Redman3298: posts the ante 7
claudelegault: posts the ante 7
ForeignSlang: posts small blind 15
CashMatteo: posts big blind 30
*** HOLE CARDS ***
Dealt to CashMatteo [7c Ac]
Redman3298: calls 30
claudelegault: folds 
londong1978: folds 
Hugo5619: folds 
tuk-tuk67: raises 90 to 120
ForeignSlang: folds 
CashMatteo: calls 90
Redman3298: calls 90
*** FLOP *** [5s 5d 2c]
CashMatteo: checks 
Redman3298: checks 
tuk-tuk67: bets 55
CashMatteo: calls 55
Redman3298: folds 
*** TURN *** [5s 5d 2c] [Jh]
CashMatteo: checks 
tuk-tuk67: checks 
*** RIVER *** [5s 5d 2c Jh] [Tc]
CashMatteo: bets 267
tuk-tuk67: calls 267
*** SHOW DOWN ***
CashMatteo: shows [7c Ac] (a pair of Fives)
tuk-tuk67: shows [Td Ad] (two pair, Tens and Fives)
tuk-tuk67 collected 1068 from pot
*** SUMMARY ***
Total pot 1068 | Rake 0 
Board [5s 5d 2c Jh Tc]
Seat 1: londong1978 folded before Flop (didn't bet)
Seat 2: Hugo5619 folded before Flop (didn't bet)
Seat 3: tuk-tuk67 (button) showed [Td Ad] and won (1068) with two pair, Tens and Fives
Seat 4: ForeignSlang (small blind) folded before Flop
Seat 5: CashMatteo (big blind) showed [7c Ac] and lost with a pair of Fives
Seat 7: Redman3298 folded on the Flop
Seat 8: claudelegault folded before Flop (didn't bet)

Hand #1280: 

PokerStars Hand #246671880757: Tournament #3659798281, $0.94+$0.06 CAD Hold'em No Limit - Level I (15/30) - 2023/10/21 22:07:33 ET
Table '3659798281 4' 8-max Seat #4 is the button
Seat 1: londong1978 (2979 in chips) 
Seat 2: Hugo5619 (3044 in chips) 
Seat 3: tuk-tuk67 (3560 in chips) 
Seat 4: ForeignSlang (3291 in chips) 
Seat 5: CashMatteo (2507 in chips) 
Seat 7: Redman3298 (2873 in chips) 
Seat 8: claudelegault (2746 in chips) 
londong1978: posts the ante 7
Hugo5619: posts the ante 7
tuk-tuk67: posts the ante 7
ForeignSlang: posts the ante 7
CashMatteo: posts the ante 7
Redman3298: posts the ante 7
claudelegault: posts the ante 7
CashMatteo: posts small blind 15
Redman3298: posts big blind 30
*** HOLE CARDS ***
Dealt to CashMatteo [9c 7c]
claudelegault: folds 
londong1978: raises 30 to 60
Hugo5619: folds 
tuk-tuk67: folds 
ForeignSlang: calls 60
CashMatteo: calls 45
Redman3298: calls 30
*** FLOP *** [Kd Tc Qd]
CashMatteo: checks 
Redman3298: checks 
londong1978: bets 60
ForeignSlang: calls 60
CashMatteo: folds 
Redman3298: folds 
*** TURN *** [Kd Tc Qd] [9d]
londong1978: bets 60
ForeignSlang: calls 60
*** RIVER *** [Kd Tc Qd 9d] [2h]
londong1978: checks 
ForeignSlang: checks 
*** SHOW DOWN ***
londong1978: shows [3h Ac] (high card Ace)
ForeignSlang: shows [Qs Ah] (a pair of Queens)
ForeignSlang collected 529 from pot
*** SUMMARY ***
Total pot 529 | Rake 0 
Board [Kd Tc Qd 9d 2h]
Seat 1: londong1978 showed [3h Ac] and lost with high card Ace
Seat 2: Hugo5619 folded before Flop (didn't bet)
Seat 3: tuk-tuk67 folded before Flop (didn't bet)
Seat 4: ForeignSlang (button) showed [Qs Ah] and won (529) with a pair of Queens
Seat 5: CashMatteo (small blind) folded on the Flop
Seat 7: Redman3298 (big blind) folded on the Flop
Seat 8: claudelegault folded before Flop (didn't bet)

Hand #1281: 

PokerStars Hand #246671886763: Tournament #3659798281, $0.94+$0.06 CAD Hold'em No Limit - Level I (15/30) - 2023/10/21 22:08:07 ET
Table '3659798281 4' 8-max Seat #5 is the button
Seat 1: londong1978 (2792 in chips) 
Seat 2: Hugo5619 (3037 in chips) 
Seat 3: tuk-tuk67 (3553 in chips) 
Seat 4: ForeignSlang (3633 in chips) 
Seat 5: CashMatteo (2440 in chips) 
Seat 7: Redman3298 (2806 in chips) 
Seat 8: claudelegault (2739 in chips) 
londong1978: posts the ante 7
Hugo5619: posts the ante 7
tuk-tuk67: posts the ante 7
ForeignSlang: posts the ante 7
CashMatteo: posts the ante 7
Redman3298: posts the ante 7
claudelegault: posts the ante 7
Redman3298: posts small blind 15
claudelegault: posts big blind 30
*** HOLE CARDS ***
Dealt to CashMatteo [Ts 3h]
londong1978: folds 
Hugo5619: calls 30
tuk-tuk67: folds 
ForeignSlang: folds 
CashMatteo: folds 
Redman3298: calls 15
claudelegault: raises 60 to 90
Hugo5619: calls 60
Redman3298: calls 60
*** FLOP *** [5d Js Th]
Redman3298: checks 
claudelegault: bets 319
Hugo5619: folds 
Redman3298: folds 
Uncalled bet (319) returned to claudelegault
claudelegault collected 319 from pot
*** SUMMARY ***
Total pot 319 | Rake 0 
Board [5d Js Th]
Seat 1: londong1978 folded before Flop (didn't bet)
Seat 2: Hugo5619 folded on the Flop
Seat 3: tuk-tuk67 folded before Flop (didn't bet)
Seat 4: ForeignSlang folded before Flop (didn't bet)
Seat 5: CashMatteo (button) folded before Flop (didn't bet)
Seat 7: Redman3298 (small blind) folded on the Flop
Seat 8: claudelegault (big blind) collected (319)

Hand #1282: 

PokerStars Hand #246671893477: Tournament #3659798281, $0.94+$0.06 CAD Hold'em No Limit - Level II (20/40) - 2023/10/21 22:08:45 ET
Table '3659798281 4' 8-max Seat #7 is the button
Seat 1: londong1978 (2785 in chips) 
Seat 2: Hugo5619 (2940 in chips) 
Seat 3: tuk-tuk67 (3546 in chips) 
Seat 4: ForeignSlang (3626 in chips) 
Seat 5: CashMatteo (2433 in chips) 
Seat 7: Redman3298 (2709 in chips) 
Seat 8: claudelegault (2961 in chips) 
londong1978: posts the ante 10
Hugo5619: posts the ante 10
tuk-tuk67: posts the ante 10
ForeignSlang: posts the ante 10
CashMatteo: posts the ante 10
Redman3298: posts the ante 10
claudelegault: posts the ante 10
claudelegault: posts small blind 20
londong1978: posts big blind 40
*** HOLE CARDS ***
Dealt to CashMatteo [Qd 7c]
Hugo5619: calls 40
tuk-tuk67: folds 
ForeignSlang: folds 
CashMatteo: folds 
Redman3298: calls 40
claudelegault: calls 20
londong1978: checks 
*** FLOP *** [5c 9d 5s]
claudelegault: checks 
londong1978: checks 
Hugo5619: checks 
Redman3298: bets 115
claudelegault: folds 
londong1978: calls 115
Hugo5619: folds 
*** TURN *** [5c 9d 5s] [Qs]
londong1978: checks 
Redman3298: bets 230
londong1978: raises 230 to 460
Redman3298: calls 230
*** RIVER *** [5c 9d 5s Qs] [9s]
londong1978: bets 690
Redman3298: folds 
Uncalled bet (690) returned to londong1978
londong1978 collected 1380 from pot
*** SUMMARY ***
Total pot 1380 | Rake 0 
Board [5c 9d 5s Qs 9s]
Seat 1: londong1978 (big blind) collected (1380)
Seat 2: Hugo5619 folded on the Flop
Seat 3: tuk-tuk67 folded before Flop (didn't bet)
Seat 4: ForeignSlang folded before Flop (didn't bet)
Seat 5: CashMatteo folded before Flop (didn't bet)
Seat 7: Redman3298 (button) folded on the River
Seat 8: claudelegault (small blind) folded on the Flop

Hand #1283: 

PokerStars Hand #246671903565: Tournament #3659798281, $0.94+$0.06 CAD Hold'em No Limit - Level II (20/40) - 2023/10/21 22:09:42 ET
Table '3659798281 4' 8-max Seat #8 is the button
Seat 1: londong1978 (3540 in chips) 
Seat 2: Hugo5619 (2890 in chips) 
Seat 3: tuk-tuk67 (3536 in chips) 
Seat 4: ForeignSlang (3616 in chips) 
Seat 5: CashMatteo (2423 in chips) 
Seat 7: Redman3298 (2084 in chips) 
Seat 8: claudelegault (2911 in chips) 
londong1978: posts the ante 10
Hugo5619: posts the ante 10
tuk-tuk67: posts the ante 10
ForeignSlang: posts the ante 10
CashMatteo: posts the ante 10
Redman3298: posts the ante 10
claudelegault: posts the ante 10
londong1978: posts small blind 20
Hugo5619: posts big blind 40
*** HOLE CARDS ***
Dealt to CashMatteo [6d Ks]
tuk-tuk67: folds 
ForeignSlang: folds 
CashMatteo: folds 
Redman3298: calls 40
claudelegault: calls 40
londong1978: calls 20
Hugo5619: checks 
*** FLOP *** [4c Ts Js]
londong1978: bets 40
Hugo5619: folds 
Redman3298: folds 
claudelegault: folds 
Uncalled bet (40) returned to londong1978
londong1978 collected 230 from pot
*** SUMMARY ***
Total pot 230 | Rake 0 
Board [4c Ts Js]
Seat 1: londong1978 (small blind) collected (230)
Seat 2: Hugo5619 (big blind) folded on the Flop
Seat 3: tuk-tuk67 folded before Flop (didn't bet)
Seat 4: ForeignSlang folded before Flop (didn't bet)
Seat 5: CashMatteo folded before Flop (didn't bet)
Seat 7: Redman3298 folded on the Flop
Seat 8: claudelegault (button) folded on the Flop

Hand #1284: 

PokerStars Hand #246671908316: Tournament #3659798281, $0.94+$0.06 CAD Hold'em No Limit - Level II (20/40) - 2023/10/21 22:10:09 ET
Table '3659798281 4' 8-max Seat #1 is the button
Seat 1: londong1978 (3720 in chips) 
Seat 2: Hugo5619 (2840 in chips) 
Seat 3: tuk-tuk67 (3526 in chips) 
Seat 4: ForeignSlang (3606 in chips) 
Seat 5: CashMatteo (2413 in chips) 
Seat 7: Redman3298 (2034 in chips) 
Seat 8: claudelegault (2861 in chips) 
londong1978: posts the ante 10
Hugo5619: posts the ante 10
tuk-tuk67: posts the ante 10
ForeignSlang: posts the ante 10
CashMatteo: posts the ante 10
Redman3298: posts the ante 10
claudelegault: posts the ante 10
Hugo5619: posts small blind 20
tuk-tuk67: posts big blind 40
*** HOLE CARDS ***
Dealt to CashMatteo [Ks 4h]
ForeignSlang: raises 80 to 120
CashMatteo: folds 
Redman3298: calls 120
claudelegault: folds 
londong1978: folds 
Hugo5619: folds 
tuk-tuk67: folds 
*** FLOP *** [As 5c 2s]
ForeignSlang: checks 
Redman3298: checks 
*** TURN *** [As 5c 2s] [4d]
ForeignSlang: bets 120
Redman3298: calls 120
*** RIVER *** [As 5c 2s 4d] [Td]
ForeignSlang: bets 120
Redman3298: calls 120
*** SHOW DOWN ***
ForeignSlang: shows [Ah Ad] (three of a kind, Aces)
Redman3298: mucks hand 
ForeignSlang collected 850 from pot
*** SUMMARY ***
Total pot 850 | Rake 0 
Board [As 5c 2s 4d Td]
Seat 1: londong1978 (button) folded before Flop (didn't bet)
Seat 2: Hugo5619 (small blind) folded before Flop
Seat 3: tuk-tuk67 (big blind) folded before Flop
Seat 4: ForeignSlang showed [Ah Ad] and won (850) with three of a kind, Aces
Seat 5: CashMatteo folded before Flop (didn't bet)
Seat 7: Redman3298 mucked [Qs Tc]
Seat 8: claudelegault folded before Flop (didn't bet)

Hand #1285: 

PokerStars Hand #246671914084: Tournament #3659798281, $0.94+$0.06 CAD Hold'em No Limit - Level II (20/40) - 2023/10/21 22:10:43 ET
Table '3659798281 4' 8-max Seat #2 is the button
Seat 1: londong1978 (3710 in chips) 
Seat 2: Hugo5619 (2810 in chips) 
Seat 3: tuk-tuk67 (3476 in chips) 
Seat 4: ForeignSlang (4086 in chips) 
Seat 5: CashMatteo (2403 in chips) 
Seat 7: Redman3298 (1664 in chips) 
Seat 8: claudelegault (2851 in chips) 
londong1978: posts the ante 10
Hugo5619: posts the ante 10
tuk-tuk67: posts the ante 10
ForeignSlang: posts the ante 10
CashMatteo: posts the ante 10
Redman3298: posts the ante 10
claudelegault: posts the ante 10
tuk-tuk67: posts small blind 20
ForeignSlang: posts big blind 40
*** HOLE CARDS ***
Dealt to CashMatteo [Jc 7s]
CashMatteo: folds 
Redman3298: calls 40
claudelegault: folds 
londong1978: folds 
Hugo5619: calls 40
tuk-tuk67: folds 
ForeignSlang: checks 
*** FLOP *** [Ac Qh Qc]
ForeignSlang: checks 
Redman3298: checks 
Hugo5619: bets 40
ForeignSlang: folds 
Redman3298: folds 
Uncalled bet (40) returned to Hugo5619
Hugo5619 collected 210 from pot
*** SUMMARY ***
Total pot 210 | Rake 0 
Board [Ac Qh Qc]
Seat 1: londong1978 folded before Flop (didn't bet)
Seat 2: Hugo5619 (button) collected (210)
Seat 3: tuk-tuk67 (small blind) folded before Flop
Seat 4: ForeignSlang (big blind) folded on the Flop
Seat 5: CashMatteo folded before Flop (didn't bet)
Seat 7: Redman3298 folded on the Flop
Seat 8: claudelegault folded before Flop (didn't bet)

Hand #1286: 

PokerStars Hand #246671919547: Tournament #3659798281, $0.94+$0.06 CAD Hold'em No Limit - Level III (30/60) - 2023/10/21 22:11:14 ET
Table '3659798281 4' 8-max Seat #3 is the button
Seat 1: londong1978 (3700 in chips) 
Seat 2: Hugo5619 (2970 in chips) 
Seat 3: tuk-tuk67 (3446 in chips) 
Seat 4: ForeignSlang (4036 in chips) 
Seat 5: CashMatteo (2393 in chips) 
Seat 7: Redman3298 (1614 in chips) 
Seat 8: claudelegault (2841 in chips) 
londong1978: posts the ante 15
Hugo5619: posts the ante 15
tuk-tuk67: posts the ante 15
ForeignSlang: posts the ante 15
CashMatteo: posts the ante 15
Redman3298: posts the ante 15
claudelegault: posts the ante 15
ForeignSlang: posts small blind 30
CashMatteo: posts big blind 60
*** HOLE CARDS ***
Dealt to CashMatteo [2c Kd]
Redman3298: folds 
claudelegault: raises 60 to 120
londong1978: calls 120
Hugo5619: calls 120
tuk-tuk67: folds 
ForeignSlang: folds 
CashMatteo: calls 60
*** FLOP *** [6h 6s 5h]
CashMatteo: checks 
claudelegault: bets 308
londong1978: folds 
Hugo5619: folds 
CashMatteo: folds 
Uncalled bet (308) returned to claudelegault
claudelegault collected 615 from pot
*** SUMMARY ***
Total pot 615 | Rake 0 
Board [6h 6s 5h]
Seat 1: londong1978 folded on the Flop
Seat 2: Hugo5619 folded on the Flop
Seat 3: tuk-tuk67 (button) folded before Flop (didn't bet)
Seat 4: ForeignSlang (small blind) folded before Flop
Seat 5: CashMatteo (big blind) folded on the Flop
Seat 7: Redman3298 folded before Flop (didn't bet)
Seat 8: claudelegault collected (615)

Hand #1287: 

PokerStars Hand #246671925897: Tournament #3659798281, $0.94+$0.06 CAD Hold'em No Limit - Level III (30/60) - 2023/10/21 22:11:51 ET
Table '3659798281 4' 8-max Seat #4 is the button
Seat 1: londong1978 (3565 in chips) 
Seat 2: Hugo5619 (2835 in chips) 
Seat 3: tuk-tuk67 (3431 in chips) 
Seat 4: ForeignSlang (3991 in chips) 
Seat 5: CashMatteo (2258 in chips) 
Seat 6: Wisedevil1977 (3000 in chips) 
Seat 8: claudelegault (3321 in chips) 
londong1978: posts the ante 15
Hugo5619: posts the ante 15
tuk-tuk67: posts the ante 15
ForeignSlang: posts the ante 15
CashMatteo: posts the ante 15
Wisedevil1977: posts the ante 15
claudelegault: posts the ante 15
CashMatteo: posts small blind 30
Wisedevil1977: posts big blind 60
*** HOLE CARDS ***
Dealt to CashMatteo [Ts 3d]
claudelegault: folds 
londong1978: raises 60 to 120
Hugo5619: calls 120
tuk-tuk67: folds 
ForeignSlang: folds 
CashMatteo: folds 
Wisedevil1977: folds 
*** FLOP *** [5s Tc Ac]
londong1978: bets 120
Hugo5619: calls 120
*** TURN *** [5s Tc Ac] [3h]
londong1978: bets 60
Hugo5619: calls 60
*** RIVER *** [5s Tc Ac 3h] [Js]
londong1978: checks 
Hugo5619: checks 
*** SHOW DOWN ***
londong1978: shows [7c 7s] (a pair of Sevens)
Hugo5619: mucks hand 
londong1978 collected 795 from pot
*** SUMMARY ***
Total pot 795 | Rake 0 
Board [5s Tc Ac 3h Js]
Seat 1: londong1978 showed [7c 7s] and won (795) with a pair of Sevens
Seat 2: Hugo5619 mucked [Qc 6c]
Seat 3: tuk-tuk67 folded before Flop (didn't bet)
Seat 4: ForeignSlang (button) folded before Flop (didn't bet)
Seat 5: CashMatteo (small blind) folded before Flop
Seat 6: Wisedevil1977 (big blind) folded before Flop
Seat 8: claudelegault folded before Flop (didn't bet)

Hand #1288: 

PokerStars Hand #246671932734: Tournament #3659798281, $0.94+$0.06 CAD Hold'em No Limit - Level III (30/60) - 2023/10/21 22:12:31 ET
Table '3659798281 4' 8-max Seat #5 is the button
Seat 1: londong1978 (4045 in chips) 
Seat 2: Hugo5619 (2520 in chips) 
Seat 3: tuk-tuk67 (3416 in chips) 
Seat 4: ForeignSlang (3976 in chips) 
Seat 5: CashMatteo (2213 in chips) 
Seat 6: Wisedevil1977 (2925 in chips) 
londong1978: posts the ante 15
Hugo5619: posts the ante 15
tuk-tuk67: posts the ante 15
ForeignSlang: posts the ante 15
CashMatteo: posts the ante 15
Wisedevil1977: posts the ante 15
Wisedevil1977: posts small blind 30
londong1978: posts big blind 60
*** HOLE CARDS ***
Dealt to CashMatteo [4h Kh]
Hugo5619: calls 60
tuk-tuk67: raises 180 to 240
ForeignSlang: folds 
CashMatteo: folds 
Wisedevil1977: folds 
londong1978: folds 
Hugo5619: folds 
Uncalled bet (180) returned to tuk-tuk67
tuk-tuk67 collected 300 from pot
tuk-tuk67: doesn't show hand 
StingerBud is disconnected 
*** SUMMARY ***
Total pot 300 | Rake 0 
Seat 1: londong1978 (big blind) folded before Flop
Seat 2: Hugo5619 folded before Flop
Seat 3: tuk-tuk67 collected (300)
Seat 4: ForeignSlang folded before Flop (didn't bet)
Seat 5: CashMatteo (button) folded before Flop (didn't bet)
Seat 6: Wisedevil1977 (small blind) folded before Flop

Hand #1289: 

PokerStars Hand #246671936152: Tournament #3659798281, $0.94+$0.06 CAD Hold'em No Limit - Level III (30/60) - 2023/10/21 22:12:50 ET
Table '3659798281 4' 8-max Seat #6 is the button
Seat 1: londong1978 (3970 in chips) 
Seat 2: Hugo5619 (2445 in chips) 
Seat 4: ForeignSlang (3961 in chips) 
Seat 5: CashMatteo (2198 in chips) 
Seat 6: Wisedevil1977 (2880 in chips) 
Seat 7: StingerBud (3000 in chips) out of hand (moved from another table into small blind)
StingerBud will be allowed to play after the button
londong1978: posts the ante 15
Hugo5619: posts the ante 15
ForeignSlang: posts the ante 15
CashMatteo: posts the ante 15
Wisedevil1977: posts the ante 15
londong1978: posts small blind 30
Hugo5619: posts big blind 60
*** HOLE CARDS ***
Dealt to CashMatteo [Qc 5d]
ForeignSlang: folds 
CashMatteo: folds 
Wisedevil1977: raises 60 to 120
londong1978: calls 90
Hugo5619: folds 
*** FLOP *** [Td 7d 9d]
londong1978: checks 
Wisedevil1977: checks 
*** TURN *** [Td 7d 9d] [8d]
londong1978: checks 
Wisedevil1977: checks 
*** RIVER *** [Td 7d 9d 8d] [Kd]
londong1978: bets 60
Wisedevil1977: raises 60 to 120
londong1978: calls 60
*** SHOW DOWN ***
Wisedevil1977: shows [Kh Qh] (a flush, King high)
londong1978: shows [2c Ac] (a flush, King high)
londong1978 collected 308 from pot
Wisedevil1977 collected 307 from pot
*** SUMMARY ***
Total pot 615 | Rake 0 
Board [Td 7d 9d 8d Kd]
Seat 1: londong1978 (small blind) showed [2c Ac] and won (308) with a flush, King high
Seat 2: Hugo5619 (big blind) folded before Flop
Seat 4: ForeignSlang folded before Flop (didn't bet)
Seat 5: CashMatteo folded before Flop (didn't bet)
Seat 6: Wisedevil1977 (button) showed [Kh Qh] and won (307) with a flush, King high

Hand #1290: 

PokerStars Hand #246671944122: Tournament #3659798281, $0.94+$0.06 CAD Hold'em No Limit - Level III (30/60) - 2023/10/21 22:13:37 ET
Table '3659798281 4' 8-max Seat #1 is the button
Seat 1: londong1978 (4023 in chips) 
Seat 2: Hugo5619 (2370 in chips) 
Seat 4: ForeignSlang (3946 in chips) 
Seat 5: CashMatteo (2183 in chips) 
Seat 6: Wisedevil1977 (2932 in chips) 
Seat 7: StingerBud (3000 in chips) 
Seat 8: Tarps0FF (3000 in chips) 
londong1978: posts the ante 15
Hugo5619: posts the ante 15
ForeignSlang: posts the ante 15
CashMatteo: posts the ante 15
Wisedevil1977: posts the ante 15
StingerBud: posts the ante 15
Tarps0FF: posts the ante 15
Hugo5619: posts small blind 30
ForeignSlang: posts big blind 60
*** HOLE CARDS ***
Dealt to CashMatteo [Qc Kd]
CashMatteo: calls 60
Wisedevil1977: folds 
StingerBud: calls 60
Tarps0FF: folds 
londong1978: folds 
Hugo5619: calls 30
ForeignSlang: checks 
*** FLOP *** [Ac Qd Qs]
Hugo5619: checks 
ForeignSlang: checks 
CashMatteo: checks 
StingerBud: bets 120
Hugo5619: folds 
ForeignSlang: folds 
CashMatteo: calls 120
*** TURN *** [Ac Qd Qs] [Jc]
CashMatteo: checks 
StingerBud: bets 240
CashMatteo: calls 240
*** RIVER *** [Ac Qd Qs Jc] [2h]
CashMatteo: checks 
StingerBud: bets 420
CashMatteo: calls 420
*** SHOW DOWN ***
StingerBud: shows [7h 9h] (a pair of Queens)
CashMatteo: shows [Qc Kd] (three of a kind, Queens)
CashMatteo collected 1905 from pot
*** SUMMARY ***
Total pot 1905 | Rake 0 
Board [Ac Qd Qs Jc 2h]
Seat 1: londong1978 (button) folded before Flop (didn't bet)
Seat 2: Hugo5619 (small blind) folded on the Flop
Seat 4: ForeignSlang (big blind) folded on the Flop
Seat 5: CashMatteo showed [Qc Kd] and won (1905) with three of a kind, Queens
Seat 6: Wisedevil1977 folded before Flop (didn't bet)
Seat 7: StingerBud showed [7h 9h] and lost with a pair of Queens
Seat 8: Tarps0FF folded before Flop (didn't bet)

Hand #1291: 

PokerStars Hand #246671958091: Tournament #3659798281, $0.94+$0.06 CAD Hold'em No Limit - Level IV (40/80) - 2023/10/21 22:15:01 ET
Table '3659798281 4' 8-max Seat #2 is the button
Seat 1: londong1978 (4008 in chips) 
Seat 2: Hugo5619 (2295 in chips) 
Seat 4: ForeignSlang (3871 in chips) 
Seat 5: CashMatteo (3233 in chips) 
Seat 6: Wisedevil1977 (2917 in chips) 
Seat 7: StingerBud (2145 in chips) 
Seat 8: Tarps0FF (2985 in chips) 
londong1978: posts the ante 20
Hugo5619: posts the ante 20
ForeignSlang: posts the ante 20
CashMatteo: posts the ante 20
Wisedevil1977: posts the ante 20
StingerBud: posts the ante 20
Tarps0FF: posts the ante 20
ForeignSlang: posts small blind 40
CashMatteo: posts big blind 80
*** HOLE CARDS ***
Dealt to CashMatteo [6s 4s]
Wisedevil1977: raises 80 to 160
StingerBud: folds 
Tarps0FF: folds 
londong1978: folds 
Hugo5619: folds 
ForeignSlang: raises 160 to 320
CashMatteo: folds 
Wisedevil1977: calls 160
*** FLOP *** [Jc 3d Js]
ForeignSlang: bets 430
Wisedevil1977: folds 
Uncalled bet (430) returned to ForeignSlang
ForeignSlang collected 860 from pot
ForeignSlang: doesn't show hand 
*** SUMMARY ***
Total pot 860 | Rake 0 
Board [Jc 3d Js]
Seat 1: londong1978 folded before Flop (didn't bet)
Seat 2: Hugo5619 (button) folded before Flop (didn't bet)
Seat 4: ForeignSlang (small blind) collected (860)
Seat 5: CashMatteo (big blind) folded before Flop
Seat 6: Wisedevil1977 folded on the Flop
Seat 7: StingerBud folded before Flop (didn't bet)
Seat 8: Tarps0FF folded before Flop (didn't bet)

Hand #1292: 

PokerStars Hand #246671962633: Tournament #3659798281, $0.94+$0.06 CAD Hold'em No Limit - Level IV (40/80) - 2023/10/21 22:15:29 ET
Table '3659798281 4' 8-max Seat #4 is the button
Seat 1: londong1978 (3988 in chips) 
Seat 2: Hugo5619 (2275 in chips) 
Seat 4: ForeignSlang (4391 in chips) 
Seat 5: CashMatteo (3133 in chips) 
Seat 6: Wisedevil1977 (2577 in chips) 
Seat 7: StingerBud (2125 in chips) 
Seat 8: Tarps0FF (2965 in chips) 
londong1978: posts the ante 20
Hugo5619: posts the ante 20
ForeignSlang: posts the ante 20
CashMatteo: posts the ante 20
Wisedevil1977: posts the ante 20
StingerBud: posts the ante 20
Tarps0FF: posts the ante 20
CashMatteo: posts small blind 40
Wisedevil1977: posts big blind 80
*** HOLE CARDS ***
Dealt to CashMatteo [Th Qd]
StingerBud: folds 
Tarps0FF: folds 
londong1978: folds 
Hugo5619: raises 80 to 160
ForeignSlang: calls 160
CashMatteo: calls 120
Wisedevil1977: folds 
*** FLOP *** [Kd 2d 6d]
CashMatteo: checks 
Hugo5619: checks 
ForeignSlang: checks 
*** TURN *** [Kd 2d 6d] [Td]
CashMatteo: checks 
Hugo5619: checks 
ForeignSlang: bets 350
CashMatteo: calls 350
Hugo5619: folds 
*** RIVER *** [Kd 2d 6d Td] [8h]
CashMatteo: bets 700
ForeignSlang: folds 
Uncalled bet (700) returned to CashMatteo
CashMatteo collected 1400 from pot
CashMatteo: doesn't show hand 
*** SUMMARY ***
Total pot 1400 | Rake 0 
Board [Kd 2d 6d Td 8h]
Seat 1: londong1978 folded before Flop (didn't bet)
Seat 2: Hugo5619 folded on the Turn
Seat 4: ForeignSlang (button) folded on the River
Seat 5: CashMatteo (small blind) collected (1400)
Seat 6: Wisedevil1977 (big blind) folded before Flop
Seat 7: StingerBud folded before Flop (didn't bet)
Seat 8: Tarps0FF folded before Flop (didn't bet)

Hand #1293: 

PokerStars Hand #246671971056: Tournament #3659798281, $0.94+$0.06 CAD Hold'em No Limit - Level IV (40/80) - 2023/10/21 22:16:19 ET
Table '3659798281 4' 8-max Seat #5 is the button
Seat 1: londong1978 (3968 in chips) 
Seat 2: Hugo5619 (2095 in chips) 
Seat 3: sunshine2304 (3000 in chips) 
Seat 4: ForeignSlang (3861 in chips) 
Seat 5: CashMatteo (4003 in chips) 
Seat 6: Wisedevil1977 (2477 in chips) 
Seat 7: StingerBud (2105 in chips) 
Seat 8: Tarps0FF (2945 in chips) 
londong1978: posts the ante 20
Hugo5619: posts the ante 20
sunshine2304: posts the ante 20
ForeignSlang: posts the ante 20
CashMatteo: posts the ante 20
Wisedevil1977: posts the ante 20
StingerBud: posts the ante 20
Tarps0FF: posts the ante 20
Wisedevil1977: posts small blind 40
StingerBud: posts big blind 80
*** HOLE CARDS ***
Dealt to CashMatteo [2d 8c]
Tarps0FF: folds 
londong1978: folds 
Hugo5619: folds 
sunshine2304: calls 80
ForeignSlang: folds 
CashMatteo: folds 
Wisedevil1977: folds 
StingerBud: checks 
*** FLOP *** [3c 6d Kh]
StingerBud: checks 
sunshine2304: checks 
*** TURN *** [3c 6d Kh] [Kd]
StingerBud: checks 
sunshine2304: checks 
*** RIVER *** [3c 6d Kh Kd] [Qc]
StingerBud: checks 
sunshine2304: checks 
*** SHOW DOWN ***
StingerBud: shows [2c 7s] (a pair of Kings)
sunshine2304: shows [Jc 7h] (a pair of Kings - Queen+Jack kicker)
sunshine2304 collected 360 from pot
*** SUMMARY ***
Total pot 360 | Rake 0 
Board [3c 6d Kh Kd Qc]
Seat 1: londong1978 folded before Flop (didn't bet)
Seat 2: Hugo5619 folded before Flop (didn't bet)
Seat 3: sunshine2304 showed [Jc 7h] and won (360) with a pair of Kings
Seat 4: ForeignSlang folded before Flop (didn't bet)
Seat 5: CashMatteo (button) folded before Flop (didn't bet)
Seat 6: Wisedevil1977 (small blind) folded before Flop
Seat 7: StingerBud (big blind) showed [2c 7s] and lost with a pair of Kings
Seat 8: Tarps0FF folded before Flop (didn't bet)

Hand #1294: 

PokerStars Hand #246671978728: Tournament #3659798281, $0.94+$0.06 CAD Hold'em No Limit - Level IV (40/80) - 2023/10/21 22:17:04 ET
Table '3659798281 4' 8-max Seat #6 is the button
Seat 1: londong1978 (3948 in chips) 
Seat 2: Hugo5619 (2075 in chips) 
Seat 3: sunshine2304 (3260 in chips) 
Seat 4: ForeignSlang (3841 in chips) 
Seat 5: CashMatteo (3983 in chips) 
Seat 6: Wisedevil1977 (2417 in chips) 
Seat 7: StingerBud (2005 in chips) 
Seat 8: Tarps0FF (2925 in chips) 
londong1978: posts the ante 20
Hugo5619: posts the ante 20
sunshine2304: posts the ante 20
ForeignSlang: posts the ante 20
CashMatteo: posts the ante 20
Wisedevil1977: posts the ante 20
StingerBud: posts the ante 20
Tarps0FF: posts the ante 20
StingerBud: posts small blind 40
Tarps0FF: posts big blind 80
*** HOLE CARDS ***
Dealt to CashMatteo [7d 2d]
londong1978: raises 160 to 240
Hugo5619: calls 240
sunshine2304: folds 
ForeignSlang: folds 
CashMatteo: folds 
Wisedevil1977: folds 
StingerBud: calls 200
Tarps0FF: folds 
*** FLOP *** [Ks 4d 9s]
StingerBud: checks 
londong1978: bets 160
Hugo5619: raises 160 to 320
StingerBud: folds 
londong1978: raises 400 to 720
Hugo5619: raises 1095 to 1815 and is all-in
londong1978: calls 1095
*** TURN *** [Ks 4d 9s] [7s]
*** RIVER *** [Ks 4d 9s 7s] [Qs]
*** SHOW DOWN ***
londong1978: shows [Kd Kc] (three of a kind, Kings)
Hugo5619: shows [Kh 9d] (two pair, Kings and Nines)
londong1978 collected 4590 from pot
Hugo5619 finished the tournament in 72nd place
*** SUMMARY ***
Total pot 4590 | Rake 0 
Board [Ks 4d 9s 7s Qs]
Seat 1: londong1978 showed [Kd Kc] and won (4590) with three of a kind, Kings
Seat 2: Hugo5619 showed [Kh 9d] and lost with two pair, Kings and Nines
Seat 3: sunshine2304 folded before Flop (didn't bet)
Seat 4: ForeignSlang folded before Flop (didn't bet)
Seat 5: CashMatteo folded before Flop (didn't bet)
Seat 6: Wisedevil1977 (button) folded before Flop (didn't bet)
Seat 7: StingerBud (small blind) folded on the Flop
Seat 8: Tarps0FF (big blind) folded before Flop

Hand #1295: 

PokerStars Hand #246671987641: Tournament #3659798281, $0.94+$0.06 CAD Hold'em No Limit - Level V (50/100) - 2023/10/21 22:17:56 ET
Table '3659798281 4' 8-max Seat #7 is the button
Seat 1: londong1978 (6463 in chips) 
Seat 3: sunshine2304 (3240 in chips) 
Seat 4: ForeignSlang (3821 in chips) 
Seat 5: CashMatteo (3963 in chips) 
Seat 6: Wisedevil1977 (2397 in chips) 
Seat 7: StingerBud (1745 in chips) 
Seat 8: Tarps0FF (2825 in chips) 
londong1978: posts the ante 25
sunshine2304: posts the ante 25
ForeignSlang: posts the ante 25
CashMatteo: posts the ante 25
Wisedevil1977: posts the ante 25
StingerBud: posts the ante 25
Tarps0FF: posts the ante 25
Tarps0FF: posts small blind 50
londong1978: posts big blind 100
*** HOLE CARDS ***
Dealt to CashMatteo [5d 6h]
sunshine2304: calls 100
ForeignSlang: calls 100
CashMatteo: folds 
Wisedevil1977: folds 
StingerBud: raises 400 to 500
Tarps0FF: folds 
londong1978: raises 5938 to 6438 and is all-in
sunshine2304: folds 
ForeignSlang: folds 
StingerBud: calls 1220 and is all-in
Uncalled bet (4718) returned to londong1978
*** FLOP *** [Ts 6d 3h]
*** TURN *** [Ts 6d 3h] [5h]
*** RIVER *** [Ts 6d 3h 5h] [Js]
*** SHOW DOWN ***
londong1978: shows [Qc Qh] (a pair of Queens)
StingerBud: shows [Kc Ad] (high card Ace)
londong1978 collected 3865 from pot
StingerBud finished the tournament in 71st place
*** SUMMARY ***
Total pot 3865 | Rake 0 
Board [Ts 6d 3h 5h Js]
Seat 1: londong1978 (big blind) showed [Qc Qh] and won (3865) with a pair of Queens
Seat 3: sunshine2304 folded before Flop
Seat 4: ForeignSlang folded before Flop
Seat 5: CashMatteo folded before Flop (didn't bet)
Seat 6: Wisedevil1977 folded before Flop (didn't bet)
Seat 7: StingerBud (button) showed [Kc Ad] and lost with high card Ace
Seat 8: Tarps0FF (small blind) folded before Flop

Hand #1296: 

PokerStars Hand #246671994368: Tournament #3659798281, $0.94+$0.06 CAD Hold'em No Limit - Level V (50/100) - 2023/10/21 22:18:36 ET
Table '3659798281 4' 8-max Seat #8 is the button
Seat 1: londong1978 (8583 in chips) 
Seat 2: sandbagger2327 (3000 in chips) 
Seat 3: sunshine2304 (3115 in chips) 
Seat 4: ForeignSlang (3696 in chips) 
Seat 5: CashMatteo (3938 in chips) 
Seat 6: Wisedevil1977 (2372 in chips) 
Seat 8: Tarps0FF (2750 in chips) 
londong1978: posts the ante 25
sandbagger2327: posts the ante 25
sunshine2304: posts the ante 25
ForeignSlang: posts the ante 25
CashMatteo: posts the ante 25
Wisedevil1977: posts the ante 25
Tarps0FF: posts the ante 25
londong1978: posts small blind 50
sandbagger2327: posts big blind 100
*** HOLE CARDS ***
Dealt to CashMatteo [6c 3h]
sunshine2304: folds 
ForeignSlang: calls 100
CashMatteo: folds 
Wisedevil1977: folds 
Tarps0FF: folds 
londong1978: calls 50
sandbagger2327: checks 
*** FLOP *** [7d 8h Ts]
londong1978: bets 100
sandbagger2327: calls 100
ForeignSlang: folds 
*** TURN *** [7d 8h Ts] [8s]
londong1978: bets 100
sandbagger2327: raises 100 to 200
londong1978: calls 100
*** RIVER *** [7d 8h Ts 8s] [3c]
londong1978: bets 100
sandbagger2327: calls 100
*** SHOW DOWN ***
londong1978: shows [Qd Td] (two pair, Tens and Eights)
sandbagger2327: mucks hand 
londong1978 collected 1275 from pot
*** SUMMARY ***
Total pot 1275 | Rake 0 
Board [7d 8h Ts 8s 3c]
Seat 1: londong1978 (small blind) showed [Qd Td] and won (1275) with two pair, Tens and Eights
Seat 2: sandbagger2327 (big blind) mucked [Js 7s]
Seat 3: sunshine2304 folded before Flop (didn't bet)
Seat 4: ForeignSlang folded on the Flop
Seat 5: CashMatteo folded before Flop (didn't bet)
Seat 6: Wisedevil1977 folded before Flop (didn't bet)
Seat 8: Tarps0FF (button) folded before Flop (didn't bet)

Hand #1297: 

PokerStars Hand #246672002504: Tournament #3659798281, $0.94+$0.06 CAD Hold'em No Limit - Level V (50/100) - 2023/10/21 22:19:24 ET
Table '3659798281 4' 8-max Seat #1 is the button
Seat 1: londong1978 (9333 in chips) 
Seat 2: sandbagger2327 (2475 in chips) 
Seat 3: sunshine2304 (3090 in chips) 
Seat 4: ForeignSlang (3571 in chips) 
Seat 5: CashMatteo (3913 in chips) 
Seat 6: Wisedevil1977 (2347 in chips) 
Seat 7: B33kon (3000 in chips) 
Seat 8: Tarps0FF (2725 in chips) 
londong1978: posts the ante 25
sandbagger2327: posts the ante 25
sunshine2304: posts the ante 25
ForeignSlang: posts the ante 25
CashMatteo: posts the ante 25
Wisedevil1977: posts the ante 25
B33kon: posts the ante 25
Tarps0FF: posts the ante 25
sandbagger2327: posts small blind 50
sunshine2304: posts big blind 100
*** HOLE CARDS ***
Dealt to CashMatteo [Qs Tc]
ForeignSlang: folds 
CashMatteo: raises 150 to 250
Wisedevil1977: calls 250
B33kon: calls 250
Tarps0FF: raises 2450 to 2700 and is all-in
londong1978: folds 
sandbagger2327: folds 
sunshine2304: folds 
CashMatteo: folds 
Wisedevil1977: calls 2072 and is all-in
B33kon: calls 2450
*** FLOP *** [Js Jc 4h]
*** TURN *** [Js Jc 4h] [6c]
*** RIVER *** [Js Jc 4h 6c] [8c]
*** SHOW DOWN ***
B33kon: shows [Td Kd] (a pair of Jacks)
Tarps0FF: shows [As Ac] (two pair, Aces and Jacks)
Tarps0FF collected 756 from side pot
Wisedevil1977: shows [Kc 4c] (a flush, King high)
Wisedevil1977 collected 7566 from main pot
*** SUMMARY ***
Total pot 8322 Main pot 7566. Side pot 756. | Rake 0 
Board [Js Jc 4h 6c 8c]
Seat 1: londong1978 (button) folded before Flop (didn't bet)
Seat 2: sandbagger2327 (small blind) folded before Flop
Seat 3: sunshine2304 (big blind) folded before Flop
Seat 4: ForeignSlang folded before Flop (didn't bet)
Seat 5: CashMatteo folded before Flop
Seat 6: Wisedevil1977 showed [Kc 4c] and won (7566) with a flush, King high
Seat 7: B33kon showed [Td Kd] and lost with a pair of Jacks
Seat 8: Tarps0FF showed [As Ac] and won (756) with two pair, Aces and Jacks

Hand #1298: 

PokerStars Hand #246672009148: Tournament #3659798281, $0.94+$0.06 CAD Hold'em No Limit - Level V (50/100) - 2023/10/21 22:20:03 ET
Table '3659798281 4' 8-max Seat #2 is the button
Seat 1: londong1978 (9308 in chips) 
Seat 2: sandbagger2327 (2400 in chips) 
Seat 3: sunshine2304 (2965 in chips) 
Seat 4: ForeignSlang (3546 in chips) 
Seat 5: CashMatteo (3638 in chips) 
Seat 6: Wisedevil1977 (7566 in chips) 
Seat 7: B33kon (275 in chips) 
Seat 8: Tarps0FF (756 in chips) 
londong1978: posts the ante 25
sandbagger2327: posts the ante 25
sunshine2304: posts the ante 25
ForeignSlang: posts the ante 25
CashMatteo: posts the ante 25
Wisedevil1977: posts the ante 25
B33kon: posts the ante 25
Tarps0FF: posts the ante 25
sunshine2304: posts small blind 50
ForeignSlang: posts big blind 100
*** HOLE CARDS ***
Dealt to CashMatteo [8c Tc]
CashMatteo: calls 100
Wisedevil1977: folds 
B33kon: raises 150 to 250 and is all-in
Tarps0FF: folds 
londong1978: folds 
sandbagger2327: folds 
sunshine2304: folds 
ForeignSlang: folds 
CashMatteo: calls 150
*** FLOP *** [Qc 8h Qs]
*** TURN *** [Qc 8h Qs] [7c]
*** RIVER *** [Qc 8h Qs 7c] [4h]
*** SHOW DOWN ***
CashMatteo: shows [8c Tc] (two pair, Queens and Eights)
B33kon: shows [7d 2d] (two pair, Queens and Sevens)
CashMatteo collected 850 from pot
B33kon finished the tournament in 68th place
*** SUMMARY ***
Total pot 850 | Rake 0 
Board [Qc 8h Qs 7c 4h]
Seat 1: londong1978 folded before Flop (didn't bet)
Seat 2: sandbagger2327 (button) folded before Flop (didn't bet)
Seat 3: sunshine2304 (small blind) folded before Flop
Seat 4: ForeignSlang (big blind) folded before Flop
Seat 5: CashMatteo showed [8c Tc] and won (850) with two pair, Queens and Eights
Seat 6: Wisedevil1977 folded before Flop (didn't bet)
Seat 7: B33kon showed [7d 2d] and lost with two pair, Queens and Sevens
Seat 8: Tarps0FF folded before Flop (didn't bet)

Hand #1299: 

PokerStars Hand #246672014782: Tournament #3659798281, $0.94+$0.06 CAD Hold'em No Limit - Level VI (60/120) - 2023/10/21 22:20:36 ET
Table '3659798281 4' 8-max Seat #3 is the button
Seat 1: londong1978 (9283 in chips) 
Seat 2: sandbagger2327 (2375 in chips) 
Seat 3: sunshine2304 (2890 in chips) 
Seat 4: ForeignSlang (3421 in chips) 
Seat 5: CashMatteo (4213 in chips) 
Seat 6: Wisedevil1977 (7541 in chips) 
Seat 8: Tarps0FF (731 in chips) 
londong1978: posts the ante 30
sandbagger2327: posts the ante 30
sunshine2304: posts the ante 30
ForeignSlang: posts the ante 30
CashMatteo: posts the ante 30
Wisedevil1977: posts the ante 30
Tarps0FF: posts the ante 30
ForeignSlang: posts small blind 60
CashMatteo: posts big blind 120
*** HOLE CARDS ***
Dealt to CashMatteo [Ah Kd]
Wisedevil1977: raises 120 to 240
Tarps0FF: raises 461 to 701 and is all-in
londong1978: folds 
sandbagger2327: folds 
sunshine2304: calls 701
ForeignSlang: folds 
CashMatteo: raises 3482 to 4183 and is all-in
Wisedevil1977: raises 3328 to 7511 and is all-in
sunshine2304: calls 2159 and is all-in
Uncalled bet (3328) returned to Wisedevil1977
*** FLOP *** [Jc 2c Jh]
*** TURN *** [Jc 2c Jh] [2h]
*** RIVER *** [Jc 2c Jh 2h] [5s]
*** SHOW DOWN ***
CashMatteo: shows [Ah Kd] (two pair, Jacks and Deuces)
Wisedevil1977: shows [Ac Ks] (two pair, Jacks and Deuces)
CashMatteo collected 1323 from side pot-2 
Wisedevil1977 collected 1323 from side pot-2 
sunshine2304: shows [Jd Qd] (a full house, Jacks full of Deuces)
sunshine2304 collected 6477 from side pot-1 
Tarps0FF: shows [Tc Td] (two pair, Jacks and Tens)
sunshine2304 collected 3074 from main pot
Tarps0FF finished the tournament in 67th place
*** SUMMARY ***
Total pot 12197 Main pot 3074. Side pot-1 6477. Side pot-2 2646. | Rake 0 
Board [Jc 2c Jh 2h 5s]
Seat 1: londong1978 folded before Flop (didn't bet)
Seat 2: sandbagger2327 folded before Flop (didn't bet)
Seat 3: sunshine2304 (button) showed [Jd Qd] and won (9551) with a full house, Jacks full of Deuces
Seat 4: ForeignSlang (small blind) folded before Flop
Seat 5: CashMatteo (big blind) showed [Ah Kd] and won (1323) with two pair, Jacks and Deuces
Seat 6: Wisedevil1977 showed [Ac Ks] and won (1323) with two pair, Jacks and Deuces
Seat 8: Tarps0FF showed [Tc Td] and lost with two pair, Jacks and Tens

Hand #1300: 

PokerStars Hand #246672021467: Tournament #3659798281, $0.94+$0.06 CAD Hold'em No Limit - Level VI (60/120) - 2023/10/21 22:21:15 ET
Table '3659798281 4' 8-max Seat #4 is the button
Seat 1: londong1978 (9253 in chips) 
Seat 2: sandbagger2327 (2345 in chips) 
Seat 3: sunshine2304 (9551 in chips) 
Seat 4: ForeignSlang (3331 in chips) 
Seat 5: CashMatteo (1323 in chips) 
Seat 7: LGrant2710 (3000 in chips) 
londong1978: posts the ante 30
sandbagger2327: posts the ante 30
sunshine2304: posts the ante 30
ForeignSlang: posts the ante 30
CashMatteo: posts the ante 30
LGrant2710: posts the ante 30
CashMatteo: posts small blind 60
LGrant2710: posts big blind 120
*** HOLE CARDS ***
Dealt to CashMatteo [Jd 6s]
londong1978: folds 
sandbagger2327: folds 
sunshine2304: calls 120
ForeignSlang: folds 
CashMatteo: folds 
LGrant2710: checks 
*** FLOP *** [5c 7h Ks]
LGrant2710: bets 240
sunshine2304: folds 
Uncalled bet (240) returned to LGrant2710
LGrant2710 collected 480 from pot
LGrant2710: shows [8h Kd] (a pair of Kings)
*** SUMMARY ***
Total pot 480 | Rake 0 
Board [5c 7h Ks]
Seat 1: londong1978 folded before Flop (didn't bet)
Seat 2: sandbagger2327 folded before Flop (didn't bet)
Seat 3: sunshine2304 folded on the Flop
Seat 4: ForeignSlang (button) folded before Flop (didn't bet)
Seat 5: CashMatteo (small blind) folded before Flop
Seat 7: LGrant2710 (big blind) collected (480)

Hand #1301: 

PokerStars Hand #246672025419: Tournament #3659798281, $0.94+$0.06 CAD Hold'em No Limit - Level VI (60/120) - 2023/10/21 22:21:38 ET
Table '3659798281 4' 8-max Seat #5 is the button
Seat 2: sandbagger2327 (2315 in chips) 
Seat 3: sunshine2304 (9401 in chips) 
Seat 4: ForeignSlang (3301 in chips) 
Seat 5: CashMatteo (1233 in chips) 
Seat 7: LGrant2710 (3330 in chips) 
sandbagger2327: posts the ante 30
sunshine2304: posts the ante 30
ForeignSlang: posts the ante 30
CashMatteo: posts the ante 30
LGrant2710: posts the ante 30
LGrant2710: posts small blind 60
sandbagger2327: posts big blind 120
*** HOLE CARDS ***
Dealt to CashMatteo [6c 5s]
sunshine2304: folds 
ForeignSlang: calls 120
CashMatteo: folds 
LGrant2710: calls 60
sandbagger2327: checks 
*** FLOP *** [5c 2c Ac]
LGrant2710: checks 
sandbagger2327: checks 
ForeignSlang: bets 255
LGrant2710: folds 
sandbagger2327: calls 255
*** TURN *** [5c 2c Ac] [Tc]
sandbagger2327: bets 240
ForeignSlang: calls 240
*** RIVER *** [5c 2c Ac Tc] [3c]
sandbagger2327: bets 360
ForeignSlang: raises 360 to 720
sandbagger2327: calls 360
*** SHOW DOWN ***
ForeignSlang: shows [Kc 9h] (a flush, Ace high)
sandbagger2327: mucks hand 
ForeignSlang collected 2940 from pot
*** SUMMARY ***
Total pot 2940 | Rake 0 
Board [5c 2c Ac Tc 3c]
Seat 2: sandbagger2327 (big blind) mucked [Jd Qc]
Seat 3: sunshine2304 folded before Flop (didn't bet)
Seat 4: ForeignSlang showed [Kc 9h] and won (2940) with a flush, Ace high
Seat 5: CashMatteo (button) folded before Flop (didn't bet)
Seat 7: LGrant2710 (small blind) folded on the Flop

Hand #1302: 

PokerStars Hand #246672034129: Tournament #3659798281, $0.94+$0.06 CAD Hold'em No Limit - Level VI (60/120) - 2023/10/21 22:22:29 ET
Table '3659798281 4' 8-max Seat #7 is the button
Seat 2: sandbagger2327 (950 in chips) 
Seat 3: sunshine2304 (9371 in chips) 
Seat 4: ForeignSlang (4876 in chips) 
Seat 5: CashMatteo (1203 in chips) 
Seat 6: Redman3298 (2480 in chips) 
Seat 7: LGrant2710 (3180 in chips) 
sandbagger2327: posts the ante 30
sunshine2304: posts the ante 30
ForeignSlang: posts the ante 30
CashMatteo: posts the ante 30
Redman3298: posts the ante 30
LGrant2710: posts the ante 30
sandbagger2327: posts small blind 60
sunshine2304: posts big blind 120
*** HOLE CARDS ***
Dealt to CashMatteo [Tc 7s]
ForeignSlang said, "losing to the 4"
ForeignSlang: folds 
CashMatteo: folds 
Redman3298: calls 120
LGrant2710: calls 120
sandbagger2327: calls 60
sunshine2304: checks 
*** FLOP *** [Th 3c 7h]
sandbagger2327: checks 
sunshine2304: checks 
Redman3298: checks 
LGrant2710: bets 330
sandbagger2327: folds 
sunshine2304: folds 
Redman3298: folds 
Uncalled bet (330) returned to LGrant2710
LGrant2710 collected 660 from pot
*** SUMMARY ***
Total pot 660 | Rake 0 
Board [Th 3c 7h]
Seat 2: sandbagger2327 (small blind) folded on the Flop
Seat 3: sunshine2304 (big blind) folded on the Flop
Seat 4: ForeignSlang folded before Flop (didn't bet)
Seat 5: CashMatteo folded before Flop (didn't bet)
Seat 6: Redman3298 folded on the Flop
Seat 7: LGrant2710 (button) collected (660)

Hand #1303: 

PokerStars Hand #246672042369: Tournament #3659798281, $0.94+$0.06 CAD Hold'em No Limit - Level VII (80/160) - 2023/10/21 22:23:17 ET
Table '3659798281 4' 8-max Seat #2 is the button
Seat 2: sandbagger2327 (800 in chips) 
Seat 3: sunshine2304 (9221 in chips) 
Seat 4: ForeignSlang (4846 in chips) 
Seat 5: CashMatteo (1173 in chips) 
Seat 6: Redman3298 (2330 in chips) 
Seat 7: LGrant2710 (3690 in chips) 
Seat 8: Knoname8 (3000 in chips) 
sandbagger2327: posts the ante 40
sunshine2304: posts the ante 40
ForeignSlang: posts the ante 40
CashMatteo: posts the ante 40
Redman3298: posts the ante 40
LGrant2710: posts the ante 40
Knoname8: posts the ante 40
sunshine2304: posts small blind 80
ForeignSlang: posts big blind 160
*** HOLE CARDS ***
Dealt to CashMatteo [Ks Kd]
CashMatteo: raises 973 to 1133 and is all-in
Redman3298: folds 
LGrant2710: folds 
Knoname8: folds 
sandbagger2327: folds 
sunshine2304: folds 
ForeignSlang: folds 
Uncalled bet (973) returned to CashMatteo
CashMatteo collected 680 from pot
CashMatteo: doesn't show hand 
*** SUMMARY ***
Total pot 680 | Rake 0 
Seat 2: sandbagger2327 (button) folded before Flop (didn't bet)
Seat 3: sunshine2304 (small blind) folded before Flop
Seat 4: ForeignSlang (big blind) folded before Flop
Seat 5: CashMatteo collected (680)
Seat 6: Redman3298 folded before Flop (didn't bet)
Seat 7: LGrant2710 folded before Flop (didn't bet)
Seat 8: Knoname8 folded before Flop (didn't bet)

Hand #1304: 

PokerStars Hand #246672044700: Tournament #3659798281, $0.94+$0.06 CAD Hold'em No Limit - Level VII (80/160) - 2023/10/21 22:23:31 ET
Table '3659798281 4' 8-max Seat #3 is the button
Seat 2: sandbagger2327 (760 in chips) 
Seat 3: sunshine2304 (9101 in chips) 
Seat 4: ForeignSlang (4646 in chips) 
Seat 5: CashMatteo (1653 in chips) 
Seat 6: Redman3298 (2290 in chips) 
Seat 7: LGrant2710 (3650 in chips) 
Seat 8: Knoname8 (2960 in chips) 
sandbagger2327: posts the ante 40
sunshine2304: posts the ante 40
ForeignSlang: posts the ante 40
CashMatteo: posts the ante 40
Redman3298: posts the ante 40
LGrant2710: posts the ante 40
Knoname8: posts the ante 40
ForeignSlang: posts small blind 80
CashMatteo: posts big blind 160
*** HOLE CARDS ***
Dealt to CashMatteo [2s 6c]
Redman3298: calls 160
LGrant2710: folds 
Knoname8: folds 
sandbagger2327: folds 
sunshine2304: folds 
ForeignSlang: calls 80
CashMatteo: checks 
*** FLOP *** [Jd Jh Kd]
ForeignSlang: bets 380
CashMatteo: folds 
Redman3298: folds 
Uncalled bet (380) returned to ForeignSlang
ForeignSlang collected 760 from pot
ForeignSlang: doesn't show hand 
*** SUMMARY ***
Total pot 760 | Rake 0 
Board [Jd Jh Kd]
Seat 2: sandbagger2327 folded before Flop (didn't bet)
Seat 3: sunshine2304 (button) folded before Flop (didn't bet)
Seat 4: ForeignSlang (small blind) collected (760)
Seat 5: CashMatteo (big blind) folded on the Flop
Seat 6: Redman3298 folded on the Flop
Seat 7: LGrant2710 folded before Flop (didn't bet)
Seat 8: Knoname8 folded before Flop (didn't bet)

Hand #1305: 

PokerStars Hand #246672050105: Tournament #3659798281, $0.94+$0.06 CAD Hold'em No Limit - Level VII (80/160) - 2023/10/21 22:24:02 ET
Table '3659798281 4' 8-max Seat #4 is the button
Seat 2: sandbagger2327 (720 in chips) 
Seat 3: JuggernautJason (3000 in chips) 
Seat 4: ForeignSlang (5206 in chips) 
Seat 5: CashMatteo (1453 in chips) 
Seat 6: Redman3298 (2090 in chips) 
Seat 7: LGrant2710 (3610 in chips) 
Seat 8: Knoname8 (2920 in chips) 
sandbagger2327: posts the ante 40
JuggernautJason: posts the ante 40
ForeignSlang: posts the ante 40
CashMatteo: posts the ante 40
Redman3298: posts the ante 40
LGrant2710: posts the ante 40
Knoname8: posts the ante 40
CashMatteo: posts small blind 80
Redman3298: posts big blind 160
*** HOLE CARDS ***
Dealt to CashMatteo [6s 3h]
LGrant2710: raises 320 to 480
Knoname8: folds 
sandbagger2327: folds 
JuggernautJason: folds 
ForeignSlang: folds 
CashMatteo: folds 
Redman3298: folds 
Uncalled bet (320) returned to LGrant2710
LGrant2710 collected 680 from pot
*** SUMMARY ***
Total pot 680 | Rake 0 
Seat 2: sandbagger2327 folded before Flop (didn't bet)
Seat 3: JuggernautJason folded before Flop (didn't bet)
Seat 4: ForeignSlang (button) folded before Flop (didn't bet)
Seat 5: CashMatteo (small blind) folded before Flop
Seat 6: Redman3298 (big blind) folded before Flop
Seat 7: LGrant2710 collected (680)
Seat 8: Knoname8 folded before Flop (didn't bet)

Hand #1306: 

PokerStars Hand #246672056515: Tournament #3659798281, $0.94+$0.06 CAD Hold'em No Limit - Level VII (80/160) - 2023/10/21 22:24:40 ET
Table '3659798281 4' 8-max Seat #5 is the button
Seat 2: sandbagger2327 (680 in chips) 
Seat 3: JuggernautJason (2960 in chips) 
Seat 4: ForeignSlang (5166 in chips) 
Seat 5: CashMatteo (1333 in chips) 
Seat 6: Redman3298 (1890 in chips) 
Seat 7: LGrant2710 (4090 in chips) 
Seat 8: Knoname8 (2880 in chips) 
sandbagger2327: posts the ante 40
JuggernautJason: posts the ante 40
ForeignSlang: posts the ante 40
CashMatteo: posts the ante 40
Redman3298: posts the ante 40
LGrant2710: posts the ante 40
Knoname8: posts the ante 40
Redman3298: posts small blind 80
LGrant2710: posts big blind 160
*** HOLE CARDS ***
Dealt to CashMatteo [6c 2c]
Knoname8: folds 
sandbagger2327: folds 
JuggernautJason: folds 
ForeignSlang: folds 
CashMatteo: folds 
Redman3298: folds 
Uncalled bet (80) returned to LGrant2710
LGrant2710 collected 440 from pot
*** SUMMARY ***
Total pot 440 | Rake 0 
Seat 2: sandbagger2327 folded before Flop (didn't bet)
Seat 3: JuggernautJason folded before Flop (didn't bet)
Seat 4: ForeignSlang folded before Flop (didn't bet)
Seat 5: CashMatteo (button) folded before Flop (didn't bet)
Seat 6: Redman3298 (small blind) folded before Flop
Seat 7: LGrant2710 (big blind) collected (440)
Seat 8: Knoname8 folded before Flop (didn't bet)

Hand #1307: 

PokerStars Hand #246672058796: Tournament #3659798281, $0.94+$0.06 CAD Hold'em No Limit - Level VII (80/160) - 2023/10/21 22:24:53 ET
Table '3659798281 4' 8-max Seat #6 is the button
Seat 2: sandbagger2327 (640 in chips) 
Seat 3: JuggernautJason (2920 in chips) 
Seat 4: ForeignSlang (5126 in chips) 
Seat 5: CashMatteo (1293 in chips) 
Seat 6: Redman3298 (1770 in chips) 
Seat 7: LGrant2710 (4410 in chips) 
Seat 8: Knoname8 (2840 in chips) 
sandbagger2327: posts the ante 40
JuggernautJason: posts the ante 40
ForeignSlang: posts the ante 40
CashMatteo: posts the ante 40
Redman3298: posts the ante 40
LGrant2710: posts the ante 40
Knoname8: posts the ante 40
LGrant2710: posts small blind 80
Knoname8: posts big blind 160
*** HOLE CARDS ***
Dealt to CashMatteo [Kh 9h]
sandbagger2327: folds 
JuggernautJason: folds 
ForeignSlang: raises 160 to 320
CashMatteo: raises 933 to 1253 and is all-in
Redman3298: folds 
LGrant2710: folds 
Knoname8: folds 
ForeignSlang: folds 
Uncalled bet (933) returned to CashMatteo
CashMatteo collected 1160 from pot
CashMatteo: doesn't show hand 
*** SUMMARY ***
Total pot 1160 | Rake 0 
Seat 2: sandbagger2327 folded before Flop (didn't bet)
Seat 3: JuggernautJason folded before Flop (didn't bet)
Seat 4: ForeignSlang folded before Flop
Seat 5: CashMatteo collected (1160)
Seat 6: Redman3298 (button) folded before Flop (didn't bet)
Seat 7: LGrant2710 (small blind) folded before Flop
Seat 8: Knoname8 (big blind) folded before Flop

Hand #1308: 

PokerStars Hand #246672062272: Tournament #3659798281, $0.94+$0.06 CAD Hold'em No Limit - Level VII (80/160) - 2023/10/21 22:25:14 ET
Table '3659798281 4' 8-max Seat #7 is the button
Seat 2: sandbagger2327 (600 in chips) 
Seat 3: JuggernautJason (2880 in chips) 
Seat 4: ForeignSlang (4766 in chips) 
Seat 5: CashMatteo (2093 in chips) 
Seat 6: Redman3298 (1730 in chips) 
Seat 7: LGrant2710 (4290 in chips) 
Seat 8: Knoname8 (2640 in chips) 
sandbagger2327: posts the ante 40
JuggernautJason: posts the ante 40
ForeignSlang: posts the ante 40
CashMatteo: posts the ante 40
Redman3298: posts the ante 40
LGrant2710: posts the ante 40
Knoname8: posts the ante 40
Knoname8: posts small blind 80
sandbagger2327: posts big blind 160
*** HOLE CARDS ***
Dealt to CashMatteo [Qd 5s]
JuggernautJason: folds 
ForeignSlang: folds 
CashMatteo: folds 
Redman3298: folds 
LGrant2710: raises 320 to 480
Knoname8: folds 
sandbagger2327: folds 
Uncalled bet (320) returned to LGrant2710
LGrant2710 collected 680 from pot
*** SUMMARY ***
Total pot 680 | Rake 0 
Seat 2: sandbagger2327 (big blind) folded before Flop
Seat 3: JuggernautJason folded before Flop (didn't bet)
Seat 4: ForeignSlang folded before Flop (didn't bet)
Seat 5: CashMatteo folded before Flop (didn't bet)
Seat 6: Redman3298 folded before Flop (didn't bet)
Seat 7: LGrant2710 (button) collected (680)
Seat 8: Knoname8 (small blind) folded before Flop

Hand #1309: 

PokerStars Hand #246672066117: Tournament #3659798281, $0.94+$0.06 CAD Hold'em No Limit - Level VII (80/160) - 2023/10/21 22:25:37 ET
Table '3659798281 4' 8-max Seat #8 is the button
Seat 2: sandbagger2327 (400 in chips) 
Seat 3: JuggernautJason (2840 in chips) 
Seat 4: ForeignSlang (4726 in chips) 
Seat 5: CashMatteo (2053 in chips) 
Seat 6: Redman3298 (1690 in chips) 
Seat 7: LGrant2710 (4770 in chips) 
Seat 8: Knoname8 (2520 in chips) 
sandbagger2327: posts the ante 40
JuggernautJason: posts the ante 40
ForeignSlang: posts the ante 40
CashMatteo: posts the ante 40
Redman3298: posts the ante 40
LGrant2710: posts the ante 40
Knoname8: posts the ante 40
sandbagger2327: posts small blind 80
JuggernautJason: posts big blind 160
*** HOLE CARDS ***
Dealt to CashMatteo [3c 8c]
ForeignSlang: folds 
CashMatteo: folds 
Redman3298: calls 160
LGrant2710: folds 
Knoname8: calls 160
sandbagger2327: raises 160 to 320
JuggernautJason: folds 
Redman3298: calls 160
Knoname8: calls 160
*** FLOP *** [7c 8s 9s]
sandbagger2327: bets 40 and is all-in
Redman3298: calls 40
Knoname8: folds 
*** TURN *** [7c 8s 9s] [4s]
*** RIVER *** [7c 8s 9s 4s] [4c]
*** SHOW DOWN ***
sandbagger2327: shows [6s 5c] (a straight, Five to Nine)
Redman3298: shows [Js 9d] (two pair, Nines and Fours)
sandbagger2327 collected 1480 from pot
*** SUMMARY ***
Total pot 1480 | Rake 0 
Board [7c 8s 9s 4s 4c]
Seat 2: sandbagger2327 (small blind) showed [6s 5c] and won (1480) with a straight, Five to Nine
Seat 3: JuggernautJason (big blind) folded before Flop
Seat 4: ForeignSlang folded before Flop (didn't bet)
Seat 5: CashMatteo folded before Flop (didn't bet)
Seat 6: Redman3298 showed [Js 9d] and lost with two pair, Nines and Fours
Seat 7: LGrant2710 folded before Flop (didn't bet)
Seat 8: Knoname8 (button) folded on the Flop

Hand #1310: 

PokerStars Hand #246672070604: Tournament #3659798281, $0.94+$0.06 CAD Hold'em No Limit - Level VII (80/160) - 2023/10/21 22:26:03 ET
Table '3659798281 4' 8-max Seat #2 is the button
Seat 2: sandbagger2327 (1480 in chips) 
Seat 3: JuggernautJason (2640 in chips) 
Seat 4: ForeignSlang (4686 in chips) 
Seat 5: CashMatteo (2013 in chips) 
Seat 6: Redman3298 (1290 in chips) 
Seat 7: LGrant2710 (4730 in chips) 
Seat 8: Knoname8 (2160 in chips) 
sandbagger2327: posts the ante 40
JuggernautJason: posts the ante 40
ForeignSlang: posts the ante 40
CashMatteo: posts the ante 40
Redman3298: posts the ante 40
LGrant2710: posts the ante 40
Knoname8: posts the ante 40
JuggernautJason: posts small blind 80
ForeignSlang: posts big blind 160
*** HOLE CARDS ***
Dealt to CashMatteo [Jh As]
CashMatteo: raises 240 to 400
Redman3298: folds 
LGrant2710: folds 
Knoname8: folds 
sandbagger2327: folds 
JuggernautJason: folds 
ForeignSlang: folds 
Uncalled bet (240) returned to CashMatteo
CashMatteo collected 680 from pot
CashMatteo: doesn't show hand 
*** SUMMARY ***
Total pot 680 | Rake 0 
Seat 2: sandbagger2327 (button) folded before Flop (didn't bet)
Seat 3: JuggernautJason (small blind) folded before Flop
Seat 4: ForeignSlang (big blind) folded before Flop
Seat 5: CashMatteo collected (680)
Seat 6: Redman3298 folded before Flop (didn't bet)
Seat 7: LGrant2710 folded before Flop (didn't bet)
Seat 8: Knoname8 folded before Flop (didn't bet)

Hand #1311: 

PokerStars Hand #246672072961: Tournament #3659798281, $0.94+$0.06 CAD Hold'em No Limit - Level VIII (100/200) - 2023/10/21 22:26:18 ET
Table '3659798281 4' 8-max Seat #3 is the button
Seat 2: sandbagger2327 (1440 in chips) 
Seat 3: JuggernautJason (2520 in chips) 
Seat 4: ForeignSlang (4486 in chips) 
Seat 5: CashMatteo (2493 in chips) 
Seat 6: Redman3298 (1250 in chips) 
Seat 7: LGrant2710 (4690 in chips) 
Seat 8: Knoname8 (2120 in chips) 
sandbagger2327: posts the ante 50
JuggernautJason: posts the ante 50
ForeignSlang: posts the ante 50
CashMatteo: posts the ante 50
Redman3298: posts the ante 50
LGrant2710: posts the ante 50
Knoname8: posts the ante 50
ForeignSlang: posts small blind 100
CashMatteo: posts big blind 200
*** HOLE CARDS ***
Dealt to CashMatteo [Td Qd]
Redman3298: folds 
LGrant2710: folds 
Knoname8: folds 
sandbagger2327: calls 200
JuggernautJason: calls 200
ForeignSlang: calls 100
ritocuja is disconnected 
CashMatteo: raises 500 to 700
sandbagger2327: calls 500
JuggernautJason: raises 1770 to 2470 and is all-in
ForeignSlang: folds 
CashMatteo: calls 1743 and is all-in
sandbagger2327: calls 690 and is all-in
Uncalled bet (27) returned to JuggernautJason
*** FLOP *** [8c As 9s]
*** TURN *** [8c As 9s] [Qs]
*** RIVER *** [8c As 9s Qs] [4s]
*** SHOW DOWN ***
CashMatteo: shows [Td Qd] (a pair of Queens)
JuggernautJason: shows [8s Js] (a flush, Ace high)
JuggernautJason collected 2106 from side pot
sandbagger2327: shows [6c 5d] (high card Ace)
JuggernautJason collected 4720 from main pot
CashMatteo finished the tournament in 61st place
sandbagger2327 finished the tournament in 62nd place
*** SUMMARY ***
Total pot 6826 Main pot 4720. Side pot 2106. | Rake 0 
Board [8c As 9s Qs 4s]
Seat 2: sandbagger2327 showed [6c 5d] and lost with high card Ace
Seat 3: JuggernautJason (button) showed [8s Js] and won (6826) with a flush, Ace high
Seat 4: ForeignSlang (small blind) folded before Flop
Seat 5: CashMatteo (big blind) showed [Td Qd] and lost with a pair of Queens
Seat 6: Redman3298 folded before Flop (didn't bet)
Seat 7: LGrant2710 folded before Flop (didn't bet)
Seat 8: Knoname8 folded before Flop (didn't bet)

Hand #1312: 

PokerStars Hand #246672117863: Tournament #3659798281, $0.94+$0.06 CAD Hold'em No Limit - Level IX (125/250) - 2023/10/21 22:30:47 ET
Table '3659798281 6' 8-max Seat #1 is the button
Seat 1: Combo77769 (5455 in chips) 
Seat 2: CashMatteo (3000 in chips) out of hand (moved from another table into small blind)
Seat 4: londong1978 (9383 in chips) 
Seat 5: Saylor0517 (2380 in chips) 
Seat 6: B33kon (5855 in chips) 
Seat 7: nashamen (2227 in chips) 
CashMatteo will be allowed to play after the button
Combo77769: posts the ante 60
londong1978: posts the ante 60
Saylor0517: posts the ante 60
B33kon: posts the ante 60
nashamen: posts the ante 60
londong1978: posts small blind 125
Saylor0517: posts big blind 250
*** HOLE CARDS ***
B33kon: calls 250
nashamen: folds 
Combo77769: folds 
londong1978: folds 
Saylor0517: checks 
*** FLOP *** [2h Kc As]
Saylor0517: bets 463
B33kon: folds 
Uncalled bet (463) returned to Saylor0517
Saylor0517 collected 925 from pot
*** SUMMARY ***
Total pot 925 | Rake 0 
Board [2h Kc As]
Seat 1: Combo77769 (button) folded before Flop (didn't bet)
Seat 4: londong1978 (small blind) folded before Flop
Seat 5: Saylor0517 (big blind) collected (925)
Seat 6: B33kon folded on the Flop
Seat 7: nashamen folded before Flop (didn't bet)

Hand #1313: 

PokerStars Hand #246672122323: Tournament #3659798281, $0.94+$0.06 CAD Hold'em No Limit - Level IX (125/250) - 2023/10/21 22:31:14 ET
Table '3659798281 6' 8-max Seat #4 is the button
Seat 1: Combo77769 (5395 in chips) 
Seat 2: CashMatteo (3000 in chips) 
Seat 4: londong1978 (9198 in chips) 
Seat 5: Saylor0517 (2995 in chips) 
Seat 6: B33kon (5545 in chips) 
Seat 7: nashamen (2167 in chips) 
Seat 8: dredon (3000 in chips) 
Combo77769: posts the ante 60
CashMatteo: posts the ante 60
londong1978: posts the ante 60
Saylor0517: posts the ante 60
B33kon: posts the ante 60
nashamen: posts the ante 60
dredon: posts the ante 60
Saylor0517: posts small blind 125
B33kon: posts big blind 250
*** HOLE CARDS ***
Dealt to CashMatteo [Tc 2d]
nashamen: folds 
dredon: folds 
Combo77769: raises 500 to 750
CashMatteo: folds 
londong1978: folds 
Saylor0517: folds 
B33kon: calls 500
*** FLOP *** [4s Ts Ac]
B33kon: bets 1023
Combo77769: folds 
Uncalled bet (1023) returned to B33kon
B33kon collected 2045 from pot
B33kon: doesn't show hand 
*** SUMMARY ***
Total pot 2045 | Rake 0 
Board [4s Ts Ac]
Seat 1: Combo77769 folded on the Flop
Seat 2: CashMatteo folded before Flop (didn't bet)
Seat 4: londong1978 (button) folded before Flop (didn't bet)
Seat 5: Saylor0517 (small blind) folded before Flop
Seat 6: B33kon (big blind) collected (2045)
Seat 7: nashamen folded before Flop (didn't bet)
Seat 8: dredon folded before Flop (didn't bet)

Hand #1314: 

PokerStars Hand #246672126396: Tournament #3659798281, $0.94+$0.06 CAD Hold'em No Limit - Level IX (125/250) - 2023/10/21 22:31:39 ET
Table '3659798281 6' 8-max Seat #5 is the button
Seat 1: Combo77769 (4585 in chips) 
Seat 2: CashMatteo (2940 in chips) 
Seat 4: londong1978 (9138 in chips) 
Seat 5: Saylor0517 (2810 in chips) 
Seat 6: B33kon (6780 in chips) 
Seat 7: nashamen (2107 in chips) 
Seat 8: dredon (2940 in chips) 
Combo77769: posts the ante 60
CashMatteo: posts the ante 60
londong1978: posts the ante 60
Saylor0517: posts the ante 60
B33kon: posts the ante 60
nashamen: posts the ante 60
dredon: posts the ante 60
B33kon: posts small blind 125
nashamen: posts big blind 250
*** HOLE CARDS ***
Dealt to CashMatteo [2s Ts]
dredon: folds 
Combo77769: folds 
CashMatteo: folds 
londong1978: calls 250
Saylor0517: folds 
B33kon: calls 125
nashamen: checks 
*** FLOP *** [Jd Qc 4c]
B33kon: checks 
nashamen: checks 
londong1978: bets 250
B33kon: calls 250
nashamen: folds 
*** TURN *** [Jd Qc 4c] [Tc]
B33kon: checks 
londong1978: bets 250
B33kon: calls 250
*** RIVER *** [Jd Qc 4c Tc] [5d]
B33kon: bets 2170
londong1978: raises 2170 to 4340
B33kon: raises 1630 to 5970 and is all-in
londong1978: calls 1630
*** SHOW DOWN ***
B33kon: shows [5c Ac] (a flush, Ace high)
londong1978: shows [7c Kc] (a flush, King high)
B33kon collected 14110 from pot
*** SUMMARY ***
Total pot 14110 | Rake 0 
Board [Jd Qc 4c Tc 5d]
Seat 1: Combo77769 folded before Flop (didn't bet)
Seat 2: CashMatteo folded before Flop (didn't bet)
Seat 4: londong1978 showed [7c Kc] and lost with a flush, King high
Seat 5: Saylor0517 (button) folded before Flop (didn't bet)
Seat 6: B33kon (small blind) showed [5c Ac] and won (14110) with a flush, Ace high
Seat 7: nashamen (big blind) folded on the Flop
Seat 8: dredon folded before Flop (didn't bet)

Hand #1315: 

PokerStars Hand #246672134936: Tournament #3659798281, $0.94+$0.06 CAD Hold'em No Limit - Level X (150/300) - 2023/10/21 22:32:30 ET
Table '3659798281 6' 8-max Seat #6 is the button
Seat 1: Combo77769 (4525 in chips) 
Seat 2: CashMatteo (2880 in chips) 
Seat 4: londong1978 (2358 in chips) 
Seat 5: Saylor0517 (2750 in chips) 
Seat 6: B33kon (14110 in chips) 
Seat 7: nashamen (1797 in chips) 
Seat 8: dredon (2880 in chips) 
Combo77769: posts the ante 75
CashMatteo: posts the ante 75
londong1978: posts the ante 75
Saylor0517: posts the ante 75
B33kon: posts the ante 75
nashamen: posts the ante 75
dredon: posts the ante 75
nashamen: posts small blind 150
dredon: posts big blind 300
*** HOLE CARDS ***
Dealt to CashMatteo [7d 8c]
Combo77769: folds 
CashMatteo: folds 
londong1978: raises 1983 to 2283 and is all-in
Saylor0517: folds 
B33kon: folds 
nashamen: folds 
dredon: folds 
Uncalled bet (1983) returned to londong1978
londong1978 collected 1275 from pot
*** SUMMARY ***
Total pot 1275 | Rake 0 
Seat 1: Combo77769 folded before Flop (didn't bet)
Seat 2: CashMatteo folded before Flop (didn't bet)
Seat 4: londong1978 collected (1275)
Seat 5: Saylor0517 folded before Flop (didn't bet)
Seat 6: B33kon (button) folded before Flop (didn't bet)
Seat 7: nashamen (small blind) folded before Flop
Seat 8: dredon (big blind) folded before Flop

Hand #1316: 

PokerStars Hand #246672138481: Tournament #3659798281, $0.94+$0.06 CAD Hold'em No Limit - Level X (150/300) - 2023/10/21 22:32:52 ET
Table '3659798281 6' 8-max Seat #7 is the button
Seat 1: Combo77769 (4450 in chips) 
Seat 2: CashMatteo (2805 in chips) 
Seat 4: londong1978 (3258 in chips) 
Seat 5: Saylor0517 (2675 in chips) 
Seat 6: B33kon (14035 in chips) 
Seat 7: nashamen (1572 in chips) 
Seat 8: dredon (2505 in chips) 
Combo77769: posts the ante 75
CashMatteo: posts the ante 75
londong1978: posts the ante 75
Saylor0517: posts the ante 75
B33kon: posts the ante 75
nashamen: posts the ante 75
dredon: posts the ante 75
dredon: posts small blind 150
Combo77769: posts big blind 300
*** HOLE CARDS ***
Dealt to CashMatteo [2c 6s]
CashMatteo: folds 
londong1978: folds 
Saylor0517: folds 
B33kon: folds 
nashamen: folds 
dredon: calls 150
Combo77769: checks 
*** FLOP *** [4d 7h 8d]
dredon: checks 
Combo77769: checks 
*** TURN *** [4d 7h 8d] [Ac]
dredon: bets 300
Combo77769: folds 
Uncalled bet (300) returned to dredon
dredon collected 1125 from pot
dredon: doesn't show hand 
*** SUMMARY ***
Total pot 1125 | Rake 0 
Board [4d 7h 8d Ac]
Seat 1: Combo77769 (big blind) folded on the Turn
Seat 2: CashMatteo folded before Flop (didn't bet)
Seat 4: londong1978 folded before Flop (didn't bet)
Seat 5: Saylor0517 folded before Flop (didn't bet)
Seat 6: B33kon folded before Flop (didn't bet)
Seat 7: nashamen (button) folded before Flop (didn't bet)
Seat 8: dredon (small blind) collected (1125)

Hand #1317: 

PokerStars Hand #246672142781: Tournament #3659798281, $0.94+$0.06 CAD Hold'em No Limit - Level X (150/300) - 2023/10/21 22:33:18 ET
Table '3659798281 6' 8-max Seat #8 is the button
Seat 1: Combo77769 (4075 in chips) 
Seat 2: CashMatteo (2730 in chips) 
Seat 3: andy_pengg (3000 in chips) 
Seat 4: londong1978 (3183 in chips) 
Seat 5: Saylor0517 (2600 in chips) 
Seat 6: B33kon (13960 in chips) 
Seat 7: nashamen (1497 in chips) 
Seat 8: dredon (3255 in chips) 
Combo77769: posts the ante 75
CashMatteo: posts the ante 75
andy_pengg: posts the ante 75
londong1978: posts the ante 75
Saylor0517: posts the ante 75
B33kon: posts the ante 75
nashamen: posts the ante 75
dredon: posts the ante 75
Combo77769: posts small blind 150
CashMatteo: posts big blind 300
*** HOLE CARDS ***
Dealt to CashMatteo [Qc 9s]
andy_pengg: folds 
londong1978: raises 2808 to 3108 and is all-in
Saylor0517: folds 
B33kon: folds 
nashamen: folds 
dredon: folds 
Combo77769: folds 
CashMatteo: calls 2355 and is all-in
Uncalled bet (453) returned to londong1978
*** FLOP *** [9c 8h 5d]
*** TURN *** [9c 8h 5d] [Ac]
*** RIVER *** [9c 8h 5d Ac] [Tc]
*** SHOW DOWN ***
CashMatteo: shows [Qc 9s] (a pair of Nines)
londong1978: shows [Kc Kd] (a pair of Kings)
londong1978 collected 6060 from pot
CashMatteo finished the tournament in 52nd place
*** SUMMARY ***
Total pot 6060 | Rake 0 
Board [9c 8h 5d Ac Tc]
Seat 1: Combo77769 (small blind) folded before Flop
Seat 2: CashMatteo (big blind) showed [Qc 9s] and lost with a pair of Nines
Seat 3: andy_pengg folded before Flop (didn't bet)
Seat 4: londong1978 showed [Kc Kd] and won (6060) with a pair of Kings
Seat 5: Saylor0517 folded before Flop (didn't bet)
Seat 6: B33kon folded before Flop (didn't bet)
Seat 7: nashamen folded before Flop (didn't bet)
Seat 8: dredon (button) folded before Flop (didn't bet)

Hand #1318: 

PokerStars Hand #246672154565:  Hold'em No Limit ($0.05/$0.10 CAD) - 2023/10/21 22:34:29 ET
Table 'Yildun' 6-max Seat #6 is the button
Seat 3: 2gd2btru422 ($9.90 in chips) 
Seat 4: CashMatteo ($9.60 in chips) 
Seat 5: OoohHi ($10.09 in chips) 
Seat 6: 60centPoker ($10 in chips) 
2gd2btru422: posts small blind $0.05
CashMatteo: posts big blind $0.10
*** HOLE CARDS ***
Dealt to CashMatteo [6d Jh]
OoohHi: raises $0.13 to $0.23
60centPoker: raises $0.52 to $0.75
2gd2btru422: folds 
CashMatteo: folds 
OoohHi: calls $0.52
*** FLOP *** [Kc 2c 3c]
OoohHi: checks 
60centPoker: bets $0.98
OoohHi: raises $0.98 to $1.96
MasterMelt leaves the table
60centPoker: folds 
Uncalled bet ($0.98) returned to OoohHi
OoohHi collected $3.45 from pot
OoohHi: doesn't show hand 
*** SUMMARY ***
Total pot $3.61 | Rake $0.16 
Board [Kc 2c 3c]
Seat 3: 2gd2btru422 (small blind) folded before Flop
Seat 4: CashMatteo (big blind) folded before Flop
Seat 5: OoohHi collected ($3.45)
Seat 6: 60centPoker (button) folded on the Flop

Hand #1319: 

PokerStars Hand #246672160773:  Hold'em No Limit ($0.05/$0.10 CAD) - 2023/10/21 22:35:06 ET
Table 'Yildun' 6-max Seat #3 is the button
Seat 3: 2gd2btru422 ($9.85 in chips) 
Seat 4: CashMatteo ($9.50 in chips) 
Seat 6: 60centPoker ($8.27 in chips) 
CashMatteo: posts small blind $0.05
OoohHi: is sitting out 
60centPoker: posts big blind $0.10
shark8_len: sits out 
*** HOLE CARDS ***
Dealt to CashMatteo [Jh 7d]
2gd2btru422: folds 
CashMatteo: folds 
Uncalled bet ($0.05) returned to 60centPoker
60centPoker collected $0.10 from pot
60centPoker: doesn't show hand 
*** SUMMARY ***
Total pot $0.10 | Rake $0 
Seat 3: 2gd2btru422 (button) folded before Flop (didn't bet)
Seat 4: CashMatteo (small blind) folded before Flop
Seat 6: 60centPoker (big blind) collected ($0.10)

Hand #1320: 

PokerStars Hand #246672162488:  Hold'em No Limit ($0.05/$0.10 CAD) - 2023/10/21 22:35:17 ET
Table 'Yildun' 6-max Seat #4 is the button
Seat 1: shark8_len ($6.89 in chips) 
Seat 3: 2gd2btru422 ($9.85 in chips) 
Seat 4: CashMatteo ($9.45 in chips) 
Seat 6: 60centPoker ($8.32 in chips) 
OoohHi will be allowed to play after the button
60centPoker: posts small blind $0.05
shark8_len: posts big blind $0.10
*** HOLE CARDS ***
Dealt to CashMatteo [6c Qc]
2gd2btru422: calls $0.10
CashMatteo: calls $0.10
60centPoker: calls $0.05
mycats99887 joins the table at seat #2 
shark8_len: checks 
*** FLOP *** [Qs 3s Th]
60centPoker: checks 
shark8_len has timed out
shark8_len: checks 
2gd2btru422: bets $0.38
CashMatteo: calls $0.38
60centPoker has timed out
60centPoker: folds 
shark8_len: folds 
*** TURN *** [Qs 3s Th] [Ac]
2gd2btru422: bets $1.11
CashMatteo: folds 
Uncalled bet ($1.11) returned to 2gd2btru422
2gd2btru422 collected $1.11 from pot
*** SUMMARY ***
Total pot $1.16 | Rake $0.05 
Board [Qs 3s Th Ac]
Seat 1: shark8_len (big blind) folded on the Flop
Seat 3: 2gd2btru422 collected ($1.11)
Seat 4: CashMatteo (button) folded on the Turn
Seat 6: 60centPoker (small blind) folded on the Flop

Hand #1321: 

PokerStars Hand #246672185364:  Hold'em No Limit ($0.05/$0.10 CAD) - 2023/10/21 22:37:38 ET
Table 'Yildun' 6-max Seat #1 is the button
Seat 1: shark8_len ($6.79 in chips) 
Seat 3: 2gd2btru422 ($10.48 in chips) 
Seat 4: CashMatteo ($8.97 in chips) 
mycats99887 will be allowed to play after the button
2gd2btru422: posts small blind $0.05
CashMatteo: posts big blind $0.10
OoohHi: sits out 
*** HOLE CARDS ***
Dealt to CashMatteo [Qd 7d]
shark8_len has timed out
shark8_len: folds 
2gd2btru422: calls $0.05
CashMatteo: checks 
*** FLOP *** [Kd Ks Qh]
2gd2btru422: checks 
CashMatteo: checks 
*** TURN *** [Kd Ks Qh] [3s]
2gd2btru422: checks 
CashMatteo: checks 
*** RIVER *** [Kd Ks Qh 3s] [5c]
2gd2btru422: checks 
CashMatteo: bets $0.19
2gd2btru422: folds 
Uncalled bet ($0.19) returned to CashMatteo
CashMatteo collected $0.19 from pot
CashMatteo: doesn't show hand 
*** SUMMARY ***
Total pot $0.20 | Rake $0.01 
Board [Kd Ks Qh 3s 5c]
Seat 1: shark8_len (button) folded before Flop (didn't bet)
Seat 3: 2gd2btru422 (small blind) folded on the River
Seat 4: CashMatteo (big blind) collected ($0.19)

Hand #1322: 

PokerStars Hand #246672190681:  Hold'em No Limit ($0.05/$0.10 CAD) - 2023/10/21 22:38:11 ET
Table 'Yildun' 6-max Seat #3 is the button
Seat 1: shark8_len ($6.79 in chips) 
Seat 3: 2gd2btru422 ($10.38 in chips) 
Seat 4: CashMatteo ($9.06 in chips) 
Seat 5: OoohHi ($11.81 in chips) 
Seat 6: 60centPoker ($8.22 in chips) 
CashMatteo: posts small blind $0.05
OoohHi: posts big blind $0.10
mycats99887: sits out 
*** HOLE CARDS ***
Dealt to CashMatteo [6h Jh]
60centPoker: folds 
shark8_len has timed out
shark8_len: folds 
2gd2btru422: folds 
CashMatteo: calls $0.05
OoohHi: checks 
*** FLOP *** [4d Kh 8d]
CashMatteo: checks 
OoohHi: checks 
*** TURN *** [4d Kh 8d] [8s]
CashMatteo: checks 
OoohHi: checks 
*** RIVER *** [4d Kh 8d 8s] [Kd]
CashMatteo: bets $0.10
OoohHi: folds 
Uncalled bet ($0.10) returned to CashMatteo
CashMatteo collected $0.19 from pot
CashMatteo: doesn't show hand 
*** SUMMARY ***
Total pot $0.20 | Rake $0.01 
Board [4d Kh 8d 8s Kd]
Seat 1: shark8_len folded before Flop (didn't bet)
Seat 3: 2gd2btru422 (button) folded before Flop (didn't bet)
Seat 4: CashMatteo (small blind) collected ($0.19)
Seat 5: OoohHi (big blind) folded on the River
Seat 6: 60centPoker folded before Flop (didn't bet)

Hand #1323: 

PokerStars Hand #246672197448:  Hold'em No Limit ($0.05/$0.10 CAD) - 2023/10/21 22:38:53 ET
Table 'Yildun' 6-max Seat #4 is the button
Seat 1: shark8_len ($6.79 in chips) 
Seat 3: 2gd2btru422 ($10.38 in chips) 
Seat 4: CashMatteo ($9.15 in chips) 
Seat 5: OoohHi ($11.71 in chips) 
Seat 6: 60centPoker ($8.22 in chips) 
OoohHi: posts small blind $0.05
60centPoker: posts big blind $0.10
mycats99887: sits out 
*** HOLE CARDS ***
Dealt to CashMatteo [8s 3s]
shark8_len has timed out
shark8_len: folds 
2gd2btru422: folds 
CashMatteo: folds 
OoohHi: raises $0.20 to $0.30
60centPoker: folds 
Uncalled bet ($0.20) returned to OoohHi
OoohHi collected $0.20 from pot
OoohHi: doesn't show hand 
*** SUMMARY ***
Total pot $0.20 | Rake $0 
Seat 1: shark8_len folded before Flop (didn't bet)
Seat 3: 2gd2btru422 folded before Flop (didn't bet)
Seat 4: CashMatteo (button) folded before Flop (didn't bet)
Seat 5: OoohHi (small blind) collected ($0.20)
Seat 6: 60centPoker (big blind) folded before Flop

Hand #1324: 

PokerStars Hand #246672201558:  Hold'em No Limit ($0.05/$0.10 CAD) - 2023/10/21 22:39:18 ET
Table 'Yildun' 6-max Seat #5 is the button
Seat 1: shark8_len ($6.79 in chips) 
Seat 3: 2gd2btru422 ($10.38 in chips) 
Seat 4: CashMatteo ($9.15 in chips) 
Seat 5: OoohHi ($11.81 in chips) 
Seat 6: 60centPoker ($8.12 in chips) 
60centPoker: posts small blind $0.05
shark8_len: posts big blind $0.10
mycats99887: sits out 
*** HOLE CARDS ***
Dealt to CashMatteo [3c Ks]
2gd2btru422 has timed out
2gd2btru422: folds 
CashMatteo: calls $0.10
OoohHi: raises $0.20 to $0.30
60centPoker: folds 
shark8_len: calls $0.20
CashMatteo: folds 
*** FLOP *** [2s 9h As]
shark8_len: bets $0.10
OoohHi: raises $0.28 to $0.38
shark8_len: calls $0.28
*** TURN *** [2s 9h As] [4c]
shark8_len: bets $0.30
OoohHi: calls $0.30
*** RIVER *** [2s 9h As 4c] [7d]
shark8_len: bets $0.40
OoohHi: calls $0.40
*** SHOW DOWN ***
shark8_len: shows [7s 8s] (a pair of Sevens)
OoohHi: shows [Jh Jc] (a pair of Jacks)
OoohHi collected $2.78 from pot
*** SUMMARY ***
Total pot $2.91 | Rake $0.13 
Board [2s 9h As 4c 7d]
Seat 1: shark8_len (big blind) showed [7s 8s] and lost with a pair of Sevens
Seat 3: 2gd2btru422 folded before Flop (didn't bet)
Seat 4: CashMatteo folded before Flop
Seat 5: OoohHi (button) showed [Jh Jc] and won ($2.78) with a pair of Jacks
Seat 6: 60centPoker (small blind) folded before Flop

Hand #1325: 

PokerStars Hand #246672210586:  Hold'em No Limit ($0.05/$0.10 CAD) - 2023/10/21 22:40:14 ET
Table 'Yildun' 6-max Seat #6 is the button
Seat 1: shark8_len ($5.41 in chips) 
Seat 2: mycats99887 ($10 in chips) 
Seat 3: 2gd2btru422 ($10.38 in chips) 
Seat 4: CashMatteo ($9.05 in chips) 
Seat 5: OoohHi ($13.21 in chips) 
Seat 6: 60centPoker ($8.07 in chips) 
shark8_len: posts small blind $0.05
mycats99887: posts big blind $0.10
*** HOLE CARDS ***
Dealt to CashMatteo [Td 3h]
2gd2btru422: folds 
CashMatteo: folds 
OoohHi: folds 
60centPoker: folds 
shark8_len: calls $0.05
mycats99887: checks 
*** FLOP *** [Jh 4d 9h]
shark8_len: checks 
mycats99887: checks 
*** TURN *** [Jh 4d 9h] [8d]
shark8_len: bets $0.10
mycats99887: calls $0.10
*** RIVER *** [Jh 4d 9h 8d] [5h]
shark8_len: bets $0.10
mycats99887: calls $0.10
*** SHOW DOWN ***
shark8_len: shows [6d 8h] (a pair of Eights)
mycats99887: shows [3c Js] (a pair of Jacks)
mycats99887 collected $0.57 from pot
*** SUMMARY ***
Total pot $0.60 | Rake $0.03 
Board [Jh 4d 9h 8d 5h]
Seat 1: shark8_len (small blind) showed [6d 8h] and lost with a pair of Eights
Seat 2: mycats99887 (big blind) showed [3c Js] and won ($0.57) with a pair of Jacks
Seat 3: 2gd2btru422 folded before Flop (didn't bet)
Seat 4: CashMatteo folded before Flop (didn't bet)
Seat 5: OoohHi folded before Flop (didn't bet)
Seat 6: 60centPoker (button) folded before Flop (didn't bet)

Hand #1326: 

PokerStars Hand #246672214832:  Hold'em No Limit ($0.05/$0.10 CAD) - 2023/10/21 22:40:41 ET
Table 'Yildun' 6-max Seat #1 is the button
Seat 1: shark8_len ($5.11 in chips) 
Seat 2: mycats99887 ($10.27 in chips) 
Seat 3: 2gd2btru422 ($10.38 in chips) 
Seat 4: CashMatteo ($9.05 in chips) 
Seat 5: OoohHi ($13.21 in chips) 
Seat 6: 60centPoker ($8.07 in chips) 
mycats99887: posts small blind $0.05
2gd2btru422: posts big blind $0.10
*** HOLE CARDS ***
Dealt to CashMatteo [3c 5h]
CashMatteo: folds 
OoohHi: folds 
60centPoker: folds 
shark8_len: folds 
mycats99887: folds 
Uncalled bet ($0.05) returned to 2gd2btru422
2gd2btru422 collected $0.10 from pot
*** SUMMARY ***
Total pot $0.10 | Rake $0 
Seat 1: shark8_len (button) folded before Flop (didn't bet)
Seat 2: mycats99887 (small blind) folded before Flop
Seat 3: 2gd2btru422 (big blind) collected ($0.10)
Seat 4: CashMatteo folded before Flop (didn't bet)
Seat 5: OoohHi folded before Flop (didn't bet)
Seat 6: 60centPoker folded before Flop (didn't bet)

Hand #1327: 

PokerStars Hand #246672217066:  Hold'em No Limit ($0.05/$0.10 CAD) - 2023/10/21 22:40:55 ET
Table 'Yildun' 6-max Seat #2 is the button
Seat 2: mycats99887 ($10.22 in chips) 
Seat 3: 2gd2btru422 ($10.43 in chips) 
Seat 4: CashMatteo ($9.05 in chips) 
Seat 5: OoohHi ($13.21 in chips) 
Seat 6: 60centPoker ($8.07 in chips) 
2gd2btru422: posts small blind $0.05
CashMatteo: posts big blind $0.10
*** HOLE CARDS ***
Dealt to CashMatteo [4h 2h]
OoohHi: folds 
60centPoker: folds 
mycats99887: folds 
2gd2btru422: raises $0.20 to $0.30
CashMatteo: calls $0.20
*** FLOP *** [3s 4c 3d]
2gd2btru422: bets $0.57
CashMatteo: calls $0.57
*** TURN *** [3s 4c 3d] [7d]
2gd2btru422: bets $1.66
CashMatteo: folds 
Uncalled bet ($1.66) returned to 2gd2btru422
2gd2btru422 collected $1.66 from pot
*** SUMMARY ***
Total pot $1.74 | Rake $0.08 
Board [3s 4c 3d 7d]
Seat 2: mycats99887 (button) folded before Flop (didn't bet)
Seat 3: 2gd2btru422 (small blind) collected ($1.66)
Seat 4: CashMatteo (big blind) folded on the Turn
Seat 5: OoohHi folded before Flop (didn't bet)
Seat 6: 60centPoker folded before Flop (didn't bet)

Hand #1328: 

PokerStars Hand #246672223248:  Hold'em No Limit ($0.05/$0.10 CAD) - 2023/10/21 22:41:34 ET
Table 'Yildun' 6-max Seat #3 is the button
Seat 2: mycats99887 ($10.22 in chips) 
Seat 3: 2gd2btru422 ($11.22 in chips) 
Seat 4: CashMatteo ($8.18 in chips) 
Seat 5: OoohHi ($13.21 in chips) 
Seat 6: 60centPoker ($8.07 in chips) 
CashMatteo: posts small blind $0.05
OoohHi: posts big blind $0.10
*** HOLE CARDS ***
Dealt to CashMatteo [Kc As]
60centPoker has timed out
60centPoker: folds 
mycats99887: folds 
2gd2btru422: folds 
CashMatteo: raises $0.15 to $0.25
OoohHi: folds 
Uncalled bet ($0.15) returned to CashMatteo
CashMatteo collected $0.20 from pot
CashMatteo: doesn't show hand 
*** SUMMARY ***
Total pot $0.20 | Rake $0 
Seat 2: mycats99887 folded before Flop (didn't bet)
Seat 3: 2gd2btru422 (button) folded before Flop (didn't bet)
Seat 4: CashMatteo (small blind) collected ($0.20)
Seat 5: OoohHi (big blind) folded before Flop
Seat 6: 60centPoker folded before Flop (didn't bet)

Hand #1329: 

PokerStars Hand #246672227033:  Hold'em No Limit ($0.05/$0.10 CAD) - 2023/10/21 22:41:58 ET
Table 'Yildun' 6-max Seat #4 is the button
Seat 2: mycats99887 ($10.22 in chips) 
Seat 3: 2gd2btru422 ($11.22 in chips) 
Seat 4: CashMatteo ($8.28 in chips) 
Seat 5: OoohHi ($13.11 in chips) 
Seat 6: 60centPoker ($8.07 in chips) 
OoohHi: posts small blind $0.05
60centPoker: posts big blind $0.10
*** HOLE CARDS ***
Dealt to CashMatteo [5s As]
mycats99887: folds 
2gd2btru422: folds 
CashMatteo: calls $0.10
OoohHi: raises $0.20 to $0.30
60centPoker: folds 
CashMatteo: calls $0.20
*** FLOP *** [8s Kc Qc]
OoohHi: bets $0.30
CashMatteo: calls $0.30
*** TURN *** [8s Kc Qc] [2d]
OoohHi: checks 
CashMatteo: checks 
*** RIVER *** [8s Kc Qc 2d] [Ac]
OoohHi: bets $0.60
CashMatteo: calls $0.60
*** SHOW DOWN ***
OoohHi: shows [8h 9h] (a pair of Eights)
CashMatteo: shows [5s As] (a pair of Aces)
CashMatteo collected $2.39 from pot
*** SUMMARY ***
Total pot $2.50 | Rake $0.11 
Board [8s Kc Qc 2d Ac]
Seat 2: mycats99887 folded before Flop (didn't bet)
Seat 3: 2gd2btru422 folded before Flop (didn't bet)
Seat 4: CashMatteo (button) showed [5s As] and won ($2.39) with a pair of Aces
Seat 5: OoohHi (small blind) showed [8h 9h] and lost with a pair of Eights
Seat 6: 60centPoker (big blind) folded before Flop

Hand #1330: 

PokerStars Hand #246672235295:  Hold'em No Limit ($0.05/$0.10 CAD) - 2023/10/21 22:42:49 ET
Table 'Yildun' 6-max Seat #5 is the button
Seat 2: mycats99887 ($10.22 in chips) 
Seat 3: 2gd2btru422 ($11.22 in chips) 
Seat 4: CashMatteo ($9.47 in chips) 
Seat 5: OoohHi ($11.91 in chips) 
Seat 6: 60centPoker ($7.97 in chips) 
60centPoker: posts small blind $0.05
mycats99887: posts big blind $0.10
*** HOLE CARDS ***
Dealt to CashMatteo [2h Jh]
2gd2btru422: calls $0.10
CashMatteo: calls $0.10
OoohHi: calls $0.10
60centPoker: folds 
mycats99887: checks 
*** FLOP *** [3c Ts Tc]
mycats99887: checks 
2gd2btru422: checks 
CashMatteo: checks 
OoohHi: checks 
*** TURN *** [3c Ts Tc] [3h]
mycats99887: checks 
2gd2btru422: bets $0.43
CashMatteo: folds 
OoohHi: folds 
mycats99887: folds 
Uncalled bet ($0.43) returned to 2gd2btru422
2gd2btru422 collected $0.43 from pot
*** SUMMARY ***
Total pot $0.45 | Rake $0.02 
Board [3c Ts Tc 3h]
Seat 2: mycats99887 (big blind) folded on the Turn
Seat 3: 2gd2btru422 collected ($0.43)
Seat 4: CashMatteo folded on the Turn
Seat 5: OoohHi (button) folded on the Turn
Seat 6: 60centPoker (small blind) folded before Flop

Hand #1331: 

PokerStars Hand #246672241337:  Hold'em No Limit ($0.05/$0.10 CAD) - 2023/10/21 22:43:27 ET
Table 'Yildun' 6-max Seat #6 is the button
Seat 2: mycats99887 ($10.12 in chips) 
Seat 3: 2gd2btru422 ($11.55 in chips) 
Seat 4: CashMatteo ($9.37 in chips) 
Seat 5: OoohHi ($11.81 in chips) 
Seat 6: 60centPoker ($10 in chips) 
mycats99887: posts small blind $0.05
2gd2btru422: posts big blind $0.10
*** HOLE CARDS ***
Dealt to CashMatteo [3h 4h]
CashMatteo: calls $0.10
OoohHi: folds 
60centPoker: folds 
mycats99887: folds 
2gd2btru422: raises $0.25 to $0.35
CashMatteo: calls $0.25
*** FLOP *** [3c 9c 9d]
2gd2btru422: checks 
CashMatteo: bets $0.36
2gd2btru422: calls $0.36
*** TURN *** [3c 9c 9d] [Jd]
2gd2btru422: checks 
CashMatteo: checks 
*** RIVER *** [3c 9c 9d Jd] [Ah]
2gd2btru422: bets $1.40
CashMatteo: calls $1.40
*** SHOW DOWN ***
2gd2btru422: shows [Tc Ad] (two pair, Aces and Nines)
CashMatteo: mucks hand 
2gd2btru422 collected $4.08 from pot
*** SUMMARY ***
Total pot $4.27 | Rake $0.19 
Board [3c 9c 9d Jd Ah]
Seat 2: mycats99887 (small blind) folded before Flop
Seat 3: 2gd2btru422 (big blind) showed [Tc Ad] and won ($4.08) with two pair, Aces and Nines
Seat 4: CashMatteo mucked [3h 4h]
Seat 5: OoohHi folded before Flop (didn't bet)
Seat 6: 60centPoker (button) folded before Flop (didn't bet)

Hand #1332: 

PokerStars Hand #246672247987:  Hold'em No Limit ($0.05/$0.10 CAD) - 2023/10/21 22:44:09 ET
Table 'Yildun' 6-max Seat #2 is the button
Seat 2: mycats99887 ($10.07 in chips) 
Seat 3: 2gd2btru422 ($13.52 in chips) 
Seat 4: CashMatteo ($7.26 in chips) 
Seat 5: OoohHi ($11.81 in chips) 
Seat 6: 60centPoker ($10 in chips) 
2gd2btru422: posts small blind $0.05
CashMatteo: posts big blind $0.10
*** HOLE CARDS ***
Dealt to CashMatteo [6s 3s]
OoohHi: folds 
60centPoker: raises $0.20 to $0.30
mycats99887: raises $0.75 to $1.05
2gd2btru422: folds 
CashMatteo: folds 
60centPoker: folds 
Uncalled bet ($0.75) returned to mycats99887
mycats99887 collected $0.75 from pot
mycats99887: doesn't show hand 
*** SUMMARY ***
Total pot $0.75 | Rake $0 
Seat 2: mycats99887 (button) collected ($0.75)
Seat 3: 2gd2btru422 (small blind) folded before Flop
Seat 4: CashMatteo (big blind) folded before Flop
Seat 5: OoohHi folded before Flop (didn't bet)
Seat 6: 60centPoker folded before Flop

Hand #1333: 

PokerStars Hand #246672251740:  Hold'em No Limit ($0.05/$0.10 CAD) - 2023/10/21 22:44:33 ET
Table 'Yildun' 6-max Seat #3 is the button
Seat 2: mycats99887 ($10.52 in chips) 
Seat 3: 2gd2btru422 ($13.47 in chips) 
Seat 4: CashMatteo ($7.16 in chips) 
Seat 5: OoohHi ($11.81 in chips) 
Seat 6: 60centPoker ($9.70 in chips) 
CashMatteo: posts small blind $0.05
OoohHi: posts big blind $0.10
*** HOLE CARDS ***
Dealt to CashMatteo [6c Qd]
60centPoker: raises $0.20 to $0.30
mycats99887: folds 
2gd2btru422: calls $0.30
CashMatteo: folds 
OoohHi: calls $0.20
*** FLOP *** [2s Ah Tc]
OoohHi: checks 
60centPoker: bets $0.24
2gd2btru422: folds 
OoohHi: folds 
Uncalled bet ($0.24) returned to 60centPoker
60centPoker collected $0.91 from pot
60centPoker: doesn't show hand 
*** SUMMARY ***
Total pot $0.95 | Rake $0.04 
Board [2s Ah Tc]
Seat 2: mycats99887 folded before Flop (didn't bet)
Seat 3: 2gd2btru422 (button) folded on the Flop
Seat 4: CashMatteo (small blind) folded before Flop
Seat 5: OoohHi (big blind) folded on the Flop
Seat 6: 60centPoker collected ($0.91)

Hand #1334: 

PokerStars Hand #246672257010:  Hold'em No Limit ($0.05/$0.10 CAD) - 2023/10/21 22:45:06 ET
Table 'Yildun' 6-max Seat #4 is the button
Seat 2: mycats99887 ($10.52 in chips) 
Seat 3: 2gd2btru422 ($13.17 in chips) 
Seat 4: CashMatteo ($7.11 in chips) 
Seat 5: OoohHi ($11.51 in chips) 
Seat 6: 60centPoker ($10.31 in chips) 
OoohHi: posts small blind $0.05
60centPoker: posts big blind $0.10
*** HOLE CARDS ***
Dealt to CashMatteo [Qc 3c]
mycats99887: folds 
2gd2btru422: folds 
CashMatteo: calls $0.10
OoohHi: calls $0.05
60centPoker: checks 
*** FLOP *** [8s 4h 2h]
OoohHi: checks 
60centPoker: checks 
CashMatteo: checks 
*** TURN *** [8s 4h 2h] [3h]
OoohHi: bets $0.10
60centPoker: folds 
CashMatteo: calls $0.10
*** RIVER *** [8s 4h 2h 3h] [4s]
OoohHi: checks 
CashMatteo: checks 
*** SHOW DOWN ***
OoohHi: shows [Kh Jd] (a pair of Fours)
CashMatteo: shows [Qc 3c] (two pair, Fours and Threes)
CashMatteo collected $0.48 from pot
*** SUMMARY ***
Total pot $0.50 | Rake $0.02 
Board [8s 4h 2h 3h 4s]
Seat 2: mycats99887 folded before Flop (didn't bet)
Seat 3: 2gd2btru422 folded before Flop (didn't bet)
Seat 4: CashMatteo (button) showed [Qc 3c] and won ($0.48) with two pair, Fours and Threes
Seat 5: OoohHi (small blind) showed [Kh Jd] and lost with a pair of Fours
Seat 6: 60centPoker (big blind) folded on the Turn

Hand #1335: 

PokerStars Hand #246672262818:  Hold'em No Limit ($0.05/$0.10 CAD) - 2023/10/21 22:45:43 ET
Table 'Yildun' 6-max Seat #5 is the button
Seat 1: shark8_len ($5.11 in chips) 
Seat 2: mycats99887 ($10.52 in chips) 
Seat 3: 2gd2btru422 ($13.17 in chips) 
Seat 4: CashMatteo ($7.39 in chips) 
Seat 5: OoohHi ($11.31 in chips) 
Seat 6: 60centPoker ($10.21 in chips) 
60centPoker: posts small blind $0.05
shark8_len: posts big blind $0.10
*** HOLE CARDS ***
Dealt to CashMatteo [2h 4d]
mycats99887: folds 
2gd2btru422: folds 
CashMatteo: folds 
OoohHi: folds 
60centPoker: raises $0.10 to $0.20
shark8_len: calls $0.10
*** FLOP *** [2s 3d 6h]
60centPoker: bets $0.21
shark8_len: calls $0.21
*** TURN *** [2s 3d 6h] [5c]
60centPoker: bets $0.28
shark8_len: calls $0.28
*** RIVER *** [2s 3d 6h 5c] [Ac]
60centPoker: bets $0.66
shark8_len: folds 
Uncalled bet ($0.66) returned to 60centPoker
60centPoker collected $1.32 from pot
60centPoker: doesn't show hand 
*** SUMMARY ***
Total pot $1.38 | Rake $0.06 
Board [2s 3d 6h 5c Ac]
Seat 1: shark8_len (big blind) folded on the River
Seat 2: mycats99887 folded before Flop (didn't bet)
Seat 3: 2gd2btru422 folded before Flop (didn't bet)
Seat 4: CashMatteo folded before Flop (didn't bet)
Seat 5: OoohHi (button) folded before Flop (didn't bet)
Seat 6: 60centPoker (small blind) collected ($1.32)

Hand #1336: 

PokerStars Hand #246672273733:  Hold'em No Limit ($0.05/$0.10 CAD) - 2023/10/21 22:46:51 ET
Table 'Yildun' 6-max Seat #6 is the button
Seat 1: shark8_len ($4.42 in chips) 
Seat 2: mycats99887 ($10.52 in chips) 
Seat 3: 2gd2btru422 ($13.17 in chips) 
Seat 4: CashMatteo ($7.39 in chips) 
Seat 5: OoohHi ($11.31 in chips) 
Seat 6: 60centPoker ($10.84 in chips) 
shark8_len: posts small blind $0.05
mycats99887: posts big blind $0.10
*** HOLE CARDS ***
Dealt to CashMatteo [Ad 8h]
2gd2btru422: folds 
CashMatteo: calls $0.10
OoohHi: calls $0.10
60centPoker: raises $0.30 to $0.40
shark8_len: raises $4.02 to $4.42 and is all-in
mycats99887: folds 
CashMatteo: folds 
OoohHi: folds 
60centPoker: folds 
Uncalled bet ($4.02) returned to shark8_len
shark8_len collected $1.10 from pot
shark8_len: doesn't show hand 
*** SUMMARY ***
Total pot $1.10 | Rake $0 
Seat 1: shark8_len (small blind) collected ($1.10)
Seat 2: mycats99887 (big blind) folded before Flop
Seat 3: 2gd2btru422 folded before Flop (didn't bet)
Seat 4: CashMatteo folded before Flop
Seat 5: OoohHi folded before Flop
Seat 6: 60centPoker (button) folded before Flop

Hand #1337: 

PokerStars Hand #246672278614:  Hold'em No Limit ($0.05/$0.10 CAD) - 2023/10/21 22:47:22 ET
Table 'Yildun' 6-max Seat #1 is the button
Seat 1: shark8_len ($5.12 in chips) 
Seat 2: mycats99887 ($10.42 in chips) 
Seat 3: 2gd2btru422 ($13.17 in chips) 
Seat 4: CashMatteo ($7.29 in chips) 
Seat 5: OoohHi ($11.21 in chips) 
Seat 6: 60centPoker ($10.44 in chips) 
mycats99887: posts small blind $0.05
2gd2btru422: posts big blind $0.10
*** HOLE CARDS ***
Dealt to CashMatteo [3d 9s]
CashMatteo: folds 
OoohHi: raises $0.16 to $0.26
60centPoker: folds 
shark8_len: folds 
mycats99887: folds 
2gd2btru422: folds 
Uncalled bet ($0.16) returned to OoohHi
OoohHi collected $0.25 from pot
OoohHi: doesn't show hand 
*** SUMMARY ***
Total pot $0.25 | Rake $0 
Seat 1: shark8_len (button) folded before Flop (didn't bet)
Seat 2: mycats99887 (small blind) folded before Flop
Seat 3: 2gd2btru422 (big blind) folded before Flop
Seat 4: CashMatteo folded before Flop (didn't bet)
Seat 5: OoohHi collected ($0.25)
Seat 6: 60centPoker folded before Flop (didn't bet)

Hand #1338: 

PokerStars Hand #246672281426:  Hold'em No Limit ($0.05/$0.10 CAD) - 2023/10/21 22:47:40 ET
Table 'Yildun' 6-max Seat #2 is the button
Seat 1: shark8_len ($5.12 in chips) 
Seat 2: mycats99887 ($10.37 in chips) 
Seat 3: 2gd2btru422 ($13.07 in chips) 
Seat 4: CashMatteo ($7.29 in chips) 
Seat 5: OoohHi ($11.36 in chips) 
Seat 6: 60centPoker ($10.44 in chips) 
2gd2btru422: posts small blind $0.05
CashMatteo: posts big blind $0.10
*** HOLE CARDS ***
Dealt to CashMatteo [3c Qd]
OoohHi: folds 
60centPoker: folds 
shark8_len has timed out
shark8_len: folds 
mycats99887: folds 
2gd2btru422: raises $0.20 to $0.30
CashMatteo: raises $0.60 to $0.90
2gd2btru422: calls $0.60
*** FLOP *** [4s Jc 7h]
2gd2btru422: checks 
CashMatteo: checks 
*** TURN *** [4s Jc 7h] [3h]
2gd2btru422: checks 
CashMatteo: bets $0.86
2gd2btru422: folds 
Uncalled bet ($0.86) returned to CashMatteo
CashMatteo collected $1.72 from pot
CashMatteo: doesn't show hand 
*** SUMMARY ***
Total pot $1.80 | Rake $0.08 
Board [4s Jc 7h 3h]
Seat 1: shark8_len folded before Flop (didn't bet)
Seat 2: mycats99887 (button) folded before Flop (didn't bet)
Seat 3: 2gd2btru422 (small blind) folded on the Turn
Seat 4: CashMatteo (big blind) collected ($1.72)
Seat 5: OoohHi folded before Flop (didn't bet)
Seat 6: 60centPoker folded before Flop (didn't bet)

Hand #1339: 

PokerStars Hand #246672290614:  Hold'em No Limit ($0.05/$0.10 CAD) - 2023/10/21 22:48:38 ET
Table 'Yildun' 6-max Seat #3 is the button
Seat 1: shark8_len ($5.12 in chips) 
Seat 2: mycats99887 ($10.37 in chips) 
Seat 3: 2gd2btru422 ($12.17 in chips) 
Seat 4: CashMatteo ($8.11 in chips) 
Seat 5: OoohHi ($11.36 in chips) 
Seat 6: 60centPoker ($10.44 in chips) 
CashMatteo: posts small blind $0.05
OoohHi: posts big blind $0.10
*** HOLE CARDS ***
Dealt to CashMatteo [8s 4c]
60centPoker has timed out
60centPoker: folds 
shark8_len has timed out
shark8_len: folds 
mycats99887: folds 
2gd2btru422: folds 
CashMatteo: folds 
Uncalled bet ($0.05) returned to OoohHi
OoohHi collected $0.10 from pot
OoohHi: doesn't show hand 
*** SUMMARY ***
Total pot $0.10 | Rake $0 
Seat 1: shark8_len folded before Flop (didn't bet)
Seat 2: mycats99887 folded before Flop (didn't bet)
Seat 3: 2gd2btru422 (button) folded before Flop (didn't bet)
Seat 4: CashMatteo (small blind) folded before Flop
Seat 5: OoohHi (big blind) collected ($0.10)
Seat 6: 60centPoker folded before Flop (didn't bet)

Hand #1340: 

PokerStars Hand #246672294936:  Hold'em No Limit ($0.05/$0.10 CAD) - 2023/10/21 22:49:06 ET
Table 'Yildun' 6-max Seat #4 is the button
Seat 2: mycats99887 ($10.37 in chips) 
Seat 3: 2gd2btru422 ($12.17 in chips) 
Seat 4: CashMatteo ($8.06 in chips) 
Seat 5: OoohHi ($11.41 in chips) 
Seat 6: 60centPoker ($10.44 in chips) 
OoohHi: posts small blind $0.05
60centPoker: posts big blind $0.10
*** HOLE CARDS ***
Dealt to CashMatteo [7h 4c]
mycats99887: folds 
2gd2btru422: folds 
CashMatteo: folds 
OoohHi: folds 
Uncalled bet ($0.05) returned to 60centPoker
60centPoker collected $0.10 from pot
60centPoker: doesn't show hand 
*** SUMMARY ***
Total pot $0.10 | Rake $0 
Seat 2: mycats99887 folded before Flop (didn't bet)
Seat 3: 2gd2btru422 folded before Flop (didn't bet)
Seat 4: CashMatteo (button) folded before Flop (didn't bet)
Seat 5: OoohHi (small blind) folded before Flop
Seat 6: 60centPoker (big blind) collected ($0.10)

Hand #1341: 

PokerStars Hand #246672296507:  Hold'em No Limit ($0.05/$0.10 CAD) - 2023/10/21 22:49:15 ET
Table 'Yildun' 6-max Seat #5 is the button
Seat 1: shark8_len ($5.12 in chips) 
Seat 2: mycats99887 ($10.37 in chips) 
Seat 3: 2gd2btru422 ($12.17 in chips) 
Seat 4: CashMatteo ($8.06 in chips) 
Seat 5: OoohHi ($11.36 in chips) 
Seat 6: 60centPoker ($10.49 in chips) 
60centPoker: posts small blind $0.05
shark8_len: posts big blind $0.10
*** HOLE CARDS ***
Dealt to CashMatteo [8s Ks]
mycats99887: calls $0.10
2gd2btru422: folds 
CashMatteo: raises $0.15 to $0.25
OoohHi: folds 
60centPoker: folds 
shark8_len: folds 
mycats99887: calls $0.15
*** FLOP *** [9c Jc Td]
mycats99887: checks 
CashMatteo: checks 
*** TURN *** [9c Jc Td] [6s]
mycats99887: checks 
CashMatteo: bets $0.31
mycats99887: folds 
Uncalled bet ($0.31) returned to CashMatteo
CashMatteo collected $0.62 from pot
CashMatteo: doesn't show hand 
*** SUMMARY ***
Total pot $0.65 | Rake $0.03 
Board [9c Jc Td 6s]
Seat 1: shark8_len (big blind) folded before Flop
Seat 2: mycats99887 folded on the Turn
Seat 3: 2gd2btru422 folded before Flop (didn't bet)
Seat 4: CashMatteo collected ($0.62)
Seat 5: OoohHi (button) folded before Flop (didn't bet)
Seat 6: 60centPoker (small blind) folded before Flop

Hand #1342: 

PokerStars Hand #246672302078:  Hold'em No Limit ($0.05/$0.10 CAD) - 2023/10/21 22:49:51 ET
Table 'Yildun' 6-max Seat #6 is the button
Seat 1: shark8_len ($5.02 in chips) 
Seat 2: mycats99887 ($10.12 in chips) 
Seat 3: 2gd2btru422 ($12.17 in chips) 
Seat 4: CashMatteo ($8.43 in chips) 
Seat 5: OoohHi ($11.36 in chips) 
Seat 6: 60centPoker ($10.44 in chips) 
shark8_len: posts small blind $0.05
mycats99887: posts big blind $0.10
*** HOLE CARDS ***
Dealt to CashMatteo [9h 2s]
2gd2btru422: folds 
CashMatteo: folds 
OoohHi: folds 
60centPoker: folds 
shark8_len: folds 
Uncalled bet ($0.05) returned to mycats99887
mycats99887 collected $0.10 from pot
mycats99887: doesn't show hand 
*** SUMMARY ***
Total pot $0.10 | Rake $0 
Seat 1: shark8_len (small blind) folded before Flop
Seat 2: mycats99887 (big blind) collected ($0.10)
Seat 3: 2gd2btru422 folded before Flop (didn't bet)
Seat 4: CashMatteo folded before Flop (didn't bet)
Seat 5: OoohHi folded before Flop (didn't bet)
Seat 6: 60centPoker (button) folded before Flop (didn't bet)

Hand #1343: 

PokerStars Hand #246672305162:  Hold'em No Limit ($0.05/$0.10 CAD) - 2023/10/21 22:50:10 ET
Table 'Yildun' 6-max Seat #1 is the button
Seat 1: shark8_len ($4.97 in chips) 
Seat 2: mycats99887 ($10.17 in chips) 
Seat 3: 2gd2btru422 ($12.17 in chips) 
Seat 4: CashMatteo ($8.43 in chips) 
Seat 5: OoohHi ($11.36 in chips) 
Seat 6: 60centPoker ($10.44 in chips) 
mycats99887: posts small blind $0.05
2gd2btru422: posts big blind $0.10
*** HOLE CARDS ***
Dealt to CashMatteo [3s 4c]
CashMatteo: folds 
OoohHi: raises $0.13 to $0.23
60centPoker: folds 
shark8_len: calls $0.23
mycats99887: folds 
2gd2btru422: calls $0.13
*** FLOP *** [Kc 2c 9d]
2gd2btru422: checks 
OoohHi: bets $0.30
shark8_len: raises $0.30 to $0.60
2gd2btru422: folds 
OoohHi: calls $0.30
*** TURN *** [Kc 2c 9d] [4h]
OoohHi: checks 
shark8_len: bets $0.90
OoohHi: calls $0.90
*** RIVER *** [Kc 2c 9d 4h] [Qs]
OoohHi: checks 
shark8_len: checks 
*** SHOW DOWN ***
OoohHi: shows [Tc Ac] (high card Ace)
shark8_len: mucks hand 
OoohHi collected $3.57 from pot
*** SUMMARY ***
Total pot $3.74 | Rake $0.17 
Board [Kc 2c 9d 4h Qs]
Seat 1: shark8_len (button) mucked [8c 7c]
Seat 2: mycats99887 (small blind) folded before Flop
Seat 3: 2gd2btru422 (big blind) folded on the Flop
Seat 4: CashMatteo folded before Flop (didn't bet)
Seat 5: OoohHi showed [Tc Ac] and won ($3.57) with high card Ace
Seat 6: 60centPoker folded before Flop (didn't bet)

Hand #1344: 

PokerStars Hand #246672312455:  Hold'em No Limit ($0.05/$0.10 CAD) - 2023/10/21 22:50:57 ET
Table 'Yildun' 6-max Seat #2 is the button
Seat 1: shark8_len ($3.24 in chips) 
Seat 2: mycats99887 ($10.12 in chips) 
Seat 3: 2gd2btru422 ($11.94 in chips) 
Seat 4: CashMatteo ($8.43 in chips) 
Seat 5: OoohHi ($13.20 in chips) 
Seat 6: 60centPoker ($10.44 in chips) 
2gd2btru422: posts small blind $0.05
CashMatteo: posts big blind $0.10
*** HOLE CARDS ***
Dealt to CashMatteo [3s Ts]
OoohHi: folds 
60centPoker: folds 
shark8_len: raises $0.25 to $0.35
mycats99887: folds 
2gd2btru422: calls $0.30
CashMatteo: calls $0.25
*** FLOP *** [7h 4d Ah]
2gd2btru422: checks 
CashMatteo: checks 
shark8_len: bets $1
2gd2btru422: folds 
CashMatteo: folds 
Uncalled bet ($1) returned to shark8_len
shark8_len collected $1 from pot
shark8_len: doesn't show hand 
*** SUMMARY ***
Total pot $1.05 | Rake $0.05 
Board [7h 4d Ah]
Seat 1: shark8_len collected ($1)
Seat 2: mycats99887 (button) folded before Flop (didn't bet)
Seat 3: 2gd2btru422 (small blind) folded on the Flop
Seat 4: CashMatteo (big blind) folded on the Flop
Seat 5: OoohHi folded before Flop (didn't bet)
Seat 6: 60centPoker folded before Flop (didn't bet)

Hand #1345: 

PokerStars Hand #246672317816:  Hold'em No Limit ($0.05/$0.10 CAD) - 2023/10/21 22:51:32 ET
Table 'Yildun' 6-max Seat #3 is the button
Seat 1: shark8_len ($3.89 in chips) 
Seat 2: mycats99887 ($10.12 in chips) 
Seat 3: 2gd2btru422 ($11.59 in chips) 
Seat 4: CashMatteo ($8.08 in chips) 
Seat 5: OoohHi ($13.20 in chips) 
Seat 6: 60centPoker ($10.44 in chips) 
CashMatteo: posts small blind $0.05
OoohHi: posts big blind $0.10
*** HOLE CARDS ***
Dealt to CashMatteo [7d Kc]
60centPoker: folds 
shark8_len: folds 
mycats99887: folds 
2gd2btru422: folds 
CashMatteo: calls $0.05
OoohHi: checks 
*** FLOP *** [Kh 9h 8s]
CashMatteo: bets $0.10
OoohHi: calls $0.10
*** TURN *** [Kh 9h 8s] [As]
CashMatteo: bets $0.19
OoohHi: folds 
Uncalled bet ($0.19) returned to CashMatteo
CashMatteo collected $0.38 from pot
CashMatteo: doesn't show hand 
*** SUMMARY ***
Total pot $0.40 | Rake $0.02 
Board [Kh 9h 8s As]
Seat 1: shark8_len folded before Flop (didn't bet)
Seat 2: mycats99887 folded before Flop (didn't bet)
Seat 3: 2gd2btru422 (button) folded before Flop (didn't bet)
Seat 4: CashMatteo (small blind) collected ($0.38)
Seat 5: OoohHi (big blind) folded on the Turn
Seat 6: 60centPoker folded before Flop (didn't bet)

Hand #1346: 

PokerStars Hand #246672323386:  Hold'em No Limit ($0.05/$0.10 CAD) - 2023/10/21 22:52:08 ET
Table 'Yildun' 6-max Seat #4 is the button
Seat 1: shark8_len ($3.89 in chips) 
Seat 2: mycats99887 ($10.12 in chips) 
Seat 3: 2gd2btru422 ($11.59 in chips) 
Seat 4: CashMatteo ($8.26 in chips) 
Seat 5: OoohHi ($13 in chips) 
Seat 6: 60centPoker ($10.44 in chips) 
OoohHi: posts small blind $0.05
60centPoker: posts big blind $0.10
*** HOLE CARDS ***
Dealt to CashMatteo [3s 3d]
shark8_len: folds 
mycats99887: folds 
2gd2btru422: raises $0.25 to $0.35
CashMatteo: raises $0.85 to $1.20
OoohHi: raises $1.90 to $3.10
60centPoker: folds 
2gd2btru422: folds 
CashMatteo: folds 
Uncalled bet ($1.90) returned to OoohHi
OoohHi collected $2.85 from pot
OoohHi: doesn't show hand 
*** SUMMARY ***
Total pot $2.85 | Rake $0 
Seat 1: shark8_len folded before Flop (didn't bet)
Seat 2: mycats99887 folded before Flop (didn't bet)
Seat 3: 2gd2btru422 folded before Flop
Seat 4: CashMatteo (button) folded before Flop
Seat 5: OoohHi (small blind) collected ($2.85)
Seat 6: 60centPoker (big blind) folded before Flop

Hand #1347: 

PokerStars Hand #246672329431:  Hold'em No Limit ($0.05/$0.10 CAD) - 2023/10/21 22:52:47 ET
Table 'Yildun' 6-max Seat #5 is the button
Seat 1: shark8_len ($3.89 in chips) 
Seat 2: mycats99887 ($10.12 in chips) 
Seat 3: 2gd2btru422 ($11.24 in chips) 
Seat 4: CashMatteo ($7.06 in chips) 
Seat 5: OoohHi ($14.65 in chips) 
Seat 6: 60centPoker ($10.34 in chips) 
60centPoker: posts small blind $0.05
shark8_len: posts big blind $0.10
*** HOLE CARDS ***
Dealt to CashMatteo [4h Ac]
mycats99887: raises $0.20 to $0.30
2gd2btru422: raises $0.75 to $1.05
CashMatteo: folds 
OoohHi: folds 
60centPoker: folds 
shark8_len: folds 
mycats99887: calls $0.75
*** FLOP *** [9c 3h 8h]
mycats99887: checks 
2gd2btru422: checks 
*** TURN *** [9c 3h 8h] [5d]
mycats99887: checks 
2gd2btru422: bets $2.15
mycats99887: folds 
Uncalled bet ($2.15) returned to 2gd2btru422
2gd2btru422 collected $2.15 from pot
*** SUMMARY ***
Total pot $2.25 | Rake $0.10 
Board [9c 3h 8h 5d]
Seat 1: shark8_len (big blind) folded before Flop
Seat 2: mycats99887 folded on the Turn
Seat 3: 2gd2btru422 collected ($2.15)
Seat 4: CashMatteo folded before Flop (didn't bet)
Seat 5: OoohHi (button) folded before Flop (didn't bet)
Seat 6: 60centPoker (small blind) folded before Flop

Hand #1348: 

PokerStars Hand #246672335432:  Hold'em No Limit ($0.05/$0.10 CAD) - 2023/10/21 22:53:26 ET
Table 'Yildun' 6-max Seat #6 is the button
Seat 1: shark8_len ($3.79 in chips) 
Seat 2: mycats99887 ($9.07 in chips) 
Seat 3: 2gd2btru422 ($12.34 in chips) 
Seat 4: CashMatteo ($7.06 in chips) 
Seat 5: OoohHi ($14.65 in chips) 
Seat 6: 60centPoker ($10.29 in chips) 
shark8_len: posts small blind $0.05
mycats99887: posts big blind $0.10
*** HOLE CARDS ***
Dealt to CashMatteo [5d 9c]
2gd2btru422: folds 
CashMatteo: folds 
OoohHi: folds 
60centPoker: folds 
shark8_len: folds 
Uncalled bet ($0.05) returned to mycats99887
mycats99887 collected $0.10 from pot
*** SUMMARY ***
Total pot $0.10 | Rake $0 
Seat 1: shark8_len (small blind) folded before Flop
Seat 2: mycats99887 (big blind) collected ($0.10)
Seat 3: 2gd2btru422 folded before Flop (didn't bet)
Seat 4: CashMatteo folded before Flop (didn't bet)
Seat 5: OoohHi folded before Flop (didn't bet)
Seat 6: 60centPoker (button) folded before Flop (didn't bet)

Hand #1349: 

PokerStars Hand #246672340783:  Hold'em No Limit ($0.05/$0.10 CAD) - 2023/10/21 22:54:01 ET
Table 'Yildun' 6-max Seat #1 is the button
Seat 1: shark8_len ($3.74 in chips) 
Seat 2: mycats99887 ($9.12 in chips) 
Seat 3: 2gd2btru422 ($12.34 in chips) 
Seat 4: CashMatteo ($7.06 in chips) 
Seat 5: OoohHi ($14.65 in chips) 
Seat 6: 60centPoker ($10.29 in chips) 
mycats99887: posts small blind $0.05
2gd2btru422: posts big blind $0.10
*** HOLE CARDS ***
Dealt to CashMatteo [Kd 7c]
CashMatteo: calls $0.10
OoohHi: folds 
60centPoker: folds 
shark8_len: folds 
mycats99887: calls $0.05
2gd2btru422: checks 
*** FLOP *** [7h Jc 5h]
mycats99887: checks 
2gd2btru422: checks 
CashMatteo: bets $0.15
mycats99887: calls $0.15
2gd2btru422: folds 
*** TURN *** [7h Jc 5h] [Kh]
mycats99887: checks 
CashMatteo: checks 
*** RIVER *** [7h Jc 5h Kh] [Ac]
mycats99887: bets $0.29
CashMatteo: raises $1.05 to $1.34
mycats99887: folds 
Uncalled bet ($1.05) returned to CashMatteo
CashMatteo collected $1.13 from pot
CashMatteo: doesn't show hand 
*** SUMMARY ***
Total pot $1.18 | Rake $0.05 
Board [7h Jc 5h Kh Ac]
Seat 1: shark8_len (button) folded before Flop (didn't bet)
Seat 2: mycats99887 (small blind) folded on the River
Seat 3: 2gd2btru422 (big blind) folded on the Flop
Seat 4: CashMatteo collected ($1.13)
Seat 5: OoohHi folded before Flop (didn't bet)
Seat 6: 60centPoker folded before Flop (didn't bet)

Hand #1350: 

PokerStars Hand #246672349343:  Hold'em No Limit ($0.05/$0.10 CAD) - 2023/10/21 22:54:58 ET
Table 'Yildun' 6-max Seat #2 is the button
Seat 1: shark8_len ($3.74 in chips) 
Seat 2: mycats99887 ($8.58 in chips) 
Seat 3: 2gd2btru422 ($12.24 in chips) 
Seat 4: CashMatteo ($7.65 in chips) 
Seat 5: OoohHi ($14.65 in chips) 
Seat 6: 60centPoker ($10.29 in chips) 
2gd2btru422: posts small blind $0.05
CashMatteo: posts big blind $0.10
*** HOLE CARDS ***
Dealt to CashMatteo [Qs Jc]
OoohHi: folds 
60centPoker: raises $0.20 to $0.30
shark8_len: folds 
mycats99887: calls $0.30
2gd2btru422: folds 
CashMatteo: calls $0.20
*** FLOP *** [8d As Th]
CashMatteo: checks 
60centPoker: bets $0.10
mycats99887: calls $0.10
CashMatteo: calls $0.10
*** TURN *** [8d As Th] [Ks]
CashMatteo: checks 
60centPoker: checks 
mycats99887: checks 
*** RIVER *** [8d As Th Ks] [2s]
CashMatteo: bets $0.60
60centPoker: folds 
mycats99887: folds 
Uncalled bet ($0.60) returned to CashMatteo
CashMatteo collected $1.19 from pot
CashMatteo: doesn't show hand 
*** SUMMARY ***
Total pot $1.25 | Rake $0.06 
Board [8d As Th Ks 2s]
Seat 1: shark8_len folded before Flop (didn't bet)
Seat 2: mycats99887 (button) folded on the River
Seat 3: 2gd2btru422 (small blind) folded before Flop
Seat 4: CashMatteo (big blind) collected ($1.19)
Seat 5: OoohHi folded before Flop (didn't bet)
Seat 6: 60centPoker folded on the River

Hand #1351: 

PokerStars Hand #246672356442:  Hold'em No Limit ($0.05/$0.10 CAD) - 2023/10/21 22:55:52 ET
Table 'Yildun' 6-max Seat #3 is the button
Seat 1: shark8_len ($3.74 in chips) 
Seat 2: mycats99887 ($8.18 in chips) 
Seat 3: 2gd2btru422 ($12.19 in chips) 
Seat 4: CashMatteo ($8.44 in chips) 
Seat 5: OoohHi ($14.65 in chips) 
Seat 6: 60centPoker ($9.89 in chips) 
CashMatteo: posts small blind $0.05
OoohHi: posts big blind $0.10
*** HOLE CARDS ***
Dealt to CashMatteo [9c 6h]
60centPoker: folds 
shark8_len has timed out
shark8_len: folds 
mycats99887: folds 
2gd2btru422: folds 
CashMatteo: calls $0.05
OoohHi: checks 
*** FLOP *** [2s 8c 7c]
CashMatteo: bets $0.19
OoohHi: folds 
Uncalled bet ($0.19) returned to CashMatteo
CashMatteo collected $0.19 from pot
CashMatteo: doesn't show hand 
*** SUMMARY ***
Total pot $0.20 | Rake $0.01 
Board [2s 8c 7c]
Seat 1: shark8_len folded before Flop (didn't bet)
Seat 2: mycats99887 folded before Flop (didn't bet)
Seat 3: 2gd2btru422 (button) folded before Flop (didn't bet)
Seat 4: CashMatteo (small blind) collected ($0.19)
Seat 5: OoohHi (big blind) folded on the Flop
Seat 6: 60centPoker folded before Flop (didn't bet)

Hand #1352: 

PokerStars Hand #246672361476:  Hold'em No Limit ($0.05/$0.10 CAD) - 2023/10/21 22:56:30 ET
Table 'Yildun' 6-max Seat #4 is the button
Seat 1: shark8_len ($3.74 in chips) 
Seat 2: mycats99887 ($8.18 in chips) 
Seat 3: 2gd2btru422 ($12.19 in chips) 
Seat 4: CashMatteo ($8.53 in chips) 
Seat 5: OoohHi ($14.55 in chips) 
Seat 6: 60centPoker ($9.89 in chips) 
OoohHi: posts small blind $0.05
60centPoker: posts big blind $0.10
*** HOLE CARDS ***
Dealt to CashMatteo [5d 2h]
shark8_len has timed out
shark8_len: folds 
mycats99887: raises $0.25 to $0.35
2gd2btru422: folds 
CashMatteo: folds 
OoohHi: folds 
60centPoker: folds 
Uncalled bet ($0.25) returned to mycats99887
mycats99887 collected $0.25 from pot
mycats99887: doesn't show hand 
*** SUMMARY ***
Total pot $0.25 | Rake $0 
Seat 1: shark8_len folded before Flop (didn't bet)
Seat 2: mycats99887 collected ($0.25)
Seat 3: 2gd2btru422 folded before Flop (didn't bet)
Seat 4: CashMatteo (button) folded before Flop (didn't bet)
Seat 5: OoohHi (small blind) folded before Flop
Seat 6: 60centPoker (big blind) folded before Flop

Hand #1353: 

PokerStars Hand #246672364121:  Hold'em No Limit ($0.05/$0.10 CAD) - 2023/10/21 22:56:51 ET
Table 'Yildun' 6-max Seat #5 is the button
Seat 2: mycats99887 ($8.33 in chips) 
Seat 3: 2gd2btru422 ($12.19 in chips) 
Seat 4: CashMatteo ($8.53 in chips) 
Seat 5: OoohHi ($14.50 in chips) 
Seat 6: 60centPoker ($9.79 in chips) 
60centPoker: posts small blind $0.05
mycats99887: posts big blind $0.10
*** HOLE CARDS ***
Dealt to CashMatteo [Tc Ah]
2gd2btru422: folds 
CashMatteo: raises $0.15 to $0.25
OoohHi: calls $0.25
60centPoker: folds 
mycats99887: folds 
*** FLOP *** [6s 4s 3c]
CashMatteo: checks 
OoohHi: checks 
*** TURN *** [6s 4s 3c] [9c]
CashMatteo: checks 
OoohHi: checks 
*** RIVER *** [6s 4s 3c 9c] [4d]
CashMatteo: checks 
OoohHi: checks 
*** SHOW DOWN ***
CashMatteo: shows [Tc Ah] (a pair of Fours)
OoohHi: mucks hand 
CashMatteo collected $0.62 from pot
*** SUMMARY ***
Total pot $0.65 | Rake $0.03 
Board [6s 4s 3c 9c 4d]
Seat 2: mycats99887 (big blind) folded before Flop
Seat 3: 2gd2btru422 folded before Flop (didn't bet)
Seat 4: CashMatteo showed [Tc Ah] and won ($0.62) with a pair of Fours
Seat 5: OoohHi (button) mucked [Ad 7d]
Seat 6: 60centPoker (small blind) folded before Flop

Hand #1354: 

PokerStars Hand #246672367965:  Hold'em No Limit ($0.05/$0.10 CAD) - 2023/10/21 22:57:21 ET
Table 'Yildun' 6-max Seat #6 is the button
Seat 2: mycats99887 ($8.23 in chips) 
Seat 3: 2gd2btru422 ($12.19 in chips) 
Seat 4: CashMatteo ($8.90 in chips) 
Seat 5: OoohHi ($14.25 in chips) 
Seat 6: 60centPoker ($9.74 in chips) 
shark8_len will be allowed to play after the button
mycats99887: posts small blind $0.05
2gd2btru422: posts big blind $0.10
*** HOLE CARDS ***
Dealt to CashMatteo [5s 4d]
CashMatteo: calls $0.10
OoohHi: folds 
60centPoker: folds 
mycats99887: folds 
2gd2btru422: checks 
*** FLOP *** [Jh Kd 8c]
2gd2btru422: checks 
CashMatteo: checks 
*** TURN *** [Jh Kd 8c] [7c]
2gd2btru422: bets $0.24
CashMatteo: calls $0.24
*** RIVER *** [Jh Kd 8c 7c] [4s]
2gd2btru422: bets $0.70
CashMatteo: calls $0.70
*** SHOW DOWN ***
2gd2btru422: shows [7d Jc] (two pair, Jacks and Sevens)
CashMatteo: mucks hand 
2gd2btru422 collected $2.03 from pot
*** SUMMARY ***
Total pot $2.13 | Rake $0.10 
Board [Jh Kd 8c 7c 4s]
Seat 2: mycats99887 (small blind) folded before Flop
Seat 3: 2gd2btru422 (big blind) showed [7d Jc] and won ($2.03) with two pair, Jacks and Sevens
Seat 4: CashMatteo mucked [5s 4d]
Seat 5: OoohHi folded before Flop (didn't bet)
Seat 6: 60centPoker (button) folded before Flop (didn't bet)

Hand #1355: 

PokerStars Hand #246672373689:  Hold'em No Limit ($0.05/$0.10 CAD) - 2023/10/21 22:58:05 ET
Table 'Yildun' 6-max Seat #2 is the button
Seat 2: mycats99887 ($8.18 in chips) 
Seat 3: 2gd2btru422 ($13.18 in chips) 
Seat 4: CashMatteo ($7.86 in chips) 
Seat 5: OoohHi ($14.25 in chips) 
Seat 6: 60centPoker ($9.74 in chips) 
2gd2btru422: posts small blind $0.05
CashMatteo: posts big blind $0.10
shark8_len: sits out 
*** HOLE CARDS ***
Dealt to CashMatteo [Ts 3s]
OoohHi: raises $0.13 to $0.23
60centPoker: folds 
mycats99887: folds 
2gd2btru422: folds 
CashMatteo: calls $0.13
*** FLOP *** [Ad Jc Tc]
CashMatteo: checks 
OoohHi: bets $0.30
CashMatteo: calls $0.30
*** TURN *** [Ad Jc Tc] [6d]
CashMatteo: checks 
OoohHi: bets $0.50
CashMatteo: folds 
Uncalled bet ($0.50) returned to OoohHi
OoohHi collected $1.06 from pot
OoohHi: doesn't show hand 
*** SUMMARY ***
Total pot $1.11 | Rake $0.05 
Board [Ad Jc Tc 6d]
Seat 2: mycats99887 (button) folded before Flop (didn't bet)
Seat 3: 2gd2btru422 (small blind) folded before Flop
Seat 4: CashMatteo (big blind) folded on the Turn
Seat 5: OoohHi collected ($1.06)
Seat 6: 60centPoker folded before Flop (didn't bet)

Hand #1356: 

PokerStars Hand #246672381970:  Hold'em No Limit ($0.05/$0.10 CAD) - 2023/10/21 22:59:09 ET
Table 'Yildun' 6-max Seat #3 is the button
Seat 2: mycats99887 ($8.18 in chips) 
Seat 3: 2gd2btru422 ($13.13 in chips) 
Seat 4: CashMatteo ($7.33 in chips) 
Seat 5: OoohHi ($14.78 in chips) 
Seat 6: 60centPoker ($9.74 in chips) 
CashMatteo: posts small blind $0.05
OoohHi: posts big blind $0.10
shark8_len: sits out 
*** HOLE CARDS ***
Dealt to CashMatteo [8s Jh]
60centPoker: folds 
mycats99887: folds 
2gd2btru422: folds 
CashMatteo: calls $0.05
OoohHi: checks 
*** FLOP *** [9c Kd 3d]
CashMatteo: checks 
OoohHi: bets $0.10
CashMatteo: calls $0.10
*** TURN *** [9c Kd 3d] [2s]
CashMatteo: checks 
OoohHi: bets $0.20
CashMatteo: folds 
Uncalled bet ($0.20) returned to OoohHi
OoohHi collected $0.38 from pot
OoohHi: doesn't show hand 
*** SUMMARY ***
Total pot $0.40 | Rake $0.02 
Board [9c Kd 3d 2s]
Seat 2: mycats99887 folded before Flop (didn't bet)
Seat 3: 2gd2btru422 (button) folded before Flop (didn't bet)
Seat 4: CashMatteo (small blind) folded on the Turn
Seat 5: OoohHi (big blind) collected ($0.38)
Seat 6: 60centPoker folded before Flop (didn't bet)

Hand #1357: 

PokerStars Hand #246672387205:  Hold'em No Limit ($0.05/$0.10 CAD) - 2023/10/21 22:59:49 ET
Table 'Yildun' 6-max Seat #4 is the button
Seat 2: mycats99887 ($8.18 in chips) 
Seat 3: 2gd2btru422 ($13.13 in chips) 
Seat 4: CashMatteo ($7.13 in chips) 
Seat 5: OoohHi ($14.96 in chips) 
Seat 6: 60centPoker ($9.74 in chips) 
OoohHi: posts small blind $0.05
60centPoker: posts big blind $0.10
shark8_len: sits out 
*** HOLE CARDS ***
Dealt to CashMatteo [3d 6c]
mycats99887: calls $0.10
2gd2btru422: folds 
CashMatteo: folds 
OoohHi: folds 
60centPoker: checks 
*** FLOP *** [Ts 6d 7c]
60centPoker: checks 
mycats99887: checks 
*** TURN *** [Ts 6d 7c] [9c]
60centPoker: bets $0.10
mycats99887: calls $0.10
*** RIVER *** [Ts 6d 7c 9c] [Jh]
60centPoker: checks 
mycats99887: bets $0.20
60centPoker: folds 
Uncalled bet ($0.20) returned to mycats99887
mycats99887 collected $0.43 from pot
mycats99887: doesn't show hand 
*** SUMMARY ***
Total pot $0.45 | Rake $0.02 
Board [Ts 6d 7c 9c Jh]
Seat 2: mycats99887 collected ($0.43)
Seat 3: 2gd2btru422 folded before Flop (didn't bet)
Seat 4: CashMatteo (button) folded before Flop (didn't bet)
Seat 5: OoohHi (small blind) folded before Flop
Seat 6: 60centPoker (big blind) folded on the River

Hand #1358: 

PokerStars Hand #246672393495:  Hold'em No Limit ($0.05/$0.10 CAD) - 2023/10/21 23:00:36 ET
Table 'Yildun' 6-max Seat #5 is the button
Seat 1: shark8_len ($3.74 in chips) 
Seat 2: mycats99887 ($8.41 in chips) 
Seat 3: 2gd2btru422 ($13.13 in chips) 
Seat 4: CashMatteo ($7.13 in chips) 
Seat 5: OoohHi ($14.91 in chips) 
Seat 6: 60centPoker ($9.54 in chips) 
60centPoker: posts small blind $0.05
shark8_len: posts big blind $0.10
*** HOLE CARDS ***
Dealt to CashMatteo [6s 8d]
mycats99887: raises $0.30 to $0.40
2gd2btru422: folds 
CashMatteo: folds 
OoohHi: folds 
60centPoker: folds 
shark8_len has timed out
shark8_len: folds 
Uncalled bet ($0.30) returned to mycats99887
mycats99887 collected $0.25 from pot
mycats99887: doesn't show hand 
*** SUMMARY ***
Total pot $0.25 | Rake $0 
Seat 1: shark8_len (big blind) folded before Flop
Seat 2: mycats99887 collected ($0.25)
Seat 3: 2gd2btru422 folded before Flop (didn't bet)
Seat 4: CashMatteo folded before Flop (didn't bet)
Seat 5: OoohHi (button) folded before Flop (didn't bet)
Seat 6: 60centPoker (small blind) folded before Flop

Hand #1359: 

PokerStars Hand #246672402114:  Hold'em No Limit ($0.05/$0.10 CAD) - 2023/10/21 23:01:35 ET
Table 'Yildun' 6-max Seat #6 is the button
Seat 2: mycats99887 ($8.56 in chips) 
Seat 3: 2gd2btru422 ($13.13 in chips) 
Seat 4: CashMatteo ($7.13 in chips) 
Seat 5: OoohHi ($14.91 in chips) 
Seat 6: 60centPoker ($9.49 in chips) 
mycats99887: posts small blind $0.05
2gd2btru422: posts big blind $0.10
*** HOLE CARDS ***
Dealt to CashMatteo [Kc 2d]
CashMatteo: folds 
OoohHi: folds 
60centPoker: raises $0.10 to $0.20
mycats99887: folds 
2gd2btru422: folds 
Uncalled bet ($0.10) returned to 60centPoker
60centPoker collected $0.25 from pot
60centPoker: doesn't show hand 
*** SUMMARY ***
Total pot $0.25 | Rake $0 
Seat 2: mycats99887 (small blind) folded before Flop
Seat 3: 2gd2btru422 (big blind) folded before Flop
Seat 4: CashMatteo folded before Flop (didn't bet)
Seat 5: OoohHi folded before Flop (didn't bet)
Seat 6: 60centPoker (button) collected ($0.25)

Hand #1360: 

PokerStars Hand #246672404888:  Hold'em No Limit ($0.05/$0.10 CAD) - 2023/10/21 23:01:54 ET
Table 'Yildun' 6-max Seat #2 is the button
Seat 2: mycats99887 ($8.51 in chips) 
Seat 3: 2gd2btru422 ($13.03 in chips) 
Seat 4: CashMatteo ($7.13 in chips) 
Seat 5: OoohHi ($14.91 in chips) 
Seat 6: 60centPoker ($9.64 in chips) 
2gd2btru422: posts small blind $0.05
CashMatteo: posts big blind $0.10
*** HOLE CARDS ***
Dealt to CashMatteo [Qd 3c]
OoohHi: folds 
60centPoker: folds 
mycats99887: folds 
2gd2btru422: folds 
Uncalled bet ($0.05) returned to CashMatteo
CashMatteo collected $0.10 from pot
CashMatteo: doesn't show hand 
*** SUMMARY ***
Total pot $0.10 | Rake $0 
Seat 2: mycats99887 (button) folded before Flop (didn't bet)
Seat 3: 2gd2btru422 (small blind) folded before Flop
Seat 4: CashMatteo (big blind) collected ($0.10)
Seat 5: OoohHi folded before Flop (didn't bet)
Seat 6: 60centPoker folded before Flop (didn't bet)

Hand #1361: 

PokerStars Hand #246672406984:  Hold'em No Limit ($0.05/$0.10 CAD) - 2023/10/21 23:02:07 ET
Table 'Yildun' 6-max Seat #3 is the button
Seat 2: mycats99887 ($8.51 in chips) 
Seat 3: 2gd2btru422 ($12.98 in chips) 
Seat 4: CashMatteo ($7.18 in chips) 
Seat 5: OoohHi ($14.91 in chips) 
Seat 6: 60centPoker ($9.64 in chips) 
CashMatteo: posts small blind $0.05
OoohHi: posts big blind $0.10
*** HOLE CARDS ***
Dealt to CashMatteo [5s Js]
60centPoker: raises $0.10 to $0.20
mycats99887: folds 
2gd2btru422: folds 
CashMatteo: calls $0.15
OoohHi: folds 
*** FLOP *** [7h 2h Td]
CashMatteo: checks 
60centPoker: bets $0.10
CashMatteo: folds 
Uncalled bet ($0.10) returned to 60centPoker
60centPoker collected $0.48 from pot
60centPoker: doesn't show hand 
*** SUMMARY ***
Total pot $0.50 | Rake $0.02 
Board [7h 2h Td]
Seat 2: mycats99887 folded before Flop (didn't bet)
Seat 3: 2gd2btru422 (button) folded before Flop (didn't bet)
Seat 4: CashMatteo (small blind) folded on the Flop
Seat 5: OoohHi (big blind) folded before Flop
Seat 6: 60centPoker collected ($0.48)

Hand #1362: 

PokerStars Hand #246672413366:  Hold'em No Limit ($0.05/$0.10 CAD) - 2023/10/21 23:02:51 ET
Table 'Yildun' 6-max Seat #4 is the button
Seat 2: mycats99887 ($8.51 in chips) 
Seat 3: 2gd2btru422 ($12.98 in chips) 
Seat 4: CashMatteo ($6.98 in chips) 
Seat 5: OoohHi ($14.81 in chips) 
Seat 6: 60centPoker ($9.92 in chips) 
OoohHi: posts small blind $0.05
60centPoker: posts big blind $0.10
*** HOLE CARDS ***
Dealt to CashMatteo [4c 7c]
mycats99887: folds 
2gd2btru422: folds 
CashMatteo: folds 
OoohHi: folds 
Uncalled bet ($0.05) returned to 60centPoker
60centPoker collected $0.10 from pot
60centPoker: doesn't show hand 
*** SUMMARY ***
Total pot $0.10 | Rake $0 
Seat 2: mycats99887 folded before Flop (didn't bet)
Seat 3: 2gd2btru422 folded before Flop (didn't bet)
Seat 4: CashMatteo (button) folded before Flop (didn't bet)
Seat 5: OoohHi (small blind) folded before Flop
Seat 6: 60centPoker (big blind) collected ($0.10)

Hand #1363: 

PokerStars Hand #246672415659:  Hold'em No Limit ($0.05/$0.10 CAD) - 2023/10/21 23:03:06 ET
Table 'Yildun' 6-max Seat #5 is the button
Seat 1: shark8_len ($3.64 in chips) 
Seat 2: mycats99887 ($8.51 in chips) 
Seat 3: 2gd2btru422 ($12.98 in chips) 
Seat 4: CashMatteo ($6.98 in chips) 
Seat 5: OoohHi ($14.76 in chips) 
Seat 6: 60centPoker ($9.97 in chips) 
60centPoker: posts small blind $0.05
shark8_len: posts big blind $0.10
*** HOLE CARDS ***
Dealt to CashMatteo [5c As]
mycats99887: folds 
2gd2btru422 has timed out
2gd2btru422: folds 
CashMatteo: raises $0.15 to $0.25
OoohHi: folds 
60centPoker: folds 
shark8_len: raises $0.55 to $0.80
CashMatteo: folds 
Uncalled bet ($0.55) returned to shark8_len
shark8_len collected $0.55 from pot
shark8_len: doesn't show hand 
*** SUMMARY ***
Total pot $0.55 | Rake $0 
Seat 1: shark8_len (big blind) collected ($0.55)
Seat 2: mycats99887 folded before Flop (didn't bet)
Seat 3: 2gd2btru422 folded before Flop (didn't bet)
Seat 4: CashMatteo folded before Flop
Seat 5: OoohHi (button) folded before Flop (didn't bet)
Seat 6: 60centPoker (small blind) folded before Flop

Hand #1364: 

PokerStars Hand #246672421166:  Hold'em No Limit ($0.05/$0.10 CAD) - 2023/10/21 23:03:42 ET
Table 'Yildun' 6-max Seat #6 is the button
Seat 1: shark8_len ($3.94 in chips) 
Seat 2: mycats99887 ($8.51 in chips) 
Seat 3: 2gd2btru422 ($12.98 in chips) 
Seat 4: CashMatteo ($6.73 in chips) 
Seat 5: OoohHi ($14.76 in chips) 
Seat 6: 60centPoker ($9.92 in chips) 
shark8_len: posts small blind $0.05
mycats99887: posts big blind $0.10
*** HOLE CARDS ***
Dealt to CashMatteo [8d Ad]
2gd2btru422: calls $0.10
CashMatteo: calls $0.10
OoohHi: folds 
60centPoker: folds 
shark8_len: folds 
mycats99887: checks 
*** FLOP *** [Ac 4c Td]
mycats99887: checks 
2gd2btru422: bets $0.33
CashMatteo: calls $0.33
mycats99887: folds 
*** TURN *** [Ac 4c Td] [Kc]
2gd2btru422: bets $0.96
CashMatteo: calls $0.96
*** RIVER *** [Ac 4c Td Kc] [Js]
2gd2btru422: bets $2.80
CashMatteo: folds 
Uncalled bet ($2.80) returned to 2gd2btru422
2gd2btru422 collected $2.80 from pot
*** SUMMARY ***
Total pot $2.93 | Rake $0.13 
Board [Ac 4c Td Kc Js]
Seat 1: shark8_len (small blind) folded before Flop
Seat 2: mycats99887 (big blind) folded on the Flop
Seat 3: 2gd2btru422 collected ($2.80)
Seat 4: CashMatteo folded on the River
Seat 5: OoohHi folded before Flop (didn't bet)
Seat 6: 60centPoker (button) folded before Flop (didn't bet)

Hand #1365: 

PokerStars Hand #246672429717:  Hold'em No Limit ($0.05/$0.10 CAD) - 2023/10/21 23:04:40 ET
Table 'Yildun' 6-max Seat #1 is the button
Seat 1: shark8_len ($3.89 in chips) 
Seat 2: mycats99887 ($8.41 in chips) 
Seat 3: 2gd2btru422 ($14.39 in chips) 
Seat 4: CashMatteo ($5.34 in chips) 
Seat 5: OoohHi ($14.76 in chips) 
Seat 6: 60centPoker ($9.92 in chips) 
mycats99887: posts small blind $0.05
2gd2btru422: posts big blind $0.10
*** HOLE CARDS ***
Dealt to CashMatteo [Ad Ts]
CashMatteo: raises $0.15 to $0.25
OoohHi: folds 
60centPoker: folds 
shark8_len: folds 
mycats99887: folds 
2gd2btru422: calls $0.15
*** FLOP *** [5d 4c 6c]
2gd2btru422: checks 
CashMatteo: bets $0.27
2gd2btru422: folds 
Uncalled bet ($0.27) returned to CashMatteo
CashMatteo collected $0.53 from pot
CashMatteo: doesn't show hand 
*** SUMMARY ***
Total pot $0.55 | Rake $0.02 
Board [5d 4c 6c]
Seat 1: shark8_len (button) folded before Flop (didn't bet)
Seat 2: mycats99887 (small blind) folded before Flop
Seat 3: 2gd2btru422 (big blind) folded on the Flop
Seat 4: CashMatteo collected ($0.53)
Seat 5: OoohHi folded before Flop (didn't bet)
Seat 6: 60centPoker folded before Flop (didn't bet)

Hand #1366: 

PokerStars Hand #246672432711:  Hold'em No Limit ($0.05/$0.10 CAD) - 2023/10/21 23:05:00 ET
Table 'Yildun' 6-max Seat #2 is the button
Seat 1: shark8_len ($3.89 in chips) 
Seat 2: mycats99887 ($8.36 in chips) 
Seat 3: 2gd2btru422 ($14.14 in chips) 
Seat 4: CashMatteo ($5.62 in chips) 
Seat 5: OoohHi ($14.76 in chips) 
Seat 6: 60centPoker ($9.92 in chips) 
2gd2btru422: posts small blind $0.05
CashMatteo: posts big blind $0.10
*** HOLE CARDS ***
Dealt to CashMatteo [5s Ts]
OoohHi: raises $0.13 to $0.23
60centPoker: folds 
shark8_len: folds 
mycats99887: folds 
2gd2btru422: folds 
CashMatteo: folds 
Uncalled bet ($0.13) returned to OoohHi
OoohHi collected $0.25 from pot
OoohHi: doesn't show hand 
*** SUMMARY ***
Total pot $0.25 | Rake $0 
Seat 1: shark8_len folded before Flop (didn't bet)
Seat 2: mycats99887 (button) folded before Flop (didn't bet)
Seat 3: 2gd2btru422 (small blind) folded before Flop
Seat 4: CashMatteo (big blind) folded before Flop
Seat 5: OoohHi collected ($0.25)
Seat 6: 60centPoker folded before Flop (didn't bet)

Hand #1367: 

PokerStars Hand #246672435818:  Hold'em No Limit ($0.05/$0.10 CAD) - 2023/10/21 23:05:20 ET
Table 'Yildun' 6-max Seat #3 is the button
Seat 1: shark8_len ($3.89 in chips) 
Seat 2: mycats99887 ($8.36 in chips) 
Seat 3: 2gd2btru422 ($14.09 in chips) 
Seat 4: CashMatteo ($5.52 in chips) 
Seat 5: OoohHi ($14.91 in chips) 
Seat 6: 60centPoker ($9.92 in chips) 
CashMatteo: posts small blind $0.05
OoohHi: posts big blind $0.10
*** HOLE CARDS ***
Dealt to CashMatteo [2h 4s]
60centPoker: folds 
shark8_len: folds 
mycats99887: folds 
2gd2btru422: folds 
CashMatteo: folds 
Uncalled bet ($0.05) returned to OoohHi
OoohHi collected $0.10 from pot
OoohHi: doesn't show hand 
*** SUMMARY ***
Total pot $0.10 | Rake $0 
Seat 1: shark8_len folded before Flop (didn't bet)
Seat 2: mycats99887 folded before Flop (didn't bet)
Seat 3: 2gd2btru422 (button) folded before Flop (didn't bet)
Seat 4: CashMatteo (small blind) folded before Flop
Seat 5: OoohHi (big blind) collected ($0.10)
Seat 6: 60centPoker folded before Flop (didn't bet)

Hand #1368: 

PokerStars Hand #246672439795:  Hold'em No Limit ($0.05/$0.10 CAD) - 2023/10/21 23:05:47 ET
Table 'Yildun' 6-max Seat #4 is the button
Seat 1: shark8_len ($3.89 in chips) 
Seat 2: mycats99887 ($8.36 in chips) 
Seat 3: 2gd2btru422 ($14.09 in chips) 
Seat 4: CashMatteo ($5.47 in chips) 
Seat 5: OoohHi ($14.96 in chips) 
Seat 6: 60centPoker ($9.92 in chips) 
OoohHi: posts small blind $0.05
60centPoker: posts big blind $0.10
*** HOLE CARDS ***
Dealt to CashMatteo [Kh 6h]
shark8_len: folds 
mycats99887: raises $0.40 to $0.50
2gd2btru422: folds 
CashMatteo: calls $0.50
OoohHi: folds 
60centPoker: folds 
*** FLOP *** [7s 7h Qs]
mycats99887: checks 
CashMatteo: checks 
*** TURN *** [7s 7h Qs] [5s]
mycats99887: bets $0.30
CashMatteo: raises $0.85 to $1.15
mycats99887: folds 
Uncalled bet ($0.85) returned to CashMatteo
CashMatteo collected $1.67 from pot
CashMatteo: doesn't show hand 
*** SUMMARY ***
Total pot $1.75 | Rake $0.08 
Board [7s 7h Qs 5s]
Seat 1: shark8_len folded before Flop (didn't bet)
Seat 2: mycats99887 folded on the Turn
Seat 3: 2gd2btru422 folded before Flop (didn't bet)
Seat 4: CashMatteo (button) collected ($1.67)
Seat 5: OoohHi (small blind) folded before Flop
Seat 6: 60centPoker (big blind) folded before Flop

Hand #1369: 

PokerStars Hand #246672450239:  Hold'em No Limit ($0.05/$0.10 CAD) - 2023/10/21 23:06:58 ET
Table 'Yildun' 6-max Seat #5 is the button
Seat 1: shark8_len ($3.89 in chips) 
Seat 2: mycats99887 ($7.56 in chips) 
Seat 3: 2gd2btru422 ($14.09 in chips) 
Seat 4: CashMatteo ($6.34 in chips) 
Seat 5: OoohHi ($14.91 in chips) 
Seat 6: 60centPoker ($9.82 in chips) 
60centPoker: posts small blind $0.05
shark8_len: posts big blind $0.10
*** HOLE CARDS ***
Dealt to CashMatteo [9s Js]
mycats99887: folds 
2gd2btru422: calls $0.10
CashMatteo: raises $0.15 to $0.25
OoohHi: folds 
60centPoker: folds 
shark8_len has timed out
shark8_len: folds 
2gd2btru422: folds 
Uncalled bet ($0.15) returned to CashMatteo
CashMatteo collected $0.35 from pot
CashMatteo: doesn't show hand 
*** SUMMARY ***
Total pot $0.35 | Rake $0 
Seat 1: shark8_len (big blind) folded before Flop
Seat 2: mycats99887 folded before Flop (didn't bet)
Seat 3: 2gd2btru422 folded before Flop
Seat 4: CashMatteo collected ($0.35)
Seat 5: OoohHi (button) folded before Flop (didn't bet)
Seat 6: 60centPoker (small blind) folded before Flop

Hand #1370: 

PokerStars Hand #246672456557:  Hold'em No Limit ($0.05/$0.10 CAD) - 2023/10/21 23:07:42 ET
Table 'Yildun' 6-max Seat #6 is the button
Seat 2: mycats99887 ($10 in chips) 
Seat 3: 2gd2btru422 ($13.99 in chips) 
Seat 4: CashMatteo ($6.59 in chips) 
Seat 5: OoohHi ($14.91 in chips) 
Seat 6: 60centPoker ($9.77 in chips) 
mycats99887: posts small blind $0.05
2gd2btru422: posts big blind $0.10
*** HOLE CARDS ***
Dealt to CashMatteo [Qc 2h]
CashMatteo: folds 
OoohHi: folds 
60centPoker: raises $0.10 to $0.20
mycats99887: folds 
2gd2btru422: folds 
Uncalled bet ($0.10) returned to 60centPoker
60centPoker collected $0.25 from pot
60centPoker: doesn't show hand 
*** SUMMARY ***
Total pot $0.25 | Rake $0 
Seat 2: mycats99887 (small blind) folded before Flop
Seat 3: 2gd2btru422 (big blind) folded before Flop
Seat 4: CashMatteo folded before Flop (didn't bet)
Seat 5: OoohHi folded before Flop (didn't bet)
Seat 6: 60centPoker (button) collected ($0.25)

Hand #1371: 

PokerStars Hand #246672458920:  Hold'em No Limit ($0.05/$0.10 CAD) - 2023/10/21 23:07:59 ET
Table 'Yildun' 6-max Seat #2 is the button
Seat 2: mycats99887 ($9.95 in chips) 
Seat 3: 2gd2btru422 ($13.89 in chips) 
Seat 4: CashMatteo ($6.59 in chips) 
Seat 5: OoohHi ($14.91 in chips) 
Seat 6: 60centPoker ($9.92 in chips) 
2gd2btru422: posts small blind $0.05
CashMatteo: posts big blind $0.10
*** HOLE CARDS ***
Dealt to CashMatteo [8c 6h]
OoohHi: folds 
60centPoker: folds 
mycats99887: folds 
2gd2btru422: folds 
Uncalled bet ($0.05) returned to CashMatteo
CashMatteo collected $0.10 from pot
CashMatteo: doesn't show hand 
*** SUMMARY ***
Total pot $0.10 | Rake $0 
Seat 2: mycats99887 (button) folded before Flop (didn't bet)
Seat 3: 2gd2btru422 (small blind) folded before Flop
Seat 4: CashMatteo (big blind) collected ($0.10)
Seat 5: OoohHi folded before Flop (didn't bet)
Seat 6: 60centPoker folded before Flop (didn't bet)

Hand #1372: 

PokerStars Hand #246672461490:  Hold'em No Limit ($0.05/$0.10 CAD) - 2023/10/21 23:08:17 ET
Table 'Yildun' 6-max Seat #3 is the button
Seat 2: mycats99887 ($9.95 in chips) 
Seat 3: 2gd2btru422 ($13.84 in chips) 
Seat 4: CashMatteo ($6.64 in chips) 
Seat 6: 60centPoker ($9.92 in chips) 
CashMatteo: posts small blind $0.05
OoohHi: is sitting out 
60centPoker: posts big blind $0.10
*** HOLE CARDS ***
Dealt to CashMatteo [8c 7c]
mycats99887: folds 
2gd2btru422: folds 
CashMatteo: calls $0.05
OoohHi leaves the table
60centPoker: raises $0.10 to $0.20
CashMatteo: calls $0.10
*** FLOP *** [Jc 3h Ad]
CashMatteo: checks 
60centPoker: bets $0.10
CashMatteo: folds 
Uncalled bet ($0.10) returned to 60centPoker
60centPoker collected $0.38 from pot
60centPoker: doesn't show hand 
*** SUMMARY ***
Total pot $0.40 | Rake $0.02 
Board [Jc 3h Ad]
Seat 2: mycats99887 folded before Flop (didn't bet)
Seat 3: 2gd2btru422 (button) folded before Flop (didn't bet)
Seat 4: CashMatteo (small blind) folded on the Flop
Seat 6: 60centPoker (big blind) collected ($0.38)

Hand #1373: 

PokerStars Hand #246672465726:  Hold'em No Limit ($0.05/$0.10 CAD) - 2023/10/21 23:08:46 ET
Table 'Yildun' 6-max Seat #4 is the button
Seat 2: mycats99887 ($9.95 in chips) 
Seat 3: 2gd2btru422 ($13.84 in chips) 
Seat 4: CashMatteo ($6.44 in chips) 
Seat 6: 60centPoker ($10.10 in chips) 
60centPoker: posts small blind $0.05
mycats99887: posts big blind $0.10
*** HOLE CARDS ***
Dealt to CashMatteo [4c 2s]
2gd2btru422: folds 
CashMatteo: folds 
60centPoker: folds 
Uncalled bet ($0.05) returned to mycats99887
mycats99887 collected $0.10 from pot
*** SUMMARY ***
Total pot $0.10 | Rake $0 
Seat 2: mycats99887 (big blind) collected ($0.10)
Seat 3: 2gd2btru422 folded before Flop (didn't bet)
Seat 4: CashMatteo (button) folded before Flop (didn't bet)
Seat 6: 60centPoker (small blind) folded before Flop

Hand #1374: 

PokerStars Hand #246672468726:  Hold'em No Limit ($0.05/$0.10 CAD) - 2023/10/21 23:09:07 ET
Table 'Yildun' 6-max Seat #6 is the button
Seat 2: mycats99887 ($10 in chips) 
Seat 3: 2gd2btru422 ($13.84 in chips) 
Seat 4: CashMatteo ($6.44 in chips) 
Seat 6: 60centPoker ($10.05 in chips) 
mycats99887: posts small blind $0.05
2gd2btru422: posts big blind $0.10
*** HOLE CARDS ***
Dealt to CashMatteo [Qh 2c]
CashMatteo: calls $0.10
60centPoker: folds 
mycats99887: folds 
2gd2btru422: checks 
*** FLOP *** [5c Js 7d]
2gd2btru422: checks 
CashMatteo: checks 
*** TURN *** [5c Js 7d] [8h]
2gd2btru422: bets $0.24
CashMatteo: folds 
Uncalled bet ($0.24) returned to 2gd2btru422
2gd2btru422 collected $0.24 from pot
*** SUMMARY ***
Total pot $0.25 | Rake $0.01 
Board [5c Js 7d 8h]
Seat 2: mycats99887 (small blind) folded before Flop
Seat 3: 2gd2btru422 (big blind) collected ($0.24)
Seat 4: CashMatteo folded on the Turn
Seat 6: 60centPoker (button) folded before Flop (didn't bet)

Hand #1375: 

PokerStars Hand #246672471605:  Hold'em No Limit ($0.05/$0.10 CAD) - 2023/10/21 23:09:27 ET
Table 'Yildun' 6-max Seat #2 is the button
Seat 2: mycats99887 ($9.95 in chips) 
Seat 3: 2gd2btru422 ($13.98 in chips) 
Seat 4: CashMatteo ($6.34 in chips) 
Seat 6: 60centPoker ($10.05 in chips) 
2gd2btru422: posts small blind $0.05
CashMatteo: posts big blind $0.10
*** HOLE CARDS ***
Dealt to CashMatteo [3c 4c]
60centPoker: folds 
mycats99887: folds 
2gd2btru422: calls $0.05
CashMatteo: checks 
*** FLOP *** [Ks 8c Tc]
2gd2btru422: bets $0.19
CashMatteo: calls $0.19
*** TURN *** [Ks 8c Tc] [Qd]
2gd2btru422: bets $0.55
CashMatteo: calls $0.55
*** RIVER *** [Ks 8c Tc Qd] [6h]
2gd2btru422: checks 
CashMatteo: bets $1.60
2gd2btru422: folds 
Uncalled bet ($1.60) returned to CashMatteo
CashMatteo collected $1.60 from pot
CashMatteo: doesn't show hand 
*** SUMMARY ***
Total pot $1.68 | Rake $0.08 
Board [Ks 8c Tc Qd 6h]
Seat 2: mycats99887 (button) folded before Flop (didn't bet)
Seat 3: 2gd2btru422 (small blind) folded on the River
Seat 4: CashMatteo (big blind) collected ($1.60)
Seat 6: 60centPoker folded before Flop (didn't bet)

Hand #1376: 

PokerStars Hand #246672478323:  Hold'em No Limit ($0.05/$0.10 CAD) - 2023/10/21 23:10:14 ET
Table 'Yildun' 6-max Seat #3 is the button
Seat 2: mycats99887 ($9.95 in chips) 
Seat 3: 2gd2btru422 ($13.14 in chips) 
Seat 4: CashMatteo ($7.10 in chips) 
Seat 6: 60centPoker ($10.05 in chips) 
CashMatteo: posts small blind $0.05
60centPoker: posts big blind $0.10
*** HOLE CARDS ***
Dealt to CashMatteo [2h 4c]
mycats99887: folds 
2gd2btru422: folds 
CashMatteo: folds 
Uncalled bet ($0.05) returned to 60centPoker
60centPoker collected $0.10 from pot
60centPoker: doesn't show hand 
*** SUMMARY ***
Total pot $0.10 | Rake $0 
Seat 2: mycats99887 folded before Flop (didn't bet)
Seat 3: 2gd2btru422 (button) folded before Flop (didn't bet)
Seat 4: CashMatteo (small blind) folded before Flop
Seat 6: 60centPoker (big blind) collected ($0.10)

Hand #1377: 

PokerStars Hand #246672480005:  Hold'em No Limit ($0.05/$0.10 CAD) - 2023/10/21 23:10:26 ET
Table 'Yildun' 6-max Seat #4 is the button
Seat 2: mycats99887 ($9.95 in chips) 
Seat 3: 2gd2btru422 ($13.14 in chips) 
Seat 4: CashMatteo ($7.05 in chips) 
Seat 6: 60centPoker ($10.10 in chips) 
60centPoker: posts small blind $0.05
mycats99887: posts big blind $0.10
*** HOLE CARDS ***
Dealt to CashMatteo [5c 9s]
2gd2btru422: folds 
CashMatteo: folds 
60centPoker: raises $0.20 to $0.30
mycats99887: folds 
Uncalled bet ($0.20) returned to 60centPoker
60centPoker collected $0.20 from pot
60centPoker: doesn't show hand 
*** SUMMARY ***
Total pot $0.20 | Rake $0 
Seat 2: mycats99887 (big blind) folded before Flop
Seat 3: 2gd2btru422 folded before Flop (didn't bet)
Seat 4: CashMatteo (button) folded before Flop (didn't bet)
Seat 6: 60centPoker (small blind) collected ($0.20)

Hand #1378: 

PokerStars Hand #246672482058:  Hold'em No Limit ($0.05/$0.10 CAD) - 2023/10/21 23:10:40 ET
Table 'Yildun' 6-max Seat #6 is the button
Seat 2: mycats99887 ($9.85 in chips) 
Seat 3: 2gd2btru422 ($13.14 in chips) 
Seat 4: CashMatteo ($7.05 in chips) 
Seat 6: 60centPoker ($10.20 in chips) 
mycats99887: posts small blind $0.05
2gd2btru422: posts big blind $0.10
*** HOLE CARDS ***
Dealt to CashMatteo [5h 2d]
CashMatteo: folds 
60centPoker: raises $0.20 to $0.30
mycats99887: calls $0.25
2gd2btru422: folds 
*** FLOP *** [6s Kh Qh]
AlderwoodOG joins the table at seat #5 
mycats99887: checks 
60centPoker: bets $0.10
mycats99887: calls $0.10
*** TURN *** [6s Kh Qh] [5c]
mycats99887: checks 
60centPoker: bets $0.10
mycats99887: calls $0.10
*** RIVER *** [6s Kh Qh 5c] [6c]
mycats99887: checks 
60centPoker: checks 
*** SHOW DOWN ***
mycats99887: shows [Ah Tc] (a pair of Sixes)
60centPoker: shows [Qc As] (two pair, Queens and Sixes)
60centPoker collected $1.05 from pot
*** SUMMARY ***
Total pot $1.10 | Rake $0.05 
Board [6s Kh Qh 5c 6c]
Seat 2: mycats99887 (small blind) showed [Ah Tc] and lost with a pair of Sixes
Seat 3: 2gd2btru422 (big blind) folded before Flop
Seat 4: CashMatteo folded before Flop (didn't bet)
Seat 6: 60centPoker (button) showed [Qc As] and won ($1.05) with two pair, Queens and Sixes

Hand #1379: 

PokerStars Hand #246672489581:  Hold'em No Limit ($0.05/$0.10 CAD) - 2023/10/21 23:11:32 ET
Table 'Yildun' 6-max Seat #2 is the button
Seat 2: mycats99887 ($9.35 in chips) 
Seat 3: 2gd2btru422 ($13.04 in chips) 
Seat 4: CashMatteo ($7.05 in chips) 
Seat 5: AlderwoodOG ($10 in chips) 
Seat 6: 60centPoker ($10.75 in chips) 
2gd2btru422: posts small blind $0.05
CashMatteo: posts big blind $0.10
AlderwoodOG: posts big blind $0.10
shark8_len: sits out 
*** HOLE CARDS ***
Dealt to CashMatteo [Ac 8s]
AlderwoodOG: checks 
60centPoker: folds 
mycats99887: folds 
2gd2btru422: folds 
CashMatteo: raises $0.15 to $0.25
AlderwoodOG: calls $0.15
*** FLOP *** [Ts 6c 6h]
CashMatteo: checks 
AlderwoodOG: bets $0.37
CashMatteo: folds 
Uncalled bet ($0.37) returned to AlderwoodOG
AlderwoodOG collected $0.53 from pot
AlderwoodOG: doesn't show hand 
*** SUMMARY ***
Total pot $0.55 | Rake $0.02 
Board [Ts 6c 6h]
Seat 2: mycats99887 (button) folded before Flop (didn't bet)
Seat 3: 2gd2btru422 (small blind) folded before Flop
Seat 4: CashMatteo (big blind) folded on the Flop
Seat 5: AlderwoodOG collected ($0.53)
Seat 6: 60centPoker folded before Flop (didn't bet)

Hand #1380: 

PokerStars Hand #246672495756:  Hold'em No Limit ($0.05/$0.10 CAD) - 2023/10/21 23:12:16 ET
Table 'Yildun' 6-max Seat #3 is the button
Seat 2: mycats99887 ($9.35 in chips) 
Seat 3: 2gd2btru422 ($12.99 in chips) 
Seat 4: CashMatteo ($6.80 in chips) 
Seat 5: AlderwoodOG ($10.28 in chips) 
Seat 6: 60centPoker ($10.75 in chips) 
CashMatteo: posts small blind $0.05
AlderwoodOG: posts big blind $0.10
shark8_len: sits out 
*** HOLE CARDS ***
Dealt to CashMatteo [9s 8s]
60centPoker: folds 
mycats99887: folds 
2gd2btru422: raises $0.25 to $0.35
CashMatteo: calls $0.30
AlderwoodOG: folds 
*** FLOP *** [Qc 2s 2c]
CashMatteo: checks 
2gd2btru422: checks 
*** TURN *** [Qc 2s 2c] [Ad]
CashMatteo: checks 
2gd2btru422: bets $0.76
CashMatteo: folds 
Uncalled bet ($0.76) returned to 2gd2btru422
2gd2btru422 collected $0.76 from pot
*** SUMMARY ***
Total pot $0.80 | Rake $0.04 
Board [Qc 2s 2c Ad]
Seat 2: mycats99887 folded before Flop (didn't bet)
Seat 3: 2gd2btru422 (button) collected ($0.76)
Seat 4: CashMatteo (small blind) folded on the Turn
Seat 5: AlderwoodOG (big blind) folded before Flop
Seat 6: 60centPoker folded before Flop (didn't bet)

Hand #1381: 

PokerStars Hand #246672500263:  Hold'em No Limit ($0.05/$0.10 CAD) - 2023/10/21 23:12:47 ET
Table 'Yildun' 6-max Seat #4 is the button
Seat 2: mycats99887 ($9.35 in chips) 
Seat 3: 2gd2btru422 ($13.40 in chips) 
Seat 4: CashMatteo ($6.45 in chips) 
Seat 5: AlderwoodOG ($10.18 in chips) 
Seat 6: 60centPoker ($10.75 in chips) 
AlderwoodOG: posts small blind $0.05
60centPoker: posts big blind $0.10
shark8_len: sits out 
*** HOLE CARDS ***
Dealt to CashMatteo [Qh 7d]
mycats99887: calls $0.10
2gd2btru422: calls $0.10
CashMatteo: calls $0.10
AlderwoodOG: calls $0.05
60centPoker: checks 
*** FLOP *** [Kc 5s 4s]
AlderwoodOG: checks 
60centPoker: checks 
mycats99887: checks 
2gd2btru422: checks 
CashMatteo: checks 
*** TURN *** [Kc 5s 4s] [Jh]
AlderwoodOG: checks 
60centPoker: checks 
mycats99887: checks 
2gd2btru422: bets $0.48
CashMatteo: folds 
AlderwoodOG: folds 
60centPoker: folds 
mycats99887: folds 
Uncalled bet ($0.48) returned to 2gd2btru422
2gd2btru422 collected $0.48 from pot
*** SUMMARY ***
Total pot $0.50 | Rake $0.02 
Board [Kc 5s 4s Jh]
Seat 2: mycats99887 folded on the Turn
Seat 3: 2gd2btru422 collected ($0.48)
Seat 4: CashMatteo (button) folded on the Turn
Seat 5: AlderwoodOG (small blind) folded on the Turn
Seat 6: 60centPoker (big blind) folded on the Turn

Hand #1382: 

PokerStars Hand #246672508410:  Hold'em No Limit ($0.05/$0.10 CAD) - 2023/10/21 23:13:45 ET
Table 'Yildun' 6-max Seat #5 is the button
Seat 1: shark8_len ($3.79 in chips) 
Seat 2: mycats99887 ($9.25 in chips) 
Seat 3: 2gd2btru422 ($13.78 in chips) 
Seat 4: CashMatteo ($6.35 in chips) 
Seat 5: AlderwoodOG ($10.08 in chips) 
Seat 6: 60centPoker ($10.65 in chips) 
60centPoker: posts small blind $0.05
shark8_len: posts big blind $0.10
*** HOLE CARDS ***
Dealt to CashMatteo [Jh 4s]
mycats99887: folds 
2gd2btru422: folds 
CashMatteo: folds 
AlderwoodOG: folds 
60centPoker: raises $0.10 to $0.20
shark8_len: raises $3.59 to $3.79 and is all-in
60centPoker: folds 
Uncalled bet ($3.59) returned to shark8_len
shark8_len collected $0.40 from pot
shark8_len: doesn't show hand 
*** SUMMARY ***
Total pot $0.40 | Rake $0 
Seat 1: shark8_len (big blind) collected ($0.40)
Seat 2: mycats99887 folded before Flop (didn't bet)
Seat 3: 2gd2btru422 folded before Flop (didn't bet)
Seat 4: CashMatteo folded before Flop (didn't bet)
Seat 5: AlderwoodOG (button) folded before Flop (didn't bet)
Seat 6: 60centPoker (small blind) folded before Flop

Hand #1383: 

PokerStars Hand #246672514085:  Hold'em No Limit ($0.05/$0.10 CAD) - 2023/10/21 23:14:26 ET
Table 'Yildun' 6-max Seat #6 is the button
Seat 1: shark8_len ($3.99 in chips) 
Seat 2: mycats99887 ($9.25 in chips) 
Seat 3: 2gd2btru422 ($13.78 in chips) 
Seat 4: CashMatteo ($6.35 in chips) 
Seat 5: AlderwoodOG ($10.08 in chips) 
Seat 6: 60centPoker ($10.45 in chips) 
shark8_len: posts small blind $0.05
mycats99887: posts big blind $0.10
*** HOLE CARDS ***
Dealt to CashMatteo [2s 2h]
2gd2btru422: folds 
CashMatteo: raises $0.15 to $0.25
AlderwoodOG: folds 
60centPoker: raises $0.50 to $0.75
shark8_len: folds 
mycats99887: folds 
CashMatteo: calls $0.50
*** FLOP *** [2d Jh 5d]
CashMatteo: checks 
60centPoker: bets $0.89
CashMatteo: calls $0.89
*** TURN *** [2d Jh 5d] [5s]
CashMatteo: checks 
60centPoker: bets $1.46
CashMatteo: calls $1.46
*** RIVER *** [2d Jh 5d 5s] [8h]
CashMatteo: bets $0.20
60centPoker: calls $0.20
*** SHOW DOWN ***
CashMatteo: shows [2s 2h] (a full house, Deuces full of Fives)
60centPoker: mucks hand 
CashMatteo collected $6.45 from pot
*** SUMMARY ***
Total pot $6.75 | Rake $0.30 
Board [2d Jh 5d 5s 8h]
Seat 1: shark8_len (small blind) folded before Flop
Seat 2: mycats99887 (big blind) folded before Flop
Seat 3: 2gd2btru422 folded before Flop (didn't bet)
Seat 4: CashMatteo showed [2s 2h] and won ($6.45) with a full house, Deuces full of Fives
Seat 5: AlderwoodOG folded before Flop (didn't bet)
Seat 6: 60centPoker (button) mucked [Ac Kc]

Hand #1384: 

PokerStars Hand #246672527615:  Hold'em No Limit ($0.05/$0.10 CAD) - 2023/10/21 23:16:01 ET
Table 'Yildun' 6-max Seat #1 is the button
Seat 1: shark8_len ($3.94 in chips) 
Seat 2: mycats99887 ($9.15 in chips) 
Seat 3: 2gd2btru422 ($13.78 in chips) 
Seat 4: CashMatteo ($9.50 in chips) 
Seat 5: AlderwoodOG ($10.08 in chips) 
Seat 6: 60centPoker ($7.15 in chips) 
mycats99887: posts small blind $0.05
2gd2btru422: posts big blind $0.10
*** HOLE CARDS ***
Dealt to CashMatteo [Ac Th]
CashMatteo: raises $0.15 to $0.25
AlderwoodOG: calls $0.25
60centPoker: folds 
shark8_len: folds 
mycats99887: folds 
2gd2btru422: folds 
*** FLOP *** [Qd Tc Jd]
CashMatteo: bets $0.31
AlderwoodOG: folds 
Uncalled bet ($0.31) returned to CashMatteo
CashMatteo collected $0.62 from pot
CashMatteo: doesn't show hand 
*** SUMMARY ***
Total pot $0.65 | Rake $0.03 
Board [Qd Tc Jd]
Seat 1: shark8_len (button) folded before Flop (didn't bet)
Seat 2: mycats99887 (small blind) folded before Flop
Seat 3: 2gd2btru422 (big blind) folded before Flop
Seat 4: CashMatteo collected ($0.62)
Seat 5: AlderwoodOG folded on the Flop
Seat 6: 60centPoker folded before Flop (didn't bet)

Hand #1385: 

PokerStars Hand #246672532008:  Hold'em No Limit ($0.05/$0.10 CAD) - 2023/10/21 23:16:32 ET
Table 'Yildun' 6-max Seat #2 is the button
Seat 1: shark8_len ($3.94 in chips) 
Seat 2: mycats99887 ($9.10 in chips) 
Seat 3: 2gd2btru422 ($13.68 in chips) 
Seat 4: CashMatteo ($9.87 in chips) 
Seat 5: AlderwoodOG ($9.83 in chips) 
Seat 6: 60centPoker ($7.15 in chips) 
2gd2btru422: posts small blind $0.05
CashMatteo: posts big blind $0.10
*** HOLE CARDS ***
Dealt to CashMatteo [4d 6h]
AlderwoodOG: raises $0.20 to $0.30
60centPoker: folds 
shark8_len: folds 
mycats99887: folds 
2gd2btru422: folds 
CashMatteo: folds 
Uncalled bet ($0.20) returned to AlderwoodOG
AlderwoodOG collected $0.25 from pot
AlderwoodOG: doesn't show hand 
*** SUMMARY ***
Total pot $0.25 | Rake $0 
Seat 1: shark8_len folded before Flop (didn't bet)
Seat 2: mycats99887 (button) folded before Flop (didn't bet)
Seat 3: 2gd2btru422 (small blind) folded before Flop
Seat 4: CashMatteo (big blind) folded before Flop
Seat 5: AlderwoodOG collected ($0.25)
Seat 6: 60centPoker folded before Flop (didn't bet)

Hand #1386: 

PokerStars Hand #246672536532:  Hold'em No Limit ($0.05/$0.10 CAD) - 2023/10/21 23:17:03 ET
Table 'Yildun' 6-max Seat #3 is the button
Seat 1: shark8_len ($3.94 in chips) 
Seat 2: mycats99887 ($9.10 in chips) 
Seat 3: 2gd2btru422 ($13.63 in chips) 
Seat 4: CashMatteo ($9.77 in chips) 
Seat 5: AlderwoodOG ($9.98 in chips) 
Seat 6: 60centPoker ($7.15 in chips) 
CashMatteo: posts small blind $0.05
AlderwoodOG: posts big blind $0.10
*** HOLE CARDS ***
Dealt to CashMatteo [6s 3h]
60centPoker: folds 
shark8_len: raises $0.10 to $0.20
mycats99887: folds 
2gd2btru422: folds 
CashMatteo: folds 
AlderwoodOG: folds 
Uncalled bet ($0.10) returned to shark8_len
shark8_len collected $0.25 from pot
shark8_len: doesn't show hand 
*** SUMMARY ***
Total pot $0.25 | Rake $0 
Seat 1: shark8_len collected ($0.25)
Seat 2: mycats99887 folded before Flop (didn't bet)
Seat 3: 2gd2btru422 (button) folded before Flop (didn't bet)
Seat 4: CashMatteo (small blind) folded before Flop
Seat 5: AlderwoodOG (big blind) folded before Flop
Seat 6: 60centPoker folded before Flop (didn't bet)

Hand #1387: 

PokerStars Hand #246672539272:  Hold'em No Limit ($0.05/$0.10 CAD) - 2023/10/21 23:17:23 ET
Table 'Yildun' 6-max Seat #4 is the button
Seat 1: shark8_len ($4.09 in chips) 
Seat 2: mycats99887 ($9.10 in chips) 
Seat 3: 2gd2btru422 ($13.63 in chips) 
Seat 4: CashMatteo ($9.72 in chips) 
Seat 5: AlderwoodOG ($9.88 in chips) 
Seat 6: 60centPoker ($10 in chips) 
AlderwoodOG: posts small blind $0.05
60centPoker: posts big blind $0.10
*** HOLE CARDS ***
Dealt to CashMatteo [Jd 9d]
shark8_len: calls $0.10
mycats99887: raises $0.20 to $0.30
2gd2btru422: folds 
CashMatteo: calls $0.30
AlderwoodOG: folds 
60centPoker: folds 
shark8_len: calls $0.20
*** FLOP *** [3h 8s Kh]
shark8_len: checks 
mycats99887: checks 
CashMatteo: checks 
*** TURN *** [3h 8s Kh] [4h]
shark8_len: checks 
mycats99887: checks 
CashMatteo: checks 
*** RIVER *** [3h 8s Kh 4h] [3s]
shark8_len: bets $0.10
mycats99887: folds 
CashMatteo: calls $0.10
*** SHOW DOWN ***
shark8_len: shows [Ac 3c] (three of a kind, Threes)
CashMatteo: mucks hand 
shark8_len collected $1.19 from pot
*** SUMMARY ***
Total pot $1.25 | Rake $0.06 
Board [3h 8s Kh 4h 3s]
Seat 1: shark8_len showed [Ac 3c] and won ($1.19) with three of a kind, Threes
Seat 2: mycats99887 folded on the River
Seat 3: 2gd2btru422 folded before Flop (didn't bet)
Seat 4: CashMatteo (button) mucked [Jd 9d]
Seat 5: AlderwoodOG (small blind) folded before Flop
Seat 6: 60centPoker (big blind) folded before Flop

Hand #1388: 

PokerStars Hand #246672544555:  Hold'em No Limit ($0.05/$0.10 CAD) - 2023/10/21 23:18:00 ET
Table 'Yildun' 6-max Seat #5 is the button
Seat 1: shark8_len ($4.88 in chips) 
Seat 2: mycats99887 ($8.80 in chips) 
Seat 3: 2gd2btru422 ($13.63 in chips) 
Seat 4: CashMatteo ($9.32 in chips) 
Seat 5: AlderwoodOG ($9.83 in chips) 
Seat 6: 60centPoker ($9.90 in chips) 
60centPoker: posts small blind $0.05
shark8_len: posts big blind $0.10
*** HOLE CARDS ***
Dealt to CashMatteo [7s Jc]
mycats99887: calls $0.10
2gd2btru422: folds 
CashMatteo: folds 
AlderwoodOG: folds 
60centPoker: raises $0.28 to $0.38
shark8_len: calls $0.28
mycats99887: calls $0.28
*** FLOP *** [4d 3c 9c]
60centPoker: checks 
shark8_len: bets $0.30
mycats99887: folds 
60centPoker: raises $9.22 to $9.52 and is all-in
shark8_len: calls $4.20 and is all-in
Uncalled bet ($5.02) returned to 60centPoker
*** TURN *** [4d 3c 9c] [Td]
*** RIVER *** [4d 3c 9c Td] [Js]
*** SHOW DOWN ***
60centPoker: shows [Kd Kh] (a pair of Kings)
shark8_len: shows [5s 5h] (a pair of Fives)
60centPoker collected $9.68 from pot
*** SUMMARY ***
Total pot $10.14 | Rake $0.46 
Board [4d 3c 9c Td Js]
Seat 1: shark8_len (big blind) showed [5s 5h] and lost with a pair of Fives
Seat 2: mycats99887 folded on the Flop
Seat 3: 2gd2btru422 folded before Flop (didn't bet)
Seat 4: CashMatteo folded before Flop (didn't bet)
Seat 5: AlderwoodOG (button) folded before Flop (didn't bet)
Seat 6: 60centPoker (small blind) showed [Kd Kh] and won ($9.68) with a pair of Kings

Hand #1389: 

PokerStars Hand #246672550535:  Hold'em No Limit ($0.05/$0.10 CAD) - 2023/10/21 23:18:43 ET
Table 'Yildun' 6-max Seat #6 is the button
Seat 2: mycats99887 ($8.42 in chips) 
Seat 3: 2gd2btru422 ($13.63 in chips) 
Seat 4: CashMatteo ($9.32 in chips) 
Seat 5: AlderwoodOG ($9.83 in chips) 
Seat 6: 60centPoker ($14.70 in chips) 
mycats99887: posts small blind $0.05
2gd2btru422: posts big blind $0.10
*** HOLE CARDS ***
Dealt to CashMatteo [3d Jd]
CashMatteo: calls $0.10
shark8_len said, " nh"
AlderwoodOG: folds 
60centPoker: raises $0.25 to $0.35
mycats99887: folds 
2gd2btru422: folds 
60centPoker said, "ty"
CashMatteo: calls $0.25
*** FLOP *** [Kd Qc 7s]
CashMatteo: checks 
60centPoker: bets $0.24
CashMatteo: raises $0.65 to $0.89
60centPoker: folds 
Uncalled bet ($0.65) returned to CashMatteo
CashMatteo collected $1.27 from pot
CashMatteo: doesn't show hand 
*** SUMMARY ***
Total pot $1.33 | Rake $0.06 
Board [Kd Qc 7s]
Seat 2: mycats99887 (small blind) folded before Flop
Seat 3: 2gd2btru422 (big blind) folded before Flop
Seat 4: CashMatteo collected ($1.27)
Seat 5: AlderwoodOG folded before Flop (didn't bet)
Seat 6: 60centPoker (button) folded on the Flop

Hand #1390: 

PokerStars Hand #246672558298:  Hold'em No Limit ($0.05/$0.10 CAD) - 2023/10/21 23:19:37 ET
Table 'Yildun' 6-max Seat #2 is the button
Seat 1: shark8_len ($10 in chips) 
Seat 2: mycats99887 ($8.37 in chips) 
Seat 3: 2gd2btru422 ($13.53 in chips) 
Seat 4: CashMatteo ($10 in chips) 
Seat 5: AlderwoodOG ($9.83 in chips) 
Seat 6: 60centPoker ($14.11 in chips) 
2gd2btru422: posts small blind $0.05
CashMatteo: posts big blind $0.10
shark8_len: posts small blind $0.05
*** HOLE CARDS ***
Dealt to CashMatteo [5h 9c]
AlderwoodOG: folds 
60centPoker: folds 
shark8_len has timed out
shark8_len: folds 
mycats99887: folds 
2gd2btru422: raises $0.25 to $0.35
CashMatteo: folds 
Uncalled bet ($0.25) returned to 2gd2btru422
CashMatteo leaves the table
2gd2btru422 collected $0.25 from pot
*** SUMMARY ***
Total pot $0.25 | Rake $0 
Seat 1: shark8_len folded before Flop (didn't bet)
Seat 2: mycats99887 (button) folded before Flop (didn't bet)
Seat 3: 2gd2btru422 (small blind) collected ($0.25)
Seat 4: CashMatteo (big blind) folded before Flop
Seat 5: AlderwoodOG folded before Flop (didn't bet)
Seat 6: 60centPoker folded before Flop (didn't bet)

Hand #1391: 

PokerStars Hand #246784513022:  Hold'em No Limit ($0.05/$0.10 CAD) - 2023/10/28 1:26:39 ET
Table 'Chow' 6-max Seat #1 is the button
Seat 1: ROGER-CDA ($8.83 in chips) 
Seat 2: Sideshow022 ($6.98 in chips) 
Seat 3: CashMatteo ($10 in chips) 
Seat 4: kervyrx7 ($4.84 in chips) 
Seat 5: Spankorama ($14.08 in chips) 
Seat 6: heckyeahbro ($12.04 in chips) 
Sideshow022: posts small blind $0.05
CashMatteo: posts big blind $0.10
*** HOLE CARDS ***
Dealt to CashMatteo [Kd Ks]
kervyrx7: raises $0.15 to $0.25
Spankorama: folds 
heckyeahbro: folds 
ROGER-CDA: folds 
Sideshow022: folds 
CashMatteo: raises $0.55 to $0.80
kervyrx7: calls $0.55
*** FLOP *** [Qs 2s Ac]
CashMatteo: checks 
kervyrx7: checks 
*** TURN *** [Qs 2s Ac] [8d]
CashMatteo: bets $1.58
kervyrx7: folds 
Uncalled bet ($1.58) returned to CashMatteo
CashMatteo collected $1.58 from pot
CashMatteo: doesn't show hand 
*** SUMMARY ***
Total pot $1.65 | Rake $0.07 
Board [Qs 2s Ac 8d]
Seat 1: ROGER-CDA (button) folded before Flop (didn't bet)
Seat 2: Sideshow022 (small blind) folded before Flop
Seat 3: CashMatteo (big blind) collected ($1.58)
Seat 4: kervyrx7 folded on the Turn
Seat 5: Spankorama folded before Flop (didn't bet)
Seat 6: heckyeahbro folded before Flop (didn't bet)

Hand #1392: 

PokerStars Hand #246784518034:  Hold'em No Limit ($0.05/$0.10 CAD) - 2023/10/28 1:27:25 ET
Table 'Chow' 6-max Seat #2 is the button
Seat 1: ROGER-CDA ($8.83 in chips) 
Seat 2: Sideshow022 ($6.93 in chips) 
Seat 3: CashMatteo ($10.78 in chips) 
Seat 4: kervyrx7 ($4.04 in chips) 
Seat 5: Spankorama ($14.08 in chips) 
Seat 6: heckyeahbro ($12.04 in chips) 
CashMatteo: posts small blind $0.05
kervyrx7: posts big blind $0.10
*** HOLE CARDS ***
Dealt to CashMatteo [Ac 7s]
Spankorama: calls $0.10
heckyeahbro: folds 
ROGER-CDA: folds 
Sideshow022: folds 
CashMatteo: calls $0.05
kervyrx7: checks 
*** FLOP *** [6c 2c 8c]
CashMatteo: checks 
kervyrx7: checks 
Spankorama: checks 
*** TURN *** [6c 2c 8c] [Qs]
CashMatteo: checks 
kervyrx7: checks 
Spankorama: checks 
*** RIVER *** [6c 2c 8c Qs] [Js]
CashMatteo: checks 
kervyrx7: checks 
Spankorama: checks 
*** SHOW DOWN ***
CashMatteo: shows [Ac 7s] (high card Ace)
kervyrx7: shows [2s 9d] (a pair of Deuces)
Spankorama: mucks hand 
kervyrx7 collected $0.29 from pot
*** SUMMARY ***
Total pot $0.30 | Rake $0.01 
Board [6c 2c 8c Qs Js]
Seat 1: ROGER-CDA folded before Flop (didn't bet)
Seat 2: Sideshow022 (button) folded before Flop (didn't bet)
Seat 3: CashMatteo (small blind) showed [Ac 7s] and lost with high card Ace
Seat 4: kervyrx7 (big blind) showed [2s 9d] and won ($0.29) with a pair of Deuces
Seat 5: Spankorama mucked [Ks Th]
Seat 6: heckyeahbro folded before Flop (didn't bet)

Hand #1393: 

PokerStars Hand #246784524038:  Hold'em No Limit ($0.05/$0.10 CAD) - 2023/10/28 1:28:20 ET
Table 'Chow' 6-max Seat #3 is the button
Seat 1: ROGER-CDA ($8.83 in chips) 
Seat 2: Sideshow022 ($6.93 in chips) 
Seat 3: CashMatteo ($10.68 in chips) 
Seat 4: kervyrx7 ($4.23 in chips) 
Seat 5: Spankorama ($13.98 in chips) 
Seat 6: heckyeahbro ($12.04 in chips) 
kervyrx7: posts small blind $0.05
Spankorama: posts big blind $0.10
*** HOLE CARDS ***
Dealt to CashMatteo [9c 3c]
heckyeahbro: folds 
ROGER-CDA: folds 
Sideshow022: calls $0.10
CashMatteo: calls $0.10
kervyrx7: raises $0.40 to $0.50
Spankorama: folds 
Sideshow022: calls $0.40
CashMatteo: calls $0.40
*** FLOP *** [6s 4s 8h]
kervyrx7: checks 
Sideshow022: checks 
CashMatteo: checks 
*** TURN *** [6s 4s 8h] [Ac]
kervyrx7: checks 
Sideshow022: checks 
CashMatteo: checks 
*** RIVER *** [6s 4s 8h Ac] [Th]
kervyrx7: checks 
Sideshow022: checks 
CashMatteo: checks 
*** SHOW DOWN ***
kervyrx7: shows [Qd Kc] (high card Ace)
Sideshow022: mucks hand 
CashMatteo: mucks hand 
kervyrx7 collected $1.53 from pot
*** SUMMARY ***
Total pot $1.60 | Rake $0.07 
Board [6s 4s 8h Ac Th]
Seat 1: ROGER-CDA folded before Flop (didn't bet)
Seat 2: Sideshow022 mucked [Ks Jh]
Seat 3: CashMatteo (button) mucked [9c 3c]
Seat 4: kervyrx7 (small blind) showed [Qd Kc] and won ($1.53) with high card Ace
Seat 5: Spankorama (big blind) folded before Flop
Seat 6: heckyeahbro folded before Flop (didn't bet)

Hand #1394: 

PokerStars Hand #246784528964:  Hold'em No Limit ($0.05/$0.10 CAD) - 2023/10/28 1:29:04 ET
Table 'Chow' 6-max Seat #4 is the button
Seat 1: ROGER-CDA ($8.83 in chips) 
Seat 2: Sideshow022 ($6.43 in chips) 
Seat 3: CashMatteo ($10.18 in chips) 
Seat 4: kervyrx7 ($5.26 in chips) 
Seat 5: Spankorama ($13.88 in chips) 
Seat 6: heckyeahbro ($12.04 in chips) 
Spankorama: posts small blind $0.05
heckyeahbro: posts big blind $0.10
*** HOLE CARDS ***
Dealt to CashMatteo [5h Jc]
ROGER-CDA: folds 
Sideshow022: folds 
CashMatteo: folds 
kervyrx7: folds 
Spankorama: raises $0.20 to $0.30
heckyeahbro: calls $0.20
*** FLOP *** [Js 5d Kh]
Spankorama: bets $0.30
heckyeahbro: folds 
Uncalled bet ($0.30) returned to Spankorama
Spankorama collected $0.57 from pot
*** SUMMARY ***
Total pot $0.60 | Rake $0.03 
Board [Js 5d Kh]
Seat 1: ROGER-CDA folded before Flop (didn't bet)
Seat 2: Sideshow022 folded before Flop (didn't bet)
Seat 3: CashMatteo folded before Flop (didn't bet)
Seat 4: kervyrx7 (button) folded before Flop (didn't bet)
Seat 5: Spankorama (small blind) collected ($0.57)
Seat 6: heckyeahbro (big blind) folded on the Flop

Hand #1395: 

PokerStars Hand #246784532515:  Hold'em No Limit ($0.05/$0.10 CAD) - 2023/10/28 1:29:37 ET
Table 'Chow' 6-max Seat #5 is the button
Seat 1: ROGER-CDA ($8.83 in chips) 
Seat 2: Sideshow022 ($6.43 in chips) 
Seat 3: CashMatteo ($10.18 in chips) 
Seat 4: kervyrx7 ($5.26 in chips) 
Seat 5: Spankorama ($14.15 in chips) 
Seat 6: heckyeahbro ($11.74 in chips) 
heckyeahbro: posts small blind $0.05
ROGER-CDA: posts big blind $0.10
*** HOLE CARDS ***
Dealt to CashMatteo [Kd Ks]
Sideshow022: folds 
CashMatteo: raises $0.15 to $0.25
kervyrx7: folds 
Spankorama: folds 
heckyeahbro: folds 
ROGER-CDA: folds 
Uncalled bet ($0.15) returned to CashMatteo
CashMatteo collected $0.25 from pot
CashMatteo: doesn't show hand 
*** SUMMARY ***
Total pot $0.25 | Rake $0 
Seat 1: ROGER-CDA (big blind) folded before Flop
Seat 2: Sideshow022 folded before Flop (didn't bet)
Seat 3: CashMatteo collected ($0.25)
Seat 4: kervyrx7 folded before Flop (didn't bet)
Seat 5: Spankorama (button) folded before Flop (didn't bet)
Seat 6: heckyeahbro (small blind) folded before Flop

Hand #1396: 

PokerStars Hand #246784534119:  Hold'em No Limit ($0.05/$0.10 CAD) - 2023/10/28 1:29:51 ET
Table 'Chow' 6-max Seat #6 is the button
Seat 1: ROGER-CDA ($8.73 in chips) 
Seat 2: Sideshow022 ($6.43 in chips) 
Seat 3: CashMatteo ($10.33 in chips) 
Seat 4: kervyrx7 ($5.26 in chips) 
Seat 5: Spankorama ($14.15 in chips) 
Seat 6: heckyeahbro ($11.69 in chips) 
ROGER-CDA: posts small blind $0.05
Sideshow022: posts big blind $0.10
*** HOLE CARDS ***
Dealt to CashMatteo [As 9d]
CashMatteo: raises $0.15 to $0.25
kervyrx7: folds 
Spankorama: calls $0.25
heckyeahbro: folds 
ROGER-CDA: folds 
Sideshow022: folds 
*** FLOP *** [3d Th 8h]
CashMatteo: checks 
Spankorama: bets $0.30
CashMatteo: calls $0.30
*** TURN *** [3d Th 8h] [7h]
CashMatteo: checks 
Spankorama: checks 
*** RIVER *** [3d Th 8h 7h] [Ad]
CashMatteo: bets $0.60
Spankorama: folds 
Uncalled bet ($0.60) returned to CashMatteo
CashMatteo collected $1.19 from pot
CashMatteo: doesn't show hand 
*** SUMMARY ***
Total pot $1.25 | Rake $0.06 
Board [3d Th 8h 7h Ad]
Seat 1: ROGER-CDA (small blind) folded before Flop
Seat 2: Sideshow022 (big blind) folded before Flop
Seat 3: CashMatteo collected ($1.19)
Seat 4: kervyrx7 folded before Flop (didn't bet)
Seat 5: Spankorama folded on the River
Seat 6: heckyeahbro (button) folded before Flop (didn't bet)

Hand #1397: 

PokerStars Hand #246784539870:  Hold'em No Limit ($0.05/$0.10 CAD) - 2023/10/28 1:30:43 ET
Table 'Chow' 6-max Seat #1 is the button
Seat 1: ROGER-CDA ($8.68 in chips) 
Seat 2: Sideshow022 ($6.33 in chips) 
Seat 3: CashMatteo ($10.97 in chips) 
Seat 4: kervyrx7 ($5.26 in chips) 
Seat 5: Spankorama ($13.60 in chips) 
Seat 6: heckyeahbro ($11.69 in chips) 
Sideshow022: posts small blind $0.05
CashMatteo: posts big blind $0.10
*** HOLE CARDS ***
Dealt to CashMatteo [Ah Kc]
kervyrx7: folds 
Spankorama: folds 
heckyeahbro: folds 
ROGER-CDA: folds 
Sideshow022: calls $0.05
CashMatteo: raises $0.15 to $0.25
Sideshow022: calls $0.15
*** FLOP *** [4c As 8s]
Sideshow022: checks 
CashMatteo: checks 
*** TURN *** [4c As 8s] [Jh]
Sideshow022: checks 
CashMatteo: bets $0.24
Sideshow022: calls $0.24
*** RIVER *** [4c As 8s Jh] [9c]
Sideshow022: checks 
CashMatteo: bets $0.94
Sideshow022: folds 
Uncalled bet ($0.94) returned to CashMatteo
CashMatteo collected $0.94 from pot
CashMatteo: doesn't show hand 
*** SUMMARY ***
Total pot $0.98 | Rake $0.04 
Board [4c As 8s Jh 9c]
Seat 1: ROGER-CDA (button) folded before Flop (didn't bet)
Seat 2: Sideshow022 (small blind) folded on the River
Seat 3: CashMatteo (big blind) collected ($0.94)
Seat 4: kervyrx7 folded before Flop (didn't bet)
Seat 5: Spankorama folded before Flop (didn't bet)
Seat 6: heckyeahbro folded before Flop (didn't bet)

Hand #1398: 

PokerStars Hand #246784545109:  Hold'em No Limit ($0.05/$0.10 CAD) - 2023/10/28 1:31:32 ET
Table 'Chow' 6-max Seat #2 is the button
Seat 1: ROGER-CDA ($8.68 in chips) 
Seat 2: Sideshow022 ($5.84 in chips) 
Seat 3: CashMatteo ($11.42 in chips) 
Seat 4: kervyrx7 ($5.26 in chips) 
Seat 5: Spankorama ($13.60 in chips) 
Seat 6: heckyeahbro ($11.69 in chips) 
CashMatteo: posts small blind $0.05
kervyrx7: posts big blind $0.10
*** HOLE CARDS ***
Dealt to CashMatteo [4c 6d]
Spankorama: folds 
heckyeahbro: folds 
ROGER-CDA: raises $0.29 to $0.39
Sideshow022: folds 
CashMatteo: folds 
kervyrx7: calls $0.29
*** FLOP *** [5d 8h 3d]
kervyrx7: checks 
ROGER-CDA: checks 
*** TURN *** [5d 8h 3d] [Jc]
kervyrx7: checks 
ROGER-CDA: bets $0.92
kervyrx7: folds 
Uncalled bet ($0.92) returned to ROGER-CDA
ROGER-CDA collected $0.79 from pot
ROGER-CDA: doesn't show hand 
*** SUMMARY ***
Total pot $0.83 | Rake $0.04 
Board [5d 8h 3d Jc]
Seat 1: ROGER-CDA collected ($0.79)
Seat 2: Sideshow022 (button) folded before Flop (didn't bet)
Seat 3: CashMatteo (small blind) folded before Flop
Seat 4: kervyrx7 (big blind) folded on the Turn
Seat 5: Spankorama folded before Flop (didn't bet)
Seat 6: heckyeahbro folded before Flop (didn't bet)

Hand #1399: 

PokerStars Hand #246784549558:  Hold'em No Limit ($0.05/$0.10 CAD) - 2023/10/28 1:32:13 ET
Table 'Chow' 6-max Seat #3 is the button
Seat 1: ROGER-CDA ($9.08 in chips) 
Seat 2: Sideshow022 ($5.84 in chips) 
Seat 3: CashMatteo ($11.37 in chips) 
Seat 4: kervyrx7 ($4.87 in chips) 
Seat 6: heckyeahbro ($11.69 in chips) 
kervyrx7: posts small blind $0.05
heckyeahbro: posts big blind $0.10
*** HOLE CARDS ***
Dealt to CashMatteo [4h 9d]
ROGER-CDA: folds 
Sideshow022: calls $0.10
CashMatteo: folds 
kervyrx7: calls $0.05
heckyeahbro: raises $0.70 to $0.80
Sideshow022: folds 
kervyrx7: folds 
Uncalled bet ($0.70) returned to heckyeahbro
heckyeahbro collected $0.30 from pot
heckyeahbro: doesn't show hand 
*** SUMMARY ***
Total pot $0.30 | Rake $0 
Seat 1: ROGER-CDA folded before Flop (didn't bet)
Seat 2: Sideshow022 folded before Flop
Seat 3: CashMatteo (button) folded before Flop (didn't bet)
Seat 4: kervyrx7 (small blind) folded before Flop
Seat 6: heckyeahbro (big blind) collected ($0.30)

Hand #1400: 

PokerStars Hand #246784553906:  Hold'em No Limit ($0.05/$0.10 CAD) - 2023/10/28 1:32:53 ET
Table 'Chow' 6-max Seat #4 is the button
Seat 1: ROGER-CDA ($9.08 in chips) 
Seat 2: Sideshow022 ($5.74 in chips) 
Seat 3: CashMatteo ($11.37 in chips) 
Seat 4: kervyrx7 ($4.77 in chips) 
Seat 6: heckyeahbro ($11.89 in chips) 
heckyeahbro: posts small blind $0.05
ROGER-CDA: posts big blind $0.10
*** HOLE CARDS ***
Dealt to CashMatteo [5c 5d]
Sideshow022: calls $0.10
CashMatteo: raises $0.15 to $0.25
kervyrx7: folds 
heckyeahbro: calls $0.20
ROGER-CDA: calls $0.15
Sideshow022: calls $0.15
*** FLOP *** [Jc Kc 2c]
heckyeahbro: checks 
ROGER-CDA: bets $1.12
Sideshow022: calls $1.12
CashMatteo: folds 
heckyeahbro: folds 
*** TURN *** [Jc Kc 2c] [2d]
ROGER-CDA: checks 
Sideshow022: checks 
*** RIVER *** [Jc Kc 2c 2d] [Ks]
ROGER-CDA: checks 
Sideshow022: checks 
*** SHOW DOWN ***
ROGER-CDA: shows [As Tc] (two pair, Kings and Deuces)
Sideshow022: shows [9d Ac] (two pair, Kings and Deuces)
ROGER-CDA collected $1.55 from pot
Sideshow022 collected $1.54 from pot
*** SUMMARY ***
Total pot $3.24 | Rake $0.15 
Board [Jc Kc 2c 2d Ks]
Seat 1: ROGER-CDA (big blind) showed [As Tc] and won ($1.55) with two pair, Kings and Deuces
Seat 2: Sideshow022 showed [9d Ac] and won ($1.54) with two pair, Kings and Deuces
Seat 3: CashMatteo folded on the Flop
Seat 4: kervyrx7 (button) folded before Flop (didn't bet)
Seat 6: heckyeahbro (small blind) folded on the Flop

Hand #1401: 

PokerStars Hand #246784561180:  Hold'em No Limit ($0.05/$0.10 CAD) - 2023/10/28 1:34:02 ET
Table 'Chow' 6-max Seat #6 is the button
Seat 1: ROGER-CDA ($9.26 in chips) 
Seat 2: Sideshow022 ($5.91 in chips) 
Seat 3: CashMatteo ($11.12 in chips) 
Seat 4: kervyrx7 ($4.77 in chips) 
Seat 6: heckyeahbro ($11.64 in chips) 
ROGER-CDA: posts small blind $0.05
Sideshow022: posts big blind $0.10
*** HOLE CARDS ***
Dealt to CashMatteo [Ac 2s]
CashMatteo: raises $0.15 to $0.25
kervyrx7: folds 
heckyeahbro: folds 
ROGER-CDA: folds 
Sideshow022: calls $0.15
*** FLOP *** [9s Kc 8s]
Sideshow022: checks 
CashMatteo: bets $0.27
Sideshow022: calls $0.27
*** TURN *** [9s Kc 8s] [3d]
Sideshow022: checks 
CashMatteo: bets $0.52
Sideshow022: folds 
Uncalled bet ($0.52) returned to CashMatteo
CashMatteo collected $1.04 from pot
CashMatteo: doesn't show hand 
*** SUMMARY ***
Total pot $1.09 | Rake $0.05 
Board [9s Kc 8s 3d]
Seat 1: ROGER-CDA (small blind) folded before Flop
Seat 2: Sideshow022 (big blind) folded on the Turn
Seat 3: CashMatteo collected ($1.04)
Seat 4: kervyrx7 folded before Flop (didn't bet)
Seat 6: heckyeahbro (button) folded before Flop (didn't bet)

Hand #1402: 

PokerStars Hand #246784565522:  Hold'em No Limit ($0.05/$0.10 CAD) - 2023/10/28 1:34:42 ET
Table 'Chow' 6-max Seat #1 is the button
Seat 1: ROGER-CDA ($9.21 in chips) 
Seat 2: Sideshow022 ($5.39 in chips) 
Seat 3: CashMatteo ($11.64 in chips) 
Seat 4: kervyrx7 ($4.77 in chips) 
Seat 6: heckyeahbro ($11.64 in chips) 
Sideshow022: posts small blind $0.05
CashMatteo: posts big blind $0.10
*** HOLE CARDS ***
Dealt to CashMatteo [6s Tc]
kervyrx7: folds 
heckyeahbro: folds 
ROGER-CDA: raises $0.29 to $0.39
Sideshow022: folds 
CashMatteo: folds 
Uncalled bet ($0.29) returned to ROGER-CDA
ROGER-CDA collected $0.25 from pot
ROGER-CDA: doesn't show hand 
*** SUMMARY ***
Total pot $0.25 | Rake $0 
Seat 1: ROGER-CDA (button) collected ($0.25)
Seat 2: Sideshow022 (small blind) folded before Flop
Seat 3: CashMatteo (big blind) folded before Flop
Seat 4: kervyrx7 folded before Flop (didn't bet)
Seat 6: heckyeahbro folded before Flop (didn't bet)

Hand #1403: 

PokerStars Hand #246784567801:  Hold'em No Limit ($0.05/$0.10 CAD) - 2023/10/28 1:35:03 ET
Table 'Chow' 6-max Seat #2 is the button
Seat 1: ROGER-CDA ($9.36 in chips) 
Seat 2: Sideshow022 ($5.34 in chips) 
Seat 3: CashMatteo ($11.54 in chips) 
Seat 4: kervyrx7 ($4.77 in chips) 
Seat 6: heckyeahbro ($11.64 in chips) 
CashMatteo: posts small blind $0.05
kervyrx7: posts big blind $0.10
*** HOLE CARDS ***
Dealt to CashMatteo [As 6d]
heckyeahbro: folds 
ROGER-CDA: raises $0.29 to $0.39
Sideshow022: folds 
Sideshow022 leaves the table
CashMatteo: calls $0.34
kervyrx7: folds 
*** FLOP *** [Qs 6s 9h]
CashMatteo: checks 
ROGER-CDA: checks 
*** TURN *** [Qs 6s 9h] [4s]
CashMatteo: bets $0.84
ROGER-CDA: folds 
Uncalled bet ($0.84) returned to CashMatteo
CashMatteo collected $0.84 from pot
CashMatteo: doesn't show hand 
*** SUMMARY ***
Total pot $0.88 | Rake $0.04 
Board [Qs 6s 9h 4s]
Seat 1: ROGER-CDA folded on the Turn
Seat 2: Sideshow022 (button) folded before Flop (didn't bet)
Seat 3: CashMatteo (small blind) collected ($0.84)
Seat 4: kervyrx7 (big blind) folded before Flop
Seat 6: heckyeahbro folded before Flop (didn't bet)

Hand #1404: 

PokerStars Hand #246784571568:  Hold'em No Limit ($0.05/$0.10 CAD) - 2023/10/28 1:35:38 ET
Table 'Chow' 6-max Seat #3 is the button
Seat 1: ROGER-CDA ($8.97 in chips) 
Seat 3: CashMatteo ($11.99 in chips) 
Seat 4: kervyrx7 ($4.67 in chips) 
Seat 5: Spankorama ($13.60 in chips) 
Seat 6: heckyeahbro ($11.64 in chips) 
kervyrx7: posts small blind $0.05
Spankorama: posts big blind $0.10
*** HOLE CARDS ***
Dealt to CashMatteo [Qd 5h]
heckyeahbro: folds 
ROGER-CDA: folds 
CashMatteo: calls $0.10
kervyrx7: calls $0.05
Spankorama: checks 
*** FLOP *** [As 6h Kd]
kervyrx7: checks 
Spankorama: checks 
CashMatteo: checks 
*** TURN *** [As 6h Kd] [Qh]
kervyrx7: checks 
Spankorama: bets $0.10
CashMatteo: calls $0.10
kervyrx7: folds 
*** RIVER *** [As 6h Kd Qh] [3d]
Talmin84 joins the table at seat #2 
Spankorama: bets $0.10
CashMatteo: calls $0.10
*** SHOW DOWN ***
Spankorama: shows [Ad 7d] (a pair of Aces)
CashMatteo: mucks hand 
Spankorama collected $0.67 from pot
*** SUMMARY ***
Total pot $0.70 | Rake $0.03 
Board [As 6h Kd Qh 3d]
Seat 1: ROGER-CDA folded before Flop (didn't bet)
Seat 3: CashMatteo (button) mucked [Qd 5h]
Seat 4: kervyrx7 (small blind) folded on the Turn
Seat 5: Spankorama (big blind) showed [Ad 7d] and won ($0.67) with a pair of Aces
Seat 6: heckyeahbro folded before Flop (didn't bet)

Hand #1405: 

PokerStars Hand #246784575538:  Hold'em No Limit ($0.05/$0.10 CAD) - 2023/10/28 1:36:15 ET
Table 'Chow' 6-max Seat #4 is the button
Seat 1: ROGER-CDA ($8.97 in chips) 
Seat 3: CashMatteo ($11.69 in chips) 
Seat 4: kervyrx7 ($4.57 in chips) 
Seat 5: Spankorama ($13.97 in chips) 
Seat 6: heckyeahbro ($11.64 in chips) 
Spankorama: posts small blind $0.05
heckyeahbro: posts big blind $0.10
Talmin84: sits out 
*** HOLE CARDS ***
Dealt to CashMatteo [Jd 9h]
ROGER-CDA: folds 
CashMatteo: calls $0.10
kervyrx7: folds 
Spankorama: folds 
heckyeahbro: checks 
*** FLOP *** [Kd 5c Td]
heckyeahbro: checks 
CashMatteo: bets $0.12
heckyeahbro: folds 
Uncalled bet ($0.12) returned to CashMatteo
CashMatteo collected $0.24 from pot
CashMatteo: doesn't show hand 
*** SUMMARY ***
Total pot $0.25 | Rake $0.01 
Board [Kd 5c Td]
Seat 1: ROGER-CDA folded before Flop (didn't bet)
Seat 3: CashMatteo collected ($0.24)
Seat 4: kervyrx7 (button) folded before Flop (didn't bet)
Seat 5: Spankorama (small blind) folded before Flop
Seat 6: heckyeahbro (big blind) folded on the Flop

Hand #1406: 

PokerStars Hand #246784578737:  Hold'em No Limit ($0.05/$0.10 CAD) - 2023/10/28 1:36:45 ET
Table 'Chow' 6-max Seat #5 is the button
Seat 1: ROGER-CDA ($8.97 in chips) 
Seat 2: Talmin84 ($8.10 in chips) 
Seat 3: CashMatteo ($11.83 in chips) 
Seat 4: kervyrx7 ($4.57 in chips) 
Seat 5: Spankorama ($13.92 in chips) 
Seat 6: heckyeahbro ($11.54 in chips) 
heckyeahbro: posts small blind $0.05
ROGER-CDA: posts big blind $0.10
Talmin84: posts big blind $0.10
*** HOLE CARDS ***
Dealt to CashMatteo [Jc Kh]
Talmin84: checks 
CashMatteo: raises $0.15 to $0.25
kervyrx7: folds 
Spankorama: folds 
heckyeahbro: calls $0.20
ROGER-CDA: folds 
Talmin84: folds 
*** FLOP *** [7c 5c 7s]
heckyeahbro: checks 
CashMatteo: checks 
*** TURN *** [7c 5c 7s] [Jh]
heckyeahbro: checks 
CashMatteo: bets $0.34
heckyeahbro: folds 
Uncalled bet ($0.34) returned to CashMatteo
CashMatteo collected $0.67 from pot
CashMatteo: doesn't show hand 
*** SUMMARY ***
Total pot $0.70 | Rake $0.03 
Board [7c 5c 7s Jh]
Seat 1: ROGER-CDA (big blind) folded before Flop
Seat 2: Talmin84 folded before Flop (didn't bet)
Seat 3: CashMatteo collected ($0.67)
Seat 4: kervyrx7 folded before Flop (didn't bet)
Seat 5: Spankorama (button) folded before Flop (didn't bet)
Seat 6: heckyeahbro (small blind) folded on the Turn

Hand #1407: 

PokerStars Hand #246784582463:  Hold'em No Limit ($0.05/$0.10 CAD) - 2023/10/28 1:37:20 ET
Table 'Chow' 6-max Seat #6 is the button
Seat 1: ROGER-CDA ($8.87 in chips) 
Seat 2: Talmin84 ($8 in chips) 
Seat 3: CashMatteo ($12.25 in chips) 
Seat 4: kervyrx7 ($4.57 in chips) 
Seat 5: Spankorama ($13.92 in chips) 
Seat 6: heckyeahbro ($11.29 in chips) 
ROGER-CDA: posts small blind $0.05
Talmin84: posts big blind $0.10
*** HOLE CARDS ***
Dealt to CashMatteo [3s 7s]
CashMatteo: folds 
kervyrx7: folds 
Spankorama: folds 
heckyeahbro: folds 
ROGER-CDA: calls $0.05
Talmin84: checks 
*** FLOP *** [7d 2c 3c]
ROGER-CDA: checks 
Talmin84: bets $0.10
ROGER-CDA: folds 
Uncalled bet ($0.10) returned to Talmin84
Talmin84 collected $0.19 from pot
*** SUMMARY ***
Total pot $0.20 | Rake $0.01 
Board [7d 2c 3c]
Seat 1: ROGER-CDA (small blind) folded on the Flop
Seat 2: Talmin84 (big blind) collected ($0.19)
Seat 3: CashMatteo folded before Flop (didn't bet)
Seat 4: kervyrx7 folded before Flop (didn't bet)
Seat 5: Spankorama folded before Flop (didn't bet)
Seat 6: heckyeahbro (button) folded before Flop (didn't bet)

Hand #1408: 

PokerStars Hand #246784586663:  Hold'em No Limit ($0.05/$0.10 CAD) - 2023/10/28 1:38:00 ET
Table 'Chow' 6-max Seat #1 is the button
Seat 1: ROGER-CDA ($8.77 in chips) 
Seat 2: Talmin84 ($8.09 in chips) 
Seat 3: CashMatteo ($12.25 in chips) 
Seat 4: kervyrx7 ($4.57 in chips) 
Seat 5: Spankorama ($13.92 in chips) 
Seat 6: heckyeahbro ($11.29 in chips) 
Talmin84: posts small blind $0.05
CashMatteo: posts big blind $0.10
*** HOLE CARDS ***
Dealt to CashMatteo [Ac 2d]
kervyrx7: folds 
Spankorama: folds 
heckyeahbro: folds 
ROGER-CDA: raises $0.29 to $0.39
Talmin84: calls $0.34
CashMatteo: calls $0.29
*** FLOP *** [Td 2c 2h]
Talmin84: bets $0.10
CashMatteo: calls $0.10
ROGER-CDA: calls $0.10
*** TURN *** [Td 2c 2h] [Ks]
Talmin84: checks 
CashMatteo: bets $0.70
ROGER-CDA: raises $3.28 to $3.98
Talmin84: folds 
CashMatteo: raises $7.78 to $11.76 and is all-in
ROGER-CDA: calls $4.30 and is all-in
Uncalled bet ($3.48) returned to CashMatteo
*** RIVER *** [Td 2c 2h Ks] [5h]
*** SHOW DOWN ***
CashMatteo: shows [Ac 2d] (three of a kind, Deuces)
ROGER-CDA: shows [Ah Kd] (two pair, Kings and Deuces)
CashMatteo collected $17.22 from pot
*** SUMMARY ***
Total pot $18.03 | Rake $0.81 
Board [Td 2c 2h Ks 5h]
Seat 1: ROGER-CDA (button) showed [Ah Kd] and lost with two pair, Kings and Deuces
Seat 2: Talmin84 (small blind) folded on the Turn
Seat 3: CashMatteo (big blind) showed [Ac 2d] and won ($17.22) with three of a kind, Deuces
Seat 4: kervyrx7 folded before Flop (didn't bet)
Seat 5: Spankorama folded before Flop (didn't bet)
Seat 6: heckyeahbro folded before Flop (didn't bet)

Hand #1409: 

PokerStars Hand #246784592387:  Hold'em No Limit ($0.05/$0.10 CAD) - 2023/10/28 1:38:54 ET
Table 'Chow' 6-max Seat #2 is the button
Seat 2: Talmin84 ($7.60 in chips) 
Seat 3: CashMatteo ($20.70 in chips) 
Seat 4: kervyrx7 ($4.57 in chips) 
Seat 5: Spankorama ($13.92 in chips) 
Seat 6: heckyeahbro ($11.29 in chips) 
CashMatteo: posts small blind $0.05
kervyrx7: posts big blind $0.10
*** HOLE CARDS ***
Dealt to CashMatteo [5s 4s]
Spankorama: folds 
heckyeahbro: folds 
Talmin84: calls $0.10
CashMatteo: calls $0.05
kervyrx7: checks 
*** FLOP *** [Jd Jh Js]
CashMatteo: checks 
kervyrx7: checks 
Talmin84: checks 
*** TURN *** [Jd Jh Js] [2h]
CashMatteo: checks 
kervyrx7: checks 
Talmin84: checks 
*** RIVER *** [Jd Jh Js 2h] [8h]
CashMatteo: checks 
kervyrx7: checks 
Talmin84: bets $0.10
CashMatteo: folds 
kervyrx7: calls $0.10
*** SHOW DOWN ***
Talmin84: shows [7s Ac] (three of a kind, Jacks)
kervyrx7: shows [Qc 2c] (a full house, Jacks full of Deuces)
kervyrx7 collected $0.48 from pot
*** SUMMARY ***
Total pot $0.50 | Rake $0.02 
Board [Jd Jh Js 2h 8h]
Seat 2: Talmin84 (button) showed [7s Ac] and lost with three of a kind, Jacks
Seat 3: CashMatteo (small blind) folded on the River
Seat 4: kervyrx7 (big blind) showed [Qc 2c] and won ($0.48) with a full house, Jacks full of Deuces
Seat 5: Spankorama folded before Flop (didn't bet)
Seat 6: heckyeahbro folded before Flop (didn't bet)

Hand #1410: 

PokerStars Hand #246784596756:  Hold'em No Limit ($0.05/$0.10 CAD) - 2023/10/28 1:39:35 ET
Table 'Chow' 6-max Seat #3 is the button
Seat 2: Talmin84 ($7.40 in chips) 
Seat 3: CashMatteo ($20.60 in chips) 
Seat 4: kervyrx7 ($4.85 in chips) 
Seat 5: Spankorama ($13.92 in chips) 
Seat 6: heckyeahbro ($11.29 in chips) 
kervyrx7: posts small blind $0.05
Spankorama: posts big blind $0.10
*** HOLE CARDS ***
Dealt to CashMatteo [Ac Jd]
heckyeahbro: folds 
Talmin84: calls $0.10
CashMatteo: raises $0.15 to $0.25
kervyrx7: calls $0.20
Spankorama: calls $0.15
Talmin84: calls $0.15
*** FLOP *** [3h 9s 4c]
kervyrx7: checks 
Spankorama: checks 
Talmin84: checks 
CashMatteo: checks 
*** TURN *** [3h 9s 4c] [4d]
kervyrx7: checks 
Spankorama: bets $0.40
Talmin84: calls $0.40
CashMatteo: folds 
kervyrx7: folds 
*** RIVER *** [3h 9s 4c 4d] [Kh]
Spankorama: checks 
Talmin84: checks 
*** SHOW DOWN ***
Spankorama: shows [7c 4h] (three of a kind, Fours)
Talmin84: mucks hand 
Spankorama collected $1.72 from pot
*** SUMMARY ***
Total pot $1.80 | Rake $0.08 
Board [3h 9s 4c 4d Kh]
Seat 2: Talmin84 mucked [3d Ad]
Seat 3: CashMatteo (button) folded on the Turn
Seat 4: kervyrx7 (small blind) folded on the Turn
Seat 5: Spankorama (big blind) showed [7c 4h] and won ($1.72) with three of a kind, Fours
Seat 6: heckyeahbro folded before Flop (didn't bet)

Hand #1411: 

PokerStars Hand #246784603277:  Hold'em No Limit ($0.05/$0.10 CAD) - 2023/10/28 1:40:37 ET
Table 'Chow' 6-max Seat #4 is the button
Seat 2: Talmin84 ($6.75 in chips) 
Seat 3: CashMatteo ($20.35 in chips) 
Seat 4: kervyrx7 ($4.60 in chips) 
Seat 5: Spankorama ($14.99 in chips) 
Seat 6: heckyeahbro ($11.29 in chips) 
Spankorama: posts small blind $0.05
heckyeahbro: posts big blind $0.10
*** HOLE CARDS ***
Dealt to CashMatteo [3c 5d]
Talmin84: folds 
CashMatteo: folds 
kervyrx7: raises $0.15 to $0.25
Spankorama: folds 
heckyeahbro: calls $0.15
*** FLOP *** [4d 6d 3d]
heckyeahbro: checks 
kervyrx7: bets $0.17
heckyeahbro: calls $0.17
*** TURN *** [4d 6d 3d] [2c]
heckyeahbro: checks 
kervyrx7: bets $0.51
heckyeahbro: calls $0.51
*** RIVER *** [4d 6d 3d 2c] [7d]
heckyeahbro: checks 
ROGER-CDA leaves the table
kervyrx7: bets $1.05
heckyeahbro: folds 
Uncalled bet ($1.05) returned to kervyrx7
kervyrx7 collected $1.82 from pot
kervyrx7: doesn't show hand 
CashMatteo said, "wtf i had 5 of dimonds"
*** SUMMARY ***
Total pot $1.91 | Rake $0.09 
Board [4d 6d 3d 2c 7d]
Seat 2: Talmin84 folded before Flop (didn't bet)
Seat 3: CashMatteo folded before Flop (didn't bet)
Seat 4: kervyrx7 (button) collected ($1.82)
Seat 5: Spankorama (small blind) folded before Flop
Seat 6: heckyeahbro (big blind) folded on the River

Hand #1412: 

PokerStars Hand #246784607418:  Hold'em No Limit ($0.05/$0.10 CAD) - 2023/10/28 1:41:15 ET
Table 'Chow' 6-max Seat #5 is the button
Seat 2: Talmin84 ($6.75 in chips) 
Seat 3: CashMatteo ($20.35 in chips) 
Seat 4: kervyrx7 ($5.49 in chips) 
Seat 5: Spankorama ($14.94 in chips) 
Seat 6: heckyeahbro ($10.36 in chips) 
heckyeahbro: posts small blind $0.05
Talmin84: posts big blind $0.10
*** HOLE CARDS ***
Dealt to CashMatteo [Ad 5h]
CashMatteo: raises $0.15 to $0.25
kervyrx7: folds 
CashMatteo said, "had the staight flush"
Spankorama: folds 
heckyeahbro: folds 
Talmin84: folds 
Uncalled bet ($0.15) returned to CashMatteo
CashMatteo collected $0.25 from pot
CashMatteo: doesn't show hand 
*** SUMMARY ***
Total pot $0.25 | Rake $0 
Seat 2: Talmin84 (big blind) folded before Flop
Seat 3: CashMatteo collected ($0.25)
Seat 4: kervyrx7 folded before Flop (didn't bet)
Seat 5: Spankorama (button) folded before Flop (didn't bet)
Seat 6: heckyeahbro (small blind) folded before Flop

Hand #1413: 

PokerStars Hand #246784609886:  Hold'em No Limit ($0.05/$0.10 CAD) - 2023/10/28 1:41:38 ET
Table 'Chow' 6-max Seat #6 is the button
Seat 2: Talmin84 ($6.65 in chips) 
Seat 3: CashMatteo ($20.50 in chips) 
Seat 4: kervyrx7 ($5.49 in chips) 
Seat 5: Spankorama ($14.94 in chips) 
Seat 6: heckyeahbro ($10.31 in chips) 
Talmin84: posts small blind $0.05
CashMatteo: posts big blind $0.10
*** HOLE CARDS ***
Dealt to CashMatteo [Jd Ks]
kervyrx7: folds 
Spankorama: folds 
heckyeahbro: folds 
Talmin84: folds 
Uncalled bet ($0.05) returned to CashMatteo
CashMatteo collected $0.10 from pot
CashMatteo: doesn't show hand 
*** SUMMARY ***
Total pot $0.10 | Rake $0 
Seat 2: Talmin84 (small blind) folded before Flop
Seat 3: CashMatteo (big blind) collected ($0.10)
Seat 4: kervyrx7 folded before Flop (didn't bet)
Seat 5: Spankorama folded before Flop (didn't bet)
Seat 6: heckyeahbro (button) folded before Flop (didn't bet)

Hand #1414: 

PokerStars Hand #246784611348:  Hold'em No Limit ($0.05/$0.10 CAD) - 2023/10/28 1:41:52 ET
Table 'Chow' 6-max Seat #2 is the button
Seat 2: Talmin84 ($6.60 in chips) 
Seat 3: CashMatteo ($20.55 in chips) 
Seat 4: kervyrx7 ($5.49 in chips) 
Seat 5: Spankorama ($14.94 in chips) 
Seat 6: heckyeahbro ($10.31 in chips) 
CashMatteo: posts small blind $0.05
kervyrx7: posts big blind $0.10
*** HOLE CARDS ***
Dealt to CashMatteo [8h 3d]
GrumpyPants44 joins the table at seat #1 
Spankorama: folds 
heckyeahbro: folds 
Talmin84: folds 
CashMatteo: folds 
Uncalled bet ($0.05) returned to kervyrx7
kervyrx7 collected $0.10 from pot
kervyrx7: doesn't show hand 
*** SUMMARY ***
Total pot $0.10 | Rake $0 
Seat 2: Talmin84 (button) folded before Flop (didn't bet)
Seat 3: CashMatteo (small blind) folded before Flop
Seat 4: kervyrx7 (big blind) collected ($0.10)
Seat 5: Spankorama folded before Flop (didn't bet)
Seat 6: heckyeahbro folded before Flop (didn't bet)

Hand #1415: 

PokerStars Hand #246784612887:  Hold'em No Limit ($0.05/$0.10 CAD) - 2023/10/28 1:42:07 ET
Table 'Chow' 6-max Seat #3 is the button
Seat 2: Talmin84 ($6.60 in chips) 
Seat 3: CashMatteo ($20.50 in chips) 
Seat 4: kervyrx7 ($5.54 in chips) 
Seat 5: Spankorama ($14.94 in chips) 
Seat 6: heckyeahbro ($10.31 in chips) 
kervyrx7: posts small blind $0.05
Spankorama: posts big blind $0.10
GrumpyPants44: sits out 
*** HOLE CARDS ***
Dealt to CashMatteo [7d As]
heckyeahbro: folds 
Talmin84: folds 
CashMatteo: raises $0.15 to $0.25
kervyrx7: folds 
Spankorama: calls $0.15
*** FLOP *** [4c 7s 2d]
Spankorama: bets $0.30
CashMatteo: calls $0.30
*** TURN *** [4c 7s 2d] [Qd]
Spankorama: bets $0.30
CashMatteo: calls $0.30
*** RIVER *** [4c 7s 2d Qd] [Qc]
Spankorama: bets $0.60
CashMatteo: calls $0.60
*** SHOW DOWN ***
Spankorama: shows [7h 6h] (two pair, Queens and Sevens)
CashMatteo: shows [7d As] (two pair, Queens and Sevens - Ace kicker)
CashMatteo collected $2.82 from pot
*** SUMMARY ***
Total pot $2.95 | Rake $0.13 
Board [4c 7s 2d Qd Qc]
Seat 2: Talmin84 folded before Flop (didn't bet)
Seat 3: CashMatteo (button) showed [7d As] and won ($2.82) with two pair, Queens and Sevens
Seat 4: kervyrx7 (small blind) folded before Flop
Seat 5: Spankorama (big blind) showed [7h 6h] and lost with two pair, Queens and Sevens
Seat 6: heckyeahbro folded before Flop (didn't bet)

Hand #1416: 

PokerStars Hand #246784616393:  Hold'em No Limit ($0.05/$0.10 CAD) - 2023/10/28 1:42:40 ET
Table 'Chow' 6-max Seat #4 is the button
Seat 2: Talmin84 ($6.60 in chips) 
Seat 3: CashMatteo ($21.87 in chips) 
Seat 4: kervyrx7 ($5.49 in chips) 
Seat 5: Spankorama ($13.49 in chips) 
Seat 6: heckyeahbro ($10.31 in chips) 
Spankorama: posts small blind $0.05
heckyeahbro: posts big blind $0.10
GrumpyPants44: sits out 
*** HOLE CARDS ***
Dealt to CashMatteo [Jc 6c]
Talmin84: calls $0.10
CashMatteo: calls $0.10
kervyrx7: calls $0.10
Spankorama: calls $0.05
heckyeahbro: checks 
*** FLOP *** [Ac 7d Ts]
Spankorama: checks 
heckyeahbro: checks 
Talmin84: bets $0.10
CashMatteo: folds 
kervyrx7: calls $0.10
Spankorama: folds 
heckyeahbro: folds 
*** TURN *** [Ac 7d Ts] [2d]
Talmin84: checks 
kervyrx7: checks 
*** RIVER *** [Ac 7d Ts 2d] [3d]
Talmin84: checks 
kervyrx7: checks 
*** SHOW DOWN ***
Talmin84: shows [9c Ks] (high card Ace)
kervyrx7: shows [7s 6s] (a pair of Sevens)
kervyrx7 collected $0.67 from pot
*** SUMMARY ***
Total pot $0.70 | Rake $0.03 
Board [Ac 7d Ts 2d 3d]
Seat 2: Talmin84 showed [9c Ks] and lost with high card Ace
Seat 3: CashMatteo folded on the Flop
Seat 4: kervyrx7 (button) showed [7s 6s] and won ($0.67) with a pair of Sevens
Seat 5: Spankorama (small blind) folded on the Flop
Seat 6: heckyeahbro (big blind) folded on the Flop

Hand #1417: 

PokerStars Hand #246784620710:  Hold'em No Limit ($0.05/$0.10 CAD) - 2023/10/28 1:43:20 ET
Table 'Chow' 6-max Seat #5 is the button
Seat 1: GrumpyPants44 ($10 in chips) 
Seat 2: Talmin84 ($6.40 in chips) 
Seat 3: CashMatteo ($21.77 in chips) 
Seat 4: kervyrx7 ($5.96 in chips) 
Seat 5: Spankorama ($13.39 in chips) 
Seat 6: heckyeahbro ($10.21 in chips) 
heckyeahbro: posts small blind $0.05
GrumpyPants44: posts big blind $0.10
*** HOLE CARDS ***
Dealt to CashMatteo [Ad Jc]
Talmin84: folds 
CashMatteo: raises $0.15 to $0.25
kervyrx7: folds 
Spankorama: folds 
heckyeahbro: folds 
GrumpyPants44: folds 
Uncalled bet ($0.15) returned to CashMatteo
CashMatteo collected $0.25 from pot
CashMatteo: doesn't show hand 
*** SUMMARY ***
Total pot $0.25 | Rake $0 
Seat 1: GrumpyPants44 (big blind) folded before Flop
Seat 2: Talmin84 folded before Flop (didn't bet)
Seat 3: CashMatteo collected ($0.25)
Seat 4: kervyrx7 folded before Flop (didn't bet)
Seat 5: Spankorama (button) folded before Flop (didn't bet)
Seat 6: heckyeahbro (small blind) folded before Flop

Hand #1418: 

PokerStars Hand #246784623349:  Hold'em No Limit ($0.05/$0.10 CAD) - 2023/10/28 1:43:45 ET
Table 'Chow' 6-max Seat #6 is the button
Seat 1: GrumpyPants44 ($9.90 in chips) 
Seat 2: Talmin84 ($6.40 in chips) 
Seat 3: CashMatteo ($21.92 in chips) 
Seat 4: kervyrx7 ($5.96 in chips) 
Seat 5: Spankorama ($13.39 in chips) 
Seat 6: heckyeahbro ($10.16 in chips) 
GrumpyPants44: posts small blind $0.05
Talmin84: posts big blind $0.10
*** HOLE CARDS ***
Dealt to CashMatteo [4c Kh]
CashMatteo: raises $0.15 to $0.25
kervyrx7: folds 
Spankorama: folds 
heckyeahbro: folds 
GrumpyPants44: folds 
Talmin84: folds 
Uncalled bet ($0.15) returned to CashMatteo
CashMatteo collected $0.25 from pot
*** SUMMARY ***
Total pot $0.25 | Rake $0 
Seat 1: GrumpyPants44 (small blind) folded before Flop
Seat 2: Talmin84 (big blind) folded before Flop
Seat 3: CashMatteo collected ($0.25)
Seat 4: kervyrx7 folded before Flop (didn't bet)
Seat 5: Spankorama folded before Flop (didn't bet)
Seat 6: heckyeahbro (button) folded before Flop (didn't bet)

Hand #1419: 

PokerStars Hand #246784624974:  Hold'em No Limit ($0.05/$0.10 CAD) - 2023/10/28 1:44:00 ET
Table 'Chow' 6-max Seat #1 is the button
Seat 1: GrumpyPants44 ($9.85 in chips) 
Seat 2: Talmin84 ($6.30 in chips) 
Seat 3: CashMatteo ($22.07 in chips) 
Seat 4: kervyrx7 ($5.96 in chips) 
Seat 5: Spankorama ($13.39 in chips) 
Seat 6: heckyeahbro ($10.16 in chips) 
Talmin84: posts small blind $0.05
CashMatteo: posts big blind $0.10
*** HOLE CARDS ***
Dealt to CashMatteo [6s 4s]
kervyrx7: raises $0.15 to $0.25
Spankorama: calls $0.25
heckyeahbro: folds 
GrumpyPants44: folds 
Talmin84: folds 
CashMatteo: calls $0.15
*** FLOP *** [Jh 2c 3d]
CashMatteo: checks 
kervyrx7: bets $0.45
Spankorama: calls $0.45
CashMatteo: calls $0.45
*** TURN *** [Jh 2c 3d] [6c]
CashMatteo: checks 
kervyrx7: bets $1.23
Spankorama: calls $1.23
CashMatteo: calls $1.23
*** RIVER *** [Jh 2c 3d 6c] [4c]
CashMatteo: checks 
kervyrx7: checks 
Spankorama: checks 
*** SHOW DOWN ***
CashMatteo: shows [6s 4s] (two pair, Sixes and Fours)
kervyrx7: mucks hand 
Spankorama: mucks hand 
CashMatteo collected $5.58 from pot
*** SUMMARY ***
Total pot $5.84 | Rake $0.26 
Board [Jh 2c 3d 6c 4c]
Seat 1: GrumpyPants44 (button) folded before Flop (didn't bet)
Seat 2: Talmin84 (small blind) folded before Flop
Seat 3: CashMatteo (big blind) showed [6s 4s] and won ($5.58) with two pair, Sixes and Fours
Seat 4: kervyrx7 mucked [Ks Kh]
Seat 5: Spankorama mucked [Ad Jd]
Seat 6: heckyeahbro folded before Flop (didn't bet)

Hand #1420: 

PokerStars Hand #246784631639:  Hold'em No Limit ($0.05/$0.10 CAD) - 2023/10/28 1:45:03 ET
Table 'Chow' 6-max Seat #2 is the button
Seat 1: GrumpyPants44 ($9.85 in chips) 
Seat 2: Talmin84 ($6.25 in chips) 
Seat 3: CashMatteo ($25.72 in chips) 
Seat 4: kervyrx7 ($4.03 in chips) 
Seat 5: Spankorama ($11.46 in chips) 
Seat 6: heckyeahbro ($10.16 in chips) 
CashMatteo: posts small blind $0.05
kervyrx7: posts big blind $0.10
*** HOLE CARDS ***
Dealt to CashMatteo [2d 9d]
Spankorama: folds 
heckyeahbro: folds 
GrumpyPants44: calls $0.10
Talmin84: folds 
CashMatteo: calls $0.05
kervyrx7: checks 
*** FLOP *** [7d 7h Th]
CashMatteo: checks 
kervyrx7: checks 
GrumpyPants44: checks 
*** TURN *** [7d 7h Th] [3d]
CashMatteo: checks 
kervyrx7: checks 
GrumpyPants44: checks 
*** RIVER *** [7d 7h Th 3d] [Jc]
CashMatteo: checks 
kervyrx7: checks 
GrumpyPants44: checks 
*** SHOW DOWN ***
CashMatteo: shows [2d 9d] (a pair of Sevens)
kervyrx7: mucks hand 
GrumpyPants44: shows [4h Ks] (a pair of Sevens - King kicker)
GrumpyPants44 collected $0.29 from pot
*** SUMMARY ***
Total pot $0.30 | Rake $0.01 
Board [7d 7h Th 3d Jc]
Seat 1: GrumpyPants44 showed [4h Ks] and won ($0.29) with a pair of Sevens
Seat 2: Talmin84 (button) folded before Flop (didn't bet)
Seat 3: CashMatteo (small blind) showed [2d 9d] and lost with a pair of Sevens
Seat 4: kervyrx7 (big blind) mucked [5d 6d]
Seat 5: Spankorama folded before Flop (didn't bet)
Seat 6: heckyeahbro folded before Flop (didn't bet)

Hand #1421: 

PokerStars Hand #246784635615:  Hold'em No Limit ($0.05/$0.10 CAD) - 2023/10/28 1:45:40 ET
Table 'Chow' 6-max Seat #3 is the button
Seat 1: GrumpyPants44 ($10.04 in chips) 
Seat 2: Talmin84 ($6.25 in chips) 
Seat 3: CashMatteo ($25.62 in chips) 
Seat 4: kervyrx7 ($4 in chips) 
Seat 5: Spankorama ($11.46 in chips) 
Seat 6: heckyeahbro ($10.16 in chips) 
kervyrx7: posts small blind $0.05
Spankorama: posts big blind $0.10
*** HOLE CARDS ***
Dealt to CashMatteo [Ad Js]
heckyeahbro: raises $0.15 to $0.25
GrumpyPants44: calls $0.25
Talmin84: calls $0.25
CashMatteo: raises $0.95 to $1.20
kervyrx7: folds 
Spankorama: folds 
heckyeahbro: folds 
GrumpyPants44: calls $0.95
Talmin84: calls $0.95
*** FLOP *** [9h 2d 6h]
GrumpyPants44: checks 
Talmin84: bets $0.10
CashMatteo: calls $0.10
GrumpyPants44: calls $0.10
*** TURN *** [9h 2d 6h] [5d]
GrumpyPants44: checks 
Talmin84: bets $0.30
CashMatteo: calls $0.30
GrumpyPants44: calls $0.30
*** RIVER *** [9h 2d 6h 5d] [Ac]
GrumpyPants44: checks 
Talmin84: bets $2.49
CashMatteo: calls $2.49
GrumpyPants44: folds 
*** SHOW DOWN ***
Talmin84: shows [9c 9s] (three of a kind, Nines)
CashMatteo: mucks hand 
Talmin84 collected $9.72 from pot
*** SUMMARY ***
Total pot $10.18 | Rake $0.46 
Board [9h 2d 6h 5d Ac]
Seat 1: GrumpyPants44 folded on the River
Seat 2: Talmin84 showed [9c 9s] and won ($9.72) with three of a kind, Nines
Seat 3: CashMatteo (button) mucked [Ad Js]
Seat 4: kervyrx7 (small blind) folded before Flop
Seat 5: Spankorama (big blind) folded before Flop
Seat 6: heckyeahbro folded before Flop

Hand #1422: 

PokerStars Hand #246784644811:  Hold'em No Limit ($0.05/$0.10 CAD) - 2023/10/28 1:47:07 ET
Table 'Chow' 6-max Seat #4 is the button
Seat 1: GrumpyPants44 ($8.44 in chips) 
Seat 2: Talmin84 ($11.88 in chips) 
Seat 3: CashMatteo ($21.53 in chips) 
Seat 4: kervyrx7 ($4 in chips) 
Seat 5: Spankorama ($11.36 in chips) 
Seat 6: heckyeahbro ($10 in chips) 
Spankorama: posts small blind $0.05
heckyeahbro: posts big blind $0.10
*** HOLE CARDS ***
Dealt to CashMatteo [2d Jh]
GrumpyPants44: calls $0.10
Talmin84: folds 
CashMatteo: folds 
kervyrx7: folds 
Spankorama: calls $0.05
heckyeahbro: checks 
*** FLOP *** [Qs Kc 8h]
Spankorama: checks 
heckyeahbro: checks 
GrumpyPants44: checks 
*** TURN *** [Qs Kc 8h] [6c]
Spankorama: checks 
heckyeahbro: checks 
GrumpyPants44: bets $0.20
Spankorama: folds 
heckyeahbro: folds 
Uncalled bet ($0.20) returned to GrumpyPants44
GrumpyPants44 collected $0.29 from pot
*** SUMMARY ***
Total pot $0.30 | Rake $0.01 
Board [Qs Kc 8h 6c]
Seat 1: GrumpyPants44 collected ($0.29)
Seat 2: Talmin84 folded before Flop (didn't bet)
Seat 3: CashMatteo folded before Flop (didn't bet)
Seat 4: kervyrx7 (button) folded before Flop (didn't bet)
Seat 5: Spankorama (small blind) folded on the Turn
Seat 6: heckyeahbro (big blind) folded on the Turn

Hand #1423: 

PokerStars Hand #246784649071:  Hold'em No Limit ($0.05/$0.10 CAD) - 2023/10/28 1:47:47 ET
Table 'Chow' 6-max Seat #5 is the button
Seat 1: GrumpyPants44 ($8.63 in chips) 
Seat 2: Talmin84 ($11.88 in chips) 
Seat 3: CashMatteo ($21.53 in chips) 
Seat 4: kervyrx7 ($4 in chips) 
Seat 5: Spankorama ($11.26 in chips) 
Seat 6: heckyeahbro ($10 in chips) 
heckyeahbro: posts small blind $0.05
GrumpyPants44: posts big blind $0.10
*** HOLE CARDS ***
Dealt to CashMatteo [Td Jd]
Talmin84: folds 
CashMatteo: raises $0.15 to $0.25
kervyrx7: folds 
Spankorama: folds 
heckyeahbro: folds 
GrumpyPants44: calls $0.15
*** FLOP *** [Qc Qh 8s]
GrumpyPants44: checks 
CashMatteo: bets $0.27
GrumpyPants44: folds 
Uncalled bet ($0.27) returned to CashMatteo
CashMatteo collected $0.53 from pot
CashMatteo: doesn't show hand 
*** SUMMARY ***
Total pot $0.55 | Rake $0.02 
Board [Qc Qh 8s]
Seat 1: GrumpyPants44 (big blind) folded on the Flop
Seat 2: Talmin84 folded before Flop (didn't bet)
Seat 3: CashMatteo collected ($0.53)
Seat 4: kervyrx7 folded before Flop (didn't bet)
Seat 5: Spankorama (button) folded before Flop (didn't bet)
Seat 6: heckyeahbro (small blind) folded before Flop

Hand #1424: 

PokerStars Hand #246784651986:  Hold'em No Limit ($0.05/$0.10 CAD) - 2023/10/28 1:48:15 ET
Table 'Chow' 6-max Seat #6 is the button
Seat 1: GrumpyPants44 ($8.38 in chips) 
Seat 2: Talmin84 ($11.88 in chips) 
Seat 3: CashMatteo ($21.81 in chips) 
Seat 4: kervyrx7 ($4 in chips) 
Seat 5: Spankorama ($11.26 in chips) 
Seat 6: heckyeahbro ($10 in chips) 
GrumpyPants44: posts small blind $0.05
Talmin84: posts big blind $0.10
*** HOLE CARDS ***
Dealt to CashMatteo [9s 6d]
CashMatteo: raises $0.15 to $0.25
kervyrx7: folds 
Spankorama: calls $0.25
heckyeahbro: folds 
GrumpyPants44: calls $0.20
Talmin84: calls $0.15
*** FLOP *** [5d Jd 3h]
GrumpyPants44: bets $0.10
Talmin84: calls $0.10
CashMatteo: folds 
Spankorama: calls $0.10
*** TURN *** [5d Jd 3h] [5c]
GrumpyPants44: bets $0.30
Talmin84: calls $0.30
Spankorama: folds 
*** RIVER *** [5d Jd 3h 5c] [Qs]
GrumpyPants44: bets $4.90
Talmin84: folds 
Uncalled bet ($4.90) returned to GrumpyPants44
GrumpyPants44 collected $1.81 from pot
*** SUMMARY ***
Total pot $1.90 | Rake $0.09 
Board [5d Jd 3h 5c Qs]
Seat 1: GrumpyPants44 (small blind) collected ($1.81)
Seat 2: Talmin84 (big blind) folded on the River
Seat 3: CashMatteo folded on the Flop
Seat 4: kervyrx7 folded before Flop (didn't bet)
Seat 5: Spankorama folded on the Turn
Seat 6: heckyeahbro (button) folded before Flop (didn't bet)

Hand #1425: 

PokerStars Hand #246784658557:  Hold'em No Limit ($0.05/$0.10 CAD) - 2023/10/28 1:49:19 ET
Table 'Chow' 6-max Seat #1 is the button
Seat 1: GrumpyPants44 ($9.54 in chips) 
Seat 2: Talmin84 ($11.23 in chips) 
Seat 3: CashMatteo ($21.56 in chips) 
Seat 4: kervyrx7 ($4 in chips) 
Seat 5: Spankorama ($10.91 in chips) 
Seat 6: heckyeahbro ($10 in chips) 
Talmin84: posts small blind $0.05
CashMatteo: posts big blind $0.10
*** HOLE CARDS ***
Dealt to CashMatteo [Js Jc]
kervyrx7: folds 
Spankorama: folds 
heckyeahbro: folds 
GrumpyPants44: calls $0.10
Talmin84: folds 
CashMatteo: raises $0.15 to $0.25
GrumpyPants44: calls $0.15
*** FLOP *** [Qs 7s 7h]
CashMatteo: checks 
GrumpyPants44: bets $0.10
CashMatteo: raises $0.73 to $0.83
GrumpyPants44: raises $0.83 to $1.66
CashMatteo: folds 
Uncalled bet ($0.83) returned to GrumpyPants44
GrumpyPants44 collected $2.11 from pot
*** SUMMARY ***
Total pot $2.21 | Rake $0.10 
Board [Qs 7s 7h]
Seat 1: GrumpyPants44 (button) collected ($2.11)
Seat 2: Talmin84 (small blind) folded before Flop
Seat 3: CashMatteo (big blind) folded on the Flop
Seat 4: kervyrx7 folded before Flop (didn't bet)
Seat 5: Spankorama folded before Flop (didn't bet)
Seat 6: heckyeahbro folded before Flop (didn't bet)

Hand #1426: 

PokerStars Hand #246784663517:  Hold'em No Limit ($0.05/$0.10 CAD) - 2023/10/28 1:50:07 ET
Table 'Chow' 6-max Seat #2 is the button
Seat 1: GrumpyPants44 ($10.57 in chips) 
Seat 2: Talmin84 ($11.18 in chips) 
Seat 3: CashMatteo ($20.48 in chips) 
Seat 4: kervyrx7 ($4 in chips) 
Seat 5: Spankorama ($10.91 in chips) 
Seat 6: heckyeahbro ($10 in chips) 
CashMatteo: posts small blind $0.05
kervyrx7: posts big blind $0.10
*** HOLE CARDS ***
Dealt to CashMatteo [7h Kh]
Spankorama: folds 
heckyeahbro: raises $0.15 to $0.25
GrumpyPants44: calls $0.25
Talmin84: calls $0.25
CashMatteo: calls $0.20
kervyrx7: folds 
*** FLOP *** [Jd 2c 7s]
CashMatteo: checks 
heckyeahbro: checks 
GrumpyPants44: checks 
Talmin84: checks 
*** TURN *** [Jd 2c 7s] [3h]
CashMatteo: bets $0.53
heckyeahbro: folds 
GrumpyPants44: folds 
Talmin84: folds 
Uncalled bet ($0.53) returned to CashMatteo
CashMatteo collected $1.05 from pot
CashMatteo: doesn't show hand 
*** SUMMARY ***
Total pot $1.10 | Rake $0.05 
Board [Jd 2c 7s 3h]
Seat 1: GrumpyPants44 folded on the Turn
Seat 2: Talmin84 (button) folded on the Turn
Seat 3: CashMatteo (small blind) collected ($1.05)
Seat 4: kervyrx7 (big blind) folded before Flop
Seat 5: Spankorama folded before Flop (didn't bet)
Seat 6: heckyeahbro folded on the Turn

Hand #1427: 

PokerStars Hand #246784666832:  Hold'em No Limit ($0.05/$0.10 CAD) - 2023/10/28 1:50:39 ET
Table 'Chow' 6-max Seat #3 is the button
Seat 1: GrumpyPants44 ($10.32 in chips) 
Seat 2: Talmin84 ($10.93 in chips) 
Seat 3: CashMatteo ($21.28 in chips) 
Seat 4: kervyrx7 ($4 in chips) 
Seat 5: Spankorama ($10.91 in chips) 
Seat 6: heckyeahbro ($10 in chips) 
kervyrx7: posts small blind $0.05
Spankorama: posts big blind $0.10
*** HOLE CARDS ***
Dealt to CashMatteo [As 9s]
heckyeahbro: folds 
GrumpyPants44: calls $0.10
Talmin84: folds 
CashMatteo: raises $0.15 to $0.25
kervyrx7: calls $0.20
Spankorama: folds 
GrumpyPants44: folds 
*** FLOP *** [8h 4d 4h]
kervyrx7: checks 
CashMatteo: checks 
*** TURN *** [8h 4d 4h] [Js]
kervyrx7: bets $0.57
CashMatteo: folds 
Uncalled bet ($0.57) returned to kervyrx7
kervyrx7 collected $0.67 from pot
kervyrx7: doesn't show hand 
*** SUMMARY ***
Total pot $0.70 | Rake $0.03 
Board [8h 4d 4h Js]
Seat 1: GrumpyPants44 folded before Flop
Seat 2: Talmin84 folded before Flop (didn't bet)
Seat 3: CashMatteo (button) folded on the Turn
Seat 4: kervyrx7 (small blind) collected ($0.67)
Seat 5: Spankorama (big blind) folded before Flop
Seat 6: heckyeahbro folded before Flop (didn't bet)

Hand #1428: 

PokerStars Hand #246784671687:  Hold'em No Limit ($0.05/$0.10 CAD) - 2023/10/28 1:51:26 ET
Table 'Chow' 6-max Seat #4 is the button
Seat 1: GrumpyPants44 ($10.22 in chips) 
Seat 2: Talmin84 ($10.93 in chips) 
Seat 3: CashMatteo ($21.03 in chips) 
Seat 4: kervyrx7 ($4.42 in chips) 
Seat 5: Spankorama ($10.81 in chips) 
Seat 6: heckyeahbro ($10 in chips) 
Spankorama: posts small blind $0.05
heckyeahbro: posts big blind $0.10
*** HOLE CARDS ***
Dealt to CashMatteo [Ts 4s]
GrumpyPants44: calls $0.10
Talmin84: folds 
CashMatteo: calls $0.10
kervyrx7: raises $0.40 to $0.50
Spankorama: folds 
heckyeahbro: folds 
GrumpyPants44: calls $0.40
CashMatteo: calls $0.40
*** FLOP *** [9d Ks 4d]
GrumpyPants44: bets $0.10
CashMatteo: calls $0.10
kervyrx7: calls $0.10
*** TURN *** [9d Ks 4d] [4c]
GrumpyPants44: bets $0.10
CashMatteo: calls $0.10
kervyrx7: calls $0.10
*** RIVER *** [9d Ks 4d 4c] [Ah]
GrumpyPants44: bets $0.30
CashMatteo: raises $2.45 to $2.75
kervyrx7: folds 
GrumpyPants44: raises $2.45 to $5.20
CashMatteo: calls $2.45
*** SHOW DOWN ***
GrumpyPants44: shows [Th Ad] (two pair, Aces and Fours)
CashMatteo: shows [Ts 4s] (three of a kind, Fours)
CashMatteo collected $12.08 from pot
*** SUMMARY ***
Total pot $12.65 | Rake $0.57 
Board [9d Ks 4d 4c Ah]
Seat 1: GrumpyPants44 showed [Th Ad] and lost with two pair, Aces and Fours
Seat 2: Talmin84 folded before Flop (didn't bet)
Seat 3: CashMatteo showed [Ts 4s] and won ($12.08) with three of a kind, Fours
Seat 4: kervyrx7 (button) folded on the River
Seat 5: Spankorama (small blind) folded before Flop
Seat 6: heckyeahbro (big blind) folded before Flop

Hand #1429: 

PokerStars Hand #246784677909:  Hold'em No Limit ($0.05/$0.10 CAD) - 2023/10/28 1:52:26 ET
Table 'Chow' 6-max Seat #5 is the button
Seat 1: GrumpyPants44 ($4.32 in chips) 
Seat 2: Talmin84 ($10.93 in chips) 
Seat 3: CashMatteo ($27.21 in chips) 
Seat 4: kervyrx7 ($4 in chips) 
Seat 5: Spankorama ($10.76 in chips) 
Seat 6: heckyeahbro ($10 in chips) 
heckyeahbro: posts small blind $0.05
GrumpyPants44: posts big blind $0.10
*** HOLE CARDS ***
Dealt to CashMatteo [Ac Kc]
Talmin84: folds 
CashMatteo: raises $0.15 to $0.25
kervyrx7: folds 
Spankorama: folds 
heckyeahbro: folds 
GrumpyPants44: calls $0.15
*** FLOP *** [Ts 3d 3h]
GrumpyPants44: checks 
CashMatteo: checks 
*** TURN *** [Ts 3d 3h] [5c]
GrumpyPants44: checks 
CashMatteo: checks 
*** RIVER *** [Ts 3d 3h 5c] [4s]
GrumpyPants44: bets $0.10
CashMatteo: calls $0.10
*** SHOW DOWN ***
GrumpyPants44: shows [4d Ks] (two pair, Fours and Threes)
CashMatteo: mucks hand 
GrumpyPants44 collected $0.72 from pot
*** SUMMARY ***
Total pot $0.75 | Rake $0.03 
Board [Ts 3d 3h 5c 4s]
Seat 1: GrumpyPants44 (big blind) showed [4d Ks] and won ($0.72) with two pair, Fours and Threes
Seat 2: Talmin84 folded before Flop (didn't bet)
Seat 3: CashMatteo mucked [Ac Kc]
Seat 4: kervyrx7 folded before Flop (didn't bet)
Seat 5: Spankorama (button) folded before Flop (didn't bet)
Seat 6: heckyeahbro (small blind) folded before Flop

Hand #1430: 

PokerStars Hand #246784681682:  Hold'em No Limit ($0.05/$0.10 CAD) - 2023/10/28 1:53:02 ET
Table 'Chow' 6-max Seat #6 is the button
Seat 1: GrumpyPants44 ($4.69 in chips) 
Seat 2: Talmin84 ($10.93 in chips) 
Seat 3: CashMatteo ($26.86 in chips) 
Seat 4: kervyrx7 ($4 in chips) 
Seat 5: Spankorama ($10.76 in chips) 
Seat 6: heckyeahbro ($10 in chips) 
GrumpyPants44: posts small blind $0.05
Talmin84: posts big blind $0.10
*** HOLE CARDS ***
Dealt to CashMatteo [5h 5s]
CashMatteo: raises $0.15 to $0.25
kervyrx7 has timed out
kervyrx7: folds 
Spankorama: calls $0.25
heckyeahbro: folds 
GrumpyPants44: calls $0.20
Talmin84: folds 
*** FLOP *** [6c Kc 4d]
GrumpyPants44: checks 
CashMatteo: checks 
Spankorama: bets $0.30
GrumpyPants44: calls $0.30
CashMatteo: calls $0.30
*** TURN *** [6c Kc 4d] [As]
GrumpyPants44: checks 
CashMatteo: checks 
Spankorama: bets $1.67
GrumpyPants44: folds 
CashMatteo: folds 
Uncalled bet ($1.67) returned to Spankorama
Spankorama collected $1.67 from pot
*** SUMMARY ***
Total pot $1.75 | Rake $0.08 
Board [6c Kc 4d As]
Seat 1: GrumpyPants44 (small blind) folded on the Turn
Seat 2: Talmin84 (big blind) folded before Flop
Seat 3: CashMatteo folded on the Turn
Seat 4: kervyrx7 folded before Flop (didn't bet)
Seat 5: Spankorama collected ($1.67)
Seat 6: heckyeahbro (button) folded before Flop (didn't bet)

Hand #1431: 

PokerStars Hand #246784687899:  Hold'em No Limit ($0.05/$0.10 CAD) - 2023/10/28 1:54:04 ET
Table 'Chow' 6-max Seat #1 is the button
Seat 1: GrumpyPants44 ($4.14 in chips) 
Seat 2: Talmin84 ($10.83 in chips) 
Seat 3: CashMatteo ($26.31 in chips) 
Seat 4: kervyrx7 ($4 in chips) 
Seat 5: Spankorama ($11.88 in chips) 
Seat 6: heckyeahbro ($10 in chips) 
Talmin84: posts small blind $0.05
CashMatteo: posts big blind $0.10
*** HOLE CARDS ***
Dealt to CashMatteo [Jc 2d]
kervyrx7: folds 
Spankorama: calls $0.10
heckyeahbro: folds 
GrumpyPants44: calls $0.10
Talmin84: raises $0.10 to $0.20
CashMatteo: calls $0.10
Spankorama: calls $0.10
GrumpyPants44: calls $0.10
*** FLOP *** [6h 4c 8h]
Talmin84: checks 
CashMatteo: checks 
Spankorama: checks 
GrumpyPants44: bets $0.10
Talmin84: calls $0.10
CashMatteo: folds 
Spankorama: calls $0.10
*** TURN *** [6h 4c 8h] [6c]
Talmin84: bets $0.10
Spankorama: calls $0.10
GrumpyPants44: folds 
*** RIVER *** [6h 4c 8h 6c] [Js]
Talmin84: bets $0.10
Spankorama: calls $0.10
*** SHOW DOWN ***
Talmin84: shows [As 9s] (a pair of Sixes)
Spankorama: shows [8c Ac] (two pair, Eights and Sixes)
Spankorama collected $1.43 from pot
*** SUMMARY ***
Total pot $1.50 | Rake $0.07 
Board [6h 4c 8h 6c Js]
Seat 1: GrumpyPants44 (button) folded on the Turn
Seat 2: Talmin84 (small blind) showed [As 9s] and lost with a pair of Sixes
Seat 3: CashMatteo (big blind) folded on the Flop
Seat 4: kervyrx7 folded before Flop (didn't bet)
Seat 5: Spankorama showed [8c Ac] and won ($1.43) with two pair, Eights and Sixes
Seat 6: heckyeahbro folded before Flop (didn't bet)

Hand #1432: 

PokerStars Hand #246784694661:  Hold'em No Limit ($0.05/$0.10 CAD) - 2023/10/28 1:55:11 ET
Table 'Chow' 6-max Seat #2 is the button
Seat 1: GrumpyPants44 ($3.84 in chips) 
Seat 2: Talmin84 ($10.33 in chips) 
Seat 3: CashMatteo ($26.11 in chips) 
Seat 4: kervyrx7 ($4 in chips) 
Seat 5: Spankorama ($12.81 in chips) 
Seat 6: heckyeahbro ($10 in chips) 
CashMatteo: posts small blind $0.05
kervyrx7: posts big blind $0.10
*** HOLE CARDS ***
Dealt to CashMatteo [3h 9c]
Spankorama: calls $0.10
heckyeahbro: folds 
GrumpyPants44: calls $0.10
Talmin84: folds 
CashMatteo: raises $0.15 to $0.25
kervyrx7: folds 
Spankorama: calls $0.15
GrumpyPants44: folds 
*** FLOP *** [6d Js Qc]
CashMatteo: bets $0.44
Spankorama: calls $0.44
*** TURN *** [6d Js Qc] [5h]
CashMatteo: checks 
Spankorama: bets $1.10
CashMatteo: folds 
Uncalled bet ($1.10) returned to Spankorama
Spankorama collected $1.51 from pot
*** SUMMARY ***
Total pot $1.58 | Rake $0.07 
Board [6d Js Qc 5h]
Seat 1: GrumpyPants44 folded before Flop
Seat 2: Talmin84 (button) folded before Flop (didn't bet)
Seat 3: CashMatteo (small blind) folded on the Turn
Seat 4: kervyrx7 (big blind) folded before Flop
Seat 5: Spankorama collected ($1.51)
Seat 6: heckyeahbro folded before Flop (didn't bet)

Hand #1433: 

PokerStars Hand #246784698584:  Hold'em No Limit ($0.05/$0.10 CAD) - 2023/10/28 1:55:55 ET
Table 'Chow' 6-max Seat #3 is the button
Seat 1: GrumpyPants44 ($3.74 in chips) 
Seat 2: Talmin84 ($10.33 in chips) 
Seat 3: CashMatteo ($25.42 in chips) 
Seat 4: kervyrx7 ($4 in chips) 
Seat 5: Spankorama ($13.63 in chips) 
Seat 6: heckyeahbro ($10 in chips) 
kervyrx7: posts small blind $0.05
Spankorama: posts big blind $0.10
*** HOLE CARDS ***
Dealt to CashMatteo [Th 2h]
heckyeahbro: folds 
GrumpyPants44: calls $0.10
Talmin84: calls $0.10
CashMatteo: raises $0.15 to $0.25
kervyrx7: calls $0.20
Spankorama: calls $0.15
GrumpyPants44: calls $0.15
Talmin84: calls $0.15
*** FLOP *** [Qd Tc Qh]
kervyrx7: checks 
Spankorama: checks 
GrumpyPants44: checks 
Talmin84: bets $0.20
CashMatteo: calls $0.20
kervyrx7: folds 
Spankorama: folds 
GrumpyPants44: calls $0.20
*** TURN *** [Qd Tc Qh] [Ad]
GrumpyPants44: checks 
Talmin84: checks 
CashMatteo: checks 
*** RIVER *** [Qd Tc Qh Ad] [Js]
GrumpyPants44: bets $0.10
Talmin84: calls $0.10
CashMatteo: calls $0.10
*** SHOW DOWN ***
GrumpyPants44: shows [9c 9d] (two pair, Queens and Nines)
Talmin84: mucks hand 
CashMatteo: shows [Th 2h] (two pair, Queens and Tens)
CashMatteo collected $2.05 from pot
*** SUMMARY ***
Total pot $2.15 | Rake $0.10 
Board [Qd Tc Qh Ad Js]
Seat 1: GrumpyPants44 showed [9c 9d] and lost with two pair, Queens and Nines
Seat 2: Talmin84 mucked [5s 5c]
Seat 3: CashMatteo (button) showed [Th 2h] and won ($2.05) with two pair, Queens and Tens
Seat 4: kervyrx7 (small blind) folded on the Flop
Seat 5: Spankorama (big blind) folded on the Flop
Seat 6: heckyeahbro folded before Flop (didn't bet)

Hand #1434: 

PokerStars Hand #246784706042:  Hold'em No Limit ($0.05/$0.10 CAD) - 2023/10/28 1:57:18 ET
Table 'Chow' 6-max Seat #4 is the button
Seat 1: GrumpyPants44 ($3.19 in chips) 
Seat 2: Talmin84 ($9.78 in chips) 
Seat 3: CashMatteo ($26.92 in chips) 
Seat 4: kervyrx7 ($4 in chips) 
Seat 5: Spankorama ($13.38 in chips) 
Seat 6: heckyeahbro ($10 in chips) 
Spankorama: posts small blind $0.05
heckyeahbro: posts big blind $0.10
*** HOLE CARDS ***
Dealt to CashMatteo [Ah Tc]
GrumpyPants44: calls $0.10
Talmin84: folds 
CashMatteo: raises $0.15 to $0.25
kervyrx7: folds 
Spankorama: folds 
heckyeahbro: folds 
GrumpyPants44: folds 
Uncalled bet ($0.15) returned to CashMatteo
CashMatteo collected $0.35 from pot
CashMatteo: doesn't show hand 
*** SUMMARY ***
Total pot $0.35 | Rake $0 
Seat 1: GrumpyPants44 folded before Flop
Seat 2: Talmin84 folded before Flop (didn't bet)
Seat 3: CashMatteo collected ($0.35)
Seat 4: kervyrx7 (button) folded before Flop (didn't bet)
Seat 5: Spankorama (small blind) folded before Flop
Seat 6: heckyeahbro (big blind) folded before Flop

Hand #1435: 

PokerStars Hand #246784707549:  Hold'em No Limit ($0.05/$0.10 CAD) - 2023/10/28 1:57:36 ET
Table 'Chow' 6-max Seat #5 is the button
Seat 1: GrumpyPants44 ($3.09 in chips) 
Seat 2: Talmin84 ($9.78 in chips) 
Seat 3: CashMatteo ($27.17 in chips) 
Seat 4: kervyrx7 ($4 in chips) 
Seat 5: Spankorama ($13.33 in chips) 
Seat 6: heckyeahbro ($10 in chips) 
heckyeahbro: posts small blind $0.05
GrumpyPants44: posts big blind $0.10
*** HOLE CARDS ***
Dealt to CashMatteo [3d 6h]
Talmin84: calls $0.10
CashMatteo: folds 
kervyrx7: folds 
Spankorama: folds 
heckyeahbro: folds 
GrumpyPants44: checks 
*** FLOP *** [8s Ks Kh]
GrumpyPants44: checks 
Talmin84: bets $0.10
GrumpyPants44: calls $0.10
*** TURN *** [8s Ks Kh] [4d]
GrumpyPants44: checks 
Talmin84: bets $0.10
GrumpyPants44: calls $0.10
*** RIVER *** [8s Ks Kh 4d] [Qd]
GrumpyPants44: checks 
Talmin84: checks 
*** SHOW DOWN ***
GrumpyPants44: shows [7d Ah] (a pair of Kings)
Talmin84: shows [Js Jc] (two pair, Kings and Jacks)
Talmin84 collected $0.62 from pot
*** SUMMARY ***
Total pot $0.65 | Rake $0.03 
Board [8s Ks Kh 4d Qd]
Seat 1: GrumpyPants44 (big blind) showed [7d Ah] and lost with a pair of Kings
Seat 2: Talmin84 showed [Js Jc] and won ($0.62) with two pair, Kings and Jacks
Seat 3: CashMatteo folded before Flop (didn't bet)
Seat 4: kervyrx7 folded before Flop (didn't bet)
Seat 5: Spankorama (button) folded before Flop (didn't bet)
Seat 6: heckyeahbro (small blind) folded before Flop

Hand #1436: 

PokerStars Hand #246784710219:  Hold'em No Limit ($0.05/$0.10 CAD) - 2023/10/28 1:58:06 ET
Table 'Chow' 6-max Seat #6 is the button
Seat 1: GrumpyPants44 ($2.79 in chips) 
Seat 2: Talmin84 ($10.10 in chips) 
Seat 3: CashMatteo ($27.17 in chips) 
Seat 4: kervyrx7 ($4 in chips) 
Seat 5: Spankorama ($13.33 in chips) 
Seat 6: heckyeahbro ($10 in chips) 
GrumpyPants44: posts small blind $0.05
Talmin84: posts big blind $0.10
*** HOLE CARDS ***
Dealt to CashMatteo [4d Qd]
CashMatteo: raises $0.15 to $0.25
kervyrx7: folds 
Spankorama: folds 
heckyeahbro: folds 
GrumpyPants44: calls $0.20
Talmin84: folds 
*** FLOP *** [6c Js Kd]
GrumpyPants44: bets $0.10
CashMatteo: raises $0.39 to $0.49
GrumpyPants44: calls $0.39
*** TURN *** [6c Js Kd] [Qc]
GrumpyPants44: bets $0.10
CashMatteo: calls $0.10
*** RIVER *** [6c Js Kd Qc] [3c]
GrumpyPants44: bets $0.30
CashMatteo: calls $0.30
*** SHOW DOWN ***
GrumpyPants44: shows [Kc 8s] (a pair of Kings)
CashMatteo: mucks hand 
GrumpyPants44 collected $2.27 from pot
*** SUMMARY ***
Total pot $2.38 | Rake $0.11 
Board [6c Js Kd Qc 3c]
Seat 1: GrumpyPants44 (small blind) showed [Kc 8s] and won ($2.27) with a pair of Kings
Seat 2: Talmin84 (big blind) folded before Flop
Seat 3: CashMatteo mucked [4d Qd]
Seat 4: kervyrx7 folded before Flop (didn't bet)
Seat 5: Spankorama folded before Flop (didn't bet)
Seat 6: heckyeahbro (button) folded before Flop (didn't bet)

Hand #1437: 

PokerStars Hand #246784713557:  Hold'em No Limit ($0.05/$0.10 CAD) - 2023/10/28 1:58:44 ET
Table 'Chow' 6-max Seat #1 is the button
Seat 1: GrumpyPants44 ($3.92 in chips) 
Seat 2: Talmin84 ($10 in chips) 
Seat 3: CashMatteo ($26.03 in chips) 
Seat 4: kervyrx7 ($4 in chips) 
Seat 5: Spankorama ($13.33 in chips) 
Seat 6: heckyeahbro ($10 in chips) 
Talmin84: posts small blind $0.05
CashMatteo: posts big blind $0.10
*** HOLE CARDS ***
Dealt to CashMatteo [Tc 7s]
kervyrx7: folds 
Spankorama: folds 
heckyeahbro: raises $0.15 to $0.25
GrumpyPants44: folds 
Talmin84: calls $0.20
CashMatteo: folds 
*** FLOP *** [Qd Ad 9h]
Talmin84: bets $0.20
heckyeahbro: calls $0.20
*** TURN *** [Qd Ad 9h] [Ts]
Talmin84: bets $0.20
heckyeahbro: calls $0.20
*** RIVER *** [Qd Ad 9h Ts] [Jc]
Talmin84: checks 
heckyeahbro: bets $0.70
Talmin84: calls $0.70
*** SHOW DOWN ***
heckyeahbro: shows [Js Jh] (three of a kind, Jacks)
Talmin84: shows [Ah Ks] (a straight, Ten to Ace)
Talmin84 collected $2.67 from pot
*** SUMMARY ***
Total pot $2.80 | Rake $0.13 
Board [Qd Ad 9h Ts Jc]
Seat 1: GrumpyPants44 (button) folded before Flop (didn't bet)
Seat 2: Talmin84 (small blind) showed [Ah Ks] and won ($2.67) with a straight, Ten to Ace
Seat 3: CashMatteo (big blind) folded before Flop
Seat 4: kervyrx7 folded before Flop (didn't bet)
Seat 5: Spankorama folded before Flop (didn't bet)
Seat 6: heckyeahbro showed [Js Jh] and lost with three of a kind, Jacks

Hand #1438: 

PokerStars Hand #246784718757:  Hold'em No Limit ($0.05/$0.10 CAD) - 2023/10/28 1:59:41 ET
Table 'Chow' 6-max Seat #2 is the button
Seat 1: GrumpyPants44 ($3.92 in chips) 
Seat 2: Talmin84 ($11.32 in chips) 
Seat 3: CashMatteo ($25.93 in chips) 
Seat 4: kervyrx7 ($4 in chips) 
Seat 5: Spankorama ($13.33 in chips) 
Seat 6: heckyeahbro ($10 in chips) 
CashMatteo: posts small blind $0.05
kervyrx7: posts big blind $0.10
*** HOLE CARDS ***
Dealt to CashMatteo [Js Kh]
Spankorama: folds 
heckyeahbro: folds 
GrumpyPants44: calls $0.10
Talmin84: folds 
CashMatteo: raises $0.15 to $0.25
kervyrx7: calls $0.15
GrumpyPants44: calls $0.15
*** FLOP *** [7d 4c Ks]
CashMatteo: bets $0.72
kervyrx7: folds 
GrumpyPants44: folds 
Uncalled bet ($0.72) returned to CashMatteo
CashMatteo collected $0.72 from pot
CashMatteo: doesn't show hand 
*** SUMMARY ***
Total pot $0.75 | Rake $0.03 
Board [7d 4c Ks]
Seat 1: GrumpyPants44 folded on the Flop
Seat 2: Talmin84 (button) folded before Flop (didn't bet)
Seat 3: CashMatteo (small blind) collected ($0.72)
Seat 4: kervyrx7 (big blind) folded on the Flop
Seat 5: Spankorama folded before Flop (didn't bet)
Seat 6: heckyeahbro folded before Flop (didn't bet)

Hand #1439: 

PokerStars Hand #246784721229:  Hold'em No Limit ($0.05/$0.10 CAD) - 2023/10/28 2:00:09 ET
Table 'Chow' 6-max Seat #3 is the button
Seat 1: GrumpyPants44 ($3.67 in chips) 
Seat 2: Talmin84 ($11.32 in chips) 
Seat 3: CashMatteo ($26.40 in chips) 
Seat 4: kervyrx7 ($4 in chips) 
Seat 5: Spankorama ($13.33 in chips) 
Seat 6: heckyeahbro ($10 in chips) 
kervyrx7: posts small blind $0.05
Spankorama: posts big blind $0.10
*** HOLE CARDS ***
Dealt to CashMatteo [Kc Jc]
heckyeahbro: folds 
GrumpyPants44: calls $0.10
Talmin84: calls $0.10
CashMatteo: raises $0.15 to $0.25
kervyrx7: folds 
Spankorama: calls $0.15
GrumpyPants44: calls $0.15
Talmin84: calls $0.15
*** FLOP *** [Qh 7h Kh]
Spankorama: checks 
GrumpyPants44: bets $0.10
Talmin84: folds 
CashMatteo: raises $0.60 to $0.70
Spankorama: folds 
GrumpyPants44: calls $0.60
*** TURN *** [Qh 7h Kh] [8s]
GrumpyPants44: bets $0.20
CashMatteo: raises $1.17 to $1.37
GrumpyPants44: calls $1.17
*** RIVER *** [Qh 7h Kh 8s] [2c]
GrumpyPants44: checks 
CashMatteo: bets $0.98
GrumpyPants44: raises $0.37 to $1.35 and is all-in
CashMatteo: calls $0.37
*** SHOW DOWN ***
GrumpyPants44: shows [As Ac] (a pair of Aces)
CashMatteo: shows [Kc Jc] (a pair of Kings)
GrumpyPants44 collected $7.53 from pot
*** SUMMARY ***
Total pot $7.89 | Rake $0.36 
Board [Qh 7h Kh 8s 2c]
Seat 1: GrumpyPants44 showed [As Ac] and won ($7.53) with a pair of Aces
Seat 2: Talmin84 folded on the Flop
Seat 3: CashMatteo (button) showed [Kc Jc] and lost with a pair of Kings
Seat 4: kervyrx7 (small blind) folded before Flop
Seat 5: Spankorama (big blind) folded on the Flop
Seat 6: heckyeahbro folded before Flop (didn't bet)

Hand #1440: 

PokerStars Hand #246784728733:  Hold'em No Limit ($0.05/$0.10 CAD) - 2023/10/28 2:01:26 ET
Table 'Chow' 6-max Seat #4 is the button
Seat 1: GrumpyPants44 ($7.53 in chips) 
Seat 2: Talmin84 ($11.07 in chips) 
Seat 3: CashMatteo ($22.73 in chips) 
Seat 4: kervyrx7 ($4 in chips) 
Seat 5: Spankorama ($13.08 in chips) 
Seat 6: heckyeahbro ($10 in chips) 
Spankorama: posts small blind $0.05
heckyeahbro: posts big blind $0.10
*** HOLE CARDS ***
Dealt to CashMatteo [9c Tc]
GrumpyPants44: calls $0.10
Talmin84: folds 
CashMatteo: raises $0.15 to $0.25
kervyrx7: folds 
Spankorama: raises $0.85 to $1.10
heckyeahbro: folds 
GrumpyPants44: folds 
CashMatteo: calls $0.85
*** FLOP *** [Kd 3s 9s]
Spankorama: checks 
CashMatteo: checks 
*** TURN *** [Kd 3s 9s] [Qc]
Spankorama: bets $1.15
CashMatteo: calls $1.15
*** RIVER *** [Kd 3s 9s Qc] [5h]
Spankorama: bets $2.25
CashMatteo: folds 
Uncalled bet ($2.25) returned to Spankorama
Spankorama collected $4.49 from pot
*** SUMMARY ***
Total pot $4.70 | Rake $0.21 
Board [Kd 3s 9s Qc 5h]
Seat 1: GrumpyPants44 folded before Flop
Seat 2: Talmin84 folded before Flop (didn't bet)
Seat 3: CashMatteo folded on the River
Seat 4: kervyrx7 (button) folded before Flop (didn't bet)
Seat 5: Spankorama (small blind) collected ($4.49)
Seat 6: heckyeahbro (big blind) folded before Flop

Hand #1441: 

PokerStars Hand #246784735271:  Hold'em No Limit ($0.05/$0.10 CAD) - 2023/10/28 2:02:30 ET
Table 'Chow' 6-max Seat #5 is the button
Seat 1: GrumpyPants44 ($7.43 in chips) 
Seat 2: Talmin84 ($11.07 in chips) 
Seat 3: CashMatteo ($20.48 in chips) 
Seat 4: kervyrx7 ($4 in chips) 
Seat 5: Spankorama ($15.32 in chips) 
Seat 6: heckyeahbro ($10 in chips) 
heckyeahbro: posts small blind $0.05
GrumpyPants44: posts big blind $0.10
*** HOLE CARDS ***
Dealt to CashMatteo [4h 5h]
Talmin84: folds 
CashMatteo: raises $0.15 to $0.25
kervyrx7: folds 
Spankorama: folds 
heckyeahbro: folds 
GrumpyPants44: calls $0.15
*** FLOP *** [Ts 3s Tc]
GrumpyPants44: checks 
CashMatteo: checks 
*** TURN *** [Ts 3s Tc] [Qs]
GrumpyPants44: checks 
CashMatteo: checks 
*** RIVER *** [Ts 3s Tc Qs] [9c]
GrumpyPants44: bets $0.20
CashMatteo: folds 
Uncalled bet ($0.20) returned to GrumpyPants44
GrumpyPants44 collected $0.53 from pot
*** SUMMARY ***
Total pot $0.55 | Rake $0.02 
Board [Ts 3s Tc Qs 9c]
Seat 1: GrumpyPants44 (big blind) collected ($0.53)
Seat 2: Talmin84 folded before Flop (didn't bet)
Seat 3: CashMatteo folded on the River
Seat 4: kervyrx7 folded before Flop (didn't bet)
Seat 5: Spankorama (button) folded before Flop (didn't bet)
Seat 6: heckyeahbro (small blind) folded before Flop

Hand #1442: 

PokerStars Hand #246784738246:  Hold'em No Limit ($0.05/$0.10 CAD) - 2023/10/28 2:02:59 ET
Table 'Chow' 6-max Seat #6 is the button
Seat 1: GrumpyPants44 ($7.71 in chips) 
Seat 2: Talmin84 ($11.07 in chips) 
Seat 3: CashMatteo ($20.23 in chips) 
Seat 4: kervyrx7 ($4 in chips) 
Seat 5: Spankorama ($15.32 in chips) 
Seat 6: heckyeahbro ($10 in chips) 
GrumpyPants44: posts small blind $0.05
Talmin84: posts big blind $0.10
*** HOLE CARDS ***
Dealt to CashMatteo [9c 5c]
CashMatteo: calls $0.10
kervyrx7: raises $0.25 to $0.35
Spankorama: folds 
heckyeahbro: folds 
GrumpyPants44: calls $0.30
Talmin84: folds 
CashMatteo: folds 
*** FLOP *** [As 9s Qh]
GrumpyPants44: checks 
kervyrx7: bets $0.28
GrumpyPants44: folds 
Uncalled bet ($0.28) returned to kervyrx7
kervyrx7 collected $0.86 from pot
kervyrx7: doesn't show hand 
*** SUMMARY ***
Total pot $0.90 | Rake $0.04 
Board [As 9s Qh]
Seat 1: GrumpyPants44 (small blind) folded on the Flop
Seat 2: Talmin84 (big blind) folded before Flop
Seat 3: CashMatteo folded before Flop
Seat 4: kervyrx7 collected ($0.86)
Seat 5: Spankorama folded before Flop (didn't bet)
Seat 6: heckyeahbro (button) folded before Flop (didn't bet)

Hand #1443: 

PokerStars Hand #246784741132:  Hold'em No Limit ($0.05/$0.10 CAD) - 2023/10/28 2:03:27 ET
Table 'Chow' 6-max Seat #1 is the button
Seat 1: GrumpyPants44 ($7.36 in chips) 
Seat 2: Talmin84 ($10.97 in chips) 
Seat 3: CashMatteo ($20.13 in chips) 
Seat 4: kervyrx7 ($4.51 in chips) 
Seat 5: Spankorama ($15.32 in chips) 
Seat 6: heckyeahbro ($10 in chips) 
Talmin84: posts small blind $0.05
CashMatteo: posts big blind $0.10
*** HOLE CARDS ***
Dealt to CashMatteo [8s 5h]
kervyrx7: raises $0.15 to $0.25
Spankorama: folds 
heckyeahbro: folds 
GrumpyPants44: calls $0.25
Talmin84: calls $0.20
CashMatteo: calls $0.15
*** FLOP *** [6c Ac 9s]
Talmin84: bets $0.10
CashMatteo: calls $0.10
kervyrx7: folds 
GrumpyPants44: calls $0.10
*** TURN *** [6c Ac 9s] [Td]
Talmin84: bets $0.10
CashMatteo: calls $0.10
GrumpyPants44: calls $0.10
*** RIVER *** [6c Ac 9s Td] [6s]
Talmin84: checks 
CashMatteo: checks 
GrumpyPants44: bets $0.30
Talmin84: calls $0.30
CashMatteo: folds 
*** SHOW DOWN ***
GrumpyPants44: shows [6d 3d] (three of a kind, Sixes)
Talmin84: mucks hand 
GrumpyPants44 collected $2.10 from pot
*** SUMMARY ***
Total pot $2.20 | Rake $0.10 
Board [6c Ac 9s Td 6s]
Seat 1: GrumpyPants44 (button) showed [6d 3d] and won ($2.10) with three of a kind, Sixes
Seat 2: Talmin84 (small blind) mucked [Qc Qh]
Seat 3: CashMatteo (big blind) folded on the River
Seat 4: kervyrx7 folded on the Flop
Seat 5: Spankorama folded before Flop (didn't bet)
Seat 6: heckyeahbro folded before Flop (didn't bet)

Hand #1444: 

PokerStars Hand #246784747441:  Hold'em No Limit ($0.05/$0.10 CAD) - 2023/10/28 2:04:27 ET
Table 'Chow' 6-max Seat #2 is the button
Seat 1: GrumpyPants44 ($8.71 in chips) 
Seat 2: Talmin84 ($10.22 in chips) 
Seat 3: CashMatteo ($19.68 in chips) 
Seat 4: kervyrx7 ($4.26 in chips) 
Seat 5: Spankorama ($15.32 in chips) 
Seat 6: heckyeahbro ($10 in chips) 
CashMatteo: posts small blind $0.05
kervyrx7: posts big blind $0.10
*** HOLE CARDS ***
Dealt to CashMatteo [6c 9s]
Spankorama: folds 
heckyeahbro: raises $0.15 to $0.25
GrumpyPants44: calls $0.25
Talmin84: folds 
CashMatteo: folds 
kervyrx7: calls $0.15
*** FLOP *** [Kd Qc 6h]
kervyrx7: checks 
heckyeahbro: checks 
GrumpyPants44: bets $0.10
kervyrx7: folds 
heckyeahbro: calls $0.10
*** TURN *** [Kd Qc 6h] [5c]
heckyeahbro: checks 
GrumpyPants44: bets $0.10
heckyeahbro: calls $0.10
*** RIVER *** [Kd Qc 6h 5c] [9c]
heckyeahbro: checks 
GrumpyPants44: bets $0.10
heckyeahbro: folds 
Uncalled bet ($0.10) returned to GrumpyPants44
GrumpyPants44 collected $1.15 from pot
*** SUMMARY ***
Total pot $1.20 | Rake $0.05 
Board [Kd Qc 6h 5c 9c]
Seat 1: GrumpyPants44 collected ($1.15)
Seat 2: Talmin84 (button) folded before Flop (didn't bet)
Seat 3: CashMatteo (small blind) folded before Flop
Seat 4: kervyrx7 (big blind) folded on the Flop
Seat 5: Spankorama folded before Flop (didn't bet)
Seat 6: heckyeahbro folded on the River

Hand #1445: 

PokerStars Hand #246784752327:  Hold'em No Limit ($0.05/$0.10 CAD) - 2023/10/28 2:05:14 ET
Table 'Chow' 6-max Seat #3 is the button
Seat 1: GrumpyPants44 ($9.41 in chips) 
Seat 2: Talmin84 ($10.22 in chips) 
Seat 3: CashMatteo ($19.63 in chips) 
Seat 4: kervyrx7 ($4.01 in chips) 
Seat 5: Spankorama ($15.32 in chips) 
Seat 6: heckyeahbro ($10 in chips) 
kervyrx7: posts small blind $0.05
Spankorama: posts big blind $0.10
*** HOLE CARDS ***
Dealt to CashMatteo [Ts Jh]
heckyeahbro: folds 
GrumpyPants44: calls $0.10
Talmin84: folds 
CashMatteo: raises $0.15 to $0.25
kervyrx7: calls $0.20
Spankorama: folds 
GrumpyPants44: calls $0.15
*** FLOP *** [7c 7d 8s]
kervyrx7: checks 
GrumpyPants44: bets $0.10
CashMatteo: calls $0.10
kervyrx7: calls $0.10
*** TURN *** [7c 7d 8s] [Qd]
kervyrx7: checks 
GrumpyPants44: bets $0.30
CashMatteo: calls $0.30
kervyrx7: folds 
*** RIVER *** [7c 7d 8s Qd] [9h]
GrumpyPants44: bets $0.40
CashMatteo: raises $1.74 to $2.14
GrumpyPants44: calls $1.74
*** SHOW DOWN ***
CashMatteo: shows [Ts Jh] (a straight, Eight to Queen)
GrumpyPants44: mucks hand 
CashMatteo collected $5.76 from pot
*** SUMMARY ***
Total pot $6.03 | Rake $0.27 
Board [7c 7d 8s Qd 9h]
Seat 1: GrumpyPants44 mucked [Th 7s]
Seat 2: Talmin84 folded before Flop (didn't bet)
Seat 3: CashMatteo (button) showed [Ts Jh] and won ($5.76) with a straight, Eight to Queen
Seat 4: kervyrx7 (small blind) folded on the Turn
Seat 5: Spankorama (big blind) folded before Flop
Seat 6: heckyeahbro folded before Flop (didn't bet)

Hand #1446: 

PokerStars Hand #246784758393:  Hold'em No Limit ($0.05/$0.10 CAD) - 2023/10/28 2:06:14 ET
Table 'Chow' 6-max Seat #4 is the button
Seat 1: GrumpyPants44 ($6.62 in chips) 
Seat 2: Talmin84 ($10.22 in chips) 
Seat 3: CashMatteo ($22.60 in chips) 
Seat 4: kervyrx7 ($4 in chips) 
Seat 5: Spankorama ($15.22 in chips) 
Seat 6: heckyeahbro ($10 in chips) 
Spankorama: posts small blind $0.05
heckyeahbro: posts big blind $0.10
*** HOLE CARDS ***
Dealt to CashMatteo [2h Ac]
GrumpyPants44: calls $0.10
Talmin84: folds 
CashMatteo: raises $0.15 to $0.25
kervyrx7: folds 
Spankorama: folds 
heckyeahbro: folds 
GrumpyPants44: folds 
Uncalled bet ($0.15) returned to CashMatteo
CashMatteo collected $0.35 from pot
CashMatteo: doesn't show hand 
*** SUMMARY ***
Total pot $0.35 | Rake $0 
Seat 1: GrumpyPants44 folded before Flop
Seat 2: Talmin84 folded before Flop (didn't bet)
Seat 3: CashMatteo collected ($0.35)
Seat 4: kervyrx7 (button) folded before Flop (didn't bet)
Seat 5: Spankorama (small blind) folded before Flop
Seat 6: heckyeahbro (big blind) folded before Flop

Hand #1447: 

PokerStars Hand #246784760169:  Hold'em No Limit ($0.05/$0.10 CAD) - 2023/10/28 2:06:30 ET
Table 'Chow' 6-max Seat #5 is the button
Seat 1: GrumpyPants44 ($6.52 in chips) 
Seat 2: Talmin84 ($10.22 in chips) 
Seat 3: CashMatteo ($22.85 in chips) 
Seat 4: kervyrx7 ($4 in chips) 
Seat 5: Spankorama ($15.17 in chips) 
Seat 6: heckyeahbro ($10 in chips) 
heckyeahbro: posts small blind $0.05
GrumpyPants44: posts big blind $0.10
*** HOLE CARDS ***
Dealt to CashMatteo [3h 5h]
Talmin84: calls $0.10
CashMatteo: calls $0.10
kervyrx7: folds 
Spankorama: calls $0.10
heckyeahbro: calls $0.05
GrumpyPants44: raises $0.10 to $0.20
Talmin84: calls $0.10
CashMatteo: calls $0.10
Spankorama: calls $0.10
heckyeahbro: calls $0.10
*** FLOP *** [2d 7d 5d]
heckyeahbro: checks 
GrumpyPants44: bets $0.30
Talmin84: folds 
CashMatteo: folds 
Spankorama: folds 
heckyeahbro: folds 
Uncalled bet ($0.30) returned to GrumpyPants44
GrumpyPants44 collected $0.96 from pot
*** SUMMARY ***
Total pot $1 | Rake $0.04 
Board [2d 7d 5d]
Seat 1: GrumpyPants44 (big blind) collected ($0.96)
Seat 2: Talmin84 folded on the Flop
Seat 3: CashMatteo folded on the Flop
Seat 4: kervyrx7 folded before Flop (didn't bet)
Seat 5: Spankorama (button) folded on the Flop
Seat 6: heckyeahbro (small blind) folded on the Flop

Hand #1448: 

PokerStars Hand #246784765315:  Hold'em No Limit ($0.05/$0.10 CAD) - 2023/10/28 2:07:21 ET
Table 'Chow' 6-max Seat #6 is the button
Seat 1: GrumpyPants44 ($7.28 in chips) 
Seat 2: Talmin84 ($10.02 in chips) 
Seat 3: CashMatteo ($22.65 in chips) 
Seat 4: kervyrx7 ($4 in chips) 
Seat 5: Spankorama ($14.97 in chips) 
Seat 6: heckyeahbro ($10 in chips) 
GrumpyPants44: posts small blind $0.05
Talmin84: posts big blind $0.10
*** HOLE CARDS ***
Dealt to CashMatteo [Kd Tc]
CashMatteo: raises $0.15 to $0.25
kervyrx7: folds 
Spankorama: calls $0.25
heckyeahbro: folds 
GrumpyPants44: calls $0.20
Talmin84: folds 
*** FLOP *** [Qh 4d Ad]
GrumpyPants44: bets $0.20
CashMatteo: calls $0.20
Spankorama: calls $0.20
*** TURN *** [Qh 4d Ad] [3c]
GrumpyPants44: bets $0.40
CashMatteo: calls $0.40
Spankorama: folds 
*** RIVER *** [Qh 4d Ad 3c] [4c]
GrumpyPants44: bets $1
CashMatteo: folds 
Uncalled bet ($1) returned to GrumpyPants44
GrumpyPants44 collected $2.15 from pot
*** SUMMARY ***
Total pot $2.25 | Rake $0.10 
Board [Qh 4d Ad 3c 4c]
Seat 1: GrumpyPants44 (small blind) collected ($2.15)
Seat 2: Talmin84 (big blind) folded before Flop
Seat 3: CashMatteo folded on the River
Seat 4: kervyrx7 folded before Flop (didn't bet)
Seat 5: Spankorama folded on the Turn
Seat 6: heckyeahbro (button) folded before Flop (didn't bet)

Hand #1449: 

PokerStars Hand #246784770827:  Hold'em No Limit ($0.05/$0.10 CAD) - 2023/10/28 2:08:13 ET
Table 'Chow' 6-max Seat #1 is the button
Seat 1: GrumpyPants44 ($8.58 in chips) 
Seat 2: Talmin84 ($9.92 in chips) 
Seat 3: CashMatteo ($21.80 in chips) 
Seat 4: kervyrx7 ($4 in chips) 
Seat 5: Spankorama ($14.52 in chips) 
Seat 6: heckyeahbro ($10 in chips) 
Talmin84: posts small blind $0.05
CashMatteo: posts big blind $0.10
*** HOLE CARDS ***
Dealt to CashMatteo [2c Kd]
kervyrx7: folds 
Spankorama: folds 
heckyeahbro: raises $0.15 to $0.25
GrumpyPants44: calls $0.25
Talmin84: folds 
CashMatteo: calls $0.15
*** FLOP *** [3d Qc Qd]
CashMatteo: checks 
heckyeahbro: bets $0.51
GrumpyPants44: folds 
CashMatteo: folds 
Uncalled bet ($0.51) returned to heckyeahbro
heckyeahbro collected $0.76 from pot
heckyeahbro: doesn't show hand 
*** SUMMARY ***
Total pot $0.80 | Rake $0.04 
Board [3d Qc Qd]
Seat 1: GrumpyPants44 (button) folded on the Flop
Seat 2: Talmin84 (small blind) folded before Flop
Seat 3: CashMatteo (big blind) folded on the Flop
Seat 4: kervyrx7 folded before Flop (didn't bet)
Seat 5: Spankorama folded before Flop (didn't bet)
Seat 6: heckyeahbro collected ($0.76)

Hand #1450: 

PokerStars Hand #246784772788:  Hold'em No Limit ($0.05/$0.10 CAD) - 2023/10/28 2:08:32 ET
Table 'Chow' 6-max Seat #2 is the button
Seat 1: GrumpyPants44 ($8.33 in chips) 
Seat 2: Talmin84 ($9.87 in chips) 
Seat 3: CashMatteo ($21.55 in chips) 
Seat 4: kervyrx7 ($4 in chips) 
Seat 5: Spankorama ($14.52 in chips) 
Seat 6: heckyeahbro ($10.51 in chips) 
CashMatteo: posts small blind $0.05
kervyrx7: posts big blind $0.10
*** HOLE CARDS ***
Dealt to CashMatteo [Ad 9c]
Spankorama: folds 
heckyeahbro: folds 
GrumpyPants44: folds 
Talmin84: calls $0.10
CashMatteo: calls $0.05
kervyrx7: raises $0.30 to $0.40
Talmin84: folds 
CashMatteo: calls $0.30
*** FLOP *** [3c 5s As]
CashMatteo: checks 
kervyrx7: bets $0.28
CashMatteo: calls $0.28
*** TURN *** [3c 5s As] [2s]
CashMatteo: checks 
kervyrx7: checks 
*** RIVER *** [3c 5s As 2s] [3s]
CashMatteo: checks 
kervyrx7: checks 
*** SHOW DOWN ***
CashMatteo: shows [Ad 9c] (two pair, Aces and Threes)
kervyrx7: mucks hand 
CashMatteo collected $1.39 from pot
*** SUMMARY ***
Total pot $1.46 | Rake $0.07 
Board [3c 5s As 2s 3s]
Seat 1: GrumpyPants44 folded before Flop (didn't bet)
Seat 2: Talmin84 (button) folded before Flop
Seat 3: CashMatteo (small blind) showed [Ad 9c] and won ($1.39) with two pair, Aces and Threes
Seat 4: kervyrx7 (big blind) mucked [Kc Jc]
Seat 5: Spankorama folded before Flop (didn't bet)
Seat 6: heckyeahbro folded before Flop (didn't bet)

Hand #1451: 

PokerStars Hand #246784778197:  Hold'em No Limit ($0.05/$0.10 CAD) - 2023/10/28 2:09:24 ET
Table 'Chow' 6-max Seat #3 is the button
Seat 1: GrumpyPants44 ($8.33 in chips) 
Seat 2: Talmin84 ($9.77 in chips) 
Seat 3: CashMatteo ($22.26 in chips) 
Seat 4: kervyrx7 ($4 in chips) 
Seat 6: heckyeahbro ($10.51 in chips) 
kervyrx7: posts small blind $0.05
heckyeahbro: posts big blind $0.10
*** HOLE CARDS ***
Dealt to CashMatteo [6c 3c]
GrumpyPants44: calls $0.10
Talmin84: folds 
CashMatteo: calls $0.10
kervyrx7: calls $0.05
heckyeahbro: checks 
*** FLOP *** [9s Ts 5d]
kervyrx7: checks 
heckyeahbro: bets $0.20
GrumpyPants44: folds 
CashMatteo: folds 
kervyrx7: calls $0.20
*** TURN *** [9s Ts 5d] [As]
kervyrx7: checks 
heckyeahbro: checks 
*** RIVER *** [9s Ts 5d As] [Jc]
kervyrx7: bets $0.65
heckyeahbro: folds 
Uncalled bet ($0.65) returned to kervyrx7
kervyrx7 collected $0.76 from pot
kervyrx7: doesn't show hand 
*** SUMMARY ***
Total pot $0.80 | Rake $0.04 
Board [9s Ts 5d As Jc]
Seat 1: GrumpyPants44 folded on the Flop
Seat 2: Talmin84 folded before Flop (didn't bet)
Seat 3: CashMatteo (button) folded on the Flop
Seat 4: kervyrx7 (small blind) collected ($0.76)
Seat 6: heckyeahbro (big blind) folded on the River

Hand #1452: 

PokerStars Hand #246784782057:  Hold'em No Limit ($0.05/$0.10 CAD) - 2023/10/28 2:10:01 ET
Table 'Chow' 6-max Seat #4 is the button
Seat 1: GrumpyPants44 ($8.23 in chips) 
Seat 2: Talmin84 ($9.77 in chips) 
Seat 3: CashMatteo ($22.16 in chips) 
Seat 4: kervyrx7 ($4.46 in chips) 
Seat 6: heckyeahbro ($10.21 in chips) 
heckyeahbro: posts small blind $0.05
GrumpyPants44: posts big blind $0.10
*** HOLE CARDS ***
Dealt to CashMatteo [3c 6s]
Talmin84: calls $0.10
CashMatteo: folds 
kervyrx7: folds 
heckyeahbro: folds 
GrumpyPants44: checks 
*** FLOP *** [4s Qh 4h]
GrumpyPants44: checks 
Talmin84: bets $0.10
GrumpyPants44: calls $0.10
*** TURN *** [4s Qh 4h] [As]
GrumpyPants44: bets $0.20
Talmin84: calls $0.20
*** RIVER *** [4s Qh 4h As] [7c]
GrumpyPants44: bets $0.30
Talmin84: folds 
Uncalled bet ($0.30) returned to GrumpyPants44
GrumpyPants44 collected $0.81 from pot
*** SUMMARY ***
Total pot $0.85 | Rake $0.04 
Board [4s Qh 4h As 7c]
Seat 1: GrumpyPants44 (big blind) collected ($0.81)
Seat 2: Talmin84 folded on the River
Seat 3: CashMatteo folded before Flop (didn't bet)
Seat 4: kervyrx7 (button) folded before Flop (didn't bet)
Seat 6: heckyeahbro (small blind) folded before Flop

Hand #1453: 

PokerStars Hand #246784786999:  Hold'em No Limit ($0.05/$0.10 CAD) - 2023/10/28 2:10:50 ET
Table 'Chow' 6-max Seat #6 is the button
Seat 1: GrumpyPants44 ($8.64 in chips) 
Seat 2: Talmin84 ($9.37 in chips) 
Seat 3: CashMatteo ($22.16 in chips) 
Seat 4: kervyrx7 ($4.46 in chips) 
Seat 6: heckyeahbro ($10.16 in chips) 
GrumpyPants44: posts small blind $0.05
Talmin84: posts big blind $0.10
*** HOLE CARDS ***
Dealt to CashMatteo [2s Ks]
CashMatteo: raises $0.15 to $0.25
kervyrx7: folds 
heckyeahbro: folds 
GrumpyPants44: calls $0.20
Talmin84: folds 
*** FLOP *** [8c 8d Kc]
GrumpyPants44: checks 
CashMatteo: checks 
*** TURN *** [8c 8d Kc] [3c]
GrumpyPants44: checks 
CashMatteo: bets $0.29
GrumpyPants44: folds 
Uncalled bet ($0.29) returned to CashMatteo
CashMatteo collected $0.57 from pot
CashMatteo: doesn't show hand 
*** SUMMARY ***
Total pot $0.60 | Rake $0.03 
Board [8c 8d Kc 3c]
Seat 1: GrumpyPants44 (small blind) folded on the Turn
Seat 2: Talmin84 (big blind) folded before Flop
Seat 3: CashMatteo collected ($0.57)
Seat 4: kervyrx7 folded before Flop (didn't bet)
Seat 6: heckyeahbro (button) folded before Flop (didn't bet)

Hand #1454: 

PokerStars Hand #246784789377:  Hold'em No Limit ($0.05/$0.10 CAD) - 2023/10/28 2:11:13 ET
Table 'Chow' 6-max Seat #1 is the button
Seat 1: GrumpyPants44 ($8.39 in chips) 
Seat 2: Talmin84 ($9.27 in chips) 
Seat 3: CashMatteo ($22.48 in chips) 
Seat 4: kervyrx7 ($4.46 in chips) 
Seat 6: heckyeahbro ($10.16 in chips) 
Talmin84: posts small blind $0.05
CashMatteo: posts big blind $0.10
*** HOLE CARDS ***
Dealt to CashMatteo [3c Qh]
kervyrx7: folds 
heckyeahbro: raises $0.15 to $0.25
GrumpyPants44: folds 
Talmin84: folds 
CashMatteo: folds 
Uncalled bet ($0.15) returned to heckyeahbro
heckyeahbro collected $0.25 from pot
heckyeahbro: doesn't show hand 
*** SUMMARY ***
Total pot $0.25 | Rake $0 
Seat 1: GrumpyPants44 (button) folded before Flop (didn't bet)
Seat 2: Talmin84 (small blind) folded before Flop
Seat 3: CashMatteo (big blind) folded before Flop
Seat 4: kervyrx7 folded before Flop (didn't bet)
Seat 6: heckyeahbro collected ($0.25)

Hand #1455: 

PokerStars Hand #246784790681:  Hold'em No Limit ($0.05/$0.10 CAD) - 2023/10/28 2:11:25 ET
Table 'Chow' 6-max Seat #2 is the button
Seat 1: GrumpyPants44 ($8.39 in chips) 
Seat 2: Talmin84 ($9.22 in chips) 
Seat 3: CashMatteo ($22.38 in chips) 
Seat 4: kervyrx7 ($4.46 in chips) 
Seat 6: heckyeahbro ($10.31 in chips) 
CashMatteo: posts small blind $0.05
kervyrx7: posts big blind $0.10
*** HOLE CARDS ***
Dealt to CashMatteo [Kc 3s]
heckyeahbro: folds 
GrumpyPants44: calls $0.10
Talmin84: folds 
CashMatteo: calls $0.05
kervyrx7: checks 
*** FLOP *** [Kd 9h Qd]
CashMatteo: bets $0.15
kervyrx7: folds 
GrumpyPants44: folds 
Uncalled bet ($0.15) returned to CashMatteo
CashMatteo collected $0.29 from pot
CashMatteo: doesn't show hand 
*** SUMMARY ***
Total pot $0.30 | Rake $0.01 
Board [Kd 9h Qd]
Seat 1: GrumpyPants44 folded on the Flop
Seat 2: Talmin84 (button) folded before Flop (didn't bet)
Seat 3: CashMatteo (small blind) collected ($0.29)
Seat 4: kervyrx7 (big blind) folded on the Flop
Seat 6: heckyeahbro folded before Flop (didn't bet)

Hand #1456: 

PokerStars Hand #246784793177:  Hold'em No Limit ($0.05/$0.10 CAD) - 2023/10/28 2:11:50 ET
Table 'Chow' 6-max Seat #3 is the button
Seat 1: GrumpyPants44 ($8.29 in chips) 
Seat 2: Talmin84 ($9.22 in chips) 
Seat 3: CashMatteo ($22.57 in chips) 
Seat 4: kervyrx7 ($4.36 in chips) 
Seat 6: heckyeahbro ($10.31 in chips) 
kervyrx7: posts small blind $0.05
heckyeahbro: posts big blind $0.10
*** HOLE CARDS ***
Dealt to CashMatteo [Qd Kh]
GrumpyPants44: calls $0.10
Talmin84: folds 
CashMatteo: raises $0.25 to $0.35
kervyrx7: folds 
heckyeahbro: folds 
GrumpyPants44: calls $0.25
*** FLOP *** [Ks Jc 5d]
GrumpyPants44: checks 
CashMatteo: bets $0.41
GrumpyPants44: folds 
Uncalled bet ($0.41) returned to CashMatteo
CashMatteo collected $0.81 from pot
CashMatteo: doesn't show hand 
*** SUMMARY ***
Total pot $0.85 | Rake $0.04 
Board [Ks Jc 5d]
Seat 1: GrumpyPants44 folded on the Flop
Seat 2: Talmin84 folded before Flop (didn't bet)
Seat 3: CashMatteo (button) collected ($0.81)
Seat 4: kervyrx7 (small blind) folded before Flop
Seat 6: heckyeahbro (big blind) folded before Flop

Hand #1457: 

PokerStars Hand #246784796005:  Hold'em No Limit ($0.05/$0.10 CAD) - 2023/10/28 2:12:17 ET
Table 'Chow' 6-max Seat #4 is the button
Seat 1: GrumpyPants44 ($7.94 in chips) 
Seat 2: Talmin84 ($9.22 in chips) 
Seat 3: CashMatteo ($23.03 in chips) 
Seat 4: kervyrx7 ($4.31 in chips) 
Seat 6: heckyeahbro ($10.21 in chips) 
heckyeahbro: posts small blind $0.05
GrumpyPants44: posts big blind $0.10
*** HOLE CARDS ***
Dealt to CashMatteo [Ks 2c]
Talmin84: calls $0.10
CashMatteo: calls $0.10
kervyrx7: raises $0.45 to $0.55
heckyeahbro: folds 
GrumpyPants44: calls $0.45
Talmin84: calls $0.45
CashMatteo: folds 
*** FLOP *** [8c 9h 8s]
GrumpyPants44: checks 
Talmin84: bets $0.10
kervyrx7: calls $0.10
GrumpyPants44: calls $0.10
*** TURN *** [8c 9h 8s] [5c]
GrumpyPants44: checks 
Talmin84: bets $0.20
kervyrx7: folds 
GrumpyPants44: calls $0.20
*** RIVER *** [8c 9h 8s 5c] [7h]
GrumpyPants44: checks 
Talmin84: bets $0.40
GrumpyPants44: folds 
Uncalled bet ($0.40) returned to Talmin84
Talmin84 collected $2.39 from pot
*** SUMMARY ***
Total pot $2.50 | Rake $0.11 
Board [8c 9h 8s 5c 7h]
Seat 1: GrumpyPants44 (big blind) folded on the River
Seat 2: Talmin84 collected ($2.39)
Seat 3: CashMatteo folded before Flop
Seat 4: kervyrx7 (button) folded on the Turn
Seat 6: heckyeahbro (small blind) folded before Flop

Hand #1458: 

PokerStars Hand #246784802213:  Hold'em No Limit ($0.05/$0.10 CAD) - 2023/10/28 2:13:17 ET
Table 'Chow' 6-max Seat #6 is the button
Seat 1: GrumpyPants44 ($7.09 in chips) 
Seat 2: Talmin84 ($10.76 in chips) 
Seat 3: CashMatteo ($22.93 in chips) 
Seat 4: kervyrx7 ($4 in chips) 
Seat 5: Spankorama ($14.52 in chips) 
Seat 6: heckyeahbro ($10.16 in chips) 
GrumpyPants44: posts small blind $0.05
Talmin84: posts big blind $0.10
Spankorama: posts small & big blinds $0.15
*** HOLE CARDS ***
Dealt to CashMatteo [7d Qc]
CashMatteo: calls $0.10
kervyrx7: raises $0.35 to $0.45
Spankorama: calls $0.35
heckyeahbro: folds 
GrumpyPants44: folds 
Talmin84: calls $0.35
CashMatteo: calls $0.35
*** FLOP *** [2c 6c 7s]
Talmin84: bets $0.10
CashMatteo: calls $0.10
kervyrx7: calls $0.10
Spankorama: calls $0.10
*** TURN *** [2c 6c 7s] [5s]
Talmin84: bets $0.80
CashMatteo: calls $0.80
kervyrx7: calls $0.80
Spankorama: folds 
*** RIVER *** [2c 6c 7s 5s] [Ad]
Talmin84: bets $0.40
CashMatteo: calls $0.40
kervyrx7: calls $0.40
*** SHOW DOWN ***
Talmin84: shows [6h 6d] (three of a kind, Sixes)
CashMatteo: mucks hand 
kervyrx7: mucks hand 
Talmin84 collected $5.63 from pot
*** SUMMARY ***
Total pot $5.90 | Rake $0.27 
Board [2c 6c 7s 5s Ad]
Seat 1: GrumpyPants44 (small blind) folded before Flop
Seat 2: Talmin84 (big blind) showed [6h 6d] and won ($5.63) with three of a kind, Sixes
Seat 3: CashMatteo mucked [7d Qc]
Seat 4: kervyrx7 mucked [2s As]
Seat 5: Spankorama folded on the Turn
Seat 6: heckyeahbro (button) folded before Flop (didn't bet)

Hand #1459: 

PokerStars Hand #246784809051:  Hold'em No Limit ($0.05/$0.10 CAD) - 2023/10/28 2:14:24 ET
Table 'Chow' 6-max Seat #1 is the button
Seat 1: GrumpyPants44 ($7.04 in chips) 
Seat 2: Talmin84 ($14.64 in chips) 
Seat 3: CashMatteo ($21.18 in chips) 
Seat 4: kervyrx7 ($2.25 in chips) 
Seat 5: Spankorama ($13.92 in chips) 
Seat 6: heckyeahbro ($10.16 in chips) 
Talmin84: posts small blind $0.05
CashMatteo: posts big blind $0.10
*** HOLE CARDS ***
Dealt to CashMatteo [6c Ad]
kervyrx7: folds 
Spankorama: folds 
heckyeahbro: raises $0.15 to $0.25
GrumpyPants44: folds 
Talmin84: folds 
CashMatteo: calls $0.15
*** FLOP *** [Ts 3s 3d]
CashMatteo: bets $0.27
heckyeahbro: raises $0.71 to $0.98
CashMatteo: folds 
Uncalled bet ($0.71) returned to heckyeahbro
heckyeahbro collected $1.04 from pot
heckyeahbro: doesn't show hand 
*** SUMMARY ***
Total pot $1.09 | Rake $0.05 
Board [Ts 3s 3d]
Seat 1: GrumpyPants44 (button) folded before Flop (didn't bet)
Seat 2: Talmin84 (small blind) folded before Flop
Seat 3: CashMatteo (big blind) folded on the Flop
Seat 4: kervyrx7 folded before Flop (didn't bet)
Seat 5: Spankorama folded before Flop (didn't bet)
Seat 6: heckyeahbro collected ($1.04)

Hand #1460: 

PokerStars Hand #246784812141:  Hold'em No Limit ($0.05/$0.10 CAD) - 2023/10/28 2:14:54 ET
Table 'Chow' 6-max Seat #2 is the button
Seat 1: GrumpyPants44 ($7.04 in chips) 
Seat 2: Talmin84 ($14.59 in chips) 
Seat 3: CashMatteo ($20.66 in chips) 
Seat 4: kervyrx7 ($4 in chips) 
Seat 5: Spankorama ($13.92 in chips) 
Seat 6: heckyeahbro ($10.68 in chips) 
CashMatteo: posts small blind $0.05
kervyrx7: posts big blind $0.10
*** HOLE CARDS ***
Dealt to CashMatteo [6s 3s]
Spankorama: folds 
heckyeahbro: folds 
GrumpyPants44: calls $0.10
Talmin84: folds 
CashMatteo: calls $0.05
kervyrx7: checks 
*** FLOP *** [Td Jh Qh]
CashMatteo: checks 
kervyrx7: checks 
GrumpyPants44: checks 
*** TURN *** [Td Jh Qh] [3h]
CashMatteo: bets $0.15
kervyrx7: folds 
GrumpyPants44: calls $0.15
*** RIVER *** [Td Jh Qh 3h] [2c]
CashMatteo: checks 
GrumpyPants44: bets $0.10
CashMatteo: calls $0.10
*** SHOW DOWN ***
GrumpyPants44: shows [8s 8d] (a pair of Eights)
CashMatteo: mucks hand 
GrumpyPants44 collected $0.76 from pot
*** SUMMARY ***
Total pot $0.80 | Rake $0.04 
Board [Td Jh Qh 3h 2c]
Seat 1: GrumpyPants44 showed [8s 8d] and won ($0.76) with a pair of Eights
Seat 2: Talmin84 (button) folded before Flop (didn't bet)
Seat 3: CashMatteo (small blind) mucked [6s 3s]
Seat 4: kervyrx7 (big blind) folded on the Turn
Seat 5: Spankorama folded before Flop (didn't bet)
Seat 6: heckyeahbro folded before Flop (didn't bet)

Hand #1461: 

PokerStars Hand #246784816346:  Hold'em No Limit ($0.05/$0.10 CAD) - 2023/10/28 2:15:34 ET
Table 'Chow' 6-max Seat #3 is the button
Seat 1: GrumpyPants44 ($7.45 in chips) 
Seat 2: Talmin84 ($14.59 in chips) 
Seat 3: CashMatteo ($20.31 in chips) 
Seat 4: kervyrx7 ($4 in chips) 
Seat 5: Spankorama ($13.92 in chips) 
Seat 6: heckyeahbro ($10.68 in chips) 
kervyrx7: posts small blind $0.05
Spankorama: posts big blind $0.10
*** HOLE CARDS ***
Dealt to CashMatteo [4c 7c]
heckyeahbro: folds 
GrumpyPants44: calls $0.10
Talmin84: calls $0.10
CashMatteo: folds 
kervyrx7: calls $0.05
Spankorama: checks 
*** FLOP *** [Jh 3h 2h]
kervyrx7: checks 
Spankorama: checks 
GrumpyPants44: checks 
Talmin84: bets $0.19
kervyrx7: folds 
Spankorama: folds 
GrumpyPants44: calls $0.19
*** TURN *** [Jh 3h 2h] [Kc]
GrumpyPants44: checks 
Talmin84: bets $0.30
GrumpyPants44: folds 
Uncalled bet ($0.30) returned to Talmin84
Talmin84 collected $0.74 from pot
*** SUMMARY ***
Total pot $0.78 | Rake $0.04 
Board [Jh 3h 2h Kc]
Seat 1: GrumpyPants44 folded on the Turn
Seat 2: Talmin84 collected ($0.74)
Seat 3: CashMatteo (button) folded before Flop (didn't bet)
Seat 4: kervyrx7 (small blind) folded on the Flop
Seat 5: Spankorama (big blind) folded on the Flop
Seat 6: heckyeahbro folded before Flop (didn't bet)

Hand #1462: 

PokerStars Hand #246784821724:  Hold'em No Limit ($0.05/$0.10 CAD) - 2023/10/28 2:16:25 ET
Table 'Chow' 6-max Seat #4 is the button
Seat 1: GrumpyPants44 ($7.16 in chips) 
Seat 2: Talmin84 ($15.04 in chips) 
Seat 3: CashMatteo ($20.31 in chips) 
Seat 4: kervyrx7 ($4 in chips) 
Seat 5: Spankorama ($13.82 in chips) 
Seat 6: heckyeahbro ($10.68 in chips) 
Spankorama: posts small blind $0.05
heckyeahbro: posts big blind $0.10
*** HOLE CARDS ***
Dealt to CashMatteo [2c 5c]
GrumpyPants44: calls $0.10
Talmin84: folds 
CashMatteo: calls $0.10
kervyrx7: folds 
Spankorama: calls $0.05
heckyeahbro: checks 
*** FLOP *** [Ad Kc 2d]
Spankorama: checks 
heckyeahbro: checks 
GrumpyPants44: bets $0.20
CashMatteo: calls $0.20
Spankorama: folds 
heckyeahbro: calls $0.20
*** TURN *** [Ad Kc 2d] [8s]
heckyeahbro: checks 
GrumpyPants44: bets $0.10
CashMatteo: calls $0.10
heckyeahbro: calls $0.10
*** RIVER *** [Ad Kc 2d 8s] [Ks]
heckyeahbro: checks 
GrumpyPants44: bets $0.10
CashMatteo: raises $0.92 to $1.02
heckyeahbro: folds 
GrumpyPants44: calls $0.92
*** SHOW DOWN ***
CashMatteo: shows [2c 5c] (two pair, Kings and Deuces)
GrumpyPants44: shows [Jc Jd] (two pair, Kings and Jacks)
GrumpyPants44 collected $3.19 from pot
*** SUMMARY ***
Total pot $3.34 | Rake $0.15 
Board [Ad Kc 2d 8s Ks]
Seat 1: GrumpyPants44 showed [Jc Jd] and won ($3.19) with two pair, Kings and Jacks
Seat 2: Talmin84 folded before Flop (didn't bet)
Seat 3: CashMatteo showed [2c 5c] and lost with two pair, Kings and Deuces
Seat 4: kervyrx7 (button) folded before Flop (didn't bet)
Seat 5: Spankorama (small blind) folded on the Flop
Seat 6: heckyeahbro (big blind) folded on the River

Hand #1463: 

PokerStars Hand #246784829476:  Hold'em No Limit ($0.05/$0.10 CAD) - 2023/10/28 2:17:40 ET
Table 'Chow' 6-max Seat #5 is the button
Seat 1: GrumpyPants44 ($8.93 in chips) 
Seat 2: Talmin84 ($15.04 in chips) 
Seat 3: CashMatteo ($18.89 in chips) 
Seat 4: kervyrx7 ($4 in chips) 
Seat 5: Spankorama ($13.72 in chips) 
Seat 6: heckyeahbro ($10.28 in chips) 
heckyeahbro: posts small blind $0.05
GrumpyPants44: posts big blind $0.10
*** HOLE CARDS ***
Dealt to CashMatteo [2c 6d]
Talmin84: folds 
CashMatteo: folds 
CashMatteo leaves the table
kervyrx7: raises $0.15 to $0.25
Spankorama: folds 
heckyeahbro: folds 
GrumpyPants44: calls $0.15
*** FLOP *** [Jd 4s 6h]
GrumpyPants44: checks 
kervyrx7: bets $0.32
GrumpyPants44: folds 
Uncalled bet ($0.32) returned to kervyrx7
kervyrx7 collected $0.53 from pot
kervyrx7: doesn't show hand 
*** SUMMARY ***
Total pot $0.55 | Rake $0.02 
Board [Jd 4s 6h]
Seat 1: GrumpyPants44 (big blind) folded on the Flop
Seat 2: Talmin84 folded before Flop (didn't bet)
Seat 3: CashMatteo folded before Flop (didn't bet)
Seat 4: kervyrx7 collected ($0.53)
Seat 5: Spankorama (button) folded before Flop (didn't bet)
Seat 6: heckyeahbro (small blind) folded before Flop

Hand #1464: 

PokerStars Hand #246784910629:  Hold'em No Limit ($0.05/$0.10 CAD) - 2023/10/28 2:30:59 ET
Table 'Wilkens II' 6-max Seat #6 is the button
Seat 1: yobrudere ($10.23 in chips) 
Seat 2: CashMatteo ($10 in chips) 
Seat 3: tedward13 ($7.71 in chips) 
Seat 4: heckyeahbro ($27.47 in chips) 
Seat 5: kimcop ($27.82 in chips) 
Seat 6: kervyrx7 ($13.26 in chips) 
yobrudere: posts small blind $0.05
CashMatteo: posts big blind $0.10
*** HOLE CARDS ***
Dealt to CashMatteo [Qs Jh]
tedward13: folds 
heckyeahbro: folds 
kimcop: folds 
kervyrx7: raises $0.15 to $0.25
yobrudere: folds 
CashMatteo: calls $0.15
*** FLOP *** [3c Ts 7d]
CashMatteo: checks 
kervyrx7: bets $0.32
CashMatteo: folds 
Uncalled bet ($0.32) returned to kervyrx7
kervyrx7 collected $0.53 from pot
kervyrx7: doesn't show hand 
*** SUMMARY ***
Total pot $0.55 | Rake $0.02 
Board [3c Ts 7d]
Seat 1: yobrudere (small blind) folded before Flop
Seat 2: CashMatteo (big blind) folded on the Flop
Seat 3: tedward13 folded before Flop (didn't bet)
Seat 4: heckyeahbro folded before Flop (didn't bet)
Seat 5: kimcop folded before Flop (didn't bet)
Seat 6: kervyrx7 (button) collected ($0.53)

Hand #1465: 

PokerStars Hand #246784912743:  Hold'em No Limit ($0.05/$0.10 CAD) - 2023/10/28 2:31:20 ET
Table 'Wilkens II' 6-max Seat #1 is the button
Seat 1: yobrudere ($10.18 in chips) 
Seat 2: CashMatteo ($9.75 in chips) 
Seat 3: tedward13 ($7.71 in chips) 
Seat 4: heckyeahbro ($27.47 in chips) 
Seat 5: kimcop ($27.82 in chips) 
Seat 6: kervyrx7 ($13.54 in chips) 
CashMatteo: posts small blind $0.05
tedward13: posts big blind $0.10
*** HOLE CARDS ***
Dealt to CashMatteo [5h 8c]
heckyeahbro: folds 
kimcop: calls $0.10
kervyrx7: folds 
yobrudere: folds 
CashMatteo: folds 
tedward13: checks 
*** FLOP *** [Qc 8d 8h]
tedward13: checks 
kimcop: bets $0.20
tedward13: folds 
Uncalled bet ($0.20) returned to kimcop
kimcop collected $0.24 from pot
*** SUMMARY ***
Total pot $0.25 | Rake $0.01 
Board [Qc 8d 8h]
Seat 1: yobrudere (button) folded before Flop (didn't bet)
Seat 2: CashMatteo (small blind) folded before Flop
Seat 3: tedward13 (big blind) folded on the Flop
Seat 4: heckyeahbro folded before Flop (didn't bet)
Seat 5: kimcop collected ($0.24)
Seat 6: kervyrx7 folded before Flop (didn't bet)

Hand #1466: 

PokerStars Hand #246784915501:  Hold'em No Limit ($0.05/$0.10 CAD) - 2023/10/28 2:31:46 ET
Table 'Wilkens II' 6-max Seat #2 is the button
Seat 1: yobrudere ($10.18 in chips) 
Seat 2: CashMatteo ($9.70 in chips) 
Seat 3: tedward13 ($7.61 in chips) 
Seat 4: heckyeahbro ($27.47 in chips) 
Seat 5: kimcop ($27.96 in chips) 
Seat 6: kervyrx7 ($13.54 in chips) 
tedward13: posts small blind $0.05
heckyeahbro: posts big blind $0.10
*** HOLE CARDS ***
Dealt to CashMatteo [Tc 3c]
kimcop: folds 
kervyrx7: folds 
yobrudere: folds 
CashMatteo: calls $0.10
tedward13: calls $0.05
heckyeahbro: checks 
*** FLOP *** [5s Qc 2c]
tedward13: checks 
heckyeahbro: checks 
CashMatteo: checks 
*** TURN *** [5s Qc 2c] [7s]
tedward13: bets $0.10
heckyeahbro: folds 
CashMatteo: calls $0.10
*** RIVER *** [5s Qc 2c 7s] [8c]
tedward13: bets $0.20
CashMatteo: raises $0.78 to $0.98
tedward13: folds 
Uncalled bet ($0.78) returned to CashMatteo
CashMatteo collected $0.86 from pot
CashMatteo: doesn't show hand 
*** SUMMARY ***
Total pot $0.90 | Rake $0.04 
Board [5s Qc 2c 7s 8c]
Seat 1: yobrudere folded before Flop (didn't bet)
Seat 2: CashMatteo (button) collected ($0.86)
Seat 3: tedward13 (small blind) folded on the River
Seat 4: heckyeahbro (big blind) folded on the Turn
Seat 5: kimcop folded before Flop (didn't bet)
Seat 6: kervyrx7 folded before Flop (didn't bet)

Hand #1467: 

PokerStars Hand #246784921143:  Hold'em No Limit ($0.05/$0.10 CAD) - 2023/10/28 2:32:41 ET
Table 'Wilkens II' 6-max Seat #3 is the button
Seat 1: yobrudere ($10.18 in chips) 
Seat 2: CashMatteo ($10.16 in chips) 
Seat 3: tedward13 ($7.21 in chips) 
Seat 4: heckyeahbro ($27.37 in chips) 
Seat 5: kimcop ($27.96 in chips) 
Seat 6: kervyrx7 ($13.54 in chips) 
heckyeahbro: posts small blind $0.05
kimcop: posts big blind $0.10
*** HOLE CARDS ***
Dealt to CashMatteo [Js 5h]
kervyrx7: folds 
yobrudere: folds 
CashMatteo: calls $0.10
tedward13: folds 
heckyeahbro: folds 
kimcop: checks 
*** FLOP *** [Kc 9h 4s]
kimcop: bets $0.20
CashMatteo: folds 
Uncalled bet ($0.20) returned to kimcop
kimcop collected $0.24 from pot
*** SUMMARY ***
Total pot $0.25 | Rake $0.01 
Board [Kc 9h 4s]
Seat 1: yobrudere folded before Flop (didn't bet)
Seat 2: CashMatteo folded on the Flop
Seat 3: tedward13 (button) folded before Flop (didn't bet)
Seat 4: heckyeahbro (small blind) folded before Flop
Seat 5: kimcop (big blind) collected ($0.24)
Seat 6: kervyrx7 folded before Flop (didn't bet)

Hand #1468: 

PokerStars Hand #246784923693:  Hold'em No Limit ($0.05/$0.10 CAD) - 2023/10/28 2:33:05 ET
Table 'Wilkens II' 6-max Seat #4 is the button
Seat 1: yobrudere ($10.18 in chips) 
Seat 2: CashMatteo ($10.06 in chips) 
Seat 3: tedward13 ($7.21 in chips) 
Seat 4: heckyeahbro ($27.32 in chips) 
Seat 5: kimcop ($28.10 in chips) 
Seat 6: kervyrx7 ($13.54 in chips) 
kimcop: posts small blind $0.05
kervyrx7: posts big blind $0.10
*** HOLE CARDS ***
Dealt to CashMatteo [Kd 4h]
yobrudere: raises $0.10 to $0.20
CashMatteo: calls $0.20
tedward13: folds 
heckyeahbro: folds 
kimcop: folds 
kervyrx7: calls $0.10
*** FLOP *** [2s 6s 2d]
kervyrx7: checks 
yobrudere: bets $0.31
CashMatteo: folds 
kervyrx7: folds 
Uncalled bet ($0.31) returned to yobrudere
yobrudere collected $0.62 from pot
yobrudere: doesn't show hand 
*** SUMMARY ***
Total pot $0.65 | Rake $0.03 
Board [2s 6s 2d]
Seat 1: yobrudere collected ($0.62)
Seat 2: CashMatteo folded on the Flop
Seat 3: tedward13 folded before Flop (didn't bet)
Seat 4: heckyeahbro (button) folded before Flop (didn't bet)
Seat 5: kimcop (small blind) folded before Flop
Seat 6: kervyrx7 (big blind) folded on the Flop

Hand #1469: 

PokerStars Hand #246784928843:  Hold'em No Limit ($0.05/$0.10 CAD) - 2023/10/28 2:33:54 ET
Table 'Wilkens II' 6-max Seat #5 is the button
Seat 1: yobrudere ($10.60 in chips) 
Seat 2: CashMatteo ($9.86 in chips) 
Seat 3: tedward13 ($7.21 in chips) 
Seat 4: heckyeahbro ($27.32 in chips) 
Seat 5: kimcop ($28.05 in chips) 
Seat 6: kervyrx7 ($13.34 in chips) 
kervyrx7: posts small blind $0.05
yobrudere: posts big blind $0.10
*** HOLE CARDS ***
Dealt to CashMatteo [Jh 9d]
CashMatteo: raises $0.15 to $0.25
tedward13: folds 
heckyeahbro: folds 
kimcop: folds 
kervyrx7: raises $0.70 to $0.95
yobrudere: folds 
CashMatteo: calls $0.70
*** FLOP *** [6c 9c Jc]
kervyrx7: bets $0.63
CashMatteo: raises $3.17 to $3.80
kervyrx7: folds 
Uncalled bet ($3.17) returned to CashMatteo
CashMatteo collected $3.11 from pot
CashMatteo: doesn't show hand 
*** SUMMARY ***
Total pot $3.26 | Rake $0.15 
Board [6c 9c Jc]
Seat 1: yobrudere (big blind) folded before Flop
Seat 2: CashMatteo collected ($3.11)
Seat 3: tedward13 folded before Flop (didn't bet)
Seat 4: heckyeahbro folded before Flop (didn't bet)
Seat 5: kimcop (button) folded before Flop (didn't bet)
Seat 6: kervyrx7 (small blind) folded on the Flop

Hand #1470: 

PokerStars Hand #246784933722:  Hold'em No Limit ($0.05/$0.10 CAD) - 2023/10/28 2:34:40 ET
Table 'Wilkens II' 6-max Seat #6 is the button
Seat 1: yobrudere ($10.50 in chips) 
Seat 2: CashMatteo ($11.39 in chips) 
Seat 3: tedward13 ($7.21 in chips) 
Seat 4: heckyeahbro ($27.32 in chips) 
Seat 5: kimcop ($28.05 in chips) 
Seat 6: kervyrx7 ($11.76 in chips) 
yobrudere: posts small blind $0.05
CashMatteo: posts big blind $0.10
*** HOLE CARDS ***
Dealt to CashMatteo [9h Kh]
tedward13: folds 
heckyeahbro: folds 
kimcop: folds 
kervyrx7: folds 
yobrudere: folds 
Uncalled bet ($0.05) returned to CashMatteo
CashMatteo collected $0.10 from pot
CashMatteo: doesn't show hand 
*** SUMMARY ***
Total pot $0.10 | Rake $0 
Seat 1: yobrudere (small blind) folded before Flop
Seat 2: CashMatteo (big blind) collected ($0.10)
Seat 3: tedward13 folded before Flop (didn't bet)
Seat 4: heckyeahbro folded before Flop (didn't bet)
Seat 5: kimcop folded before Flop (didn't bet)
Seat 6: kervyrx7 (button) folded before Flop (didn't bet)

Hand #1471: 

PokerStars Hand #246784934884:  Hold'em No Limit ($0.05/$0.10 CAD) - 2023/10/28 2:34:51 ET
Table 'Wilkens II' 6-max Seat #1 is the button
Seat 1: yobrudere ($10.45 in chips) 
Seat 2: CashMatteo ($11.44 in chips) 
Seat 3: tedward13 ($7.21 in chips) 
Seat 4: heckyeahbro ($27.32 in chips) 
Seat 5: kimcop ($28.05 in chips) 
Seat 6: kervyrx7 ($11.76 in chips) 
CashMatteo: posts small blind $0.05
tedward13: posts big blind $0.10
*** HOLE CARDS ***
Dealt to CashMatteo [9d Ks]
heckyeahbro: raises $0.15 to $0.25
kimcop: folds 
kervyrx7: folds 
yobrudere: calls $0.25
CashMatteo: calls $0.20
tedward13: calls $0.15
*** FLOP *** [3c 8d Qs]
CashMatteo: checks 
tedward13: checks 
heckyeahbro: bets $0.77
yobrudere: calls $0.77
CashMatteo: folds 
tedward13: folds 
*** TURN *** [3c 8d Qs] [Jd]
heckyeahbro: checks 
yobrudere: bets $1.82
heckyeahbro: calls $1.82
*** RIVER *** [3c 8d Qs Jd] [9s]
heckyeahbro: checks 
yobrudere: bets $2.95
heckyeahbro: calls $2.95
*** SHOW DOWN ***
yobrudere: shows [Kd Qh] (a pair of Queens)
heckyeahbro: shows [Qd Qc] (three of a kind, Queens)
heckyeahbro collected $11.54 from pot
*** SUMMARY ***
Total pot $12.08 | Rake $0.54 
Board [3c 8d Qs Jd 9s]
Seat 1: yobrudere (button) showed [Kd Qh] and lost with a pair of Queens
Seat 2: CashMatteo (small blind) folded on the Flop
Seat 3: tedward13 (big blind) folded on the Flop
Seat 4: heckyeahbro showed [Qd Qc] and won ($11.54) with three of a kind, Queens
Seat 5: kimcop folded before Flop (didn't bet)
Seat 6: kervyrx7 folded before Flop (didn't bet)

Hand #1472: 

PokerStars Hand #246784940073:  Hold'em No Limit ($0.05/$0.10 CAD) - 2023/10/28 2:35:41 ET
Table 'Wilkens II' 6-max Seat #2 is the button
Seat 1: yobrudere ($4.66 in chips) 
Seat 2: CashMatteo ($11.19 in chips) 
Seat 3: tedward13 ($6.96 in chips) 
Seat 4: heckyeahbro ($33.07 in chips) 
Seat 5: kimcop ($28.05 in chips) 
Seat 6: kervyrx7 ($11.76 in chips) 
tedward13: posts small blind $0.05
heckyeahbro: posts big blind $0.10
*** HOLE CARDS ***
Dealt to CashMatteo [8s Ah]
kimcop: calls $0.10
kervyrx7: folds 
yobrudere: folds 
CashMatteo: raises $0.15 to $0.25
tedward13: folds 
heckyeahbro: folds 
kimcop: calls $0.15
*** FLOP *** [6h Jh Kc]
kimcop: checks 
CashMatteo: checks 
*** TURN *** [6h Jh Kc] [3d]
kimcop: bets $0.20
CashMatteo: folds 
Uncalled bet ($0.20) returned to kimcop
kimcop collected $0.62 from pot
*** SUMMARY ***
Total pot $0.65 | Rake $0.03 
Board [6h Jh Kc 3d]
Seat 1: yobrudere folded before Flop (didn't bet)
Seat 2: CashMatteo (button) folded on the Turn
Seat 3: tedward13 (small blind) folded before Flop
Seat 4: heckyeahbro (big blind) folded before Flop
Seat 5: kimcop collected ($0.62)
Seat 6: kervyrx7 folded before Flop (didn't bet)

Hand #1473: 

PokerStars Hand #246784943867:  Hold'em No Limit ($0.05/$0.10 CAD) - 2023/10/28 2:36:18 ET
Table 'Wilkens II' 6-max Seat #3 is the button
Seat 1: yobrudere ($10 in chips) 
Seat 2: CashMatteo ($10.94 in chips) 
Seat 3: tedward13 ($6.91 in chips) 
Seat 4: heckyeahbro ($32.97 in chips) 
Seat 6: kervyrx7 ($11.76 in chips) 
heckyeahbro: posts small blind $0.05
kimcop: is sitting out 
kervyrx7: posts big blind $0.10
*** HOLE CARDS ***
Dealt to CashMatteo [2h Jh]
yobrudere: folds 
CashMatteo: raises $0.15 to $0.25
tedward13: folds 
heckyeahbro: folds 
kervyrx7: folds 
Uncalled bet ($0.15) returned to CashMatteo
CashMatteo collected $0.25 from pot
CashMatteo: doesn't show hand 
*** SUMMARY ***
Total pot $0.25 | Rake $0 
Seat 1: yobrudere folded before Flop (didn't bet)
Seat 2: CashMatteo collected ($0.25)
Seat 3: tedward13 (button) folded before Flop (didn't bet)
Seat 4: heckyeahbro (small blind) folded before Flop
Seat 6: kervyrx7 (big blind) folded before Flop

Hand #1474: 

PokerStars Hand #246784945781:  Hold'em No Limit ($0.05/$0.10 CAD) - 2023/10/28 2:36:36 ET
Table 'Wilkens II' 6-max Seat #4 is the button
Seat 1: yobrudere ($10 in chips) 
Seat 2: CashMatteo ($11.09 in chips) 
Seat 3: tedward13 ($6.91 in chips) 
Seat 4: heckyeahbro ($32.92 in chips) 
Seat 6: kervyrx7 ($11.66 in chips) 
kervyrx7: posts small blind $0.05
yobrudere: posts big blind $0.10
*** HOLE CARDS ***
Dealt to CashMatteo [5h 8h]
CashMatteo: calls $0.10
tedward13: calls $0.10
heckyeahbro: folds 
kervyrx7: folds 
yobrudere: checks 
*** FLOP *** [Ah 5d 6s]
yobrudere: checks 
CashMatteo: checks 
tedward13: checks 
*** TURN *** [Ah 5d 6s] [Qd]
yobrudere: checks 
CashMatteo: checks 
tedward13: checks 
*** RIVER *** [Ah 5d 6s Qd] [4d]
yobrudere: checks 
CashMatteo: checks 
tedward13: checks 
*** SHOW DOWN ***
yobrudere: shows [8s Js] (high card Ace)
CashMatteo: shows [5h 8h] (a pair of Fives)
tedward13: mucks hand 
CashMatteo collected $0.33 from pot
*** SUMMARY ***
Total pot $0.35 | Rake $0.02 
Board [Ah 5d 6s Qd 4d]
Seat 1: yobrudere (big blind) showed [8s Js] and lost with high card Ace
Seat 2: CashMatteo showed [5h 8h] and won ($0.33) with a pair of Fives
Seat 3: tedward13 mucked [Ts 9s]
Seat 4: heckyeahbro (button) folded before Flop (didn't bet)
Seat 6: kervyrx7 (small blind) folded before Flop

Hand #1475: 

PokerStars Hand #246784949774:  Hold'em No Limit ($0.05/$0.10 CAD) - 2023/10/28 2:37:13 ET
Table 'Wilkens II' 6-max Seat #6 is the button
Seat 1: yobrudere ($9.90 in chips) 
Seat 2: CashMatteo ($11.32 in chips) 
Seat 3: tedward13 ($6.81 in chips) 
Seat 4: heckyeahbro ($32.92 in chips) 
Seat 6: kervyrx7 ($11.61 in chips) 
yobrudere: posts small blind $0.05
CashMatteo: posts big blind $0.10
*** HOLE CARDS ***
Dealt to CashMatteo [9s 9c]
tedward13: folds 
heckyeahbro: folds 
kervyrx7: folds 
yobrudere: folds 
Uncalled bet ($0.05) returned to CashMatteo
CashMatteo collected $0.10 from pot
CashMatteo: doesn't show hand 
*** SUMMARY ***
Total pot $0.10 | Rake $0 
Seat 1: yobrudere (small blind) folded before Flop
Seat 2: CashMatteo (big blind) collected ($0.10)
Seat 3: tedward13 folded before Flop (didn't bet)
Seat 4: heckyeahbro folded before Flop (didn't bet)
Seat 6: kervyrx7 (button) folded before Flop (didn't bet)

Hand #1476: 

PokerStars Hand #246784951235:  Hold'em No Limit ($0.05/$0.10 CAD) - 2023/10/28 2:37:27 ET
Table 'Wilkens II' 6-max Seat #1 is the button
Seat 1: yobrudere ($9.85 in chips) 
Seat 2: CashMatteo ($11.37 in chips) 
Seat 3: tedward13 ($6.81 in chips) 
Seat 4: heckyeahbro ($32.92 in chips) 
Seat 6: kervyrx7 ($11.61 in chips) 
CashMatteo: posts small blind $0.05
tedward13: posts big blind $0.10
*** HOLE CARDS ***
Dealt to CashMatteo [7d Ts]
heckyeahbro: folds 
kervyrx7: folds 
yobrudere: folds 
CashMatteo: calls $0.05
tedward13: checks 
*** FLOP *** [5h 3c Tc]
CashMatteo: checks 
tedward13: checks 
*** TURN *** [5h 3c Tc] [Qc]
CashMatteo: checks 
tedward13: bets $0.10
CashMatteo: calls $0.10
*** RIVER *** [5h 3c Tc Qc] [Jh]
CashMatteo: checks 
tedward13: bets $0.20
CashMatteo: folds 
Uncalled bet ($0.20) returned to tedward13
tedward13 collected $0.38 from pot
*** SUMMARY ***
Total pot $0.40 | Rake $0.02 
Board [5h 3c Tc Qc Jh]
Seat 1: yobrudere (button) folded before Flop (didn't bet)
Seat 2: CashMatteo (small blind) folded on the River
Seat 3: tedward13 (big blind) collected ($0.38)
Seat 4: heckyeahbro folded before Flop (didn't bet)
Seat 6: kervyrx7 folded before Flop (didn't bet)

Hand #1477: 

PokerStars Hand #246784956552:  Hold'em No Limit ($0.05/$0.10 CAD) - 2023/10/28 2:38:18 ET
Table 'Wilkens II' 6-max Seat #2 is the button
Seat 1: yobrudere ($9.85 in chips) 
Seat 2: CashMatteo ($11.17 in chips) 
Seat 3: tedward13 ($6.99 in chips) 
Seat 4: heckyeahbro ($32.92 in chips) 
Seat 6: kervyrx7 ($11.61 in chips) 
tedward13: posts small blind $0.05
heckyeahbro: posts big blind $0.10
*** HOLE CARDS ***
Dealt to CashMatteo [Js 5h]
kervyrx7: raises $0.15 to $0.25
yobrudere: folds 
CashMatteo: folds 
tedward13: folds 
heckyeahbro: folds 
Uncalled bet ($0.15) returned to kervyrx7
kervyrx7 collected $0.25 from pot
kervyrx7: doesn't show hand 
*** SUMMARY ***
Total pot $0.25 | Rake $0 
Seat 1: yobrudere folded before Flop (didn't bet)
Seat 2: CashMatteo (button) folded before Flop (didn't bet)
Seat 3: tedward13 (small blind) folded before Flop
Seat 4: heckyeahbro (big blind) folded before Flop
Seat 6: kervyrx7 collected ($0.25)

Hand #1478: 

PokerStars Hand #246784958648:  Hold'em No Limit ($0.05/$0.10 CAD) - 2023/10/28 2:38:37 ET
Table 'Wilkens II' 6-max Seat #3 is the button
Seat 1: yobrudere ($9.85 in chips) 
Seat 2: CashMatteo ($11.17 in chips) 
Seat 3: tedward13 ($6.94 in chips) 
Seat 4: heckyeahbro ($32.82 in chips) 
Seat 6: kervyrx7 ($11.76 in chips) 
heckyeahbro: posts small blind $0.05
kervyrx7: posts big blind $0.10
*** HOLE CARDS ***
Dealt to CashMatteo [3d 9h]
yobrudere: folds 
CashMatteo: folds 
tedward13: folds 
heckyeahbro: raises $0.20 to $0.30
kervyrx7: calls $0.20
*** FLOP *** [Ks Td Ad]
heckyeahbro: checks 
kervyrx7: bets $0.19
heckyeahbro: calls $0.19
*** TURN *** [Ks Td Ad] [Qd]
heckyeahbro: checks 
kervyrx7: checks 
*** RIVER *** [Ks Td Ad Qd] [Qh]
heckyeahbro: checks 
kervyrx7: bets $0.31
heckyeahbro: calls $0.31
*** SHOW DOWN ***
kervyrx7: shows [Qs 6h] (three of a kind, Queens)
heckyeahbro: mucks hand 
kervyrx7 collected $1.53 from pot
*** SUMMARY ***
Total pot $1.60 | Rake $0.07 
Board [Ks Td Ad Qd Qh]
Seat 1: yobrudere folded before Flop (didn't bet)
Seat 2: CashMatteo folded before Flop (didn't bet)
Seat 3: tedward13 (button) folded before Flop (didn't bet)
Seat 4: heckyeahbro (small blind) mucked [Ah 2s]
Seat 6: kervyrx7 (big blind) showed [Qs 6h] and won ($1.53) with three of a kind, Queens

Hand #1479: 

PokerStars Hand #246784963076:  Hold'em No Limit ($0.05/$0.10 CAD) - 2023/10/28 2:39:20 ET
Table 'Wilkens II' 6-max Seat #4 is the button
Seat 1: yobrudere ($9.85 in chips) 
Seat 2: CashMatteo ($11.17 in chips) 
Seat 3: tedward13 ($6.94 in chips) 
Seat 4: heckyeahbro ($32.02 in chips) 
Seat 6: kervyrx7 ($12.49 in chips) 
kervyrx7: posts small blind $0.05
yobrudere: posts big blind $0.10
*** HOLE CARDS ***
Dealt to CashMatteo [4c 7c]
CashMatteo: calls $0.10
tedward13: folds 
heckyeahbro: folds 
kervyrx7: raises $0.35 to $0.45
yobrudere: folds 
CashMatteo: calls $0.35
*** FLOP *** [9h Qs Tc]
kervyrx7: bets $0.58
CashMatteo: folds 
Uncalled bet ($0.58) returned to kervyrx7
kervyrx7 collected $0.96 from pot
kervyrx7: doesn't show hand 
*** SUMMARY ***
Total pot $1 | Rake $0.04 
Board [9h Qs Tc]
Seat 1: yobrudere (big blind) folded before Flop
Seat 2: CashMatteo folded on the Flop
Seat 3: tedward13 folded before Flop (didn't bet)
Seat 4: heckyeahbro (button) folded before Flop (didn't bet)
Seat 6: kervyrx7 (small blind) collected ($0.96)

Hand #1480: 

PokerStars Hand #246784965507:  Hold'em No Limit ($0.05/$0.10 CAD) - 2023/10/28 2:39:43 ET
Table 'Wilkens II' 6-max Seat #6 is the button
Seat 1: yobrudere ($9.75 in chips) 
Seat 2: CashMatteo ($10.72 in chips) 
Seat 3: tedward13 ($6.94 in chips) 
Seat 4: heckyeahbro ($32.02 in chips) 
Seat 6: kervyrx7 ($13 in chips) 
yobrudere: posts small blind $0.05
CashMatteo: posts big blind $0.10
*** HOLE CARDS ***
Dealt to CashMatteo [Td 9h]
tedward13: folds 
heckyeahbro: folds 
kervyrx7: raises $0.15 to $0.25
yobrudere: folds 
CashMatteo: calls $0.15
*** FLOP *** [Js Kd 4c]
CashMatteo: checks 
kervyrx7: bets $0.17
CashMatteo: calls $0.17
*** TURN *** [Js Kd 4c] [7s]
CashMatteo: checks 
kervyrx7: bets $0.51
CashMatteo: calls $0.51
*** RIVER *** [Js Kd 4c 7s] [6s]
CashMatteo: checks 
kervyrx7: bets $1.55
CashMatteo: folds 
Uncalled bet ($1.55) returned to kervyrx7
kervyrx7 collected $1.82 from pot
kervyrx7: doesn't show hand 
*** SUMMARY ***
Total pot $1.91 | Rake $0.09 
Board [Js Kd 4c 7s 6s]
Seat 1: yobrudere (small blind) folded before Flop
Seat 2: CashMatteo (big blind) folded on the River
Seat 3: tedward13 folded before Flop (didn't bet)
Seat 4: heckyeahbro folded before Flop (didn't bet)
Seat 6: kervyrx7 (button) collected ($1.82)

Hand #1481: 

PokerStars Hand #246784970238:  Hold'em No Limit ($0.05/$0.10 CAD) - 2023/10/28 2:40:29 ET
Table 'Wilkens II' 6-max Seat #1 is the button
Seat 1: yobrudere ($9.70 in chips) 
Seat 2: CashMatteo ($9.79 in chips) 
Seat 3: tedward13 ($6.94 in chips) 
Seat 4: heckyeahbro ($32.02 in chips) 
Seat 6: kervyrx7 ($13.89 in chips) 
CashMatteo: posts small blind $0.05
tedward13: posts big blind $0.10
*** HOLE CARDS ***
Dealt to CashMatteo [9h 5c]
heckyeahbro: folds 
kervyrx7: raises $0.15 to $0.25
yobrudere: calls $0.25
CashMatteo: folds 
tedward13: calls $0.15
*** FLOP *** [8d 6h 8s]
tedward13: checks 
kervyrx7: checks 
yobrudere: bets $0.38
tedward13: calls $0.38
kervyrx7: folds 
*** TURN *** [8d 6h 8s] [2c]
tedward13: checks 
yobrudere: checks 
*** RIVER *** [8d 6h 8s 2c] [6d]
tedward13: bets $0.75
yobrudere: calls $0.75
*** SHOW DOWN ***
tedward13: shows [Th 8c] (a full house, Eights full of Sixes)
yobrudere: mucks hand 
tedward13 collected $2.92 from pot
*** SUMMARY ***
Total pot $3.06 | Rake $0.14 
Board [8d 6h 8s 2c 6d]
Seat 1: yobrudere (button) mucked [Ad 2d]
Seat 2: CashMatteo (small blind) folded before Flop
Seat 3: tedward13 (big blind) showed [Th 8c] and won ($2.92) with a full house, Eights full of Sixes
Seat 4: heckyeahbro folded before Flop (didn't bet)
Seat 6: kervyrx7 folded on the Flop

Hand #1482: 

PokerStars Hand #246784975679:  Hold'em No Limit ($0.05/$0.10 CAD) - 2023/10/28 2:41:23 ET
Table 'Wilkens II' 6-max Seat #2 is the button
Seat 1: yobrudere ($8.32 in chips) 
Seat 2: CashMatteo ($9.74 in chips) 
Seat 3: tedward13 ($8.48 in chips) 
Seat 4: heckyeahbro ($32.02 in chips) 
Seat 6: kervyrx7 ($13.64 in chips) 
tedward13: posts small blind $0.05
heckyeahbro: posts big blind $0.10
*** HOLE CARDS ***
Dealt to CashMatteo [Jc 5s]
kervyrx7: folds 
yobrudere: folds 
CashMatteo: folds 
tedward13: raises $0.10 to $0.20
heckyeahbro: calls $0.10
*** FLOP *** [3s As Ac]
tedward13: checks 
heckyeahbro: checks 
*** TURN *** [3s As Ac] [9d]
tedward13: checks 
heckyeahbro: checks 
*** RIVER *** [3s As Ac 9d] [6h]
tedward13: checks 
heckyeahbro: checks 
*** SHOW DOWN ***
tedward13: shows [Kc 8s] (a pair of Aces)
heckyeahbro: mucks hand 
tedward13 collected $0.38 from pot
*** SUMMARY ***
Total pot $0.40 | Rake $0.02 
Board [3s As Ac 9d 6h]
Seat 1: yobrudere folded before Flop (didn't bet)
Seat 2: CashMatteo (button) folded before Flop (didn't bet)
Seat 3: tedward13 (small blind) showed [Kc 8s] and won ($0.38) with a pair of Aces
Seat 4: heckyeahbro (big blind) mucked [Kd 4d]
Seat 6: kervyrx7 folded before Flop (didn't bet)

Hand #1483: 

PokerStars Hand #246784980587:  Hold'em No Limit ($0.05/$0.10 CAD) - 2023/10/28 2:42:10 ET
Table 'Wilkens II' 6-max Seat #3 is the button
Seat 1: yobrudere ($10 in chips) 
Seat 2: CashMatteo ($9.74 in chips) 
Seat 3: tedward13 ($8.66 in chips) 
Seat 4: heckyeahbro ($31.82 in chips) 
Seat 6: kervyrx7 ($13.64 in chips) 
heckyeahbro: posts small blind $0.05
kervyrx7: posts big blind $0.10
*** HOLE CARDS ***
Dealt to CashMatteo [9d 3h]
yobrudere: folds 
CashMatteo: folds 
tedward13: raises $0.10 to $0.20
heckyeahbro: raises $0.80 to $1
kervyrx7: folds 
tedward13: folds 
Uncalled bet ($0.80) returned to heckyeahbro
heckyeahbro collected $0.50 from pot
heckyeahbro: doesn't show hand 
*** SUMMARY ***
Total pot $0.50 | Rake $0 
Seat 1: yobrudere folded before Flop (didn't bet)
Seat 2: CashMatteo folded before Flop (didn't bet)
Seat 3: tedward13 (button) folded before Flop
Seat 4: heckyeahbro (small blind) collected ($0.50)
Seat 6: kervyrx7 (big blind) folded before Flop

Hand #1484: 

PokerStars Hand #246784982869:  Hold'em No Limit ($0.05/$0.10 CAD) - 2023/10/28 2:42:32 ET
Table 'Wilkens II' 6-max Seat #4 is the button
Seat 1: yobrudere ($10 in chips) 
Seat 2: CashMatteo ($9.74 in chips) 
Seat 3: tedward13 ($8.46 in chips) 
Seat 4: heckyeahbro ($32.12 in chips) 
Seat 6: kervyrx7 ($13.54 in chips) 
kervyrx7: posts small blind $0.05
yobrudere: posts big blind $0.10
*** HOLE CARDS ***
Dealt to CashMatteo [2c 3h]
CashMatteo: folds 
tedward13: folds 
heckyeahbro: raises $0.15 to $0.25
kervyrx7: folds 
yobrudere: folds 
Uncalled bet ($0.15) returned to heckyeahbro
heckyeahbro collected $0.25 from pot
heckyeahbro: doesn't show hand 
*** SUMMARY ***
Total pot $0.25 | Rake $0 
Seat 1: yobrudere (big blind) folded before Flop
Seat 2: CashMatteo folded before Flop (didn't bet)
Seat 3: tedward13 folded before Flop (didn't bet)
Seat 4: heckyeahbro (button) collected ($0.25)
Seat 6: kervyrx7 (small blind) folded before Flop

Hand #1485: 

PokerStars Hand #246784984892:  Hold'em No Limit ($0.05/$0.10 CAD) - 2023/10/28 2:42:52 ET
Table 'Wilkens II' 6-max Seat #6 is the button
Seat 1: yobrudere ($9.90 in chips) 
Seat 2: CashMatteo ($9.74 in chips) 
Seat 3: tedward13 ($8.46 in chips) 
Seat 4: heckyeahbro ($32.27 in chips) 
Seat 6: kervyrx7 ($13.49 in chips) 
yobrudere: posts small blind $0.05
CashMatteo: posts big blind $0.10
*** HOLE CARDS ***
Dealt to CashMatteo [Tc Qs]
tedward13: folds 
heckyeahbro: raises $0.15 to $0.25
kervyrx7: folds 
yobrudere: folds 
CashMatteo: calls $0.15
*** FLOP *** [6d Jh 6c]
CashMatteo: checks 
heckyeahbro: bets $0.35
CashMatteo: folds 
Uncalled bet ($0.35) returned to heckyeahbro
heckyeahbro collected $0.53 from pot
heckyeahbro: doesn't show hand 
*** SUMMARY ***
Total pot $0.55 | Rake $0.02 
Board [6d Jh 6c]
Seat 1: yobrudere (small blind) folded before Flop
Seat 2: CashMatteo (big blind) folded on the Flop
Seat 3: tedward13 folded before Flop (didn't bet)
Seat 4: heckyeahbro collected ($0.53)
Seat 6: kervyrx7 (button) folded before Flop (didn't bet)

Hand #1486: 

PokerStars Hand #246784987291:  Hold'em No Limit ($0.05/$0.10 CAD) - 2023/10/28 2:43:15 ET
Table 'Wilkens II' 6-max Seat #1 is the button
Seat 1: yobrudere ($9.85 in chips) 
Seat 2: CashMatteo ($9.49 in chips) 
Seat 3: tedward13 ($8.46 in chips) 
Seat 4: heckyeahbro ($32.55 in chips) 
Seat 6: kervyrx7 ($13.49 in chips) 
CashMatteo: posts small blind $0.05
tedward13: posts big blind $0.10
*** HOLE CARDS ***
Dealt to CashMatteo [Qh 2c]
heckyeahbro: folds 
kervyrx7: folds 
yobrudere: raises $0.10 to $0.20
CashMatteo: folds 
tedward13: calls $0.10
*** FLOP *** [Ac 6c 5c]
tedward13: checks 
yobrudere: bets $0.22
tedward13: calls $0.22
*** TURN *** [Ac 6c 5c] [Ks]
tedward13: checks 
yobrudere: bets $0.43
tedward13: calls $0.43
*** RIVER *** [Ac 6c 5c Ks] [8h]
tedward13: checks 
yobrudere: bets $0.55
tedward13: folds 
Uncalled bet ($0.55) returned to yobrudere
yobrudere collected $1.67 from pot
yobrudere: doesn't show hand 
*** SUMMARY ***
Total pot $1.75 | Rake $0.08 
Board [Ac 6c 5c Ks 8h]
Seat 1: yobrudere (button) collected ($1.67)
Seat 2: CashMatteo (small blind) folded before Flop
Seat 3: tedward13 (big blind) folded on the River
Seat 4: heckyeahbro folded before Flop (didn't bet)
Seat 6: kervyrx7 folded before Flop (didn't bet)

Hand #1487: 

PokerStars Hand #246784991289:  Hold'em No Limit ($0.05/$0.10 CAD) - 2023/10/28 2:43:54 ET
Table 'Wilkens II' 6-max Seat #2 is the button
Seat 1: yobrudere ($10.67 in chips) 
Seat 2: CashMatteo ($9.44 in chips) 
Seat 3: tedward13 ($7.61 in chips) 
Seat 4: heckyeahbro ($32.55 in chips) 
Seat 6: kervyrx7 ($13.49 in chips) 
tedward13: posts small blind $0.05
heckyeahbro: posts big blind $0.10
*** HOLE CARDS ***
Dealt to CashMatteo [2c 6h]
kervyrx7: raises $0.15 to $0.25
yobrudere: folds 
CashMatteo: folds 
tedward13: folds 
heckyeahbro: folds 
Uncalled bet ($0.15) returned to kervyrx7
kervyrx7 collected $0.25 from pot
kervyrx7: doesn't show hand 
*** SUMMARY ***
Total pot $0.25 | Rake $0 
Seat 1: yobrudere folded before Flop (didn't bet)
Seat 2: CashMatteo (button) folded before Flop (didn't bet)
Seat 3: tedward13 (small blind) folded before Flop
Seat 4: heckyeahbro (big blind) folded before Flop
Seat 6: kervyrx7 collected ($0.25)

Hand #1488: 

PokerStars Hand #246784992616:  Hold'em No Limit ($0.05/$0.10 CAD) - 2023/10/28 2:44:07 ET
Table 'Wilkens II' 6-max Seat #3 is the button
Seat 1: yobrudere ($10.67 in chips) 
Seat 2: CashMatteo ($9.44 in chips) 
Seat 3: tedward13 ($7.56 in chips) 
Seat 4: heckyeahbro ($32.45 in chips) 
Seat 6: kervyrx7 ($13.64 in chips) 
heckyeahbro: posts small blind $0.05
kervyrx7: posts big blind $0.10
*** HOLE CARDS ***
Dealt to CashMatteo [5d 4d]
yobrudere: folds 
CashMatteo: raises $0.15 to $0.25
tedward13: calls $0.25
heckyeahbro: calls $0.20
kervyrx7: calls $0.15
*** FLOP *** [7s 6h Qh]
heckyeahbro: bets $0.64
kervyrx7: folds 
CashMatteo: calls $0.64
tedward13: raises $1.54 to $2.18
heckyeahbro: folds 
CashMatteo: calls $1.54
*** TURN *** [7s 6h Qh] [Jd]
CashMatteo: checks 
tedward13: bets $5.13 and is all-in
CashMatteo: calls $5.13
*** RIVER *** [7s 6h Qh Jd] [5h]
*** SHOW DOWN ***
CashMatteo: shows [5d 4d] (a pair of Fives)
tedward13: shows [6c 6s] (three of a kind, Sixes)
tedward13 collected $15.53 from pot
*** SUMMARY ***
Total pot $16.26 | Rake $0.73 
Board [7s 6h Qh Jd 5h]
Seat 1: yobrudere folded before Flop (didn't bet)
Seat 2: CashMatteo showed [5d 4d] and lost with a pair of Fives
Seat 3: tedward13 (button) showed [6c 6s] and won ($15.53) with three of a kind, Sixes
Seat 4: heckyeahbro (small blind) folded on the Flop
Seat 6: kervyrx7 (big blind) folded on the Flop

Hand #1489: 

PokerStars Hand #246785000047:  Hold'em No Limit ($0.05/$0.10 CAD) - 2023/10/28 2:45:18 ET
Table 'Wilkens II' 6-max Seat #4 is the button
Seat 1: yobrudere ($10.67 in chips) 
Seat 2: CashMatteo ($1.88 in chips) 
Seat 3: tedward13 ($15.53 in chips) 
Seat 4: heckyeahbro ($31.56 in chips) 
Seat 6: kervyrx7 ($13.39 in chips) 
kimcop will be allowed to play after the button
kervyrx7: posts small blind $0.05
yobrudere: posts big blind $0.10
*** HOLE CARDS ***
Dealt to CashMatteo [Td Js]
CashMatteo: raises $0.15 to $0.25
tedward13: folds 
heckyeahbro: folds 
kervyrx7: folds 
yobrudere: calls $0.15
*** FLOP *** [3d 6c Th]
yobrudere: checks 
CashMatteo: bets $0.27
yobrudere: calls $0.27
*** TURN *** [3d 6c Th] [Jd]
yobrudere: checks 
CashMatteo: bets $0.52
yobrudere: calls $0.52
*** RIVER *** [3d 6c Th Jd] [3c]
yobrudere: checks 
CashMatteo: bets $0.84 and is all-in
yobrudere: folds 
Uncalled bet ($0.84) returned to CashMatteo
CashMatteo collected $2.03 from pot
CashMatteo: doesn't show hand 
*** SUMMARY ***
Total pot $2.13 | Rake $0.10 
Board [3d 6c Th Jd 3c]
Seat 1: yobrudere (big blind) folded on the River
Seat 2: CashMatteo collected ($2.03)
Seat 3: tedward13 folded before Flop (didn't bet)
Seat 4: heckyeahbro (button) folded before Flop (didn't bet)
Seat 6: kervyrx7 (small blind) folded before Flop

Hand #1490: 

PokerStars Hand #246785004458:  Hold'em No Limit ($0.05/$0.10 CAD) - 2023/10/28 2:46:01 ET
Table 'Wilkens II' 6-max Seat #6 is the button
Seat 1: yobrudere ($9.63 in chips) 
Seat 2: CashMatteo ($2.87 in chips) 
Seat 3: tedward13 ($15.53 in chips) 
Seat 4: heckyeahbro ($31.56 in chips) 
Seat 5: kimcop ($28.42 in chips) 
Seat 6: kervyrx7 ($13.34 in chips) 
yobrudere: posts small blind $0.05
CashMatteo: posts big blind $0.10
kimcop: posts small & big blinds $0.15
*** HOLE CARDS ***
Dealt to CashMatteo [9h 6d]
tedward13: folds 
heckyeahbro: folds 
kimcop: checks 
kervyrx7: folds 
yobrudere: calls $0.05
CashMatteo: checks 
*** FLOP *** [2s 4c 5d]
yobrudere: checks 
CashMatteo: checks 
kimcop: checks 
*** TURN *** [2s 4c 5d] [Kd]
yobrudere: checks 
CashMatteo: checks 
kimcop: checks 
*** RIVER *** [2s 4c 5d Kd] [8h]
yobrudere: bets $0.17
CashMatteo: folds 
kimcop: folds 
Uncalled bet ($0.17) returned to yobrudere
yobrudere collected $0.33 from pot
yobrudere: doesn't show hand 
*** SUMMARY ***
Total pot $0.35 | Rake $0.02 
Board [2s 4c 5d Kd 8h]
Seat 1: yobrudere (small blind) collected ($0.33)
Seat 2: CashMatteo (big blind) folded on the River
Seat 3: tedward13 folded before Flop (didn't bet)
Seat 4: heckyeahbro folded before Flop (didn't bet)
Seat 5: kimcop folded on the River (didn't bet)
Seat 6: kervyrx7 (button) folded before Flop (didn't bet)

Hand #1491: 

PokerStars Hand #246785009979:  Hold'em No Limit ($0.05/$0.10 CAD) - 2023/10/28 2:46:53 ET
Table 'Wilkens II' 6-max Seat #1 is the button
Seat 1: yobrudere ($10 in chips) 
Seat 2: CashMatteo ($2.77 in chips) 
Seat 3: tedward13 ($15.53 in chips) 
Seat 4: heckyeahbro ($31.56 in chips) 
Seat 5: kimcop ($28.27 in chips) 
Seat 6: kervyrx7 ($13.34 in chips) 
CashMatteo: posts small blind $0.05
tedward13: posts big blind $0.10
*** HOLE CARDS ***
Dealt to CashMatteo [Ad Kh]
heckyeahbro: folds 
kimcop: folds 
kervyrx7: raises $0.15 to $0.25
yobrudere: calls $0.25
CashMatteo: raises $0.75 to $1
tedward13: folds 
kervyrx7: folds 
yobrudere: folds 
Uncalled bet ($0.75) returned to CashMatteo
CashMatteo collected $0.85 from pot
CashMatteo: doesn't show hand 
*** SUMMARY ***
Total pot $0.85 | Rake $0 
Seat 1: yobrudere (button) folded before Flop
Seat 2: CashMatteo (small blind) collected ($0.85)
Seat 3: tedward13 (big blind) folded before Flop
Seat 4: heckyeahbro folded before Flop (didn't bet)
Seat 5: kimcop folded before Flop (didn't bet)
Seat 6: kervyrx7 folded before Flop

Hand #1492: 

PokerStars Hand #246785012709:  Hold'em No Limit ($0.05/$0.10 CAD) - 2023/10/28 2:47:20 ET
Table 'Wilkens II' 6-max Seat #2 is the button
Seat 1: yobrudere ($9.75 in chips) 
Seat 2: CashMatteo ($3.37 in chips) 
Seat 3: tedward13 ($15.43 in chips) 
Seat 4: heckyeahbro ($31.56 in chips) 
Seat 5: kimcop ($28.27 in chips) 
Seat 6: kervyrx7 ($13.09 in chips) 
tedward13: posts small blind $0.05
heckyeahbro: posts big blind $0.10
*** HOLE CARDS ***
Dealt to CashMatteo [8d Kc]
kimcop: calls $0.10
kervyrx7: folds 
yobrudere: folds 
CashMatteo: calls $0.10
tedward13: calls $0.05
heckyeahbro: checks 
*** FLOP *** [5d As Ah]
tedward13: checks 
heckyeahbro: checks 
kimcop: checks 
CashMatteo: bets $0.25
tedward13: folds 
heckyeahbro: folds 
kimcop: folds 
Uncalled bet ($0.25) returned to CashMatteo
CashMatteo collected $0.38 from pot
CashMatteo: doesn't show hand 
*** SUMMARY ***
Total pot $0.40 | Rake $0.02 
Board [5d As Ah]
Seat 1: yobrudere folded before Flop (didn't bet)
Seat 2: CashMatteo (button) collected ($0.38)
Seat 3: tedward13 (small blind) folded on the Flop
Seat 4: heckyeahbro (big blind) folded on the Flop
Seat 5: kimcop folded on the Flop
Seat 6: kervyrx7 folded before Flop (didn't bet)

Hand #1493: 

PokerStars Hand #246785016610:  Hold'em No Limit ($0.05/$0.10 CAD) - 2023/10/28 2:47:57 ET
Table 'Wilkens II' 6-max Seat #3 is the button
Seat 1: yobrudere ($9.75 in chips) 
Seat 2: CashMatteo ($3.65 in chips) 
Seat 3: tedward13 ($15.33 in chips) 
Seat 4: heckyeahbro ($31.46 in chips) 
Seat 5: kimcop ($28.17 in chips) 
Seat 6: kervyrx7 ($13.09 in chips) 
heckyeahbro: posts small blind $0.05
kimcop: posts big blind $0.10
*** HOLE CARDS ***
Dealt to CashMatteo [Jd 7d]
kervyrx7: folds 
yobrudere: raises $0.10 to $0.20
CashMatteo: calls $0.20
tedward13: calls $0.20
heckyeahbro: folds 
kimcop: folds 
*** FLOP *** [6d Ks 4s]
yobrudere: checks 
CashMatteo: checks 
tedward13: bets $0.30
yobrudere: folds 
CashMatteo: folds 
Uncalled bet ($0.30) returned to tedward13
tedward13 collected $0.72 from pot
*** SUMMARY ***
Total pot $0.75 | Rake $0.03 
Board [6d Ks 4s]
Seat 1: yobrudere folded on the Flop
Seat 2: CashMatteo folded on the Flop
Seat 3: tedward13 (button) collected ($0.72)
Seat 4: heckyeahbro (small blind) folded before Flop
Seat 5: kimcop (big blind) folded before Flop
Seat 6: kervyrx7 folded before Flop (didn't bet)

Hand #1494: 

PokerStars Hand #246785019672:  Hold'em No Limit ($0.05/$0.10 CAD) - 2023/10/28 2:48:26 ET
Table 'Wilkens II' 6-max Seat #4 is the button
Seat 1: yobrudere ($10 in chips) 
Seat 2: CashMatteo ($3.45 in chips) 
Seat 3: tedward13 ($15.85 in chips) 
Seat 4: heckyeahbro ($31.41 in chips) 
Seat 5: kimcop ($28.07 in chips) 
Seat 6: kervyrx7 ($13.09 in chips) 
kimcop: posts small blind $0.05
kervyrx7: posts big blind $0.10
*** HOLE CARDS ***
Dealt to CashMatteo [4d 9h]
yobrudere: folds 
CashMatteo: folds 
tedward13: folds 
heckyeahbro: folds 
kimcop: calls $0.05
kervyrx7: raises $0.25 to $0.35
kimcop: folds 
Uncalled bet ($0.25) returned to kervyrx7
kervyrx7 collected $0.20 from pot
kervyrx7: doesn't show hand 
*** SUMMARY ***
Total pot $0.20 | Rake $0 
Seat 1: yobrudere folded before Flop (didn't bet)
Seat 2: CashMatteo folded before Flop (didn't bet)
Seat 3: tedward13 folded before Flop (didn't bet)
Seat 4: heckyeahbro (button) folded before Flop (didn't bet)
Seat 5: kimcop (small blind) folded before Flop
Seat 6: kervyrx7 (big blind) collected ($0.20)

Hand #1495: 

PokerStars Hand #246785021602:  Hold'em No Limit ($0.05/$0.10 CAD) - 2023/10/28 2:48:45 ET
Table 'Wilkens II' 6-max Seat #5 is the button
Seat 1: yobrudere ($10 in chips) 
Seat 2: CashMatteo ($3.45 in chips) 
Seat 3: tedward13 ($15.85 in chips) 
Seat 4: heckyeahbro ($31.41 in chips) 
Seat 5: kimcop ($27.97 in chips) 
Seat 6: kervyrx7 ($13.19 in chips) 
kervyrx7: posts small blind $0.05
yobrudere: posts big blind $0.10
*** HOLE CARDS ***
Dealt to CashMatteo [Jh 7s]
CashMatteo: folds 
tedward13: raises $0.10 to $0.20
heckyeahbro: raises $0.80 to $1
kimcop: folds 
kervyrx7: folds 
yobrudere: folds 
tedward13: calls $0.80
*** FLOP *** [6h Ts Ah]
tedward13: checks 
heckyeahbro: bets $1.07
tedward13: calls $1.07
*** TURN *** [6h Ts Ah] [Th]
tedward13: checks 
heckyeahbro: bets $2.13
tedward13: folds 
Uncalled bet ($2.13) returned to heckyeahbro
heckyeahbro collected $4.10 from pot
heckyeahbro: doesn't show hand 
*** SUMMARY ***
Total pot $4.29 | Rake $0.19 
Board [6h Ts Ah Th]
Seat 1: yobrudere (big blind) folded before Flop
Seat 2: CashMatteo folded before Flop (didn't bet)
Seat 3: tedward13 folded on the Turn
Seat 4: heckyeahbro collected ($4.10)
Seat 5: kimcop (button) folded before Flop (didn't bet)
Seat 6: kervyrx7 (small blind) folded before Flop

Hand #1496: 

PokerStars Hand #246785026165:  Hold'em No Limit ($0.05/$0.10 CAD) - 2023/10/28 2:49:29 ET
Table 'Wilkens II' 6-max Seat #6 is the button
Seat 1: yobrudere ($9.90 in chips) 
Seat 2: CashMatteo ($3.45 in chips) 
Seat 3: tedward13 ($13.78 in chips) 
Seat 4: heckyeahbro ($33.44 in chips) 
Seat 5: kimcop ($27.97 in chips) 
Seat 6: kervyrx7 ($13.14 in chips) 
yobrudere: posts small blind $0.05
CashMatteo: posts big blind $0.10
*** HOLE CARDS ***
Dealt to CashMatteo [Jc 6c]
tedward13: folds 
heckyeahbro: folds 
kimcop: folds 
kervyrx7: raises $0.15 to $0.25
yobrudere: folds 
CashMatteo: calls $0.15
*** FLOP *** [Tc 6s 9s]
CashMatteo: checks 
kervyrx7: bets $0.32
CashMatteo: calls $0.32
*** TURN *** [Tc 6s 9s] [9h]
CashMatteo: checks 
kervyrx7: bets $0.68
CashMatteo: folds 
Uncalled bet ($0.68) returned to kervyrx7
kervyrx7 collected $1.14 from pot
kervyrx7: doesn't show hand 
*** SUMMARY ***
Total pot $1.19 | Rake $0.05 
Board [Tc 6s 9s 9h]
Seat 1: yobrudere (small blind) folded before Flop
Seat 2: CashMatteo (big blind) folded on the Turn
Seat 3: tedward13 folded before Flop (didn't bet)
Seat 4: heckyeahbro folded before Flop (didn't bet)
Seat 5: kimcop folded before Flop (didn't bet)
Seat 6: kervyrx7 (button) collected ($1.14)

Hand #1497: 

PokerStars Hand #246785029933:  Hold'em No Limit ($0.05/$0.10 CAD) - 2023/10/28 2:50:06 ET
Table 'Wilkens II' 6-max Seat #1 is the button
Seat 1: yobrudere ($9.85 in chips) 
Seat 2: CashMatteo ($2.88 in chips) 
Seat 3: tedward13 ($13.78 in chips) 
Seat 4: heckyeahbro ($33.44 in chips) 
Seat 5: kimcop ($27.97 in chips) 
Seat 6: kervyrx7 ($13.71 in chips) 
CashMatteo: posts small blind $0.05
tedward13: posts big blind $0.10
*** HOLE CARDS ***
Dealt to CashMatteo [Ks 3d]
heckyeahbro: folds 
kimcop: folds 
kervyrx7: folds 
yobrudere: folds 
CashMatteo: folds 
Uncalled bet ($0.05) returned to tedward13
tedward13 collected $0.10 from pot
*** SUMMARY ***
Total pot $0.10 | Rake $0 
Seat 1: yobrudere (button) folded before Flop (didn't bet)
Seat 2: CashMatteo (small blind) folded before Flop
Seat 3: tedward13 (big blind) collected ($0.10)
Seat 4: heckyeahbro folded before Flop (didn't bet)
Seat 5: kimcop folded before Flop (didn't bet)
Seat 6: kervyrx7 folded before Flop (didn't bet)

Hand #1498: 

PokerStars Hand #246785031582:  Hold'em No Limit ($0.05/$0.10 CAD) - 2023/10/28 2:50:22 ET
Table 'Wilkens II' 6-max Seat #2 is the button
Seat 1: yobrudere ($9.85 in chips) 
Seat 2: CashMatteo ($2.83 in chips) 
Seat 3: tedward13 ($13.83 in chips) 
Seat 4: heckyeahbro ($33.44 in chips) 
Seat 5: kimcop ($27.97 in chips) 
Seat 6: kervyrx7 ($13.71 in chips) 
tedward13: posts small blind $0.05
heckyeahbro: posts big blind $0.10
*** HOLE CARDS ***
Dealt to CashMatteo [Jh Qc]
kimcop: folds 
kervyrx7: folds 
yobrudere: folds 
CashMatteo: raises $0.15 to $0.25
tedward13: calls $0.20
heckyeahbro: folds 
*** FLOP *** [Th 5c 3c]
tedward13: checks 
CashMatteo: bets $0.29
tedward13: calls $0.29
*** TURN *** [Th 5c 3c] [Ac]
tedward13: checks 
CashMatteo: checks 
*** RIVER *** [Th 5c 3c Ac] [Ad]
tedward13: checks 
CashMatteo: checks 
*** SHOW DOWN ***
tedward13: shows [9h 9s] (two pair, Aces and Nines)
CashMatteo: mucks hand 
tedward13 collected $1.13 from pot
*** SUMMARY ***
Total pot $1.18 | Rake $0.05 
Board [Th 5c 3c Ac Ad]
Seat 1: yobrudere folded before Flop (didn't bet)
Seat 2: CashMatteo (button) mucked [Jh Qc]
Seat 3: tedward13 (small blind) showed [9h 9s] and won ($1.13) with two pair, Aces and Nines
Seat 4: heckyeahbro (big blind) folded before Flop
Seat 5: kimcop folded before Flop (didn't bet)
Seat 6: kervyrx7 folded before Flop (didn't bet)

Hand #1499: 

PokerStars Hand #246785034829:  Hold'em No Limit ($0.05/$0.10 CAD) - 2023/10/28 2:50:54 ET
Table 'Wilkens II' 6-max Seat #3 is the button
Seat 1: yobrudere ($9.85 in chips) 
Seat 2: CashMatteo ($2.29 in chips) 
Seat 3: tedward13 ($14.42 in chips) 
Seat 4: heckyeahbro ($33.34 in chips) 
Seat 5: kimcop ($27.97 in chips) 
Seat 6: kervyrx7 ($13.71 in chips) 
heckyeahbro: posts small blind $0.05
kimcop: posts big blind $0.10
*** HOLE CARDS ***
Dealt to CashMatteo [2c Qs]
kervyrx7: folds 
yobrudere: folds 
CashMatteo: folds 
tedward13: folds 
heckyeahbro: folds 
Uncalled bet ($0.05) returned to kimcop
kimcop collected $0.10 from pot
*** SUMMARY ***
Total pot $0.10 | Rake $0 
Seat 1: yobrudere folded before Flop (didn't bet)
Seat 2: CashMatteo folded before Flop (didn't bet)
Seat 3: tedward13 (button) folded before Flop (didn't bet)
Seat 4: heckyeahbro (small blind) folded before Flop
Seat 5: kimcop (big blind) collected ($0.10)
Seat 6: kervyrx7 folded before Flop (didn't bet)

Hand #1500: 

PokerStars Hand #246785036450:  Hold'em No Limit ($0.05/$0.10 CAD) - 2023/10/28 2:51:09 ET
Table 'Wilkens II' 6-max Seat #4 is the button
Seat 1: yobrudere ($9.85 in chips) 
Seat 2: CashMatteo ($2.29 in chips) 
Seat 3: tedward13 ($14.42 in chips) 
Seat 4: heckyeahbro ($33.29 in chips) 
Seat 5: kimcop ($28.02 in chips) 
Seat 6: kervyrx7 ($13.71 in chips) 
kimcop: posts small blind $0.05
kervyrx7: posts big blind $0.10
*** HOLE CARDS ***
Dealt to CashMatteo [As Kd]
yobrudere: folds 
CashMatteo: raises $0.15 to $0.25
tedward13: folds 
heckyeahbro: folds 
kimcop: folds 
kervyrx7: raises $0.70 to $0.95
CashMatteo: raises $1.34 to $2.29 and is all-in
kervyrx7: calls $1.34
*** FLOP *** [5d Kc 4h]
*** TURN *** [5d Kc 4h] [7c]
*** RIVER *** [5d Kc 4h 7c] [5s]
*** SHOW DOWN ***
kervyrx7: shows [Ah Jh] (a pair of Fives)
CashMatteo: shows [As Kd] (two pair, Kings and Fives)
CashMatteo collected $4.42 from pot
*** SUMMARY ***
Total pot $4.63 | Rake $0.21 
Board [5d Kc 4h 7c 5s]
Seat 1: yobrudere folded before Flop (didn't bet)
Seat 2: CashMatteo showed [As Kd] and won ($4.42) with two pair, Kings and Fives
Seat 3: tedward13 folded before Flop (didn't bet)
Seat 4: heckyeahbro (button) folded before Flop (didn't bet)
Seat 5: kimcop (small blind) folded before Flop
Seat 6: kervyrx7 (big blind) showed [Ah Jh] and lost with a pair of Fives

Hand #1501: 

PokerStars Hand #246785039634:  Hold'em No Limit ($0.05/$0.10 CAD) - 2023/10/28 2:51:40 ET
Table 'Wilkens II' 6-max Seat #5 is the button
Seat 1: yobrudere ($9.85 in chips) 
Seat 2: CashMatteo ($4.42 in chips) 
Seat 3: tedward13 ($14.42 in chips) 
Seat 4: heckyeahbro ($33.29 in chips) 
Seat 5: kimcop ($27.97 in chips) 
Seat 6: kervyrx7 ($11.42 in chips) 
kervyrx7: posts small blind $0.05
yobrudere: posts big blind $0.10
*** HOLE CARDS ***
Dealt to CashMatteo [4c Qc]
CashMatteo: calls $0.10
tedward13: calls $0.10
heckyeahbro: raises $0.80 to $0.90
kimcop: folds 
kervyrx7: folds 
yobrudere: folds 
CashMatteo: folds 
tedward13: folds 
Uncalled bet ($0.80) returned to heckyeahbro
heckyeahbro collected $0.45 from pot
heckyeahbro: doesn't show hand 
*** SUMMARY ***
Total pot $0.45 | Rake $0 
Seat 1: yobrudere (big blind) folded before Flop
Seat 2: CashMatteo folded before Flop
Seat 3: tedward13 folded before Flop
Seat 4: heckyeahbro collected ($0.45)
Seat 5: kimcop (button) folded before Flop (didn't bet)
Seat 6: kervyrx7 (small blind) folded before Flop

Hand #1502: 

PokerStars Hand #246785041799:  Hold'em No Limit ($0.05/$0.10 CAD) - 2023/10/28 2:52:01 ET
Table 'Wilkens II' 6-max Seat #6 is the button
Seat 1: yobrudere ($9.75 in chips) 
Seat 2: CashMatteo ($4.32 in chips) 
Seat 3: tedward13 ($14.32 in chips) 
Seat 4: heckyeahbro ($33.64 in chips) 
Seat 5: kimcop ($27.97 in chips) 
Seat 6: kervyrx7 ($11.37 in chips) 
yobrudere: posts small blind $0.05
CashMatteo: posts big blind $0.10
*** HOLE CARDS ***
Dealt to CashMatteo [7c Ks]
tedward13: raises $0.10 to $0.20
heckyeahbro: folds 
kimcop: folds 
kervyrx7: calls $0.20
yobrudere: folds 
CashMatteo: calls $0.10
*** FLOP *** [As Js 6c]
CashMatteo: checks 
tedward13: bets $0.31
kervyrx7: folds 
CashMatteo: folds 
Uncalled bet ($0.31) returned to tedward13
tedward13 collected $0.62 from pot
*** SUMMARY ***
Total pot $0.65 | Rake $0.03 
Board [As Js 6c]
Seat 1: yobrudere (small blind) folded before Flop
Seat 2: CashMatteo (big blind) folded on the Flop
Seat 3: tedward13 collected ($0.62)
Seat 4: heckyeahbro folded before Flop (didn't bet)
Seat 5: kimcop folded before Flop (didn't bet)
Seat 6: kervyrx7 (button) folded on the Flop

Hand #1503: 

PokerStars Hand #246785044523:  Hold'em No Limit ($0.05/$0.10 CAD) - 2023/10/28 2:52:28 ET
Table 'Wilkens II' 6-max Seat #1 is the button
Seat 1: yobrudere ($9.70 in chips) 
Seat 2: CashMatteo ($4.12 in chips) 
Seat 3: tedward13 ($14.74 in chips) 
Seat 4: heckyeahbro ($33.64 in chips) 
Seat 5: kimcop ($27.97 in chips) 
Seat 6: kervyrx7 ($11.17 in chips) 
CashMatteo: posts small blind $0.05
tedward13: posts big blind $0.10
*** HOLE CARDS ***
Dealt to CashMatteo [4s Qs]
heckyeahbro: raises $0.15 to $0.25
kimcop: folds 
kervyrx7: folds 
yobrudere: folds 
CashMatteo: calls $0.20
tedward13: calls $0.15
*** FLOP *** [7c 5d Th]
CashMatteo: checks 
tedward13: checks 
heckyeahbro: bets $0.48
CashMatteo: folds 
tedward13: calls $0.48
*** TURN *** [7c 5d Th] [2s]
tedward13: checks 
heckyeahbro: checks 
*** RIVER *** [7c 5d Th 2s] [3s]
tedward13: bets $0.70
heckyeahbro: calls $0.70
*** SHOW DOWN ***
tedward13: shows [8d Td] (a pair of Tens)
heckyeahbro: mucks hand 
tedward13 collected $2.97 from pot
*** SUMMARY ***
Total pot $3.11 | Rake $0.14 
Board [7c 5d Th 2s 3s]
Seat 1: yobrudere (button) folded before Flop (didn't bet)
Seat 2: CashMatteo (small blind) folded on the Flop
Seat 3: tedward13 (big blind) showed [8d Td] and won ($2.97) with a pair of Tens
Seat 4: heckyeahbro mucked [8h 7h]
Seat 5: kimcop folded before Flop (didn't bet)
Seat 6: kervyrx7 folded before Flop (didn't bet)

Hand #1504: 

PokerStars Hand #246785049487:  Hold'em No Limit ($0.05/$0.10 CAD) - 2023/10/28 2:53:18 ET
Table 'Wilkens II' 6-max Seat #2 is the button
Seat 1: yobrudere ($9.70 in chips) 
Seat 2: CashMatteo ($3.87 in chips) 
Seat 3: tedward13 ($16.28 in chips) 
Seat 4: heckyeahbro ($32.21 in chips) 
Seat 5: kimcop ($27.97 in chips) 
Seat 6: kervyrx7 ($11.17 in chips) 
tedward13: posts small blind $0.05
heckyeahbro: posts big blind $0.10
*** HOLE CARDS ***
Dealt to CashMatteo [5c Th]
kimcop: calls $0.10
kervyrx7: folds 
yobrudere: calls $0.10
CashMatteo: folds 
tedward13: calls $0.05
heckyeahbro: checks 
*** FLOP *** [Jc 3d 9d]
tedward13: checks 
heckyeahbro: checks 
kimcop: bets $0.20
yobrudere: calls $0.20
tedward13: folds 
heckyeahbro: folds 
*** TURN *** [Jc 3d 9d] [7d]
kimcop: bets $0.20
yobrudere: calls $0.20
*** RIVER *** [Jc 3d 9d 7d] [Qs]
kimcop: bets $0.30
yobrudere: calls $0.30
*** SHOW DOWN ***
kimcop: shows [Qh 9h] (two pair, Queens and Nines)
yobrudere: mucks hand 
kimcop collected $1.72 from pot
*** SUMMARY ***
Total pot $1.80 | Rake $0.08 
Board [Jc 3d 9d 7d Qs]
Seat 1: yobrudere mucked [Td Js]
Seat 2: CashMatteo (button) folded before Flop (didn't bet)
Seat 3: tedward13 (small blind) folded on the Flop
Seat 4: heckyeahbro (big blind) folded on the Flop
Seat 5: kimcop showed [Qh 9h] and won ($1.72) with two pair, Queens and Nines
Seat 6: kervyrx7 folded before Flop (didn't bet)

Hand #1505: 

PokerStars Hand #246785054406:  Hold'em No Limit ($0.05/$0.10 CAD) - 2023/10/28 2:54:06 ET
Table 'Wilkens II' 6-max Seat #3 is the button
Seat 1: yobrudere ($8.90 in chips) 
Seat 2: CashMatteo ($3.87 in chips) 
Seat 3: tedward13 ($16.18 in chips) 
Seat 4: heckyeahbro ($32.11 in chips) 
Seat 5: kimcop ($28.89 in chips) 
Seat 6: kervyrx7 ($11.17 in chips) 
heckyeahbro: posts small blind $0.05
kimcop: posts big blind $0.10
*** HOLE CARDS ***
Dealt to CashMatteo [9c 2s]
kervyrx7: folds 
yobrudere: raises $0.10 to $0.20
CashMatteo: folds 
tedward13: folds 
heckyeahbro: folds 
kimcop: calls $0.10
*** FLOP *** [9d Qd 3d]
kimcop: bets $0.20
yobrudere: calls $0.20
*** TURN *** [9d Qd 3d] [Td]
kimcop: bets $0.30
yobrudere: raises $0.80 to $1.10
kimcop: folds 
Uncalled bet ($0.80) returned to yobrudere
yobrudere collected $1.38 from pot
yobrudere: doesn't show hand 
*** SUMMARY ***
Total pot $1.45 | Rake $0.07 
Board [9d Qd 3d Td]
Seat 1: yobrudere collected ($1.38)
Seat 2: CashMatteo folded before Flop (didn't bet)
Seat 3: tedward13 (button) folded before Flop (didn't bet)
Seat 4: heckyeahbro (small blind) folded before Flop
Seat 5: kimcop (big blind) folded on the Turn
Seat 6: kervyrx7 folded before Flop (didn't bet)

Hand #1506: 

PokerStars Hand #246785058430:  Hold'em No Limit ($0.05/$0.10 CAD) - 2023/10/28 2:54:45 ET
Table 'Wilkens II' 6-max Seat #4 is the button
Seat 1: yobrudere ($10 in chips) 
Seat 2: CashMatteo ($3.87 in chips) 
Seat 3: tedward13 ($16.18 in chips) 
Seat 4: heckyeahbro ($32.06 in chips) 
Seat 5: kimcop ($28.19 in chips) 
Seat 6: kervyrx7 ($11.17 in chips) 
kimcop: posts small blind $0.05
kervyrx7: posts big blind $0.10
*** HOLE CARDS ***
Dealt to CashMatteo [Th 3h]
yobrudere: raises $0.10 to $0.20
CashMatteo: folds 
tedward13: calls $0.20
heckyeahbro: calls $0.20
kimcop: folds 
kervyrx7: folds 
*** FLOP *** [7s 4d 9h]
yobrudere: checks 
tedward13: checks 
heckyeahbro: checks 
*** TURN *** [7s 4d 9h] [8h]
yobrudere: checks 
tedward13: checks 
heckyeahbro: bets $0.48
yobrudere: folds 
tedward13: folds 
Uncalled bet ($0.48) returned to heckyeahbro
heckyeahbro collected $0.72 from pot
heckyeahbro: doesn't show hand 
*** SUMMARY ***
Total pot $0.75 | Rake $0.03 
Board [7s 4d 9h 8h]
Seat 1: yobrudere folded on the Turn
Seat 2: CashMatteo folded before Flop (didn't bet)
Seat 3: tedward13 folded on the Turn
Seat 4: heckyeahbro (button) collected ($0.72)
Seat 5: kimcop (small blind) folded before Flop
Seat 6: kervyrx7 (big blind) folded before Flop

Hand #1507: 

PokerStars Hand #246785062225:  Hold'em No Limit ($0.05/$0.10 CAD) - 2023/10/28 2:55:25 ET
Table 'Wilkens II' 6-max Seat #5 is the button
Seat 1: yobrudere ($9.80 in chips) 
Seat 2: CashMatteo ($3.87 in chips) 
Seat 3: tedward13 ($15.98 in chips) 
Seat 4: heckyeahbro ($32.58 in chips) 
Seat 5: kimcop ($28.14 in chips) 
Seat 6: kervyrx7 ($11.07 in chips) 
kervyrx7: posts small blind $0.05
yobrudere: posts big blind $0.10
*** HOLE CARDS ***
Dealt to CashMatteo [Kh 2s]
CashMatteo: folds 
tedward13: folds 
heckyeahbro: folds 
kimcop: folds 
kervyrx7: raises $0.25 to $0.35
yobrudere: folds 
Uncalled bet ($0.25) returned to kervyrx7
kervyrx7 collected $0.20 from pot
kervyrx7: doesn't show hand 
*** SUMMARY ***
Total pot $0.20 | Rake $0 
Seat 1: yobrudere (big blind) folded before Flop
Seat 2: CashMatteo folded before Flop (didn't bet)
Seat 3: tedward13 folded before Flop (didn't bet)
Seat 4: heckyeahbro folded before Flop (didn't bet)
Seat 5: kimcop (button) folded before Flop (didn't bet)
Seat 6: kervyrx7 (small blind) collected ($0.20)

Hand #1508: 

PokerStars Hand #246785064344:  Hold'em No Limit ($0.05/$0.10 CAD) - 2023/10/28 2:55:49 ET
Table 'Wilkens II' 6-max Seat #6 is the button
Seat 1: yobrudere ($10 in chips) 
Seat 2: CashMatteo ($3.87 in chips) 
Seat 3: tedward13 ($15.98 in chips) 
Seat 4: heckyeahbro ($32.58 in chips) 
Seat 5: kimcop ($28.14 in chips) 
Seat 6: kervyrx7 ($11.17 in chips) 
yobrudere: posts small blind $0.05
CashMatteo: posts big blind $0.10
*** HOLE CARDS ***
Dealt to CashMatteo [Ah Jh]
tedward13: folds 
heckyeahbro: folds 
kimcop: folds 
kervyrx7: folds 
yobrudere: folds 
Uncalled bet ($0.05) returned to CashMatteo
CashMatteo collected $0.10 from pot
CashMatteo: doesn't show hand 
*** SUMMARY ***
Total pot $0.10 | Rake $0 
Seat 1: yobrudere (small blind) folded before Flop
Seat 2: CashMatteo (big blind) collected ($0.10)
Seat 3: tedward13 folded before Flop (didn't bet)
Seat 4: heckyeahbro folded before Flop (didn't bet)
Seat 5: kimcop folded before Flop (didn't bet)
Seat 6: kervyrx7 (button) folded before Flop (didn't bet)

Hand #1509: 

PokerStars Hand #246785065612:  Hold'em No Limit ($0.05/$0.10 CAD) - 2023/10/28 2:56:03 ET
Table 'Wilkens II' 6-max Seat #1 is the button
Seat 1: yobrudere ($9.95 in chips) 
Seat 2: CashMatteo ($3.92 in chips) 
Seat 3: tedward13 ($15.98 in chips) 
Seat 4: heckyeahbro ($32.58 in chips) 
Seat 5: kimcop ($28.14 in chips) 
Seat 6: kervyrx7 ($11.17 in chips) 
CashMatteo: posts small blind $0.05
tedward13: posts big blind $0.10
*** HOLE CARDS ***
Dealt to CashMatteo [2d 7c]
heckyeahbro: folds 
kimcop: calls $0.10
kervyrx7: folds 
yobrudere: calls $0.10
CashMatteo: calls $0.05
tedward13: checks 
*** FLOP *** [Ac 2c Tc]
CashMatteo: checks 
tedward13: checks 
kimcop: bets $0.10
yobrudere: raises $0.20 to $0.30
CashMatteo: folds 
tedward13: folds 
kimcop: folds 
Uncalled bet ($0.20) returned to yobrudere
yobrudere collected $0.57 from pot
yobrudere: doesn't show hand 
*** SUMMARY ***
Total pot $0.60 | Rake $0.03 
Board [Ac 2c Tc]
Seat 1: yobrudere (button) collected ($0.57)
Seat 2: CashMatteo (small blind) folded on the Flop
Seat 3: tedward13 (big blind) folded on the Flop
Seat 4: heckyeahbro folded before Flop (didn't bet)
Seat 5: kimcop folded on the Flop
Seat 6: kervyrx7 folded before Flop (didn't bet)

Hand #1510: 

PokerStars Hand #246785070213:  Hold'em No Limit ($0.05/$0.10 CAD) - 2023/10/28 2:56:54 ET
Table 'Wilkens II' 6-max Seat #2 is the button
Seat 1: yobrudere ($10.32 in chips) 
Seat 2: CashMatteo ($3.82 in chips) 
Seat 3: tedward13 ($15.88 in chips) 
Seat 4: heckyeahbro ($32.58 in chips) 
Seat 5: kimcop ($27.94 in chips) 
Seat 6: kervyrx7 ($11.17 in chips) 
tedward13: posts small blind $0.05
heckyeahbro: posts big blind $0.10
*** HOLE CARDS ***
Dealt to CashMatteo [Ks 8h]
kimcop: folds 
kervyrx7: folds 
yobrudere: folds 
CashMatteo: raises $0.15 to $0.25
tedward13: folds 
heckyeahbro: folds 
Uncalled bet ($0.15) returned to CashMatteo
CashMatteo collected $0.25 from pot
CashMatteo: doesn't show hand 
*** SUMMARY ***
Total pot $0.25 | Rake $0 
Seat 1: yobrudere folded before Flop (didn't bet)
Seat 2: CashMatteo (button) collected ($0.25)
Seat 3: tedward13 (small blind) folded before Flop
Seat 4: heckyeahbro (big blind) folded before Flop
Seat 5: kimcop folded before Flop (didn't bet)
Seat 6: kervyrx7 folded before Flop (didn't bet)

Hand #1511: 

PokerStars Hand #246785071977:  Hold'em No Limit ($0.05/$0.10 CAD) - 2023/10/28 2:57:13 ET
Table 'Wilkens II' 6-max Seat #3 is the button
Seat 1: yobrudere ($10.32 in chips) 
Seat 2: CashMatteo ($3.97 in chips) 
Seat 3: tedward13 ($15.83 in chips) 
Seat 4: heckyeahbro ($32.48 in chips) 
Seat 5: kimcop ($27.94 in chips) 
Seat 6: kervyrx7 ($11.17 in chips) 
heckyeahbro: posts small blind $0.05
kimcop: posts big blind $0.10
*** HOLE CARDS ***
Dealt to CashMatteo [6s Ah]
kervyrx7: folds 
yobrudere: folds 
CashMatteo: raises $0.15 to $0.25
tedward13: folds 
heckyeahbro: folds 
kimcop: folds 
Uncalled bet ($0.15) returned to CashMatteo
CashMatteo collected $0.25 from pot
CashMatteo: doesn't show hand 
*** SUMMARY ***
Total pot $0.25 | Rake $0 
Seat 1: yobrudere folded before Flop (didn't bet)
Seat 2: CashMatteo collected ($0.25)
Seat 3: tedward13 (button) folded before Flop (didn't bet)
Seat 4: heckyeahbro (small blind) folded before Flop
Seat 5: kimcop (big blind) folded before Flop
Seat 6: kervyrx7 folded before Flop (didn't bet)

Hand #1512: 

PokerStars Hand #246785073485:  Hold'em No Limit ($0.05/$0.10 CAD) - 2023/10/28 2:57:30 ET
Table 'Wilkens II' 6-max Seat #4 is the button
Seat 1: yobrudere ($10.32 in chips) 
Seat 2: CashMatteo ($4.12 in chips) 
Seat 3: tedward13 ($15.83 in chips) 
Seat 4: heckyeahbro ($32.43 in chips) 
Seat 5: kimcop ($27.84 in chips) 
Seat 6: kervyrx7 ($11.17 in chips) 
kimcop: posts small blind $0.05
kervyrx7: posts big blind $0.10
*** HOLE CARDS ***
Dealt to CashMatteo [6d 4h]
yobrudere: folds 
CashMatteo: raises $0.15 to $0.25
tedward13: folds 
heckyeahbro: folds 
kimcop: folds 
kervyrx7: calls $0.15
*** FLOP *** [4c 7c 4d]
kervyrx7: checks 
CashMatteo: bets $0.27
kervyrx7: folds 
Uncalled bet ($0.27) returned to CashMatteo
CashMatteo collected $0.53 from pot
CashMatteo: doesn't show hand 
*** SUMMARY ***
Total pot $0.55 | Rake $0.02 
Board [4c 7c 4d]
Seat 1: yobrudere folded before Flop (didn't bet)
Seat 2: CashMatteo collected ($0.53)
Seat 3: tedward13 folded before Flop (didn't bet)
Seat 4: heckyeahbro (button) folded before Flop (didn't bet)
Seat 5: kimcop (small blind) folded before Flop
Seat 6: kervyrx7 (big blind) folded on the Flop

Hand #1513: 

PokerStars Hand #246785075845:  Hold'em No Limit ($0.05/$0.10 CAD) - 2023/10/28 2:57:56 ET
Table 'Wilkens II' 6-max Seat #5 is the button
Seat 1: yobrudere ($10.32 in chips) 
Seat 2: CashMatteo ($4.40 in chips) 
Seat 3: tedward13 ($15.83 in chips) 
Seat 4: heckyeahbro ($32.43 in chips) 
Seat 5: kimcop ($27.79 in chips) 
Seat 6: kervyrx7 ($10.92 in chips) 
kervyrx7: posts small blind $0.05
yobrudere: posts big blind $0.10
*** HOLE CARDS ***
Dealt to CashMatteo [Js Tc]
CashMatteo: raises $0.15 to $0.25
tedward13: folds 
heckyeahbro: folds 
kimcop: folds 
kervyrx7: folds 
yobrudere: folds 
Uncalled bet ($0.15) returned to CashMatteo
CashMatteo collected $0.25 from pot
CashMatteo: doesn't show hand 
*** SUMMARY ***
Total pot $0.25 | Rake $0 
Seat 1: yobrudere (big blind) folded before Flop
Seat 2: CashMatteo collected ($0.25)
Seat 3: tedward13 folded before Flop (didn't bet)
Seat 4: heckyeahbro folded before Flop (didn't bet)
Seat 5: kimcop (button) folded before Flop (didn't bet)
Seat 6: kervyrx7 (small blind) folded before Flop

Hand #1514: 

PokerStars Hand #246785077255:  Hold'em No Limit ($0.05/$0.10 CAD) - 2023/10/28 2:58:11 ET
Table 'Wilkens II' 6-max Seat #6 is the button
Seat 1: yobrudere ($10.22 in chips) 
Seat 2: CashMatteo ($4.55 in chips) 
Seat 3: tedward13 ($15.83 in chips) 
Seat 4: heckyeahbro ($32.43 in chips) 
Seat 5: kimcop ($27.79 in chips) 
Seat 6: kervyrx7 ($10.87 in chips) 
yobrudere: posts small blind $0.05
CashMatteo: posts big blind $0.10
*** HOLE CARDS ***
Dealt to CashMatteo [Qh 8s]
tedward13: folds 
heckyeahbro: folds 
kimcop: folds 
kervyrx7: raises $0.15 to $0.25
yobrudere: folds 
CashMatteo: raises $0.50 to $0.75
kervyrx7: folds 
Uncalled bet ($0.50) returned to CashMatteo
CashMatteo collected $0.55 from pot
CashMatteo: doesn't show hand 
*** SUMMARY ***
Total pot $0.55 | Rake $0 
Seat 1: yobrudere (small blind) folded before Flop
Seat 2: CashMatteo (big blind) collected ($0.55)
Seat 3: tedward13 folded before Flop (didn't bet)
Seat 4: heckyeahbro folded before Flop (didn't bet)
Seat 5: kimcop folded before Flop (didn't bet)
Seat 6: kervyrx7 (button) folded before Flop

Hand #1515: 

PokerStars Hand #246785079746:  Hold'em No Limit ($0.05/$0.10 CAD) - 2023/10/28 2:58:38 ET
Table 'Wilkens II' 6-max Seat #1 is the button
Seat 1: yobrudere ($10.17 in chips) 
Seat 2: CashMatteo ($4.85 in chips) 
Seat 3: tedward13 ($15.83 in chips) 
Seat 4: heckyeahbro ($32.43 in chips) 
Seat 5: kimcop ($27.79 in chips) 
Seat 6: kervyrx7 ($10.62 in chips) 
CashMatteo: posts small blind $0.05
tedward13: posts big blind $0.10
*** HOLE CARDS ***
Dealt to CashMatteo [3d Th]
heckyeahbro: folds 
kimcop: folds 
kervyrx7: folds 
yobrudere: folds 
CashMatteo: raises $0.15 to $0.25
tedward13: folds 
Uncalled bet ($0.15) returned to CashMatteo
CashMatteo collected $0.20 from pot
CashMatteo: doesn't show hand 
*** SUMMARY ***
Total pot $0.20 | Rake $0 
Seat 1: yobrudere (button) folded before Flop (didn't bet)
Seat 2: CashMatteo (small blind) collected ($0.20)
Seat 3: tedward13 (big blind) folded before Flop
Seat 4: heckyeahbro folded before Flop (didn't bet)
Seat 5: kimcop folded before Flop (didn't bet)
Seat 6: kervyrx7 folded before Flop (didn't bet)

Hand #1516: 

PokerStars Hand #246785082106:  Hold'em No Limit ($0.05/$0.10 CAD) - 2023/10/28 2:59:03 ET
Table 'Wilkens II' 6-max Seat #2 is the button
Seat 2: CashMatteo ($4.95 in chips) 
Seat 3: tedward13 ($15.73 in chips) 
Seat 4: heckyeahbro ($32.43 in chips) 
Seat 5: kimcop ($27.79 in chips) 
Seat 6: kervyrx7 ($10.62 in chips) 
tedward13: posts small blind $0.05
heckyeahbro: posts big blind $0.10
*** HOLE CARDS ***
Dealt to CashMatteo [Ks 5c]
kimcop: folds 
kervyrx7: folds 
CashMatteo: raises $0.15 to $0.25
tedward13: folds 
heckyeahbro: calls $0.15
*** FLOP *** [3h 6d 5s]
heckyeahbro: checks 
CashMatteo: bets $0.27
heckyeahbro: calls $0.27
*** TURN *** [3h 6d 5s] [3d]
heckyeahbro: checks 
CashMatteo: checks 
*** RIVER *** [3h 6d 5s 3d] [Qc]
heckyeahbro: checks 
CashMatteo: checks 
*** SHOW DOWN ***
heckyeahbro: shows [8h 6h] (two pair, Sixes and Threes)
CashMatteo: mucks hand 
heckyeahbro collected $1.04 from pot
*** SUMMARY ***
Total pot $1.09 | Rake $0.05 
Board [3h 6d 5s 3d Qc]
Seat 2: CashMatteo (button) mucked [Ks 5c]
Seat 3: tedward13 (small blind) folded before Flop
Seat 4: heckyeahbro (big blind) showed [8h 6h] and won ($1.04) with two pair, Sixes and Threes
Seat 5: kimcop folded before Flop (didn't bet)
Seat 6: kervyrx7 folded before Flop (didn't bet)

Hand #1517: 

PokerStars Hand #246785085089:  Hold'em No Limit ($0.05/$0.10 CAD) - 2023/10/28 2:59:35 ET
Table 'Wilkens II' 6-max Seat #3 is the button
Seat 2: CashMatteo ($4.43 in chips) 
Seat 3: tedward13 ($15.68 in chips) 
Seat 4: heckyeahbro ($32.95 in chips) 
Seat 5: kimcop ($27.79 in chips) 
Seat 6: kervyrx7 ($10.62 in chips) 
heckyeahbro: posts small blind $0.05
kimcop: posts big blind $0.10
*** HOLE CARDS ***
Dealt to CashMatteo [3h 5c]
kervyrx7: folds 
CashMatteo: raises $0.15 to $0.25
tedward13: folds 
heckyeahbro: folds 
kimcop: calls $0.15
*** FLOP *** [9d Qh 2c]
kimcop: checks 
CashMatteo: bets $0.27
kimcop: folds 
Uncalled bet ($0.27) returned to CashMatteo
CashMatteo collected $0.53 from pot
CashMatteo: doesn't show hand 
*** SUMMARY ***
Total pot $0.55 | Rake $0.02 
Board [9d Qh 2c]
Seat 2: CashMatteo collected ($0.53)
Seat 3: tedward13 (button) folded before Flop (didn't bet)
Seat 4: heckyeahbro (small blind) folded before Flop
Seat 5: kimcop (big blind) folded on the Flop
Seat 6: kervyrx7 folded before Flop (didn't bet)

Hand #1518: 

PokerStars Hand #246785087532:  Hold'em No Limit ($0.05/$0.10 CAD) - 2023/10/28 3:00:01 ET
Table 'Wilkens II' 6-max Seat #4 is the button
Seat 2: CashMatteo ($4.71 in chips) 
Seat 3: tedward13 ($15.68 in chips) 
Seat 4: heckyeahbro ($32.90 in chips) 
Seat 5: kimcop ($27.54 in chips) 
kimcop: posts small blind $0.05
kervyrx7: is sitting out 
kervyrx7 leaves the table
CashMatteo: posts big blind $0.10
*** HOLE CARDS ***
Dealt to CashMatteo [6c Td]
tedward13: folds 
frnkthetank joins the table at seat #6 
heckyeahbro: raises $0.15 to $0.25
kimcop: folds 
CashMatteo: calls $0.15
*** FLOP *** [8c 3h 9c]
CashMatteo: checks 
heckyeahbro: bets $0.35
CashMatteo: calls $0.35
*** TURN *** [8c 3h 9c] [Kh]
CashMatteo: checks 
heckyeahbro: bets $0.79
CashMatteo: folds 
Uncalled bet ($0.79) returned to heckyeahbro
heckyeahbro collected $1.19 from pot
heckyeahbro: doesn't show hand 
*** SUMMARY ***
Total pot $1.25 | Rake $0.06 
Board [8c 3h 9c Kh]
Seat 2: CashMatteo (big blind) folded on the Turn
Seat 3: tedward13 folded before Flop (didn't bet)
Seat 4: heckyeahbro (button) collected ($1.19)
Seat 5: kimcop (small blind) folded before Flop

Hand #1519: 

PokerStars Hand #246785091774:  Hold'em No Limit ($0.05/$0.10 CAD) - 2023/10/28 3:00:44 ET
Table 'Wilkens II' 6-max Seat #5 is the button
Seat 2: CashMatteo ($4.11 in chips) 
Seat 3: tedward13 ($15.68 in chips) 
Seat 4: heckyeahbro ($33.49 in chips) 
Seat 5: kimcop ($27.49 in chips) 
frnkthetank will be allowed to play after the button
CashMatteo: posts small blind $0.05
tedward13: posts big blind $0.10
*** HOLE CARDS ***
Dealt to CashMatteo [Qh 4h]
heckyeahbro: folds 
kimcop: folds 
CashMatteo: raises $0.15 to $0.25
tedward13: folds 
Uncalled bet ($0.15) returned to CashMatteo
CashMatteo collected $0.20 from pot
CashMatteo: doesn't show hand 
*** SUMMARY ***
Total pot $0.20 | Rake $0 
Seat 2: CashMatteo (small blind) collected ($0.20)
Seat 3: tedward13 (big blind) folded before Flop
Seat 4: heckyeahbro folded before Flop (didn't bet)
Seat 5: kimcop (button) folded before Flop (didn't bet)

Hand #1520: 

PokerStars Hand #246785093490:  Hold'em No Limit ($0.05/$0.10 CAD) - 2023/10/28 3:01:01 ET
Table 'Wilkens II' 6-max Seat #2 is the button
Seat 2: CashMatteo ($4.21 in chips) 
Seat 3: tedward13 ($15.58 in chips) 
Seat 4: heckyeahbro ($33.49 in chips) 
Seat 5: kimcop ($27.49 in chips) 
tedward13: posts small blind $0.05
heckyeahbro: posts big blind $0.10
frnkthetank: sits out 
*** HOLE CARDS ***
Dealt to CashMatteo [Ts 8d]
kimcop: raises $0.10 to $0.20
CashMatteo: calls $0.20
tedward13: folds 
heckyeahbro: calls $0.10
*** FLOP *** [9d 2h Qc]
heckyeahbro: checks 
kimcop: bets $0.20
CashMatteo: calls $0.20
heckyeahbro: calls $0.20
*** TURN *** [9d 2h Qc] [Qh]
heckyeahbro: checks 
kimcop: bets $0.30
CashMatteo: calls $0.30
heckyeahbro: raises $1.09 to $1.39
kimcop: folds 
CashMatteo: folds 
Uncalled bet ($1.09) returned to heckyeahbro
heckyeahbro collected $2.05 from pot
heckyeahbro: doesn't show hand 
*** SUMMARY ***
Total pot $2.15 | Rake $0.10 
Board [9d 2h Qc Qh]
Seat 2: CashMatteo (button) folded on the Turn
Seat 3: tedward13 (small blind) folded before Flop
Seat 4: heckyeahbro (big blind) collected ($2.05)
Seat 5: kimcop folded on the Turn

Hand #1521: 

PokerStars Hand #246785098424:  Hold'em No Limit ($0.05/$0.10 CAD) - 2023/10/28 3:01:48 ET
Table 'Wilkens II' 6-max Seat #3 is the button
Seat 2: CashMatteo ($3.51 in chips) 
Seat 3: tedward13 ($15.53 in chips) 
Seat 4: heckyeahbro ($34.84 in chips) 
Seat 5: kimcop ($26.79 in chips) 
heckyeahbro: posts small blind $0.05
kimcop: posts big blind $0.10
frnkthetank: sits out 
*** HOLE CARDS ***
Dealt to CashMatteo [Kc Kh]
CashMatteo: calls $0.10
tedward13: calls $0.10
heckyeahbro: raises $0.80 to $0.90
kimcop: folds 
CashMatteo: raises $0.80 to $1.70
tedward13: folds 
heckyeahbro: raises $33.14 to $34.84 and is all-in
CashMatteo: calls $1.81 and is all-in
Uncalled bet ($31.33) returned to heckyeahbro
*** FLOP *** [Tc 2h Js]
*** TURN *** [Tc 2h Js] [Jd]
*** RIVER *** [Tc 2h Js Jd] [4h]
*** SHOW DOWN ***
heckyeahbro: shows [8d 8s] (two pair, Jacks and Eights)
CashMatteo: shows [Kc Kh] (two pair, Kings and Jacks)
CashMatteo collected $6.90 from pot
*** SUMMARY ***
Total pot $7.22 | Rake $0.32 
Board [Tc 2h Js Jd 4h]
Seat 2: CashMatteo showed [Kc Kh] and won ($6.90) with two pair, Kings and Jacks
Seat 3: tedward13 (button) folded before Flop
Seat 4: heckyeahbro (small blind) showed [8d 8s] and lost with two pair, Jacks and Eights
Seat 5: kimcop (big blind) folded before Flop

Hand #1522: 

PokerStars Hand #246785102607:  Hold'em No Limit ($0.05/$0.10 CAD) - 2023/10/28 3:02:28 ET
Table 'Wilkens II' 6-max Seat #4 is the button
Seat 2: CashMatteo ($6.90 in chips) 
Seat 3: tedward13 ($15.43 in chips) 
Seat 4: heckyeahbro ($31.33 in chips) 
Seat 5: kimcop ($26.69 in chips) 
Seat 6: frnkthetank ($8 in chips) 
kimcop: posts small blind $0.05
frnkthetank: posts big blind $0.10
*** HOLE CARDS ***
Dealt to CashMatteo [Qs Jc]
CashMatteo: raises $0.15 to $0.25
tedward13: folds 
heckyeahbro: calls $0.25
kimcop: folds 
frnkthetank: calls $0.15
*** FLOP *** [5h 3h Ah]
frnkthetank: checks 
CashMatteo: checks 
heckyeahbro: bets $0.51
frnkthetank: calls $0.51
CashMatteo: folds 
*** TURN *** [5h 3h Ah] [2d]
frnkthetank: checks 
heckyeahbro: bets $1.16
frnkthetank: calls $1.16
*** RIVER *** [5h 3h Ah 2d] [Kh]
frnkthetank: checks 
heckyeahbro: checks 
*** SHOW DOWN ***
frnkthetank: shows [2c 4c] (a straight, Ace to Five)
heckyeahbro: mucks hand 
frnkthetank collected $3.95 from pot
*** SUMMARY ***
Total pot $4.14 | Rake $0.19 
Board [5h 3h Ah 2d Kh]
Seat 2: CashMatteo folded on the Flop
Seat 3: tedward13 folded before Flop (didn't bet)
Seat 4: heckyeahbro (button) mucked [3d 3c]
Seat 5: kimcop (small blind) folded before Flop
Seat 6: frnkthetank (big blind) showed [2c 4c] and won ($3.95) with a straight, Ace to Five

Hand #1523: 

PokerStars Hand #246785107236:  Hold'em No Limit ($0.05/$0.10 CAD) - 2023/10/28 3:03:12 ET
Table 'Wilkens II' 6-max Seat #5 is the button
Seat 1: yobrudere ($10.17 in chips) 
Seat 2: CashMatteo ($6.65 in chips) 
Seat 3: tedward13 ($15.43 in chips) 
Seat 4: heckyeahbro ($29.41 in chips) 
Seat 5: kimcop ($26.64 in chips) 
Seat 6: frnkthetank ($10.03 in chips) 
frnkthetank: posts small blind $0.05
yobrudere: posts big blind $0.10
*** HOLE CARDS ***
Dealt to CashMatteo [2d 9d]
CashMatteo: raises $0.15 to $0.25
tedward13: folds 
heckyeahbro: folds 
kimcop: calls $0.25
frnkthetank: calls $0.20
yobrudere: calls $0.15
*** FLOP *** [Tc Ad 4d]
frnkthetank: checks 
yobrudere: checks 
CashMatteo: bets $0.48
kimcop: calls $0.48
frnkthetank: folds 
yobrudere: calls $0.48
*** TURN *** [Tc Ad 4d] [Qh]
yobrudere: checks 
CashMatteo: checks 
kimcop: bets $0.30
yobrudere: calls $0.30
CashMatteo: calls $0.30
*** RIVER *** [Tc Ad 4d Qh] [4h]
yobrudere: checks 
CashMatteo: checks 
kimcop: checks 
*** SHOW DOWN ***
yobrudere: shows [6d 3d] (a pair of Fours)
CashMatteo: shows [2d 9d] (a pair of Fours)
kimcop: shows [Ah Kc] (two pair, Aces and Fours)
kimcop collected $3.19 from pot
*** SUMMARY ***
Total pot $3.34 | Rake $0.15 
Board [Tc Ad 4d Qh 4h]
Seat 1: yobrudere (big blind) showed [6d 3d] and lost with a pair of Fours
Seat 2: CashMatteo showed [2d 9d] and lost with a pair of Fours
Seat 3: tedward13 folded before Flop (didn't bet)
Seat 4: heckyeahbro folded before Flop (didn't bet)
Seat 5: kimcop (button) showed [Ah Kc] and won ($3.19) with two pair, Aces and Fours
Seat 6: frnkthetank (small blind) folded on the Flop

Hand #1524: 

PokerStars Hand #246785113496:  Hold'em No Limit ($0.05/$0.10 CAD) - 2023/10/28 3:04:11 ET
Table 'Wilkens II' 6-max Seat #6 is the button
Seat 1: yobrudere ($10 in chips) 
Seat 2: CashMatteo ($5.62 in chips) 
Seat 3: tedward13 ($15.43 in chips) 
Seat 4: heckyeahbro ($29.41 in chips) 
Seat 5: kimcop ($28.80 in chips) 
Seat 6: frnkthetank ($9.78 in chips) 
yobrudere: posts small blind $0.05
CashMatteo: posts big blind $0.10
*** HOLE CARDS ***
Dealt to CashMatteo [Th 5s]
tedward13: folds 
heckyeahbro: raises $0.15 to $0.25
kimcop: folds 
frnkthetank: folds 
yobrudere: folds 
CashMatteo: calls $0.15
*** FLOP *** [8d 2c Tc]
CashMatteo: checks 
heckyeahbro: checks 
*** TURN *** [8d 2c Tc] [6s]
CashMatteo: bets $0.27
heckyeahbro: calls $0.27
*** RIVER *** [8d 2c Tc 6s] [3c]
CashMatteo: checks 
heckyeahbro: checks 
*** SHOW DOWN ***
CashMatteo: shows [Th 5s] (a pair of Tens)
heckyeahbro: mucks hand 
CashMatteo collected $1.04 from pot
*** SUMMARY ***
Total pot $1.09 | Rake $0.05 
Board [8d 2c Tc 6s 3c]
Seat 1: yobrudere (small blind) folded before Flop
Seat 2: CashMatteo (big blind) showed [Th 5s] and won ($1.04) with a pair of Tens
Seat 3: tedward13 folded before Flop (didn't bet)
Seat 4: heckyeahbro mucked [Kc Qh]
Seat 5: kimcop folded before Flop (didn't bet)
Seat 6: frnkthetank (button) folded before Flop (didn't bet)

Hand #1525: 

PokerStars Hand #246785116866:  Hold'em No Limit ($0.05/$0.10 CAD) - 2023/10/28 3:04:43 ET
Table 'Wilkens II' 6-max Seat #1 is the button
Seat 1: yobrudere ($9.95 in chips) 
Seat 2: CashMatteo ($6.14 in chips) 
Seat 3: tedward13 ($15.43 in chips) 
Seat 4: heckyeahbro ($28.89 in chips) 
Seat 5: kimcop ($28.80 in chips) 
Seat 6: frnkthetank ($9.78 in chips) 
CashMatteo: posts small blind $0.05
tedward13: posts big blind $0.10
*** HOLE CARDS ***
Dealt to CashMatteo [3c 2c]
heckyeahbro: folds 
kimcop: calls $0.10
frnkthetank: calls $0.10
yobrudere: folds 
CashMatteo: raises $0.40 to $0.50
tedward13: calls $0.40
kimcop: folds 
frnkthetank: folds 
*** FLOP *** [4h 4c 9s]
CashMatteo: bets $0.58
tedward13: folds 
Uncalled bet ($0.58) returned to CashMatteo
CashMatteo collected $1.15 from pot
CashMatteo: doesn't show hand 
*** SUMMARY ***
Total pot $1.20 | Rake $0.05 
Board [4h 4c 9s]
Seat 1: yobrudere (button) folded before Flop (didn't bet)
Seat 2: CashMatteo (small blind) collected ($1.15)
Seat 3: tedward13 (big blind) folded on the Flop
Seat 4: heckyeahbro folded before Flop (didn't bet)
Seat 5: kimcop folded before Flop
Seat 6: frnkthetank folded before Flop

Hand #1526: 

PokerStars Hand #246785120541:  Hold'em No Limit ($0.05/$0.10 CAD) - 2023/10/28 3:05:17 ET
Table 'Wilkens II' 6-max Seat #2 is the button
Seat 1: yobrudere ($9.95 in chips) 
Seat 2: CashMatteo ($6.79 in chips) 
Seat 3: tedward13 ($14.93 in chips) 
Seat 5: kimcop ($28.70 in chips) 
Seat 6: frnkthetank ($9.68 in chips) 
tedward13: posts small blind $0.05
heckyeahbro: is sitting out 
kimcop: posts big blind $0.10
*** HOLE CARDS ***
Dealt to CashMatteo [2c 7c]
heckyeahbro leaves the table
frnkthetank: raises $0.20 to $0.30
yobrudere: folds 
CashMatteo: raises $0.50 to $0.80
tedward13: folds 
kimcop: folds 
frnkthetank: calls $0.50
*** FLOP *** [2d Ks Ad]
frnkthetank: checks 
CashMatteo: bets $0.84
frnkthetank: calls $0.84
*** TURN *** [2d Ks Ad] [3s]
frnkthetank: checks 
CashMatteo: checks 
*** RIVER *** [2d Ks Ad 3s] [2s]
frnkthetank: checks 
CashMatteo: bets $1.80
frnkthetank: calls $1.80
*** SHOW DOWN ***
CashMatteo: shows [2c 7c] (three of a kind, Deuces)
frnkthetank: mucks hand 
CashMatteo collected $6.71 from pot
*** SUMMARY ***
Total pot $7.03 | Rake $0.32 
Board [2d Ks Ad 3s 2s]
Seat 1: yobrudere folded before Flop (didn't bet)
Seat 2: CashMatteo (button) showed [2c 7c] and won ($6.71) with three of a kind, Deuces
Seat 3: tedward13 (small blind) folded before Flop
Seat 5: kimcop (big blind) folded before Flop
Seat 6: frnkthetank mucked [Ah Qc]

Hand #1527: 

PokerStars Hand #246785125857:  Hold'em No Limit ($0.05/$0.10 CAD) - 2023/10/28 3:06:08 ET
Table 'Wilkens II' 6-max Seat #3 is the button
Seat 1: yobrudere ($9.95 in chips) 
Seat 2: CashMatteo ($10.06 in chips) 
Seat 3: tedward13 ($14.88 in chips) 
Seat 5: kimcop ($28.60 in chips) 
Seat 6: frnkthetank ($6.24 in chips) 
kimcop: posts small blind $0.05
frnkthetank: posts big blind $0.10
*** HOLE CARDS ***
Dealt to CashMatteo [Jc 8d]
yobrudere: folds 
CashMatteo: raises $0.15 to $0.25
tedward13: folds 
kimcop: folds 
frnkthetank: folds 
Uncalled bet ($0.15) returned to CashMatteo
CashMatteo collected $0.25 from pot
CashMatteo: doesn't show hand 
*** SUMMARY ***
Total pot $0.25 | Rake $0 
Seat 1: yobrudere folded before Flop (didn't bet)
Seat 2: CashMatteo collected ($0.25)
Seat 3: tedward13 (button) folded before Flop (didn't bet)
Seat 5: kimcop (small blind) folded before Flop
Seat 6: frnkthetank (big blind) folded before Flop

Hand #1528: 

PokerStars Hand #246785127800:  Hold'em No Limit ($0.05/$0.10 CAD) - 2023/10/28 3:06:27 ET
Table 'Wilkens II' 6-max Seat #5 is the button
Seat 1: yobrudere ($9.95 in chips) 
Seat 2: CashMatteo ($10.21 in chips) 
Seat 3: tedward13 ($14.88 in chips) 
Seat 5: kimcop ($28.55 in chips) 
Seat 6: frnkthetank ($6.14 in chips) 
frnkthetank: posts small blind $0.05
yobrudere: posts big blind $0.10
*** HOLE CARDS ***
Dealt to CashMatteo [Js Ks]
CashMatteo: raises $0.15 to $0.25
tedward13: folds 
kimcop: folds 
frnkthetank: folds 
yobrudere: folds 
Uncalled bet ($0.15) returned to CashMatteo
CashMatteo collected $0.25 from pot
CashMatteo: doesn't show hand 
*** SUMMARY ***
Total pot $0.25 | Rake $0 
Seat 1: yobrudere (big blind) folded before Flop
Seat 2: CashMatteo collected ($0.25)
Seat 3: tedward13 folded before Flop (didn't bet)
Seat 5: kimcop (button) folded before Flop (didn't bet)
Seat 6: frnkthetank (small blind) folded before Flop

Hand #1529: 

PokerStars Hand #246785129428:  Hold'em No Limit ($0.05/$0.10 CAD) - 2023/10/28 3:06:41 ET
Table 'Wilkens II' 6-max Seat #6 is the button
Seat 1: yobrudere ($9.85 in chips) 
Seat 2: CashMatteo ($10.36 in chips) 
Seat 3: tedward13 ($14.88 in chips) 
Seat 5: kimcop ($28.55 in chips) 
Seat 6: frnkthetank ($6.09 in chips) 
yobrudere: posts small blind $0.05
CashMatteo: posts big blind $0.10
*** HOLE CARDS ***
Dealt to CashMatteo [6s Ah]
tedward13: folds 
kimcop: folds 
frnkthetank: raises $0.20 to $0.30
yobrudere: folds 
CashMatteo: raises $0.50 to $0.80
frnkthetank: calls $0.50
*** FLOP *** [4s 8s 2s]
CashMatteo: bets $0.79
frnkthetank: folds 
Uncalled bet ($0.79) returned to CashMatteo
CashMatteo collected $1.58 from pot
CashMatteo: doesn't show hand 
*** SUMMARY ***
Total pot $1.65 | Rake $0.07 
Board [4s 8s 2s]
Seat 1: yobrudere (small blind) folded before Flop
Seat 2: CashMatteo (big blind) collected ($1.58)
Seat 3: tedward13 folded before Flop (didn't bet)
Seat 5: kimcop folded before Flop (didn't bet)
Seat 6: frnkthetank (button) folded on the Flop

Hand #1530: 

PokerStars Hand #246785132604:  Hold'em No Limit ($0.05/$0.10 CAD) - 2023/10/28 3:07:12 ET
Table 'Wilkens II' 6-max Seat #1 is the button
Seat 1: yobrudere ($9.80 in chips) 
Seat 2: CashMatteo ($11.14 in chips) 
Seat 3: tedward13 ($14.88 in chips) 
Seat 5: kimcop ($28.55 in chips) 
Seat 6: frnkthetank ($5.29 in chips) 
CashMatteo: posts small blind $0.05
tedward13: posts big blind $0.10
*** HOLE CARDS ***
Dealt to CashMatteo [Kd Qs]
kimcop: folds 
frnkthetank: folds 
yobrudere: folds 
CashMatteo: raises $0.15 to $0.25
tedward13: folds 
Uncalled bet ($0.15) returned to CashMatteo
CashMatteo collected $0.20 from pot
CashMatteo: doesn't show hand 
*** SUMMARY ***
Total pot $0.20 | Rake $0 
Seat 1: yobrudere (button) folded before Flop (didn't bet)
Seat 2: CashMatteo (small blind) collected ($0.20)
Seat 3: tedward13 (big blind) folded before Flop
Seat 5: kimcop folded before Flop (didn't bet)
Seat 6: frnkthetank folded before Flop (didn't bet)

Hand #1531: 

PokerStars Hand #246785134362:  Hold'em No Limit ($0.05/$0.10 CAD) - 2023/10/28 3:07:29 ET
Table 'Wilkens II' 6-max Seat #2 is the button
Seat 1: yobrudere ($9.80 in chips) 
Seat 2: CashMatteo ($11.24 in chips) 
Seat 3: tedward13 ($14.78 in chips) 
Seat 5: kimcop ($28.55 in chips) 
Seat 6: frnkthetank ($5.29 in chips) 
tedward13: posts small blind $0.05
kimcop: posts big blind $0.10
*** HOLE CARDS ***
Dealt to CashMatteo [5d Td]
frnkthetank: raises $0.20 to $0.30
yobrudere: folds 
CashMatteo: raises $0.50 to $0.80
tedward13: folds 
kimcop: folds 
frnkthetank: raises $4.49 to $5.29 and is all-in
CashMatteo: folds 
Uncalled bet ($4.49) returned to frnkthetank
frnkthetank collected $1.75 from pot
*** SUMMARY ***
Total pot $1.75 | Rake $0 
Seat 1: yobrudere folded before Flop (didn't bet)
Seat 2: CashMatteo (button) folded before Flop
Seat 3: tedward13 (small blind) folded before Flop
Seat 5: kimcop (big blind) folded before Flop
Seat 6: frnkthetank collected ($1.75)

Hand #1532: 

PokerStars Hand #246785137369:  Hold'em No Limit ($0.05/$0.10 CAD) - 2023/10/28 3:07:58 ET
Table 'Wilkens II' 6-max Seat #3 is the button
Seat 1: yobrudere ($9.80 in chips) 
Seat 2: CashMatteo ($10.44 in chips) 
Seat 3: tedward13 ($14.73 in chips) 
Seat 5: kimcop ($28.45 in chips) 
Seat 6: frnkthetank ($6.24 in chips) 
kimcop: posts small blind $0.05
frnkthetank: posts big blind $0.10
*** HOLE CARDS ***
Dealt to CashMatteo [4s Jd]
yobrudere: raises $0.10 to $0.20
CashMatteo: folds 
Khab00m joins the table at seat #4 
tedward13: folds 
kimcop: calls $0.15
frnkthetank: folds 
*** FLOP *** [2c 5s 6c]
kimcop: bets $0.10
yobrudere: raises $0.20 to $0.30
kimcop: calls $0.20
*** TURN *** [2c 5s 6c] [Ah]
kimcop: checks 
yobrudere: bets $0.53
kimcop: folds 
Uncalled bet ($0.53) returned to yobrudere
yobrudere collected $1.05 from pot
yobrudere: doesn't show hand 
*** SUMMARY ***
Total pot $1.10 | Rake $0.05 
Board [2c 5s 6c Ah]
Seat 1: yobrudere collected ($1.05)
Seat 2: CashMatteo folded before Flop (didn't bet)
Seat 3: tedward13 (button) folded before Flop (didn't bet)
Seat 5: kimcop (small blind) folded on the Turn
Seat 6: frnkthetank (big blind) folded before Flop

Hand #1533: 

PokerStars Hand #246785141522:  Hold'em No Limit ($0.05/$0.10 CAD) - 2023/10/28 3:08:37 ET
Table 'Wilkens II' 6-max Seat #5 is the button
Seat 1: yobrudere ($10.35 in chips) 
Seat 2: CashMatteo ($10.44 in chips) 
Seat 3: tedward13 ($14.73 in chips) 
Seat 5: kimcop ($27.95 in chips) 
Seat 6: frnkthetank ($6.14 in chips) 
frnkthetank: posts small blind $0.05
yobrudere: posts big blind $0.10
Khab00m: sits out 
*** HOLE CARDS ***
Dealt to CashMatteo [Kc 5h]
CashMatteo: raises $0.15 to $0.25
tedward13: folds 
kimcop: folds 
frnkthetank: folds 
yobrudere: folds 
Uncalled bet ($0.15) returned to CashMatteo
CashMatteo collected $0.25 from pot
CashMatteo: doesn't show hand 
*** SUMMARY ***
Total pot $0.25 | Rake $0 
Seat 1: yobrudere (big blind) folded before Flop
Seat 2: CashMatteo collected ($0.25)
Seat 3: tedward13 folded before Flop (didn't bet)
Seat 5: kimcop (button) folded before Flop (didn't bet)
Seat 6: frnkthetank (small blind) folded before Flop

Hand #1534: 

PokerStars Hand #246785142986:  Hold'em No Limit ($0.05/$0.10 CAD) - 2023/10/28 3:08:51 ET
Table 'Wilkens II' 6-max Seat #6 is the button
Seat 1: yobrudere ($10.25 in chips) 
Seat 2: CashMatteo ($10.59 in chips) 
Seat 3: tedward13 ($14.73 in chips) 
Seat 5: kimcop ($27.95 in chips) 
Seat 6: frnkthetank ($6.09 in chips) 
yobrudere: posts small blind $0.05
CashMatteo: posts big blind $0.10
Khab00m: sits out 
*** HOLE CARDS ***
Dealt to CashMatteo [Qh Td]
tedward13: folds 
kimcop: folds 
frnkthetank: folds 
yobrudere: calls $0.05
CashMatteo: raises $0.15 to $0.25
yobrudere: calls $0.15
*** FLOP *** [5d 8h Qs]
yobrudere: checks 
CashMatteo: bets $0.24
yobrudere: calls $0.24
*** TURN *** [5d 8h Qs] [3h]
yobrudere: checks 
CashMatteo: bets $0.47
yobrudere: folds 
Uncalled bet ($0.47) returned to CashMatteo
CashMatteo collected $0.94 from pot
CashMatteo: doesn't show hand 
*** SUMMARY ***
Total pot $0.98 | Rake $0.04 
Board [5d 8h Qs 3h]
Seat 1: yobrudere (small blind) folded on the Turn
Seat 2: CashMatteo (big blind) collected ($0.94)
Seat 3: tedward13 folded before Flop (didn't bet)
Seat 5: kimcop folded before Flop (didn't bet)
Seat 6: frnkthetank (button) folded before Flop (didn't bet)

Hand #1535: 

PokerStars Hand #246785146266:  Hold'em No Limit ($0.05/$0.10 CAD) - 2023/10/28 3:09:23 ET
Table 'Wilkens II' 6-max Seat #1 is the button
Seat 1: yobrudere ($9.76 in chips) 
Seat 2: CashMatteo ($11.04 in chips) 
Seat 3: tedward13 ($14.73 in chips) 
Seat 5: kimcop ($27.95 in chips) 
Seat 6: frnkthetank ($6.09 in chips) 
CashMatteo: posts small blind $0.05
tedward13: posts big blind $0.10
Khab00m: sits out 
*** HOLE CARDS ***
Dealt to CashMatteo [8d Jd]
kimcop: folds 
frnkthetank: raises $0.20 to $0.30
yobrudere: folds 
CashMatteo: raises $0.50 to $0.80
tedward13: folds 
frnkthetank: calls $0.50
*** FLOP *** [7s 3d Kc]
CashMatteo: checks 
frnkthetank: checks 
*** TURN *** [7s 3d Kc] [Js]
CashMatteo: bets $0.81
frnkthetank: folds 
Uncalled bet ($0.81) returned to CashMatteo
CashMatteo collected $1.62 from pot
CashMatteo: doesn't show hand 
*** SUMMARY ***
Total pot $1.70 | Rake $0.08 
Board [7s 3d Kc Js]
Seat 1: yobrudere (button) folded before Flop (didn't bet)
Seat 2: CashMatteo (small blind) collected ($1.62)
Seat 3: tedward13 (big blind) folded before Flop
Seat 5: kimcop folded before Flop (didn't bet)
Seat 6: frnkthetank folded on the Turn

Hand #1536: 

PokerStars Hand #246785149528:  Hold'em No Limit ($0.05/$0.10 CAD) - 2023/10/28 3:09:54 ET
Table 'Wilkens II' 6-max Seat #2 is the button
Seat 1: yobrudere ($10 in chips) 
Seat 2: CashMatteo ($11.86 in chips) 
Seat 3: tedward13 ($14.63 in chips) 
Seat 4: Khab00m ($10 in chips) 
Seat 5: kimcop ($27.95 in chips) 
Seat 6: frnkthetank ($5.29 in chips) 
tedward13: posts small blind $0.05
Khab00m: posts big blind $0.10
*** HOLE CARDS ***
Dealt to CashMatteo [8s 3c]
kimcop: calls $0.10
frnkthetank: calls $0.10
yobrudere: folds 
CashMatteo: raises $0.40 to $0.50
tedward13: folds 
Khab00m: folds 
kimcop: folds 
frnkthetank: calls $0.40
*** FLOP *** [4h 8h 9s]
frnkthetank: checks 
CashMatteo: bets $0.60
frnkthetank: folds 
Uncalled bet ($0.60) returned to CashMatteo
CashMatteo collected $1.19 from pot
CashMatteo: doesn't show hand 
*** SUMMARY ***
Total pot $1.25 | Rake $0.06 
Board [4h 8h 9s]
Seat 1: yobrudere folded before Flop (didn't bet)
Seat 2: CashMatteo (button) collected ($1.19)
Seat 3: tedward13 (small blind) folded before Flop
Seat 4: Khab00m (big blind) folded before Flop
Seat 5: kimcop folded before Flop
Seat 6: frnkthetank folded on the Flop

Hand #1537: 

PokerStars Hand #246785153598:  Hold'em No Limit ($0.05/$0.10 CAD) - 2023/10/28 3:10:33 ET
Table 'Wilkens II' 6-max Seat #3 is the button
Seat 1: yobrudere ($10 in chips) 
Seat 2: CashMatteo ($12.55 in chips) 
Seat 3: tedward13 ($14.58 in chips) 
Seat 4: Khab00m ($9.90 in chips) 
Seat 5: kimcop ($27.85 in chips) 
Seat 6: frnkthetank ($4.79 in chips) 
Khab00m: posts small blind $0.05
kimcop: posts big blind $0.10
*** HOLE CARDS ***
Dealt to CashMatteo [Jc 8c]
frnkthetank: folds 
yobrudere: raises $0.10 to $0.20
CashMatteo: raises $0.50 to $0.70
tedward13: folds 
Khab00m: folds 
kimcop: folds 
yobrudere: folds 
Uncalled bet ($0.50) returned to CashMatteo
CashMatteo collected $0.55 from pot
CashMatteo: doesn't show hand 
*** SUMMARY ***
Total pot $0.55 | Rake $0 
Seat 1: yobrudere folded before Flop
Seat 2: CashMatteo collected ($0.55)
Seat 3: tedward13 (button) folded before Flop (didn't bet)
Seat 4: Khab00m (small blind) folded before Flop
Seat 5: kimcop (big blind) folded before Flop
Seat 6: frnkthetank folded before Flop (didn't bet)

Hand #1538: 

PokerStars Hand #246785155787:  Hold'em No Limit ($0.05/$0.10 CAD) - 2023/10/28 3:10:53 ET
Table 'Wilkens II' 6-max Seat #4 is the button
Seat 1: yobrudere ($9.80 in chips) 
Seat 2: CashMatteo ($12.90 in chips) 
Seat 3: tedward13 ($14.58 in chips) 
Seat 4: Khab00m ($9.85 in chips) 
Seat 5: kimcop ($27.75 in chips) 
Seat 6: frnkthetank ($4.79 in chips) 
kimcop: posts small blind $0.05
frnkthetank: posts big blind $0.10
*** HOLE CARDS ***
Dealt to CashMatteo [As Tc]
yobrudere: folds 
CashMatteo: raises $0.15 to $0.25
tedward13: calls $0.25
Khab00m: calls $0.25
kimcop: folds 
frnkthetank: folds 
*** FLOP *** [3c Ts 6d]
CashMatteo: bets $0.43
tedward13: folds 
Khab00m: folds 
Uncalled bet ($0.43) returned to CashMatteo
CashMatteo collected $0.86 from pot
CashMatteo: doesn't show hand 
*** SUMMARY ***
Total pot $0.90 | Rake $0.04 
Board [3c Ts 6d]
Seat 1: yobrudere folded before Flop (didn't bet)
Seat 2: CashMatteo collected ($0.86)
Seat 3: tedward13 folded on the Flop
Seat 4: Khab00m (button) folded on the Flop
Seat 5: kimcop (small blind) folded before Flop
Seat 6: frnkthetank (big blind) folded before Flop

Hand #1539: 

PokerStars Hand #246785159475:  Hold'em No Limit ($0.05/$0.10 CAD) - 2023/10/28 3:11:28 ET
Table 'Wilkens II' 6-max Seat #5 is the button
Seat 1: yobrudere ($9.80 in chips) 
Seat 2: CashMatteo ($13.51 in chips) 
Seat 3: tedward13 ($14.33 in chips) 
Seat 4: Khab00m ($9.60 in chips) 
Seat 5: kimcop ($27.70 in chips) 
Seat 6: frnkthetank ($4.69 in chips) 
frnkthetank: posts small blind $0.05
yobrudere: posts big blind $0.10
*** HOLE CARDS ***
Dealt to CashMatteo [Qc Kd]
CashMatteo: raises $0.15 to $0.25
tedward13: folds 
Khab00m: calls $0.25
kimcop: folds 
frnkthetank: folds 
yobrudere: folds 
*** FLOP *** [5d 8c 2d]
CashMatteo: bets $0.31
Khab00m: raises $0.31 to $0.62
CashMatteo: calls $0.31
*** TURN *** [5d 8c 2d] [Tc]
CashMatteo: checks 
Khab00m: bets $0.90
CashMatteo: raises $1.50 to $2.40
Khab00m: folds 
Uncalled bet ($1.50) returned to CashMatteo
CashMatteo collected $3.52 from pot
CashMatteo: doesn't show hand 
*** SUMMARY ***
Total pot $3.69 | Rake $0.17 
Board [5d 8c 2d Tc]
Seat 1: yobrudere (big blind) folded before Flop
Seat 2: CashMatteo collected ($3.52)
Seat 3: tedward13 folded before Flop (didn't bet)
Seat 4: Khab00m folded on the Turn
Seat 5: kimcop (button) folded before Flop (didn't bet)
Seat 6: frnkthetank (small blind) folded before Flop

Hand #1540: 

PokerStars Hand #246785166126:  Hold'em No Limit ($0.05/$0.10 CAD) - 2023/10/28 3:12:31 ET
Table 'Wilkens II' 6-max Seat #6 is the button
Seat 1: yobrudere ($9.70 in chips) 
Seat 2: CashMatteo ($15.26 in chips) 
Seat 3: tedward13 ($14.33 in chips) 
Seat 4: Khab00m ($7.83 in chips) 
Seat 5: kimcop ($27.70 in chips) 
Seat 6: frnkthetank ($4.64 in chips) 
yobrudere: posts small blind $0.05
CashMatteo: posts big blind $0.10
*** HOLE CARDS ***
Dealt to CashMatteo [2c 2h]
tedward13: raises $0.10 to $0.20
Khab00m: folds 
kimcop: folds 
frnkthetank: calls $0.20
yobrudere: folds 
CashMatteo: raises $0.60 to $0.80
tedward13: calls $0.60
frnkthetank: calls $0.60
*** FLOP *** [Jc As 4s]
CashMatteo: bets $1.17
tedward13: folds 
frnkthetank: raises $2.67 to $3.84 and is all-in
CashMatteo: folds 
Uncalled bet ($2.67) returned to frnkthetank
frnkthetank collected $4.57 from pot
frnkthetank: shows [9s 7s] (high card Ace)
*** SUMMARY ***
Total pot $4.79 | Rake $0.22 
Board [Jc As 4s]
Seat 1: yobrudere (small blind) folded before Flop
Seat 2: CashMatteo (big blind) folded on the Flop
Seat 3: tedward13 folded on the Flop
Seat 4: Khab00m folded before Flop (didn't bet)
Seat 5: kimcop folded before Flop (didn't bet)
Seat 6: frnkthetank (button) collected ($4.57)

Hand #1541: 

PokerStars Hand #246785170276:  Hold'em No Limit ($0.05/$0.10 CAD) - 2023/10/28 3:13:10 ET
Table 'Wilkens II' 6-max Seat #1 is the button
Seat 1: yobrudere ($10 in chips) 
Seat 2: CashMatteo ($13.29 in chips) 
Seat 3: tedward13 ($13.53 in chips) 
Seat 4: Khab00m ($10 in chips) 
Seat 5: kimcop ($27.70 in chips) 
Seat 6: frnkthetank ($7.24 in chips) 
CashMatteo: posts small blind $0.05
tedward13: posts big blind $0.10
*** HOLE CARDS ***
Dealt to CashMatteo [5s Ad]
Khab00m: folds 
kimcop: folds 
frnkthetank: folds 
yobrudere: raises $0.10 to $0.20
CashMatteo: raises $0.50 to $0.70
tedward13: folds 
yobrudere: folds 
Uncalled bet ($0.50) returned to CashMatteo
CashMatteo collected $0.50 from pot
CashMatteo: doesn't show hand 
*** SUMMARY ***
Total pot $0.50 | Rake $0 
Seat 1: yobrudere (button) folded before Flop
Seat 2: CashMatteo (small blind) collected ($0.50)
Seat 3: tedward13 (big blind) folded before Flop
Seat 4: Khab00m folded before Flop (didn't bet)
Seat 5: kimcop folded before Flop (didn't bet)
Seat 6: frnkthetank folded before Flop (didn't bet)

Hand #1542: 

PokerStars Hand #246785173251:  Hold'em No Limit ($0.05/$0.10 CAD) - 2023/10/28 3:13:39 ET
Table 'Wilkens II' 6-max Seat #2 is the button
Seat 1: yobrudere ($9.80 in chips) 
Seat 2: CashMatteo ($13.59 in chips) 
Seat 3: tedward13 ($13.43 in chips) 
Seat 4: Khab00m ($10 in chips) 
Seat 5: kimcop ($27.70 in chips) 
Seat 6: frnkthetank ($7.24 in chips) 
tedward13: posts small blind $0.05
Khab00m: posts big blind $0.10
*** HOLE CARDS ***
Dealt to CashMatteo [Tc 9h]
kimcop: folds 
frnkthetank: folds 
yobrudere: calls $0.10
CashMatteo: raises $0.15 to $0.25
tedward13: folds 
Khab00m: folds 
yobrudere: calls $0.15
*** FLOP *** [6c 5c 7h]
yobrudere: checks 
CashMatteo: bets $0.31
yobrudere: calls $0.31
*** TURN *** [6c 5c 7h] [Ks]
yobrudere: checks 
CashMatteo: bets $0.61
yobrudere: folds 
Uncalled bet ($0.61) returned to CashMatteo
CashMatteo collected $1.21 from pot
CashMatteo: doesn't show hand 
*** SUMMARY ***
Total pot $1.27 | Rake $0.06 
Board [6c 5c 7h Ks]
Seat 1: yobrudere folded on the Turn
Seat 2: CashMatteo (button) collected ($1.21)
Seat 3: tedward13 (small blind) folded before Flop
Seat 4: Khab00m (big blind) folded before Flop
Seat 5: kimcop folded before Flop (didn't bet)
Seat 6: frnkthetank folded before Flop (didn't bet)

Hand #1543: 

PokerStars Hand #246785176948:  Hold'em No Limit ($0.05/$0.10 CAD) - 2023/10/28 3:14:13 ET
Table 'Wilkens II' 6-max Seat #3 is the button
Seat 1: yobrudere ($9.24 in chips) 
Seat 2: CashMatteo ($14.24 in chips) 
Seat 3: tedward13 ($13.38 in chips) 
Seat 4: Khab00m ($9.90 in chips) 
Seat 5: kimcop ($27.70 in chips) 
Seat 6: frnkthetank ($7.24 in chips) 
Khab00m: posts small blind $0.05
kimcop: posts big blind $0.10
*** HOLE CARDS ***
Dealt to CashMatteo [7s 2c]
frnkthetank: folds 
yobrudere: folds 
CashMatteo: raises $0.15 to $0.25
tedward13: folds 
Khab00m: folds 
kimcop: folds 
Uncalled bet ($0.15) returned to CashMatteo
CashMatteo collected $0.25 from pot
CashMatteo: doesn't show hand 
*** SUMMARY ***
Total pot $0.25 | Rake $0 
Seat 1: yobrudere folded before Flop (didn't bet)
Seat 2: CashMatteo collected ($0.25)
Seat 3: tedward13 (button) folded before Flop (didn't bet)
Seat 4: Khab00m (small blind) folded before Flop
Seat 5: kimcop (big blind) folded before Flop
Seat 6: frnkthetank folded before Flop (didn't bet)

Hand #1544: 

PokerStars Hand #246785178920:  Hold'em No Limit ($0.05/$0.10 CAD) - 2023/10/28 3:14:32 ET
Table 'Wilkens II' 6-max Seat #4 is the button
Seat 1: yobrudere ($10 in chips) 
Seat 2: CashMatteo ($14.39 in chips) 
Seat 3: tedward13 ($13.38 in chips) 
Seat 4: Khab00m ($9.85 in chips) 
Seat 5: kimcop ($27.60 in chips) 
Seat 6: frnkthetank ($7.24 in chips) 
kimcop: posts small blind $0.05
frnkthetank: posts big blind $0.10
*** HOLE CARDS ***
Dealt to CashMatteo [Js Jc]
yobrudere: raises $0.10 to $0.20
CashMatteo: raises $0.60 to $0.80
tedward13: folds 
Khab00m: folds 
kimcop: folds 
frnkthetank: calls $0.70
yobrudere: raises $2.40 to $3.20
CashMatteo: raises $11.19 to $14.39 and is all-in
frnkthetank: folds 
yobrudere: calls $6.80 and is all-in
Uncalled bet ($4.39) returned to CashMatteo
*** FLOP *** [9h 3h Ah]
*** TURN *** [9h 3h Ah] [2d]
*** RIVER *** [9h 3h Ah 2d] [3d]
*** SHOW DOWN ***
yobrudere: shows [Kc Ac] (two pair, Aces and Threes)
CashMatteo: shows [Js Jc] (two pair, Jacks and Threes)
yobrudere collected $19.91 from pot
*** SUMMARY ***
Total pot $20.85 | Rake $0.94 
Board [9h 3h Ah 2d 3d]
Seat 1: yobrudere showed [Kc Ac] and won ($19.91) with two pair, Aces and Threes
Seat 2: CashMatteo showed [Js Jc] and lost with two pair, Jacks and Threes
Seat 3: tedward13 folded before Flop (didn't bet)
Seat 4: Khab00m (button) folded before Flop (didn't bet)
Seat 5: kimcop (small blind) folded before Flop
Seat 6: frnkthetank (big blind) folded before Flop

Hand #1545: 

PokerStars Hand #246785182270:  Hold'em No Limit ($0.05/$0.10 CAD) - 2023/10/28 3:15:03 ET
Table 'Wilkens II' 6-max Seat #5 is the button
Seat 1: yobrudere ($19.91 in chips) 
Seat 2: CashMatteo ($4.39 in chips) 
Seat 3: tedward13 ($13.38 in chips) 
Seat 4: Khab00m ($9.85 in chips) 
Seat 5: kimcop ($27.55 in chips) 
Seat 6: frnkthetank ($6.44 in chips) 
frnkthetank: posts small blind $0.05
yobrudere: posts big blind $0.10
*** HOLE CARDS ***
Dealt to CashMatteo [8d 9h]
frnkthetank said, "nh"
CashMatteo: raises $0.15 to $0.25
tedward13: raises $0.85 to $1.10
Khab00m: calls $1.10
kimcop: folds 
frnkthetank: folds 
yobrudere: folds 
CashMatteo: folds 
*** FLOP *** [Jc Qd 3h]
tedward13: bets $1.24
Khab00m: calls $1.24
*** TURN *** [Jc Qd 3h] [Ks]
tedward13: checks 
Khab00m: bets $2
tedward13: calls $2
*** RIVER *** [Jc Qd 3h Ks] [7d]
tedward13: checks 
Khab00m: bets $2.90
tedward13: calls $2.90
*** SHOW DOWN ***
Khab00m: shows [8h Kh] (a pair of Kings)
tedward13: shows [Kd Ad] (a pair of Kings - Ace kicker)
frnkthetank said, "Love it when donkeys get punished "
tedward13 collected $14.21 from pot
*** SUMMARY ***
Total pot $14.88 | Rake $0.67 
Board [Jc Qd 3h Ks 7d]
Seat 1: yobrudere (big blind) folded before Flop
Seat 2: CashMatteo folded before Flop
Seat 3: tedward13 showed [Kd Ad] and won ($14.21) with a pair of Kings
Seat 4: Khab00m showed [8h Kh] and lost with a pair of Kings
Seat 5: kimcop (button) folded before Flop (didn't bet)
Seat 6: frnkthetank (small blind) folded before Flop

Hand #1546: 

PokerStars Hand #246785188184:  Hold'em No Limit ($0.05/$0.10 CAD) - 2023/10/28 3:15:59 ET
Table 'Wilkens II' 6-max Seat #6 is the button
Seat 1: yobrudere ($19.81 in chips) 
Seat 2: CashMatteo ($4.14 in chips) 
Seat 3: tedward13 ($20.35 in chips) 
Seat 4: Khab00m ($2.61 in chips) 
Seat 5: kimcop ($27.55 in chips) 
Seat 6: frnkthetank ($6.39 in chips) 
yobrudere: posts small blind $0.05
CashMatteo: posts big blind $0.10
*** HOLE CARDS ***
Dealt to CashMatteo [8d Ad]
tedward13: folds 
Khab00m: folds 
kimcop: folds 
frnkthetank: folds 
yobrudere: calls $0.05
CashMatteo: raises $4.04 to $4.14 and is all-in
yobrudere: folds 
Uncalled bet ($4.04) returned to CashMatteo
CashMatteo collected $0.20 from pot
CashMatteo: doesn't show hand 
*** SUMMARY ***
Total pot $0.20 | Rake $0 
Seat 1: yobrudere (small blind) folded before Flop
Seat 2: CashMatteo (big blind) collected ($0.20)
Seat 3: tedward13 folded before Flop (didn't bet)
Seat 4: Khab00m folded before Flop (didn't bet)
Seat 5: kimcop folded before Flop (didn't bet)
Seat 6: frnkthetank (button) folded before Flop (didn't bet)

Hand #1547: 

PokerStars Hand #246785190076:  Hold'em No Limit ($0.05/$0.10 CAD) - 2023/10/28 3:16:17 ET
Table 'Wilkens II' 6-max Seat #1 is the button
Seat 1: yobrudere ($19.71 in chips) 
Seat 2: CashMatteo ($4.24 in chips) 
Seat 3: tedward13 ($20.35 in chips) 
Seat 4: Khab00m ($10 in chips) 
Seat 5: kimcop ($27.55 in chips) 
Seat 6: frnkthetank ($6.39 in chips) 
CashMatteo: posts small blind $0.05
tedward13: posts big blind $0.10
*** HOLE CARDS ***
Dealt to CashMatteo [Ad Th]
Khab00m has timed out
Khab00m: folds 
kimcop: folds 
frnkthetank: folds 
yobrudere: folds 
CashMatteo: raises $0.15 to $0.25
tedward13: calls $0.15
*** FLOP *** [6s 4d 2d]
CashMatteo: bets $0.24
tedward13: calls $0.24
*** TURN *** [6s 4d 2d] [5s]
CashMatteo: checks 
tedward13: bets $0.20
CashMatteo: calls $0.20
*** RIVER *** [6s 4d 2d 5s] [5h]
CashMatteo: checks 
tedward13: bets $0.66
CashMatteo: calls $0.66
*** SHOW DOWN ***
tedward13: shows [Td 5d] (three of a kind, Fives)
CashMatteo: mucks hand 
tedward13 collected $2.58 from pot
*** SUMMARY ***
Total pot $2.70 | Rake $0.12 
Board [6s 4d 2d 5s 5h]
Seat 1: yobrudere (button) folded before Flop (didn't bet)
Seat 2: CashMatteo (small blind) mucked [Ad Th]
Seat 3: tedward13 (big blind) showed [Td 5d] and won ($2.58) with three of a kind, Fives
Seat 4: Khab00m folded before Flop (didn't bet)
Seat 5: kimcop folded before Flop (didn't bet)
Seat 6: frnkthetank folded before Flop (didn't bet)

Hand #1548: 

PokerStars Hand #246785195511:  Hold'em No Limit ($0.05/$0.10 CAD) - 2023/10/28 3:17:07 ET
Table 'Wilkens II' 6-max Seat #2 is the button
Seat 1: yobrudere ($19.71 in chips) 
Seat 2: CashMatteo ($2.89 in chips) 
Seat 3: tedward13 ($21.58 in chips) 
Seat 5: kimcop ($27.55 in chips) 
Seat 6: frnkthetank ($6.39 in chips) 
tedward13: posts small blind $0.05
kimcop: posts big blind $0.10
*** HOLE CARDS ***
Dealt to CashMatteo [8s Ts]
frnkthetank: calls $0.10
yobrudere: folds 
CashMatteo: raises $0.15 to $0.25
frnkthetank said, "Haha"
tedward13: folds 
kimcop: folds 
frnkthetank: calls $0.15
*** FLOP *** [8h Qd 6c]
frnkthetank: checks 
CashMatteo: bets $0.31
frnkthetank: folds 
Uncalled bet ($0.31) returned to CashMatteo
CashMatteo collected $0.62 from pot
CashMatteo: doesn't show hand 
*** SUMMARY ***
Total pot $0.65 | Rake $0.03 
Board [8h Qd 6c]
Seat 1: yobrudere folded before Flop (didn't bet)
Seat 2: CashMatteo (button) collected ($0.62)
Seat 3: tedward13 (small blind) folded before Flop
Seat 5: kimcop (big blind) folded before Flop
Seat 6: frnkthetank folded on the Flop

Hand #1549: 

PokerStars Hand #246785198303:  Hold'em No Limit ($0.05/$0.10 CAD) - 2023/10/28 3:17:33 ET
Table 'Wilkens II' 6-max Seat #3 is the button
Seat 1: yobrudere ($19.71 in chips) 
Seat 2: CashMatteo ($3.26 in chips) 
Seat 3: tedward13 ($21.53 in chips) 
Seat 5: kimcop ($27.45 in chips) 
Seat 6: frnkthetank ($6.14 in chips) 
Khab00m will be allowed to play after the button
kimcop: posts small blind $0.05
frnkthetank: posts big blind $0.10
*** HOLE CARDS ***
Dealt to CashMatteo [Kd 4s]
yobrudere: folds 
CashMatteo: folds 
tedward13: raises $0.10 to $0.20
kimcop: folds 
frnkthetank: calls $0.10
*** FLOP *** [Jh 5c Jd]
frnkthetank: checks 
tedward13: bets $0.30
frnkthetank: folds 
Uncalled bet ($0.30) returned to tedward13
tedward13 collected $0.43 from pot
*** SUMMARY ***
Total pot $0.45 | Rake $0.02 
Board [Jh 5c Jd]
Seat 1: yobrudere folded before Flop (didn't bet)
Seat 2: CashMatteo folded before Flop (didn't bet)
Seat 3: tedward13 (button) collected ($0.43)
Seat 5: kimcop (small blind) folded before Flop
Seat 6: frnkthetank (big blind) folded on the Flop

Hand #1550: 

PokerStars Hand #246785201271:  Hold'em No Limit ($0.05/$0.10 CAD) - 2023/10/28 3:18:00 ET
Table 'Wilkens II' 6-max Seat #5 is the button
Seat 1: yobrudere ($19.71 in chips) 
Seat 2: CashMatteo ($3.26 in chips) 
Seat 3: tedward13 ($21.76 in chips) 
Seat 5: kimcop ($27.40 in chips) 
Seat 6: frnkthetank ($5.94 in chips) 
frnkthetank: posts small blind $0.05
yobrudere: posts big blind $0.10
Khab00m: sits out 
*** HOLE CARDS ***
Dealt to CashMatteo [3d Tc]
CashMatteo: raises $0.15 to $0.25
tedward13: folds 
kimcop: folds 
frnkthetank: calls $0.20
yobrudere: folds 
*** FLOP *** [4d Td 9c]
frnkthetank: checks 
CashMatteo: bets $0.29
frnkthetank: folds 
Uncalled bet ($0.29) returned to CashMatteo
CashMatteo collected $0.57 from pot
CashMatteo: doesn't show hand 
*** SUMMARY ***
Total pot $0.60 | Rake $0.03 
Board [4d Td 9c]
Seat 1: yobrudere (big blind) folded before Flop
Seat 2: CashMatteo collected ($0.57)
Seat 3: tedward13 folded before Flop (didn't bet)
Seat 5: kimcop (button) folded before Flop (didn't bet)
Seat 6: frnkthetank (small blind) folded on the Flop

Hand #1551: 

PokerStars Hand #246785203389:  Hold'em No Limit ($0.05/$0.10 CAD) - 2023/10/28 3:18:19 ET
Table 'Wilkens II' 6-max Seat #6 is the button
Seat 1: yobrudere ($19.61 in chips) 
Seat 2: CashMatteo ($3.58 in chips) 
Seat 3: tedward13 ($21.76 in chips) 
Seat 5: kimcop ($27.40 in chips) 
Seat 6: frnkthetank ($5.69 in chips) 
yobrudere: posts small blind $0.05
CashMatteo: posts big blind $0.10
Khab00m: sits out 
*** HOLE CARDS ***
Dealt to CashMatteo [4s Ts]
tedward13: folds 
kimcop: folds 
frnkthetank: folds 
yobrudere: folds 
Uncalled bet ($0.05) returned to CashMatteo
CashMatteo collected $0.10 from pot
CashMatteo: doesn't show hand 
*** SUMMARY ***
Total pot $0.10 | Rake $0 
Seat 1: yobrudere (small blind) folded before Flop
Seat 2: CashMatteo (big blind) collected ($0.10)
Seat 3: tedward13 folded before Flop (didn't bet)
Seat 5: kimcop folded before Flop (didn't bet)
Seat 6: frnkthetank (button) folded before Flop (didn't bet)

Hand #1552: 

PokerStars Hand #246785205162:  Hold'em No Limit ($0.05/$0.10 CAD) - 2023/10/28 3:18:36 ET
Table 'Wilkens II' 6-max Seat #1 is the button
Seat 1: yobrudere ($19.56 in chips) 
Seat 2: CashMatteo ($3.63 in chips) 
Seat 3: tedward13 ($21.76 in chips) 
Seat 5: kimcop ($27.40 in chips) 
Seat 6: frnkthetank ($5.69 in chips) 
CashMatteo: posts small blind $0.05
tedward13: posts big blind $0.10
Khab00m: sits out 
*** HOLE CARDS ***
Dealt to CashMatteo [9h 2d]
kimcop: folds 
frnkthetank: folds 
yobrudere: folds 
CashMatteo: raises $0.15 to $0.25
tedward13: calls $0.15
*** FLOP *** [5d 4s Kh]
CashMatteo: bets $0.24
tedward13: folds 
Uncalled bet ($0.24) returned to CashMatteo
CashMatteo collected $0.48 from pot
CashMatteo: doesn't show hand 
*** SUMMARY ***
Total pot $0.50 | Rake $0.02 
Board [5d 4s Kh]
Seat 1: yobrudere (button) folded before Flop (didn't bet)
Seat 2: CashMatteo (small blind) collected ($0.48)
Seat 3: tedward13 (big blind) folded on the Flop
Seat 5: kimcop folded before Flop (didn't bet)
Seat 6: frnkthetank folded before Flop (didn't bet)

Hand #1553: 

PokerStars Hand #246785207470:  Hold'em No Limit ($0.05/$0.10 CAD) - 2023/10/28 3:18:58 ET
Table 'Wilkens II' 6-max Seat #2 is the button
Seat 1: yobrudere ($19.56 in chips) 
Seat 2: CashMatteo ($3.86 in chips) 
Seat 3: tedward13 ($21.51 in chips) 
Seat 4: Khab00m ($10 in chips) 
Seat 5: kimcop ($27.40 in chips) 
Seat 6: frnkthetank ($5.69 in chips) 
tedward13: posts small blind $0.05
Khab00m: posts big blind $0.10
*** HOLE CARDS ***
Dealt to CashMatteo [Ks Qd]
kimcop: calls $0.10
frnkthetank: folds 
yobrudere: folds 
CashMatteo: raises $0.40 to $0.50
tedward13: folds 
Khab00m: folds 
kimcop: folds 
Uncalled bet ($0.40) returned to CashMatteo
CashMatteo collected $0.35 from pot
CashMatteo: doesn't show hand 
*** SUMMARY ***
Total pot $0.35 | Rake $0 
Seat 1: yobrudere folded before Flop (didn't bet)
Seat 2: CashMatteo (button) collected ($0.35)
Seat 3: tedward13 (small blind) folded before Flop
Seat 4: Khab00m (big blind) folded before Flop
Seat 5: kimcop folded before Flop
Seat 6: frnkthetank folded before Flop (didn't bet)

Hand #1554: 

PokerStars Hand #246785209392:  Hold'em No Limit ($0.05/$0.10 CAD) - 2023/10/28 3:19:16 ET
Table 'Wilkens II' 6-max Seat #3 is the button
Seat 1: yobrudere ($19.56 in chips) 
Seat 2: CashMatteo ($4.11 in chips) 
Seat 3: tedward13 ($21.46 in chips) 
Seat 4: Khab00m ($9.90 in chips) 
Seat 5: kimcop ($27.30 in chips) 
Seat 6: frnkthetank ($5.69 in chips) 
Khab00m: posts small blind $0.05
kimcop: posts big blind $0.10
*** HOLE CARDS ***
Dealt to CashMatteo [9h Ah]
frnkthetank: calls $0.10
yobrudere: folds 
CashMatteo: raises $0.35 to $0.45
tedward13: folds 
Khab00m: raises $1.10 to $1.55
kimcop: folds 
frnkthetank: folds 
CashMatteo: raises $2.56 to $4.11 and is all-in
Khab00m: calls $2.56
*** FLOP *** [5c 7d 3s]
*** TURN *** [5c 7d 3s] [3c]
*** RIVER *** [5c 7d 3s 3c] [8h]
*** SHOW DOWN ***
Khab00m: shows [As Ks] (a pair of Threes)
CashMatteo: shows [9h Ah] (a pair of Threes - lower kicker)
Khab00m collected $8.04 from pot
*** SUMMARY ***
Total pot $8.42 | Rake $0.38 
Board [5c 7d 3s 3c 8h]
Seat 1: yobrudere folded before Flop (didn't bet)
Seat 2: CashMatteo showed [9h Ah] and lost with a pair of Threes
Seat 3: tedward13 (button) folded before Flop (didn't bet)
Seat 4: Khab00m (small blind) showed [As Ks] and won ($8.04) with a pair of Threes
Seat 5: kimcop (big blind) folded before Flop
Seat 6: frnkthetank folded before Flop

Hand #1555: 

PokerStars Hand #246785218976: Tournament #3664951546, $0.92+$0.08 CAD Hold'em No Limit - Level I (10/20) - 2023/10/28 3:20:43 ET
Table '3664951546 1' 3-max Seat #1 is the button
Seat 1: CashMatteo (500 in chips) 
Seat 2: janger6 (500 in chips) 
Seat 3: toodarnlucky (500 in chips) 
janger6: posts small blind 10
toodarnlucky: posts big blind 20
*** HOLE CARDS ***
Dealt to CashMatteo [7c Qh]
CashMatteo: folds 
janger6: calls 10
toodarnlucky: raises 40 to 60
janger6: folds 
Uncalled bet (40) returned to toodarnlucky
toodarnlucky collected 40 from pot
toodarnlucky: doesn't show hand 
*** SUMMARY ***
Total pot 40 | Rake 0 
Seat 1: CashMatteo (button) folded before Flop (didn't bet)
Seat 2: janger6 (small blind) folded before Flop
Seat 3: toodarnlucky (big blind) collected (40)

Hand #1556: 

PokerStars Hand #246785220127: Tournament #3664951546, $0.92+$0.08 CAD Hold'em No Limit - Level I (10/20) - 2023/10/28 3:20:53 ET
Table '3664951546 1' 3-max Seat #2 is the button
Seat 1: CashMatteo (500 in chips) 
Seat 2: janger6 (480 in chips) 
Seat 3: toodarnlucky (520 in chips) 
toodarnlucky: posts small blind 10
CashMatteo: posts big blind 20
*** HOLE CARDS ***
Dealt to CashMatteo [6c 7c]
janger6: folds 
toodarnlucky: raises 40 to 60
CashMatteo: calls 40
*** FLOP *** [8d Ts Jh]
toodarnlucky: checks 
CashMatteo: bets 60
toodarnlucky: folds 
Uncalled bet (60) returned to CashMatteo
CashMatteo collected 120 from pot
CashMatteo: doesn't show hand 
*** SUMMARY ***
Total pot 120 | Rake 0 
Board [8d Ts Jh]
Seat 1: CashMatteo (big blind) collected (120)
Seat 2: janger6 (button) folded before Flop (didn't bet)
Seat 3: toodarnlucky (small blind) folded on the Flop

Hand #1557: 

PokerStars Hand #246785222024: Tournament #3664951546, $0.92+$0.08 CAD Hold'em No Limit - Level I (10/20) - 2023/10/28 3:21:11 ET
Table '3664951546 1' 3-max Seat #3 is the button
Seat 1: CashMatteo (560 in chips) 
Seat 2: janger6 (480 in chips) 
Seat 3: toodarnlucky (460 in chips) 
CashMatteo: posts small blind 10
janger6: posts big blind 20
*** HOLE CARDS ***
Dealt to CashMatteo [7h 5s]
toodarnlucky: calls 20
CashMatteo: calls 10
janger6: checks 
*** FLOP *** [Qd 5h 4d]
CashMatteo: checks 
janger6: checks 
toodarnlucky: bets 40
CashMatteo: calls 40
janger6: calls 40
*** TURN *** [Qd 5h 4d] [Kh]
CashMatteo: checks 
janger6: checks 
toodarnlucky: checks 
*** RIVER *** [Qd 5h 4d Kh] [Kc]
CashMatteo: checks 
janger6: checks 
toodarnlucky: checks 
*** SHOW DOWN ***
CashMatteo: shows [7h 5s] (two pair, Kings and Fives)
janger6: mucks hand 
toodarnlucky: mucks hand 
CashMatteo collected 180 from pot
*** SUMMARY ***
Total pot 180 | Rake 0 
Board [Qd 5h 4d Kh Kc]
Seat 1: CashMatteo (small blind) showed [7h 5s] and won (180) with two pair, Kings and Fives
Seat 2: janger6 (big blind) mucked [3d 4h]
Seat 3: toodarnlucky (button) mucked [4s 2s]

Hand #1558: 

PokerStars Hand #246785226408: Tournament #3664951546, $0.92+$0.08 CAD Hold'em No Limit - Level I (10/20) - 2023/10/28 3:21:51 ET
Table '3664951546 1' 3-max Seat #1 is the button
Seat 1: CashMatteo (680 in chips) 
Seat 2: janger6 (420 in chips) 
Seat 3: toodarnlucky (400 in chips) 
janger6: posts small blind 10
toodarnlucky: posts big blind 20
*** HOLE CARDS ***
Dealt to CashMatteo [6h As]
CashMatteo: raises 40 to 60
janger6: folds 
toodarnlucky: raises 100 to 160
CashMatteo: calls 100
*** FLOP *** [Ad 5h 7s]
toodarnlucky: checks 
CashMatteo: bets 80
toodarnlucky: folds 
Uncalled bet (80) returned to CashMatteo
CashMatteo collected 330 from pot
CashMatteo: doesn't show hand 
*** SUMMARY ***
Total pot 330 | Rake 0 
Board [Ad 5h 7s]
Seat 1: CashMatteo (button) collected (330)
Seat 2: janger6 (small blind) folded before Flop
Seat 3: toodarnlucky (big blind) folded on the Flop

Hand #1559: 

PokerStars Hand #246785230691: Tournament #3664951546, $0.92+$0.08 CAD Hold'em No Limit - Level I (10/20) - 2023/10/28 3:22:31 ET
Table '3664951546 1' 3-max Seat #2 is the button
Seat 1: CashMatteo (850 in chips) 
Seat 2: janger6 (410 in chips) 
Seat 3: toodarnlucky (240 in chips) 
toodarnlucky: posts small blind 10
CashMatteo: posts big blind 20
*** HOLE CARDS ***
Dealt to CashMatteo [7h Td]
janger6: folds 
toodarnlucky: raises 60 to 80
CashMatteo: folds 
Uncalled bet (60) returned to toodarnlucky
toodarnlucky collected 40 from pot
toodarnlucky: doesn't show hand 
*** SUMMARY ***
Total pot 40 | Rake 0 
Seat 1: CashMatteo (big blind) folded before Flop
Seat 2: janger6 (button) folded before Flop (didn't bet)
Seat 3: toodarnlucky (small blind) collected (40)

Hand #1560: 

PokerStars Hand #246785232526: Tournament #3664951546, $0.92+$0.08 CAD Hold'em No Limit - Level II (15/30) - 2023/10/28 3:22:49 ET
Table '3664951546 1' 3-max Seat #3 is the button
Seat 1: CashMatteo (830 in chips) 
Seat 2: janger6 (410 in chips) 
Seat 3: toodarnlucky (260 in chips) 
CashMatteo: posts small blind 15
janger6: posts big blind 30
*** HOLE CARDS ***
Dealt to CashMatteo [Td 9h]
toodarnlucky: calls 30
CashMatteo: calls 15
janger6: checks 
*** FLOP *** [5c 2h Ts]
CashMatteo: checks 
janger6: checks 
toodarnlucky: bets 90
CashMatteo: raises 140 to 230
janger6: folds 
toodarnlucky: calls 140 and is all-in
*** TURN *** [5c 2h Ts] [3d]
*** RIVER *** [5c 2h Ts 3d] [Qc]
*** SHOW DOWN ***
CashMatteo: shows [Td 9h] (a pair of Tens)
toodarnlucky: shows [5d 7d] (a pair of Fives)
CashMatteo collected 550 from pot
toodarnlucky finished the tournament in 3rd place
*** SUMMARY ***
Total pot 550 | Rake 0 
Board [5c 2h Ts 3d Qc]
Seat 1: CashMatteo (small blind) showed [Td 9h] and won (550) with a pair of Tens
Seat 2: janger6 (big blind) folded on the Flop
Seat 3: toodarnlucky (button) showed [5d 7d] and lost with a pair of Fives

Hand #1561: 

PokerStars Hand #246785236556: Tournament #3664951546, $0.92+$0.08 CAD Hold'em No Limit - Level II (15/30) - 2023/10/28 3:23:26 ET
Table '3664951546 1' 3-max Seat #2 is the button
Seat 1: CashMatteo (1120 in chips) 
Seat 2: janger6 (380 in chips) 
janger6: posts small blind 15
CashMatteo: posts big blind 30
*** HOLE CARDS ***
Dealt to CashMatteo [6s Kh]
janger6: calls 15
CashMatteo: raises 45 to 75
janger6: folds 
Uncalled bet (45) returned to CashMatteo
CashMatteo collected 60 from pot
CashMatteo: doesn't show hand 
*** SUMMARY ***
Total pot 60 | Rake 0 
Seat 1: CashMatteo (big blind) collected (60)
Seat 2: janger6 (button) (small blind) folded before Flop

Hand #1562: 

PokerStars Hand #246785237543: Tournament #3664951546, $0.92+$0.08 CAD Hold'em No Limit - Level II (15/30) - 2023/10/28 3:23:35 ET
Table '3664951546 1' 3-max Seat #1 is the button
Seat 1: CashMatteo (1150 in chips) 
Seat 2: janger6 (350 in chips) 
CashMatteo: posts small blind 15
janger6: posts big blind 30
*** HOLE CARDS ***
Dealt to CashMatteo [3d Jd]
CashMatteo: raises 45 to 75
janger6: calls 45
*** FLOP *** [Ts 4c Kc]
janger6: checks 
CashMatteo: checks 
*** TURN *** [Ts 4c Kc] [9c]
janger6: checks 
CashMatteo: checks 
*** RIVER *** [Ts 4c Kc 9c] [3c]
janger6: checks 
CashMatteo: bets 150
janger6: folds 
Uncalled bet (150) returned to CashMatteo
CashMatteo collected 150 from pot
CashMatteo: doesn't show hand 
*** SUMMARY ***
Total pot 150 | Rake 0 
Board [Ts 4c Kc 9c 3c]
Seat 1: CashMatteo (button) (small blind) collected (150)
Seat 2: janger6 (big blind) folded on the River

Hand #1563: 

PokerStars Hand #246785239855: Tournament #3664951546, $0.92+$0.08 CAD Hold'em No Limit - Level II (15/30) - 2023/10/28 3:23:57 ET
Table '3664951546 1' 3-max Seat #2 is the button
Seat 1: CashMatteo (1225 in chips) 
Seat 2: janger6 (275 in chips) 
janger6: posts small blind 15
CashMatteo: posts big blind 30
*** HOLE CARDS ***
Dealt to CashMatteo [4d 3h]
janger6: calls 15
CashMatteo: checks 
*** FLOP *** [Ad 7s 5h]
CashMatteo: checks 
janger6: bets 30
CashMatteo: calls 30
*** TURN *** [Ad 7s 5h] [Kd]
CashMatteo: checks 
janger6: bets 30
CashMatteo: folds 
Uncalled bet (30) returned to janger6
janger6 collected 120 from pot
janger6: doesn't show hand 
*** SUMMARY ***
Total pot 120 | Rake 0 
Board [Ad 7s 5h Kd]
Seat 1: CashMatteo (big blind) folded on the Turn
Seat 2: janger6 (button) (small blind) collected (120)

Hand #1564: 

PokerStars Hand #246785241945: Tournament #3664951546, $0.92+$0.08 CAD Hold'em No Limit - Level II (15/30) - 2023/10/28 3:24:17 ET
Table '3664951546 1' 3-max Seat #1 is the button
Seat 1: CashMatteo (1165 in chips) 
Seat 2: janger6 (335 in chips) 
CashMatteo: posts small blind 15
janger6: posts big blind 30
*** HOLE CARDS ***
Dealt to CashMatteo [8d 7c]
CashMatteo: raises 45 to 75
janger6: folds 
Uncalled bet (45) returned to CashMatteo
CashMatteo collected 60 from pot
CashMatteo: doesn't show hand 
*** SUMMARY ***
Total pot 60 | Rake 0 
Seat 1: CashMatteo (button) (small blind) collected (60)
Seat 2: janger6 (big blind) folded before Flop

Hand #1565: 

PokerStars Hand #246785242782: Tournament #3664951546, $0.92+$0.08 CAD Hold'em No Limit - Level II (15/30) - 2023/10/28 3:24:25 ET
Table '3664951546 1' 3-max Seat #2 is the button
Seat 1: CashMatteo (1195 in chips) 
Seat 2: janger6 (305 in chips) 
janger6: posts small blind 15
CashMatteo: posts big blind 30
*** HOLE CARDS ***
Dealt to CashMatteo [5s 7c]
janger6: calls 15
CashMatteo: checks 
*** FLOP *** [5d Kh 7s]
CashMatteo: checks 
janger6: checks 
*** TURN *** [5d Kh 7s] [9s]
CashMatteo: bets 30
janger6: folds 
Uncalled bet (30) returned to CashMatteo
CashMatteo collected 60 from pot
CashMatteo: doesn't show hand 
*** SUMMARY ***
Total pot 60 | Rake 0 
Board [5d Kh 7s 9s]
Seat 1: CashMatteo (big blind) collected (60)
Seat 2: janger6 (button) (small blind) folded on the Turn

Hand #1566: 

PokerStars Hand #246785244407: Tournament #3664951546, $0.92+$0.08 CAD Hold'em No Limit - Level II (15/30) - 2023/10/28 3:24:39 ET
Table '3664951546 1' 3-max Seat #1 is the button
Seat 1: CashMatteo (1225 in chips) 
Seat 2: janger6 (275 in chips) 
CashMatteo: posts small blind 15
janger6: posts big blind 30
*** HOLE CARDS ***
Dealt to CashMatteo [9d Kd]
CashMatteo: raises 45 to 75
janger6: folds 
Uncalled bet (45) returned to CashMatteo
CashMatteo collected 60 from pot
CashMatteo: doesn't show hand 
*** SUMMARY ***
Total pot 60 | Rake 0 
Seat 1: CashMatteo (button) (small blind) collected (60)
Seat 2: janger6 (big blind) folded before Flop

Hand #1567: 

PokerStars Hand #246785245523: Tournament #3664951546, $0.92+$0.08 CAD Hold'em No Limit - Level III (20/40) - 2023/10/28 3:24:50 ET
Table '3664951546 1' 3-max Seat #2 is the button
Seat 1: CashMatteo (1255 in chips) 
Seat 2: janger6 (245 in chips) 
janger6: posts small blind 20
CashMatteo: posts big blind 40
*** HOLE CARDS ***
Dealt to CashMatteo [Ks Ac]
janger6: calls 20
CashMatteo: raises 1215 to 1255 and is all-in
janger6: folds 
Uncalled bet (1215) returned to CashMatteo
CashMatteo collected 80 from pot
CashMatteo: doesn't show hand 
*** SUMMARY ***
Total pot 80 | Rake 0 
Seat 1: CashMatteo (big blind) collected (80)
Seat 2: janger6 (button) (small blind) folded before Flop

Hand #1568: 

PokerStars Hand #246785246619: Tournament #3664951546, $0.92+$0.08 CAD Hold'em No Limit - Level III (20/40) - 2023/10/28 3:25:00 ET
Table '3664951546 1' 3-max Seat #1 is the button
Seat 1: CashMatteo (1295 in chips) 
Seat 2: janger6 (205 in chips) 
CashMatteo: posts small blind 20
janger6: posts big blind 40
*** HOLE CARDS ***
Dealt to CashMatteo [Qd Ah]
CashMatteo: raises 1255 to 1295 and is all-in
janger6: folds 
Uncalled bet (1255) returned to CashMatteo
CashMatteo collected 80 from pot
CashMatteo: doesn't show hand 
*** SUMMARY ***
Total pot 80 | Rake 0 
Seat 1: CashMatteo (button) (small blind) collected (80)
Seat 2: janger6 (big blind) folded before Flop

Hand #1569: 

PokerStars Hand #246785247492: Tournament #3664951546, $0.92+$0.08 CAD Hold'em No Limit - Level III (20/40) - 2023/10/28 3:25:08 ET
Table '3664951546 1' 3-max Seat #2 is the button
Seat 1: CashMatteo (1335 in chips) 
Seat 2: janger6 (165 in chips) 
janger6: posts small blind 20
CashMatteo: posts big blind 40
*** HOLE CARDS ***
Dealt to CashMatteo [2h 6d]
janger6: calls 20
CashMatteo: raises 1295 to 1335 and is all-in
janger6: calls 125 and is all-in
Uncalled bet (1170) returned to CashMatteo
*** FLOP *** [7s 4c Kd]
*** TURN *** [7s 4c Kd] [7d]
*** RIVER *** [7s 4c Kd 7d] [5h]
*** SHOW DOWN ***
CashMatteo: shows [2h 6d] (a pair of Sevens)
janger6: shows [6s 5c] (two pair, Sevens and Fives)
janger6 collected 330 from pot
*** SUMMARY ***
Total pot 330 | Rake 0 
Board [7s 4c Kd 7d 5h]
Seat 1: CashMatteo (big blind) showed [2h 6d] and lost with a pair of Sevens
Seat 2: janger6 (button) (small blind) showed [6s 5c] and won (330) with two pair, Sevens and Fives

Hand #1570: 

PokerStars Hand #246785249396: Tournament #3664951546, $0.92+$0.08 CAD Hold'em No Limit - Level III (20/40) - 2023/10/28 3:25:25 ET
Table '3664951546 1' 3-max Seat #1 is the button
Seat 1: CashMatteo (1170 in chips) 
Seat 2: janger6 (330 in chips) 
CashMatteo: posts small blind 20
janger6: posts big blind 40
*** HOLE CARDS ***
Dealt to CashMatteo [Jc 6s]
CashMatteo: folds 
Uncalled bet (20) returned to janger6
janger6 collected 40 from pot
janger6: doesn't show hand 
*** SUMMARY ***
Total pot 40 | Rake 0 
Seat 1: CashMatteo (button) (small blind) folded before Flop
Seat 2: janger6 (big blind) collected (40)

Hand #1571: 

PokerStars Hand #246785249957: Tournament #3664951546, $0.92+$0.08 CAD Hold'em No Limit - Level III (20/40) - 2023/10/28 3:25:30 ET
Table '3664951546 1' 3-max Seat #2 is the button
Seat 1: CashMatteo (1150 in chips) 
Seat 2: janger6 (350 in chips) 
janger6: posts small blind 20
CashMatteo: posts big blind 40
*** HOLE CARDS ***
Dealt to CashMatteo [Qs 4s]
janger6: calls 20
CashMatteo: checks 
*** FLOP *** [8s Tc Qd]
CashMatteo: checks 
janger6: checks 
*** TURN *** [8s Tc Qd] [5s]
CashMatteo: bets 40
janger6: calls 40
*** RIVER *** [8s Tc Qd 5s] [7h]
CashMatteo: checks 
janger6: checks 
*** SHOW DOWN ***
CashMatteo: shows [Qs 4s] (a pair of Queens)
janger6: mucks hand 
CashMatteo collected 160 from pot
*** SUMMARY ***
Total pot 160 | Rake 0 
Board [8s Tc Qd 5s 7h]
Seat 1: CashMatteo (big blind) showed [Qs 4s] and won (160) with a pair of Queens
Seat 2: janger6 (button) (small blind) mucked [2h 5h]

Hand #1572: 

PokerStars Hand #246785251763: Tournament #3664951546, $0.92+$0.08 CAD Hold'em No Limit - Level III (20/40) - 2023/10/28 3:25:47 ET
Table '3664951546 1' 3-max Seat #1 is the button
Seat 1: CashMatteo (1230 in chips) 
Seat 2: janger6 (270 in chips) 
CashMatteo: posts small blind 20
janger6: posts big blind 40
*** HOLE CARDS ***
Dealt to CashMatteo [Qs Qc]
CashMatteo: raises 60 to 100
janger6: folds 
Uncalled bet (60) returned to CashMatteo
CashMatteo collected 80 from pot
CashMatteo: doesn't show hand 
*** SUMMARY ***
Total pot 80 | Rake 0 
Seat 1: CashMatteo (button) (small blind) collected (80)
Seat 2: janger6 (big blind) folded before Flop

Hand #1573: 

PokerStars Hand #246785252747: Tournament #3664951546, $0.92+$0.08 CAD Hold'em No Limit - Level III (20/40) - 2023/10/28 3:25:56 ET
Table '3664951546 1' 3-max Seat #2 is the button
Seat 1: CashMatteo (1270 in chips) 
Seat 2: janger6 (230 in chips) 
janger6: posts small blind 20
CashMatteo: posts big blind 40
*** HOLE CARDS ***
Dealt to CashMatteo [4h Kc]
janger6: calls 20
CashMatteo: checks 
*** FLOP *** [Th 8s Js]
CashMatteo: checks 
janger6: checks 
*** TURN *** [Th 8s Js] [9h]
CashMatteo: bets 40
janger6: calls 40
*** RIVER *** [Th 8s Js 9h] [2c]
CashMatteo: checks 
janger6: bets 150 and is all-in
CashMatteo: folds 
Uncalled bet (150) returned to janger6
janger6 collected 160 from pot
janger6: doesn't show hand 
*** SUMMARY ***
Total pot 160 | Rake 0 
Board [Th 8s Js 9h 2c]
Seat 1: CashMatteo (big blind) folded on the River
Seat 2: janger6 (button) (small blind) collected (160)

Hand #1574: 

PokerStars Hand #246785255694: Tournament #3664951546, $0.92+$0.08 CAD Hold'em No Limit - Level III (20/40) - 2023/10/28 3:26:23 ET
Table '3664951546 1' 3-max Seat #1 is the button
Seat 1: CashMatteo (1190 in chips) 
Seat 2: janger6 (310 in chips) 
CashMatteo: posts small blind 20
janger6: posts big blind 40
*** HOLE CARDS ***
Dealt to CashMatteo [8s As]
CashMatteo: raises 60 to 100
janger6: folds 
Uncalled bet (60) returned to CashMatteo
CashMatteo collected 80 from pot
CashMatteo: doesn't show hand 
*** SUMMARY ***
Total pot 80 | Rake 0 
Seat 1: CashMatteo (button) (small blind) collected (80)
Seat 2: janger6 (big blind) folded before Flop

Hand #1575: 

PokerStars Hand #246785256595: Tournament #3664951546, $0.92+$0.08 CAD Hold'em No Limit - Level III (20/40) - 2023/10/28 3:26:31 ET
Table '3664951546 1' 3-max Seat #2 is the button
Seat 1: CashMatteo (1230 in chips) 
Seat 2: janger6 (270 in chips) 
janger6: posts small blind 20
CashMatteo: posts big blind 40
*** HOLE CARDS ***
Dealt to CashMatteo [2s 7s]
janger6: folds 
Uncalled bet (20) returned to CashMatteo
CashMatteo collected 40 from pot
CashMatteo: doesn't show hand 
*** SUMMARY ***
Total pot 40 | Rake 0 
Seat 1: CashMatteo (big blind) collected (40)
Seat 2: janger6 (button) (small blind) folded before Flop

Hand #1576: 

PokerStars Hand #246785257173: Tournament #3664951546, $0.92+$0.08 CAD Hold'em No Limit - Level III (20/40) - 2023/10/28 3:26:36 ET
Table '3664951546 1' 3-max Seat #1 is the button
Seat 1: CashMatteo (1250 in chips) 
Seat 2: janger6 (250 in chips) 
CashMatteo: posts small blind 20
janger6: posts big blind 40
*** HOLE CARDS ***
Dealt to CashMatteo [Ad Tc]
CashMatteo: raises 60 to 100
janger6: folds 
Uncalled bet (60) returned to CashMatteo
CashMatteo collected 80 from pot
CashMatteo: doesn't show hand 
*** SUMMARY ***
Total pot 80 | Rake 0 
Seat 1: CashMatteo (button) (small blind) collected (80)
Seat 2: janger6 (big blind) folded before Flop

Hand #1577: 

PokerStars Hand #246785258665: Tournament #3664951546, $0.92+$0.08 CAD Hold'em No Limit - Level IV (30/60) - 2023/10/28 3:26:50 ET
Table '3664951546 1' 3-max Seat #2 is the button
Seat 1: CashMatteo (1290 in chips) 
Seat 2: janger6 (210 in chips) 
janger6: posts small blind 30
CashMatteo: posts big blind 60
*** HOLE CARDS ***
Dealt to CashMatteo [8s 8c]
janger6: calls 30
CashMatteo: raises 1230 to 1290 and is all-in
janger6: calls 150 and is all-in
Uncalled bet (1080) returned to CashMatteo
*** FLOP *** [3c Qd 6c]
*** TURN *** [3c Qd 6c] [5c]
*** RIVER *** [3c Qd 6c 5c] [9d]
*** SHOW DOWN ***
CashMatteo: shows [8s 8c] (a pair of Eights)
janger6: shows [6d Qs] (two pair, Queens and Sixes)
janger6 collected 420 from pot
*** SUMMARY ***
Total pot 420 | Rake 0 
Board [3c Qd 6c 5c 9d]
Seat 1: CashMatteo (big blind) showed [8s 8c] and lost with a pair of Eights
Seat 2: janger6 (button) (small blind) showed [6d Qs] and won (420) with two pair, Queens and Sixes

Hand #1578: 

PokerStars Hand #246785260340: Tournament #3664951546, $0.92+$0.08 CAD Hold'em No Limit - Level IV (30/60) - 2023/10/28 3:27:05 ET
Table '3664951546 1' 3-max Seat #1 is the button
Seat 1: CashMatteo (1080 in chips) 
Seat 2: janger6 (420 in chips) 
CashMatteo: posts small blind 30
janger6: posts big blind 60
*** HOLE CARDS ***
Dealt to CashMatteo [8d 3s]
CashMatteo: folds 
Uncalled bet (30) returned to janger6
janger6 collected 60 from pot
janger6: doesn't show hand 
*** SUMMARY ***
Total pot 60 | Rake 0 
Seat 1: CashMatteo (button) (small blind) folded before Flop
Seat 2: janger6 (big blind) collected (60)

Hand #1579: 

PokerStars Hand #246785260879: Tournament #3664951546, $0.92+$0.08 CAD Hold'em No Limit - Level IV (30/60) - 2023/10/28 3:27:10 ET
Table '3664951546 1' 3-max Seat #2 is the button
Seat 1: CashMatteo (1050 in chips) 
Seat 2: janger6 (450 in chips) 
janger6: posts small blind 30
CashMatteo: posts big blind 60
*** HOLE CARDS ***
Dealt to CashMatteo [5h 8c]
janger6: calls 30
CashMatteo: checks 
*** FLOP *** [4d 2h 6c]
CashMatteo: checks 
janger6: checks 
*** TURN *** [4d 2h 6c] [Jd]
CashMatteo: bets 60
janger6: calls 60
*** RIVER *** [4d 2h 6c Jd] [Th]
CashMatteo: checks 
janger6: checks 
*** SHOW DOWN ***
CashMatteo: shows [5h 8c] (high card Jack)
janger6: shows [3d Kd] (high card King)
janger6 collected 240 from pot
*** SUMMARY ***
Total pot 240 | Rake 0 
Board [4d 2h 6c Jd Th]
Seat 1: CashMatteo (big blind) showed [5h 8c] and lost with high card Jack
Seat 2: janger6 (button) (small blind) showed [3d Kd] and won (240) with high card King

Hand #1580: 

PokerStars Hand #246785262953: Tournament #3664951546, $0.92+$0.08 CAD Hold'em No Limit - Level IV (30/60) - 2023/10/28 3:27:29 ET
Table '3664951546 1' 3-max Seat #1 is the button
Seat 1: CashMatteo (930 in chips) 
Seat 2: janger6 (570 in chips) 
CashMatteo: posts small blind 30
janger6: posts big blind 60
*** HOLE CARDS ***
Dealt to CashMatteo [2h 5h]
CashMatteo: raises 90 to 150
janger6: calls 90
*** FLOP *** [Qh Th 6d]
janger6: checks 
CashMatteo: bets 150
janger6: folds 
Uncalled bet (150) returned to CashMatteo
CashMatteo collected 300 from pot
CashMatteo: doesn't show hand 
*** SUMMARY ***
Total pot 300 | Rake 0 
Board [Qh Th 6d]
Seat 1: CashMatteo (button) (small blind) collected (300)
Seat 2: janger6 (big blind) folded on the Flop

Hand #1581: 

PokerStars Hand #246785264515: Tournament #3664951546, $0.92+$0.08 CAD Hold'em No Limit - Level IV (30/60) - 2023/10/28 3:27:44 ET
Table '3664951546 1' 3-max Seat #2 is the button
Seat 1: CashMatteo (1080 in chips) 
Seat 2: janger6 (420 in chips) 
janger6: posts small blind 30
CashMatteo: posts big blind 60
*** HOLE CARDS ***
Dealt to CashMatteo [Kd Jh]
janger6: calls 30
CashMatteo: raises 90 to 150
janger6: raises 270 to 420 and is all-in
CashMatteo: calls 270
*** FLOP *** [7c Ad Qh]
*** TURN *** [7c Ad Qh] [3d]
*** RIVER *** [7c Ad Qh 3d] [5c]
*** SHOW DOWN ***
CashMatteo: shows [Kd Jh] (high card Ace)
janger6: shows [6d 6h] (a pair of Sixes)
janger6 collected 840 from pot
*** SUMMARY ***
Total pot 840 | Rake 0 
Board [7c Ad Qh 3d 5c]
Seat 1: CashMatteo (big blind) showed [Kd Jh] and lost with high card Ace
Seat 2: janger6 (button) (small blind) showed [6d 6h] and won (840) with a pair of Sixes

Hand #1582: 

PokerStars Hand #246785267373: Tournament #3664951546, $0.92+$0.08 CAD Hold'em No Limit - Level IV (30/60) - 2023/10/28 3:28:10 ET
Table '3664951546 1' 3-max Seat #1 is the button
Seat 1: CashMatteo (660 in chips) 
Seat 2: janger6 (840 in chips) 
CashMatteo: posts small blind 30
janger6: posts big blind 60
*** HOLE CARDS ***
Dealt to CashMatteo [7d Kc]
CashMatteo: folds 
Uncalled bet (30) returned to janger6
janger6 collected 60 from pot
janger6: doesn't show hand 
*** SUMMARY ***
Total pot 60 | Rake 0 
Seat 1: CashMatteo (button) (small blind) folded before Flop
Seat 2: janger6 (big blind) collected (60)

Hand #1583: 

PokerStars Hand #246785267941: Tournament #3664951546, $0.92+$0.08 CAD Hold'em No Limit - Level IV (30/60) - 2023/10/28 3:28:15 ET
Table '3664951546 1' 3-max Seat #2 is the button
Seat 1: CashMatteo (630 in chips) 
Seat 2: janger6 (870 in chips) 
janger6: posts small blind 30
CashMatteo: posts big blind 60
*** HOLE CARDS ***
Dealt to CashMatteo [5h 4d]
janger6: calls 30
CashMatteo: checks 
*** FLOP *** [8d 6d Qs]
CashMatteo: checks 
janger6: checks 
*** TURN *** [8d 6d Qs] [3c]
CashMatteo: bets 60
janger6: calls 60
*** RIVER *** [8d 6d Qs 3c] [8h]
CashMatteo: bets 120
janger6: folds 
Uncalled bet (120) returned to CashMatteo
CashMatteo collected 240 from pot
CashMatteo: doesn't show hand 
*** SUMMARY ***
Total pot 240 | Rake 0 
Board [8d 6d Qs 3c 8h]
Seat 1: CashMatteo (big blind) collected (240)
Seat 2: janger6 (button) (small blind) folded on the River

Hand #1584: 

PokerStars Hand #246785270057: Tournament #3664951546, $0.92+$0.08 CAD Hold'em No Limit - Level IV (30/60) - 2023/10/28 3:28:34 ET
Table '3664951546 1' 3-max Seat #1 is the button
Seat 1: CashMatteo (750 in chips) 
Seat 2: janger6 (750 in chips) 
CashMatteo: posts small blind 30
janger6: posts big blind 60
*** HOLE CARDS ***
Dealt to CashMatteo [7d Ah]
CashMatteo: raises 690 to 750 and is all-in
janger6: folds 
Uncalled bet (690) returned to CashMatteo
CashMatteo collected 120 from pot
CashMatteo: doesn't show hand 
*** SUMMARY ***
Total pot 120 | Rake 0 
Seat 1: CashMatteo (button) (small blind) collected (120)
Seat 2: janger6 (big blind) folded before Flop

Hand #1585: 

PokerStars Hand #246785270811: Tournament #3664951546, $0.92+$0.08 CAD Hold'em No Limit - Level IV (30/60) - 2023/10/28 3:28:41 ET
Table '3664951546 1' 3-max Seat #2 is the button
Seat 1: CashMatteo (810 in chips) 
Seat 2: janger6 (690 in chips) 
janger6: posts small blind 30
CashMatteo: posts big blind 60
*** HOLE CARDS ***
Dealt to CashMatteo [8d 2h]
janger6: calls 30
CashMatteo: checks 
*** FLOP *** [Td 2s 7d]
CashMatteo: checks 
janger6: checks 
*** TURN *** [Td 2s 7d] [4d]
CashMatteo: bets 60
janger6: folds 
Uncalled bet (60) returned to CashMatteo
CashMatteo collected 120 from pot
CashMatteo: doesn't show hand 
*** SUMMARY ***
Total pot 120 | Rake 0 
Board [Td 2s 7d 4d]
Seat 1: CashMatteo (big blind) collected (120)
Seat 2: janger6 (button) (small blind) folded on the Turn

Hand #1586: 

PokerStars Hand #246785272766: Tournament #3664951546, $0.92+$0.08 CAD Hold'em No Limit - Level V (40/80) - 2023/10/28 3:28:59 ET
Table '3664951546 1' 3-max Seat #1 is the button
Seat 1: CashMatteo (870 in chips) 
Seat 2: janger6 (630 in chips) 
CashMatteo: posts small blind 40
janger6: posts big blind 80
*** HOLE CARDS ***
Dealt to CashMatteo [Ks 4c]
CashMatteo: calls 40
janger6: checks 
*** FLOP *** [2s 9s Th]
janger6: checks 
CashMatteo: bets 80
janger6: folds 
Uncalled bet (80) returned to CashMatteo
CashMatteo collected 160 from pot
CashMatteo: doesn't show hand 
*** SUMMARY ***
Total pot 160 | Rake 0 
Board [2s 9s Th]
Seat 1: CashMatteo (button) (small blind) collected (160)
Seat 2: janger6 (big blind) folded on the Flop

Hand #1587: 

PokerStars Hand #246785274211: Tournament #3664951546, $0.92+$0.08 CAD Hold'em No Limit - Level V (40/80) - 2023/10/28 3:29:12 ET
Table '3664951546 1' 3-max Seat #2 is the button
Seat 1: CashMatteo (950 in chips) 
Seat 2: janger6 (550 in chips) 
janger6: posts small blind 40
CashMatteo: posts big blind 80
*** HOLE CARDS ***
Dealt to CashMatteo [Kc 7s]
janger6: calls 40
CashMatteo: checks 
*** FLOP *** [Jc Jd Tc]
CashMatteo: bets 80
janger6: raises 390 to 470 and is all-in
CashMatteo: folds 
Uncalled bet (390) returned to janger6
janger6 collected 320 from pot
*** SUMMARY ***
Total pot 320 | Rake 0 
Board [Jc Jd Tc]
Seat 1: CashMatteo (big blind) folded on the Flop
Seat 2: janger6 (button) (small blind) collected (320)

Hand #1588: 

PokerStars Hand #246785276117: Tournament #3664951546, $0.92+$0.08 CAD Hold'em No Limit - Level V (40/80) - 2023/10/28 3:29:30 ET
Table '3664951546 1' 3-max Seat #1 is the button
Seat 1: CashMatteo (790 in chips) 
Seat 2: janger6 (710 in chips) 
CashMatteo: posts small blind 40
janger6: posts big blind 80
*** HOLE CARDS ***
Dealt to CashMatteo [Kh Ks]
CashMatteo: raises 120 to 200
janger6: raises 510 to 710 and is all-in
CashMatteo: calls 510
*** FLOP *** [Jh Qc Td]
*** TURN *** [Jh Qc Td] [3c]
*** RIVER *** [Jh Qc Td 3c] [3h]
*** SHOW DOWN ***
janger6: shows [Ts As] (two pair, Tens and Threes)
CashMatteo: shows [Kh Ks] (two pair, Kings and Threes)
CashMatteo collected 1420 from pot
janger6 finished the tournament in 2nd place
CashMatteo wins the tournament and receives $2.00 - congratulations!
*** SUMMARY ***
Total pot 1420 | Rake 0 
Board [Jh Qc Td 3c 3h]
Seat 1: CashMatteo (button) (small blind) showed [Kh Ks] and won (1420) with two pair, Kings and Threes
Seat 2: janger6 (big blind) showed [Ts As] and lost with two pair, Tens and Threes

Hand #1589: 

PokerStars Hand #246785289285: Tournament #3664952950, $1.84+$0.16 CAD Hold'em No Limit - Level I (10/20) - 2023/10/28 3:31:31 ET
Table '3664952950 1' 3-max Seat #1 is the button
Seat 1: xXMartinXx04 (500 in chips) 
Seat 2: janger6 (500 in chips) 
Seat 3: CashMatteo (500 in chips) 
janger6: posts small blind 10
CashMatteo: posts big blind 20
*** HOLE CARDS ***
Dealt to CashMatteo [5d 3d]
xXMartinXx04: raises 20 to 40
janger6: folds 
CashMatteo: calls 20
*** FLOP *** [8c 4s 7h]
CashMatteo: checks 
xXMartinXx04: checks 
*** TURN *** [8c 4s 7h] [Ac]
CashMatteo: checks 
xXMartinXx04: bets 60
CashMatteo: folds 
Uncalled bet (60) returned to xXMartinXx04
xXMartinXx04 collected 90 from pot
*** SUMMARY ***
Total pot 90 | Rake 0 
Board [8c 4s 7h Ac]
Seat 1: xXMartinXx04 (button) collected (90)
Seat 2: janger6 (small blind) folded before Flop
Seat 3: CashMatteo (big blind) folded on the Turn

Hand #1590: 

PokerStars Hand #246785292436: Tournament #3664952950, $1.84+$0.16 CAD Hold'em No Limit - Level I (10/20) - 2023/10/28 3:31:59 ET
Table '3664952950 1' 3-max Seat #2 is the button
Seat 1: xXMartinXx04 (550 in chips) 
Seat 2: janger6 (490 in chips) 
Seat 3: CashMatteo (460 in chips) 
CashMatteo: posts small blind 10
xXMartinXx04: posts big blind 20
*** HOLE CARDS ***
Dealt to CashMatteo [4s Js]
janger6: calls 20
CashMatteo: calls 10
xXMartinXx04: raises 20 to 40
janger6: calls 20
CashMatteo: calls 20
*** FLOP *** [8d 5d 8c]
CashMatteo: checks 
xXMartinXx04: checks 
janger6: checks 
*** TURN *** [8d 5d 8c] [7c]
CashMatteo: checks 
xXMartinXx04: bets 20
janger6: folds 
CashMatteo: calls 20
*** RIVER *** [8d 5d 8c 7c] [7h]
CashMatteo: checks 
xXMartinXx04: bets 50
CashMatteo: calls 50
*** SHOW DOWN ***
xXMartinXx04: shows [9d Ah] (two pair, Eights and Sevens)
CashMatteo: mucks hand 
xXMartinXx04 collected 260 from pot
*** SUMMARY ***
Total pot 260 | Rake 0 
Board [8d 5d 8c 7c 7h]
Seat 1: xXMartinXx04 (big blind) showed [9d Ah] and won (260) with two pair, Eights and Sevens
Seat 2: janger6 (button) folded on the Turn
Seat 3: CashMatteo (small blind) mucked [4s Js]

Hand #1591: 

PokerStars Hand #246785297269: Tournament #3664952950, $1.84+$0.16 CAD Hold'em No Limit - Level I (10/20) - 2023/10/28 3:32:43 ET
Table '3664952950 1' 3-max Seat #3 is the button
Seat 1: xXMartinXx04 (700 in chips) 
Seat 2: janger6 (450 in chips) 
Seat 3: CashMatteo (350 in chips) 
xXMartinXx04: posts small blind 10
janger6: posts big blind 20
*** HOLE CARDS ***
Dealt to CashMatteo [4d 5c]
CashMatteo: folds 
xXMartinXx04: calls 10
janger6: checks 
*** FLOP *** [6s 2d Jh]
xXMartinXx04: checks 
janger6: checks 
*** TURN *** [6s 2d Jh] [Ah]
xXMartinXx04: checks 
janger6: checks 
*** RIVER *** [6s 2d Jh Ah] [7h]
xXMartinXx04: checks 
janger6: checks 
*** SHOW DOWN ***
xXMartinXx04: shows [Ad 8c] (a pair of Aces)
janger6: mucks hand 
xXMartinXx04 collected 40 from pot
*** SUMMARY ***
Total pot 40 | Rake 0 
Board [6s 2d Jh Ah 7h]
Seat 1: xXMartinXx04 (small blind) showed [Ad 8c] and won (40) with a pair of Aces
Seat 2: janger6 (big blind) mucked [7c 3c]
Seat 3: CashMatteo (button) folded before Flop (didn't bet)

Hand #1592: 

PokerStars Hand #246785299876: Tournament #3664952950, $1.84+$0.16 CAD Hold'em No Limit - Level I (10/20) - 2023/10/28 3:33:08 ET
Table '3664952950 1' 3-max Seat #1 is the button
Seat 1: xXMartinXx04 (720 in chips) 
Seat 2: janger6 (430 in chips) 
Seat 3: CashMatteo (350 in chips) 
janger6: posts small blind 10
CashMatteo: posts big blind 20
*** HOLE CARDS ***
Dealt to CashMatteo [5h 2h]
xXMartinXx04: calls 20
janger6: calls 10
CashMatteo: checks 
*** FLOP *** [7d 6d 5s]
janger6: bets 20
CashMatteo: calls 20
xXMartinXx04: calls 20
*** TURN *** [7d 6d 5s] [9s]
janger6: checks 
CashMatteo: checks 
xXMartinXx04: checks 
*** RIVER *** [7d 6d 5s 9s] [Ts]
janger6: checks 
CashMatteo: checks 
xXMartinXx04: checks 
*** SHOW DOWN ***
janger6: shows [7c 3c] (a pair of Sevens)
CashMatteo: mucks hand 
xXMartinXx04: shows [9d 3s] (a pair of Nines)
xXMartinXx04 collected 120 from pot
*** SUMMARY ***
Total pot 120 | Rake 0 
Board [7d 6d 5s 9s Ts]
Seat 1: xXMartinXx04 (button) showed [9d 3s] and won (120) with a pair of Nines
Seat 2: janger6 (small blind) showed [7c 3c] and lost with a pair of Sevens
Seat 3: CashMatteo (big blind) mucked [5h 2h]

Hand #1593: 

PokerStars Hand #246785304168: Tournament #3664952950, $1.84+$0.16 CAD Hold'em No Limit - Level I (10/20) - 2023/10/28 3:33:48 ET
Table '3664952950 1' 3-max Seat #2 is the button
Seat 1: xXMartinXx04 (800 in chips) 
Seat 2: janger6 (390 in chips) 
Seat 3: CashMatteo (310 in chips) 
CashMatteo: posts small blind 10
xXMartinXx04: posts big blind 20
*** HOLE CARDS ***
Dealt to CashMatteo [Ah Jc]
janger6: raises 20 to 40
CashMatteo: raises 80 to 120
xXMartinXx04: folds 
janger6: calls 80
*** FLOP *** [5d Qh 6s]
CashMatteo: bets 190 and is all-in
janger6: folds 
Uncalled bet (190) returned to CashMatteo
CashMatteo collected 260 from pot
CashMatteo: doesn't show hand 
*** SUMMARY ***
Total pot 260 | Rake 0 
Board [5d Qh 6s]
Seat 1: xXMartinXx04 (big blind) folded before Flop
Seat 2: janger6 (button) folded on the Flop
Seat 3: CashMatteo (small blind) collected (260)

Hand #1594: 

PokerStars Hand #246785307674: Tournament #3664952950, $1.84+$0.16 CAD Hold'em No Limit - Level I (10/20) - 2023/10/28 3:34:20 ET
Table '3664952950 1' 3-max Seat #3 is the button
Seat 1: xXMartinXx04 (780 in chips) 
Seat 2: janger6 (270 in chips) 
Seat 3: CashMatteo (450 in chips) 
xXMartinXx04: posts small blind 10
janger6: posts big blind 20
*** HOLE CARDS ***
Dealt to CashMatteo [Qh Kh]
CashMatteo: raises 30 to 50
xXMartinXx04: calls 40
janger6: folds 
*** FLOP *** [Ts 8d 2s]
xXMartinXx04: checks 
CashMatteo: checks 
*** TURN *** [Ts 8d 2s] [7c]
xXMartinXx04: checks 
CashMatteo: checks 
*** RIVER *** [Ts 8d 2s 7c] [Th]
xXMartinXx04: bets 20
CashMatteo: calls 20
*** SHOW DOWN ***
xXMartinXx04: shows [3d 3s] (two pair, Tens and Threes)
CashMatteo: mucks hand 
xXMartinXx04 collected 160 from pot
*** SUMMARY ***
Total pot 160 | Rake 0 
Board [Ts 8d 2s 7c Th]
Seat 1: xXMartinXx04 (small blind) showed [3d 3s] and won (160) with two pair, Tens and Threes
Seat 2: janger6 (big blind) folded before Flop
Seat 3: CashMatteo (button) mucked [Qh Kh]

Hand #1595: 

PokerStars Hand #246785311995: Tournament #3664952950, $1.84+$0.16 CAD Hold'em No Limit - Level II (15/30) - 2023/10/28 3:35:00 ET
Table '3664952950 1' 3-max Seat #1 is the button
Seat 1: xXMartinXx04 (870 in chips) 
Seat 2: janger6 (250 in chips) 
Seat 3: CashMatteo (380 in chips) 
janger6: posts small blind 15
CashMatteo: posts big blind 30
*** HOLE CARDS ***
Dealt to CashMatteo [4s Qd]
xXMartinXx04: raises 30 to 60
janger6: folds 
CashMatteo: folds 
Uncalled bet (30) returned to xXMartinXx04
xXMartinXx04 collected 75 from pot
*** SUMMARY ***
Total pot 75 | Rake 0 
Seat 1: xXMartinXx04 (button) collected (75)
Seat 2: janger6 (small blind) folded before Flop
Seat 3: CashMatteo (big blind) folded before Flop

Hand #1596: 

PokerStars Hand #246785313278: Tournament #3664952950, $1.84+$0.16 CAD Hold'em No Limit - Level II (15/30) - 2023/10/28 3:35:12 ET
Table '3664952950 1' 3-max Seat #2 is the button
Seat 1: xXMartinXx04 (915 in chips) 
Seat 2: janger6 (235 in chips) 
Seat 3: CashMatteo (350 in chips) 
CashMatteo: posts small blind 15
xXMartinXx04: posts big blind 30
*** HOLE CARDS ***
Dealt to CashMatteo [Ks 9s]
janger6: folds 
CashMatteo: raises 45 to 75
xXMartinXx04: calls 45
*** FLOP *** [4c 6d 2c]
CashMatteo: checks 
xXMartinXx04: checks 
*** TURN *** [4c 6d 2c] [8h]
CashMatteo: checks 
xXMartinXx04: bets 60
CashMatteo: folds 
Uncalled bet (60) returned to xXMartinXx04
xXMartinXx04 collected 150 from pot
*** SUMMARY ***
Total pot 150 | Rake 0 
Board [4c 6d 2c 8h]
Seat 1: xXMartinXx04 (big blind) collected (150)
Seat 2: janger6 (button) folded before Flop (didn't bet)
Seat 3: CashMatteo (small blind) folded on the Turn

Hand #1597: 

PokerStars Hand #246785316212: Tournament #3664952950, $1.84+$0.16 CAD Hold'em No Limit - Level II (15/30) - 2023/10/28 3:35:39 ET
Table '3664952950 1' 3-max Seat #3 is the button
Seat 1: xXMartinXx04 (990 in chips) 
Seat 2: janger6 (235 in chips) 
Seat 3: CashMatteo (275 in chips) 
xXMartinXx04: posts small blind 15
janger6: posts big blind 30
*** HOLE CARDS ***
Dealt to CashMatteo [9s Tc]
CashMatteo: raises 45 to 75
xXMartinXx04: folds 
janger6: raises 160 to 235 and is all-in
CashMatteo: calls 160
*** FLOP *** [4h 2d 5s]
*** TURN *** [4h 2d 5s] [Jd]
*** RIVER *** [4h 2d 5s Jd] [Jc]
*** SHOW DOWN ***
janger6: shows [Kd Ts] (a pair of Jacks)
CashMatteo: shows [9s Tc] (a pair of Jacks - lower kicker)
janger6 collected 485 from pot
*** SUMMARY ***
Total pot 485 | Rake 0 
Board [4h 2d 5s Jd Jc]
Seat 1: xXMartinXx04 (small blind) folded before Flop
Seat 2: janger6 (big blind) showed [Kd Ts] and won (485) with a pair of Jacks
Seat 3: CashMatteo (button) showed [9s Tc] and lost with a pair of Jacks

Hand #1598: 

PokerStars Hand #246785318775: Tournament #3664952950, $1.84+$0.16 CAD Hold'em No Limit - Level II (15/30) - 2023/10/28 3:36:03 ET
Table '3664952950 1' 3-max Seat #1 is the button
Seat 1: xXMartinXx04 (975 in chips) 
Seat 2: janger6 (485 in chips) 
Seat 3: CashMatteo (40 in chips) 
janger6: posts small blind 15
CashMatteo: posts big blind 30
*** HOLE CARDS ***
Dealt to CashMatteo [5d 3h]
xXMartinXx04: raises 30 to 60
janger6: calls 45
CashMatteo: calls 10 and is all-in
*** FLOP *** [2s Ks 4s]
janger6: checks 
xXMartinXx04: bets 60
janger6: folds 
Uncalled bet (60) returned to xXMartinXx04
*** TURN *** [2s Ks 4s] [Ts]
*** RIVER *** [2s Ks 4s Ts] [Js]
*** SHOW DOWN ***
xXMartinXx04: shows [Kh 7h] (a flush, King high)
xXMartinXx04 collected 40 from side pot
CashMatteo: shows [5d 3h] (a flush, King high)
CashMatteo collected 60 from main pot
xXMartinXx04 collected 60 from main pot
*** SUMMARY ***
Total pot 160 Main pot 120. Side pot 40. | Rake 0 
Board [2s Ks 4s Ts Js]
Seat 1: xXMartinXx04 (button) showed [Kh 7h] and won (100) with a flush, King high
Seat 2: janger6 (small blind) folded on the Flop
Seat 3: CashMatteo (big blind) showed [5d 3h] and won (60) with a flush, King high

Hand #1599: 

PokerStars Hand #246785321093: Tournament #3664952950, $1.84+$0.16 CAD Hold'em No Limit - Level II (15/30) - 2023/10/28 3:36:25 ET
Table '3664952950 1' 3-max Seat #2 is the button
Seat 1: xXMartinXx04 (1015 in chips) 
Seat 2: janger6 (425 in chips) 
Seat 3: CashMatteo (60 in chips) 
CashMatteo: posts small blind 15
xXMartinXx04: posts big blind 30
*** HOLE CARDS ***
Dealt to CashMatteo [9c 8d]
janger6: folds 
CashMatteo: raises 30 to 60 and is all-in
xXMartinXx04: calls 30
*** FLOP *** [Tc Kh 2d]
*** TURN *** [Tc Kh 2d] [4s]
*** RIVER *** [Tc Kh 2d 4s] [Ts]
*** SHOW DOWN ***
CashMatteo: shows [9c 8d] (a pair of Tens)
xXMartinXx04: shows [6s 7c] (a pair of Tens - lower kicker)
CashMatteo collected 120 from pot
*** SUMMARY ***
Total pot 120 | Rake 0 
Board [Tc Kh 2d 4s Ts]
Seat 1: xXMartinXx04 (big blind) showed [6s 7c] and lost with a pair of Tens
Seat 2: janger6 (button) folded before Flop (didn't bet)
Seat 3: CashMatteo (small blind) showed [9c 8d] and won (120) with a pair of Tens

Hand #1600: 

PokerStars Hand #246785322643: Tournament #3664952950, $1.84+$0.16 CAD Hold'em No Limit - Level II (15/30) - 2023/10/28 3:36:39 ET
Table '3664952950 1' 3-max Seat #3 is the button
Seat 1: xXMartinXx04 (955 in chips) 
Seat 2: janger6 (425 in chips) 
Seat 3: CashMatteo (120 in chips) 
xXMartinXx04: posts small blind 15
janger6: posts big blind 30
*** HOLE CARDS ***
Dealt to CashMatteo [6h Js]
CashMatteo: folds 
xXMartinXx04: calls 15
janger6: checks 
*** FLOP *** [Qs 8h Jd]
xXMartinXx04: bets 30
janger6: calls 30
*** TURN *** [Qs 8h Jd] [Ts]
xXMartinXx04: checks 
janger6: checks 
*** RIVER *** [Qs 8h Jd Ts] [2d]
xXMartinXx04: bets 120
janger6: calls 120
*** SHOW DOWN ***
xXMartinXx04: shows [Qd 9c] (a straight, Eight to Queen)
janger6: mucks hand 
xXMartinXx04 collected 360 from pot
*** SUMMARY ***
Total pot 360 | Rake 0 
Board [Qs 8h Jd Ts 2d]
Seat 1: xXMartinXx04 (small blind) showed [Qd 9c] and won (360) with a straight, Eight to Queen
Seat 2: janger6 (big blind) mucked [2h 8s]
Seat 3: CashMatteo (button) folded before Flop (didn't bet)

Hand #1601: 

PokerStars Hand #246785325223: Tournament #3664952950, $1.84+$0.16 CAD Hold'em No Limit - Level II (15/30) - 2023/10/28 3:37:03 ET
Table '3664952950 1' 3-max Seat #1 is the button
Seat 1: xXMartinXx04 (1135 in chips) 
Seat 2: janger6 (245 in chips) 
Seat 3: CashMatteo (120 in chips) 
janger6: posts small blind 15
CashMatteo: posts big blind 30
*** HOLE CARDS ***
Dealt to CashMatteo [Jd Kc]
xXMartinXx04: calls 30
janger6: calls 15
CashMatteo: raises 90 to 120 and is all-in
xXMartinXx04: calls 90
janger6: raises 125 to 245 and is all-in
xXMartinXx04: calls 125
*** FLOP *** [Tc 6s 6h]
*** TURN *** [Tc 6s 6h] [Qd]
*** RIVER *** [Tc 6s 6h Qd] [Jc]
*** SHOW DOWN ***
janger6: shows [4s 4d] (two pair, Sixes and Fours)
xXMartinXx04: shows [2h Ks] (a pair of Sixes)
janger6 collected 250 from side pot
CashMatteo: shows [Jd Kc] (two pair, Jacks and Sixes)
CashMatteo collected 360 from main pot
*** SUMMARY ***
Total pot 610 Main pot 360. Side pot 250. | Rake 0 
Board [Tc 6s 6h Qd Jc]
Seat 1: xXMartinXx04 (button) showed [2h Ks] and lost with a pair of Sixes
Seat 2: janger6 (small blind) showed [4s 4d] and won (250) with two pair, Sixes and Fours
Seat 3: CashMatteo (big blind) showed [Jd Kc] and won (360) with two pair, Jacks and Sixes

Hand #1602: 

PokerStars Hand #246785327539: Tournament #3664952950, $1.84+$0.16 CAD Hold'em No Limit - Level II (15/30) - 2023/10/28 3:37:25 ET
Table '3664952950 1' 3-max Seat #2 is the button
Seat 1: xXMartinXx04 (890 in chips) 
Seat 2: janger6 (250 in chips) 
Seat 3: CashMatteo (360 in chips) 
CashMatteo: posts small blind 15
xXMartinXx04: posts big blind 30
*** HOLE CARDS ***
Dealt to CashMatteo [Qs As]
janger6: folds 
CashMatteo: raises 45 to 75
xXMartinXx04: calls 45
*** FLOP *** [5h Kc Ac]
CashMatteo: bets 75
xXMartinXx04: raises 300 to 375
CashMatteo: calls 210 and is all-in
Uncalled bet (90) returned to xXMartinXx04
*** TURN *** [5h Kc Ac] [3c]
*** RIVER *** [5h Kc Ac 3c] [5c]
*** SHOW DOWN ***
CashMatteo: shows [Qs As] (two pair, Aces and Fives)
xXMartinXx04: shows [Ad 2h] (two pair, Aces and Fives)
CashMatteo collected 360 from pot
xXMartinXx04 collected 360 from pot
*** SUMMARY ***
Total pot 720 | Rake 0 
Board [5h Kc Ac 3c 5c]
Seat 1: xXMartinXx04 (big blind) showed [Ad 2h] and won (360) with two pair, Aces and Fives
Seat 2: janger6 (button) folded before Flop (didn't bet)
Seat 3: CashMatteo (small blind) showed [Qs As] and won (360) with two pair, Aces and Fives

Hand #1603: 

PokerStars Hand #246785330385: Tournament #3664952950, $1.84+$0.16 CAD Hold'em No Limit - Level III (20/40) - 2023/10/28 3:37:51 ET
Table '3664952950 1' 3-max Seat #3 is the button
Seat 1: xXMartinXx04 (890 in chips) 
Seat 2: janger6 (250 in chips) 
Seat 3: CashMatteo (360 in chips) 
xXMartinXx04: posts small blind 20
janger6: posts big blind 40
*** HOLE CARDS ***
Dealt to CashMatteo [6c Th]
CashMatteo: folds 
xXMartinXx04: calls 20
janger6: checks 
*** FLOP *** [Jh 2s 6d]
xXMartinXx04: checks 
janger6: checks 
*** TURN *** [Jh 2s 6d] [4c]
xXMartinXx04: bets 40
janger6: calls 40
*** RIVER *** [Jh 2s 6d 4c] [Jc]
xXMartinXx04: checks 
janger6: checks 
*** SHOW DOWN ***
xXMartinXx04: shows [4h 7h] (two pair, Jacks and Fours)
janger6: mucks hand 
xXMartinXx04 collected 160 from pot
*** SUMMARY ***
Total pot 160 | Rake 0 
Board [Jh 2s 6d 4c Jc]
Seat 1: xXMartinXx04 (small blind) showed [4h 7h] and won (160) with two pair, Jacks and Fours
Seat 2: janger6 (big blind) mucked [4d 5d]
Seat 3: CashMatteo (button) folded before Flop (didn't bet)

Hand #1604: 

PokerStars Hand #246785332394: Tournament #3664952950, $1.84+$0.16 CAD Hold'em No Limit - Level III (20/40) - 2023/10/28 3:38:10 ET
Table '3664952950 1' 3-max Seat #1 is the button
Seat 1: xXMartinXx04 (970 in chips) 
Seat 2: janger6 (170 in chips) 
Seat 3: CashMatteo (360 in chips) 
janger6: posts small blind 20
CashMatteo: posts big blind 40
*** HOLE CARDS ***
Dealt to CashMatteo [9s 3s]
xXMartinXx04: raises 40 to 80
janger6: folds 
CashMatteo: calls 40
*** FLOP *** [2d 3h Th]
CashMatteo: checks 
xXMartinXx04: checks 
*** TURN *** [2d 3h Th] [7h]
CashMatteo: checks 
xXMartinXx04: bets 40
CashMatteo: calls 40
*** RIVER *** [2d 3h Th 7h] [8h]
CashMatteo: checks 
xXMartinXx04: bets 40
CashMatteo: folds 
Uncalled bet (40) returned to xXMartinXx04
xXMartinXx04 collected 260 from pot
*** SUMMARY ***
Total pot 260 | Rake 0 
Board [2d 3h Th 7h 8h]
Seat 1: xXMartinXx04 (button) collected (260)
Seat 2: janger6 (small blind) folded before Flop
Seat 3: CashMatteo (big blind) folded on the River

Hand #1605: 

PokerStars Hand #246785335257: Tournament #3664952950, $1.84+$0.16 CAD Hold'em No Limit - Level III (20/40) - 2023/10/28 3:38:36 ET
Table '3664952950 1' 3-max Seat #2 is the button
Seat 1: xXMartinXx04 (1110 in chips) 
Seat 2: janger6 (150 in chips) 
Seat 3: CashMatteo (240 in chips) 
CashMatteo: posts small blind 20
xXMartinXx04: posts big blind 40
*** HOLE CARDS ***
Dealt to CashMatteo [Js 2h]
janger6: folds 
CashMatteo: folds 
Uncalled bet (20) returned to xXMartinXx04
xXMartinXx04 collected 40 from pot
*** SUMMARY ***
Total pot 40 | Rake 0 
Seat 1: xXMartinXx04 (big blind) collected (40)
Seat 2: janger6 (button) folded before Flop (didn't bet)
Seat 3: CashMatteo (small blind) folded before Flop

Hand #1606: 

PokerStars Hand #246785336008: Tournament #3664952950, $1.84+$0.16 CAD Hold'em No Limit - Level III (20/40) - 2023/10/28 3:38:43 ET
Table '3664952950 1' 3-max Seat #3 is the button
Seat 1: xXMartinXx04 (1130 in chips) 
Seat 2: janger6 (150 in chips) 
Seat 3: CashMatteo (220 in chips) 
xXMartinXx04: posts small blind 20
janger6: posts big blind 40
*** HOLE CARDS ***
Dealt to CashMatteo [7c 5h]
CashMatteo: folds 
xXMartinXx04: calls 20
janger6: raises 110 to 150 and is all-in
xXMartinXx04: calls 110
*** FLOP *** [3c 5c Ah]
*** TURN *** [3c 5c Ah] [Kc]
*** RIVER *** [3c 5c Ah Kc] [7s]
*** SHOW DOWN ***
xXMartinXx04: shows [3h Th] (a pair of Threes)
janger6: shows [4c 4d] (a pair of Fours)
janger6 collected 300 from pot
*** SUMMARY ***
Total pot 300 | Rake 0 
Board [3c 5c Ah Kc 7s]
Seat 1: xXMartinXx04 (small blind) showed [3h Th] and lost with a pair of Threes
Seat 2: janger6 (big blind) showed [4c 4d] and won (300) with a pair of Fours
Seat 3: CashMatteo (button) folded before Flop (didn't bet)

Hand #1607: 

PokerStars Hand #246785338114: Tournament #3664952950, $1.84+$0.16 CAD Hold'em No Limit - Level III (20/40) - 2023/10/28 3:39:02 ET
Table '3664952950 1' 3-max Seat #1 is the button
Seat 1: xXMartinXx04 (980 in chips) 
Seat 2: janger6 (300 in chips) 
Seat 3: CashMatteo (220 in chips) 
janger6: posts small blind 20
CashMatteo: posts big blind 40
*** HOLE CARDS ***
Dealt to CashMatteo [As Tc]
xXMartinXx04: calls 40
janger6: calls 20
CashMatteo: raises 180 to 220 and is all-in
xXMartinXx04: calls 180
janger6: folds 
*** FLOP *** [9s 4c Jd]
*** TURN *** [9s 4c Jd] [3h]
*** RIVER *** [9s 4c Jd 3h] [Qs]
*** SHOW DOWN ***
CashMatteo: shows [As Tc] (high card Ace)
xXMartinXx04: shows [6d 4d] (a pair of Fours)
xXMartinXx04 collected 480 from pot
CashMatteo finished the tournament in 3rd place
*** SUMMARY ***
Total pot 480 | Rake 0 
Board [9s 4c Jd 3h Qs]
Seat 1: xXMartinXx04 (button) showed [6d 4d] and won (480) with a pair of Fours
Seat 2: janger6 (small blind) folded before Flop
Seat 3: CashMatteo (big blind) showed [As Tc] and lost with high card Ace

Hand #1608: 

PokerStars Hand #246785360853:  Hold'em No Limit ($0.05/$0.10 CAD) - 2023/10/28 3:42:30 ET
Table 'Corduba II' 6-max Seat #1 is the button
Seat 1: CashMatteo ($10 in chips) 
Seat 4: MB Breezy ($10 in chips) 
CashMatteo: posts small blind $0.05
MB Breezy: posts big blind $0.10
*** HOLE CARDS ***
Dealt to CashMatteo [Qc Jh]
CashMatteo: calls $0.05
Lil'L.J.2022 joins the table at seat #5 
MB Breezy: raises $0.20 to $0.30
CashMatteo: calls $0.20
*** FLOP *** [7s 3d Kh]
MB Breezy: bets $0.30
CashMatteo: folds 
Uncalled bet ($0.30) returned to MB Breezy
MB Breezy collected $0.57 from pot
MB Breezy: doesn't show hand 
*** SUMMARY ***
Total pot $0.60 | Rake $0.03 
Board [7s 3d Kh]
Seat 1: CashMatteo (button) (small blind) folded on the Flop
Seat 4: MB Breezy (big blind) collected ($0.57)

Hand #1609: 

PokerStars Hand #246785362965:  Hold'em No Limit ($0.05/$0.10 CAD) - 2023/10/28 3:42:49 ET
Table 'Corduba II' 6-max Seat #1 is the button
Seat 1: CashMatteo ($9.70 in chips) 
Seat 4: MB Breezy ($10.27 in chips) 
Seat 5: Lil'L.J.2022 ($10 in chips) 
MB Breezy: posts small blind $0.05
Lil'L.J.2022: posts big blind $0.10
*** HOLE CARDS ***
Dealt to CashMatteo [5s 2d]
CashMatteo: folds 
MB Breezy: calls $0.05
janger6 joins the table at seat #6 
Lil'L.J.2022: checks 
*** FLOP *** [8h Jd Qc]
MB Breezy: bets $0.10
Lil'L.J.2022: calls $0.10
*** TURN *** [8h Jd Qc] [3d]
MB Breezy: checks 
Lil'L.J.2022: bets $0.20
MB Breezy: calls $0.20
*** RIVER *** [8h Jd Qc 3d] [4s]
MB Breezy: checks 
Lil'L.J.2022: checks 
*** SHOW DOWN ***
MB Breezy: shows [6d 8s] (a pair of Eights)
Lil'L.J.2022: shows [Jh 7h] (a pair of Jacks)
Lil'L.J.2022 collected $0.76 from pot
*** SUMMARY ***
Total pot $0.80 | Rake $0.04 
Board [8h Jd Qc 3d 4s]
Seat 1: CashMatteo (button) folded before Flop (didn't bet)
Seat 4: MB Breezy (small blind) showed [6d 8s] and lost with a pair of Eights
Seat 5: Lil'L.J.2022 (big blind) showed [Jh 7h] and won ($0.76) with a pair of Jacks

Hand #1610: 

PokerStars Hand #246785369264:  Hold'em No Limit ($0.05/$0.10 CAD) - 2023/10/28 3:43:46 ET
Table 'Corduba II' 6-max Seat #4 is the button
Seat 1: CashMatteo ($9.70 in chips) 
Seat 4: MB Breezy ($9.87 in chips) 
Seat 5: Lil'L.J.2022 ($10.36 in chips) 
Seat 6: janger6 ($8 in chips) 
Lil'L.J.2022: posts small blind $0.05
janger6: posts big blind $0.10
*** HOLE CARDS ***
Dealt to CashMatteo [8h Jh]
CashMatteo: calls $0.10
zViveXz joins the table at seat #2 
MB Breezy: raises $0.20 to $0.30
Lil'L.J.2022: folds 
janger6: calls $0.20
CashMatteo: calls $0.20
*** FLOP *** [6c 6d Qh]
janger6: bets $0.10
CashMatteo: raises $0.56 to $0.66
MB Breezy: folds 
janger6: calls $0.56
*** TURN *** [6c 6d Qh] [3s]
janger6: bets $0.10
CashMatteo: calls $0.10
*** RIVER *** [6c 6d Qh 3s] [Tc]
janger6: bets $0.10
CashMatteo: raises $2.56 to $2.66
janger6: folds 
Uncalled bet ($2.56) returned to CashMatteo
CashMatteo collected $2.55 from pot
CashMatteo: doesn't show hand 
*** SUMMARY ***
Total pot $2.67 | Rake $0.12 
Board [6c 6d Qh 3s Tc]
Seat 1: CashMatteo collected ($2.55)
Seat 4: MB Breezy (button) folded on the Flop
Seat 5: Lil'L.J.2022 (small blind) folded before Flop
Seat 6: janger6 (big blind) folded on the River

Hand #1611: 

PokerStars Hand #246785374536:  Hold'em No Limit ($0.05/$0.10 CAD) - 2023/10/28 3:44:33 ET
Table 'Corduba II' 6-max Seat #5 is the button
Seat 1: CashMatteo ($11.09 in chips) 
Seat 2: zViveXz ($10 in chips) 
Seat 4: MB Breezy ($9.57 in chips) 
Seat 5: Lil'L.J.2022 ($10.31 in chips) 
Seat 6: janger6 ($6.84 in chips) 
janger6: posts small blind $0.05
CashMatteo: posts big blind $0.10
zViveXz: posts big blind $0.10
*** HOLE CARDS ***
Dealt to CashMatteo [Qs 5d]
zViveXz: raises $0.15 to $0.25
MB Breezy: folds 
Lil'L.J.2022: folds 
janger6: calls $0.20
CashMatteo: folds 
*** FLOP *** [As 4d 3c]
CashMatteo leaves the table
janger6: checks 
zViveXz: bets $0.29
janger6: folds 
Uncalled bet ($0.29) returned to zViveXz
zViveXz collected $0.57 from pot
zViveXz: doesn't show hand 
*** SUMMARY ***
Total pot $0.60 | Rake $0.03 
Board [As 4d 3c]
Seat 1: CashMatteo (big blind) folded before Flop
Seat 2: zViveXz collected ($0.57)
Seat 4: MB Breezy folded before Flop (didn't bet)
Seat 5: Lil'L.J.2022 (button) folded before Flop (didn't bet)
Seat 6: janger6 (small blind) folded on the Flop

Hand #1612: 

PokerStars Hand #246785497767:  Hold'em No Limit ($0.10/$0.25 CAD) - 2023/10/28 4:03:13 ET
Table 'Melanie' 6-max Seat #6 is the button
Seat 1: lSmoothEFoldsl ($35.41 in chips) 
Seat 2: 1stedcharizard ($34.35 in chips) 
Seat 3: sweetlou4224 ($10.91 in chips) 
Seat 4: CashMatteo ($20 in chips) 
Seat 5: BeefnBroccoli ($20 in chips) 
Seat 6: DDoL ($25.92 in chips) 
lSmoothEFoldsl: posts small blind $0.10
1stedcharizard: posts big blind $0.25
CashMatteo: posts big blind $0.25
BeefnBroccoli: posts big blind $0.25
*** HOLE CARDS ***
Dealt to CashMatteo [2h Kd]
sweetlou4224: calls $0.25
CashMatteo: checks 
BeefnBroccoli: checks 
DDoL: folds 
lSmoothEFoldsl: calls $0.15
1stedcharizard: checks 
*** FLOP *** [Kh Ac 4c]
lSmoothEFoldsl: checks 
1stedcharizard: checks 
sweetlou4224: checks 
CashMatteo: checks 
BeefnBroccoli: checks 
*** TURN *** [Kh Ac 4c] [8s]
lSmoothEFoldsl: checks 
1stedcharizard: checks 
sweetlou4224: checks 
CashMatteo: bets $0.37
BeefnBroccoli: folds 
lSmoothEFoldsl: raises $1.14 to $1.51
1stedcharizard: folds 
sweetlou4224: folds 
CashMatteo: folds 
Uncalled bet ($1.14) returned to lSmoothEFoldsl
lSmoothEFoldsl collected $1.90 from pot
*** SUMMARY ***
Total pot $1.99 | Rake $0.09 
Board [Kh Ac 4c 8s]
Seat 1: lSmoothEFoldsl (small blind) collected ($1.90)
Seat 2: 1stedcharizard (big blind) folded on the Turn
Seat 3: sweetlou4224 folded on the Turn
Seat 4: CashMatteo folded on the Turn
Seat 5: BeefnBroccoli folded on the Turn (didn't bet)
Seat 6: DDoL (button) folded before Flop (didn't bet)

Hand #1613: 

PokerStars Hand #246785504975:  Hold'em No Limit ($0.10/$0.25 CAD) - 2023/10/28 4:04:14 ET
Table 'Melanie' 6-max Seat #1 is the button
Seat 1: lSmoothEFoldsl ($36.69 in chips) 
Seat 2: 1stedcharizard ($34.10 in chips) 
Seat 3: sweetlou4224 ($10.66 in chips) 
Seat 4: CashMatteo ($19.38 in chips) 
Seat 5: BeefnBroccoli ($19.75 in chips) 
Seat 6: DDoL ($25.92 in chips) 
1stedcharizard: posts small blind $0.10
sweetlou4224: posts big blind $0.25
*** HOLE CARDS ***
Dealt to CashMatteo [3h 5c]
CashMatteo: folds 
BeefnBroccoli: folds 
DDoL: raises $0.37 to $0.62
lSmoothEFoldsl: folds 
1stedcharizard: folds 
sweetlou4224: calls $0.37
*** FLOP *** [Ah 9h 3s]
sweetlou4224: checks 
DDoL: bets $0.45
sweetlou4224: folds 
Uncalled bet ($0.45) returned to DDoL
DDoL collected $1.28 from pot
DDoL: doesn't show hand 
*** SUMMARY ***
Total pot $1.34 | Rake $0.06 
Board [Ah 9h 3s]
Seat 1: lSmoothEFoldsl (button) folded before Flop (didn't bet)
Seat 2: 1stedcharizard (small blind) folded before Flop
Seat 3: sweetlou4224 (big blind) folded on the Flop
Seat 4: CashMatteo folded before Flop (didn't bet)
Seat 5: BeefnBroccoli folded before Flop (didn't bet)
Seat 6: DDoL collected ($1.28)

Hand #1614: 

PokerStars Hand #246785510497:  Hold'em No Limit ($0.10/$0.25 CAD) - 2023/10/28 4:05:01 ET
Table 'Melanie' 6-max Seat #2 is the button
Seat 1: lSmoothEFoldsl ($36.69 in chips) 
Seat 2: 1stedcharizard ($34 in chips) 
Seat 3: sweetlou4224 ($10.04 in chips) 
Seat 4: CashMatteo ($19.38 in chips) 
Seat 5: BeefnBroccoli ($19.75 in chips) 
Seat 6: DDoL ($26.58 in chips) 
sweetlou4224: posts small blind $0.10
CashMatteo: posts big blind $0.25
*** HOLE CARDS ***
Dealt to CashMatteo [Qh Td]
BeefnBroccoli: calls $0.25
DDoL: folds 
lSmoothEFoldsl: folds 
1stedcharizard: folds 
sweetlou4224: calls $0.15
CashMatteo: checks 
*** FLOP *** [Kd 6h Qd]
sweetlou4224: bets $0.25
CashMatteo: calls $0.25
BeefnBroccoli: calls $0.25
*** TURN *** [Kd 6h Qd] [3c]
sweetlou4224: bets $1
CashMatteo: calls $1
BeefnBroccoli: folds 
*** RIVER *** [Kd 6h Qd 3c] [Kh]
sweetlou4224: bets $2.25
CashMatteo: calls $2.25
*** SHOW DOWN ***
sweetlou4224: shows [Ts Js] (a pair of Kings)
CashMatteo: shows [Qh Td] (two pair, Kings and Queens)
CashMatteo collected $7.64 from pot
*** SUMMARY ***
Total pot $8 | Rake $0.36 
Board [Kd 6h Qd 3c Kh]
Seat 1: lSmoothEFoldsl folded before Flop (didn't bet)
Seat 2: 1stedcharizard (button) folded before Flop (didn't bet)
Seat 3: sweetlou4224 (small blind) showed [Ts Js] and lost with a pair of Kings
Seat 4: CashMatteo (big blind) showed [Qh Td] and won ($7.64) with two pair, Kings and Queens
Seat 5: BeefnBroccoli folded on the Turn
Seat 6: DDoL folded before Flop (didn't bet)

Hand #1615: 

PokerStars Hand #246785517826:  Hold'em No Limit ($0.10/$0.25 CAD) - 2023/10/28 4:06:04 ET
Table 'Melanie' 6-max Seat #3 is the button
Seat 1: lSmoothEFoldsl ($36.69 in chips) 
Seat 2: 1stedcharizard ($34 in chips) 
Seat 3: sweetlou4224 ($6.29 in chips) 
Seat 4: CashMatteo ($23.27 in chips) 
Seat 5: BeefnBroccoli ($19.25 in chips) 
Seat 6: DDoL ($26.58 in chips) 
CashMatteo: posts small blind $0.10
BeefnBroccoli: posts big blind $0.25
*** HOLE CARDS ***
Dealt to CashMatteo [Kd Ah]
DDoL: folds 
lSmoothEFoldsl: raises $0.35 to $0.60
1stedcharizard: folds 
sweetlou4224: calls $0.60
CashMatteo: raises $2.15 to $2.75
BeefnBroccoli: calls $2.50
lSmoothEFoldsl: calls $2.15
sweetlou4224: calls $2.15
*** FLOP *** [Qs 9d Kc]
CashMatteo: checks 
BeefnBroccoli: bets $16.50 and is all-in
lSmoothEFoldsl: folds 
sweetlou4224: folds 
CashMatteo: calls $16.50
*** TURN *** [Qs 9d Kc] [3c]
*** RIVER *** [Qs 9d Kc 3c] [Js]
*** SHOW DOWN ***
CashMatteo: shows [Kd Ah] (a pair of Kings)
BeefnBroccoli: shows [Ac Th] (a straight, Ten to Ace)
BeefnBroccoli collected $42.02 from pot
*** SUMMARY ***
Total pot $44 | Rake $1.98 
Board [Qs 9d Kc 3c Js]
Seat 1: lSmoothEFoldsl folded on the Flop
Seat 2: 1stedcharizard folded before Flop (didn't bet)
Seat 3: sweetlou4224 (button) folded on the Flop
Seat 4: CashMatteo (small blind) showed [Kd Ah] and lost with a pair of Kings
Seat 5: BeefnBroccoli (big blind) showed [Ac Th] and won ($42.02) with a straight, Ten to Ace
Seat 6: DDoL folded before Flop (didn't bet)

Hand #1616: 

PokerStars Hand #246785525419:  Hold'em No Limit ($0.10/$0.25 CAD) - 2023/10/28 4:07:10 ET
Table 'Melanie' 6-max Seat #4 is the button
Seat 1: lSmoothEFoldsl ($33.94 in chips) 
Seat 2: 1stedcharizard ($34 in chips) 
Seat 3: sweetlou4224 ($3.54 in chips) 
Seat 4: CashMatteo ($4.02 in chips) 
Seat 5: BeefnBroccoli ($42.02 in chips) 
Seat 6: DDoL ($26.58 in chips) 
BeefnBroccoli: posts small blind $0.10
DDoL: posts big blind $0.25
*** HOLE CARDS ***
Dealt to CashMatteo [9s 9d]
lSmoothEFoldsl: folds 
1stedcharizard: folds 
sweetlou4224: raises $3.29 to $3.54 and is all-in
CashMatteo: raises $0.48 to $4.02 and is all-in
BeefnBroccoli: folds 
DDoL: folds 
Uncalled bet ($0.48) returned to CashMatteo
BeefnBroccoli leaves the table
*** FLOP *** [7h As 5s]
*** TURN *** [7h As 5s] [Th]
*** RIVER *** [7h As 5s Th] [Ts]
*** SHOW DOWN ***
sweetlou4224: shows [Qh Ad] (two pair, Aces and Tens)
CashMatteo: shows [9s 9d] (two pair, Tens and Nines)
sweetlou4224 collected $7.10 from pot
*** SUMMARY ***
Total pot $7.43 | Rake $0.33 
Board [7h As 5s Th Ts]
Seat 1: lSmoothEFoldsl folded before Flop (didn't bet)
Seat 2: 1stedcharizard folded before Flop (didn't bet)
Seat 3: sweetlou4224 showed [Qh Ad] and won ($7.10) with two pair, Aces and Tens
Seat 4: CashMatteo (button) showed [9s 9d] and lost with two pair, Tens and Nines
Seat 5: BeefnBroccoli (small blind) folded before Flop
Seat 6: DDoL (big blind) folded before Flop

Hand #1617: 

PokerStars Hand #246785528283:  Hold'em No Limit ($0.10/$0.25 CAD) - 2023/10/28 4:07:34 ET
Table 'Melanie' 6-max Seat #6 is the button
Seat 1: lSmoothEFoldsl ($33.94 in chips) 
Seat 2: 1stedcharizard ($34 in chips) 
Seat 3: sweetlou4224 ($7.10 in chips) 
Seat 4: CashMatteo ($0.48 in chips) 
Seat 6: DDoL ($26.33 in chips) 
lSmoothEFoldsl: posts small blind $0.10
1stedcharizard: posts big blind $0.25
*** HOLE CARDS ***
Dealt to CashMatteo [As 2h]
sweetlou4224: calls $0.25
CashMatteo: raises $0.23 to $0.48 and is all-in
DDoL: folds 
lSmoothEFoldsl: folds 
1stedcharizard: calls $0.23
sweetlou4224: calls $0.23
*** FLOP *** [7d 3d Qd]
1stedcharizard: bets $0.74
sweetlou4224: calls $0.74
*** TURN *** [7d 3d Qd] [6d]
1stedcharizard: checks 
sweetlou4224: checks 
*** RIVER *** [7d 3d Qd 6d] [9h]
1stedcharizard: bets $2.16
sweetlou4224: folds 
Uncalled bet ($2.16) returned to 1stedcharizard
*** SHOW DOWN ***
1stedcharizard: shows [Ad 9s] (a flush, Ace high)
1stedcharizard collected $1.41 from side pot
CashMatteo: shows [As 2h] (high card Ace)
1stedcharizard collected $1.47 from main pot
*** SUMMARY ***
Total pot $3.02 Main pot $1.47. Side pot $1.41. | Rake $0.14 
Board [7d 3d Qd 6d 9h]
Seat 1: lSmoothEFoldsl (small blind) folded before Flop
Seat 2: 1stedcharizard (big blind) showed [Ad 9s] and won ($2.88) with a flush, Ace high
Seat 3: sweetlou4224 folded on the River
Seat 4: CashMatteo showed [As 2h] and lost with high card Ace
Seat 6: DDoL (button) folded before Flop (didn't bet)

Hand #1618: 

PokerStars Hand #246785544928:  Hold'em No Limit ($0.10/$0.25 CAD) - 2023/10/28 4:09:57 ET
Table 'Melanie' 6-max Seat #2 is the button
Seat 1: lSmoothEFoldsl ($33.84 in chips) 
Seat 2: 1stedcharizard ($34.24 in chips) 
Seat 3: sweetlou4224 ($7.17 in chips) 
Seat 4: CashMatteo ($12.19 in chips) 
Seat 6: DDoL ($26.33 in chips) 
sweetlou4224: posts small blind $0.10
CashMatteo: posts big blind $0.25
*** HOLE CARDS ***
Dealt to CashMatteo [3s 9d]
DDoL: folds 
lSmoothEFoldsl: folds 
1stedcharizard: folds 
sweetlou4224: calls $0.15
CashMatteo: checks 
*** FLOP *** [Kc Kd Ac]
sweetlou4224: checks 
CashMatteo: checks 
*** TURN *** [Kc Kd Ac] [Ad]
sweetlou4224: bets $1
CashMatteo: folds 
Uncalled bet ($1) returned to sweetlou4224
sweetlou4224 collected $0.48 from pot
*** SUMMARY ***
Total pot $0.50 | Rake $0.02 
Board [Kc Kd Ac Ad]
Seat 1: lSmoothEFoldsl folded before Flop (didn't bet)
Seat 2: 1stedcharizard (button) folded before Flop (didn't bet)
Seat 3: sweetlou4224 (small blind) collected ($0.48)
Seat 4: CashMatteo (big blind) folded on the Turn
Seat 6: DDoL folded before Flop (didn't bet)

Hand #1619: 

PokerStars Hand #246785549854:  Hold'em No Limit ($0.10/$0.25 CAD) - 2023/10/28 4:10:39 ET
Table 'Melanie' 6-max Seat #3 is the button
Seat 1: lSmoothEFoldsl ($33.84 in chips) 
Seat 2: 1stedcharizard ($34.24 in chips) 
Seat 3: sweetlou4224 ($7.40 in chips) 
Seat 4: CashMatteo ($11.94 in chips) 
Seat 6: DDoL ($26.33 in chips) 
CashMatteo: posts small blind $0.10
DDoL: posts big blind $0.25
*** HOLE CARDS ***
Dealt to CashMatteo [As 2h]
lSmoothEFoldsl: raises $0.35 to $0.60
1stedcharizard: folds 
sweetlou4224: calls $0.60
CashMatteo: folds 
DDoL: calls $0.35
*** FLOP *** [Jh 6c Qh]
DDoL: checks 
lSmoothEFoldsl: checks 
sweetlou4224: checks 
*** TURN *** [Jh 6c Qh] [4h]
DDoL: checks 
lSmoothEFoldsl: checks 
sweetlou4224: checks 
*** RIVER *** [Jh 6c Qh 4h] [6s]
SmokinPot joins the table at seat #5 
DDoL: checks 
lSmoothEFoldsl: checks 
SmokinPot leaves the table
sweetlou4224: checks 
*** SHOW DOWN ***
DDoL: shows [9h 9s] (two pair, Nines and Sixes)
lSmoothEFoldsl: mucks hand 
sweetlou4224: mucks hand 
DDoL collected $1.81 from pot
*** SUMMARY ***
Total pot $1.90 | Rake $0.09 
Board [Jh 6c Qh 4h 6s]
Seat 1: lSmoothEFoldsl mucked [3c 3s]
Seat 2: 1stedcharizard folded before Flop (didn't bet)
Seat 3: sweetlou4224 (button) mucked [3h Ad]
Seat 4: CashMatteo (small blind) folded before Flop
Seat 6: DDoL (big blind) showed [9h 9s] and won ($1.81) with two pair, Nines and Sixes

Hand #1620: 

PokerStars Hand #246785556704:  Hold'em No Limit ($0.10/$0.25 CAD) - 2023/10/28 4:11:37 ET
Table 'Melanie' 6-max Seat #4 is the button
Seat 1: lSmoothEFoldsl ($33.24 in chips) 
Seat 2: 1stedcharizard ($34.24 in chips) 
Seat 3: sweetlou4224 ($6.80 in chips) 
Seat 4: CashMatteo ($11.84 in chips) 
Seat 6: DDoL ($27.54 in chips) 
DDoL: posts small blind $0.10
lSmoothEFoldsl: posts big blind $0.25
*** HOLE CARDS ***
Dealt to CashMatteo [6s 3c]
blu3sage joins the table at seat #5 
1stedcharizard: folds 
sweetlou4224: calls $0.25
CashMatteo: folds 
DDoL: calls $0.15
lSmoothEFoldsl: checks 
*** FLOP *** [2h 4d 3h]
DDoL: checks 
lSmoothEFoldsl: bets $0.25
sweetlou4224: calls $0.25
DDoL: calls $0.25
*** TURN *** [2h 4d 3h] [Qh]
DDoL: checks 
lSmoothEFoldsl: checks 
sweetlou4224: bets $1
DDoL: folds 
lSmoothEFoldsl: folds 
Uncalled bet ($1) returned to sweetlou4224
sweetlou4224 collected $1.43 from pot
*** SUMMARY ***
Total pot $1.50 | Rake $0.07 
Board [2h 4d 3h Qh]
Seat 1: lSmoothEFoldsl (big blind) folded on the Turn
Seat 2: 1stedcharizard folded before Flop (didn't bet)
Seat 3: sweetlou4224 collected ($1.43)
Seat 4: CashMatteo (button) folded before Flop (didn't bet)
Seat 6: DDoL (small blind) folded on the Turn

Hand #1621: 

PokerStars Hand #246785568388:  Hold'em No Limit ($0.10/$0.25 CAD) - 2023/10/28 4:13:16 ET
Table 'Melanie' 6-max Seat #6 is the button
Seat 1: lSmoothEFoldsl ($32.74 in chips) 
Seat 2: 1stedcharizard ($34.24 in chips) 
Seat 3: sweetlou4224 ($7.73 in chips) 
Seat 4: CashMatteo ($11.84 in chips) 
Seat 5: blu3sage ($20 in chips) 
Seat 6: DDoL ($27.04 in chips) 
lSmoothEFoldsl: posts small blind $0.10
1stedcharizard: posts big blind $0.25
blu3sage: posts big blind $0.25
*** HOLE CARDS ***
Dealt to CashMatteo [7d 2d]
sweetlou4224: calls $0.25
CashMatteo: folds 
blu3sage: checks 
DDoL: folds 
lSmoothEFoldsl: raises $2.17 to $2.42
1stedcharizard: folds 
sweetlou4224: folds 
blu3sage: folds 
Uncalled bet ($2.17) returned to lSmoothEFoldsl
lSmoothEFoldsl collected $1 from pot
*** SUMMARY ***
Total pot $1 | Rake $0 
Seat 1: lSmoothEFoldsl (small blind) collected ($1)
Seat 2: 1stedcharizard (big blind) folded before Flop
Seat 3: sweetlou4224 folded before Flop
Seat 4: CashMatteo folded before Flop (didn't bet)
Seat 5: blu3sage folded before Flop (didn't bet)
Seat 6: DDoL (button) folded before Flop (didn't bet)

Hand #1622: 

PokerStars Hand #246785573843:  Hold'em No Limit ($0.10/$0.25 CAD) - 2023/10/28 4:14:03 ET
Table 'Melanie' 6-max Seat #1 is the button
Seat 1: lSmoothEFoldsl ($33.49 in chips) 
Seat 2: 1stedcharizard ($33.99 in chips) 
Seat 3: sweetlou4224 ($7.48 in chips) 
Seat 4: CashMatteo ($11.84 in chips) 
Seat 5: blu3sage ($19.75 in chips) 
Seat 6: DDoL ($27.04 in chips) 
1stedcharizard: posts small blind $0.10
sweetlou4224: posts big blind $0.25
*** HOLE CARDS ***
Dealt to CashMatteo [Qh 2d]
CashMatteo: folds 
blu3sage: folds 
DDoL: folds 
lSmoothEFoldsl: folds 
1stedcharizard: folds 
Uncalled bet ($0.15) returned to sweetlou4224
sweetlou4224 collected $0.20 from pot
*** SUMMARY ***
Total pot $0.20 | Rake $0 
Seat 1: lSmoothEFoldsl (button) folded before Flop (didn't bet)
Seat 2: 1stedcharizard (small blind) folded before Flop
Seat 3: sweetlou4224 (big blind) collected ($0.20)
Seat 4: CashMatteo folded before Flop (didn't bet)
Seat 5: blu3sage folded before Flop (didn't bet)
Seat 6: DDoL folded before Flop (didn't bet)

Hand #1623: 

PokerStars Hand #246785575322:  Hold'em No Limit ($0.10/$0.25 CAD) - 2023/10/28 4:14:16 ET
Table 'Melanie' 6-max Seat #2 is the button
Seat 1: lSmoothEFoldsl ($33.49 in chips) 
Seat 2: 1stedcharizard ($33.89 in chips) 
Seat 3: sweetlou4224 ($7.58 in chips) 
Seat 4: CashMatteo ($11.84 in chips) 
Seat 5: blu3sage ($19.75 in chips) 
Seat 6: DDoL ($27.04 in chips) 
sweetlou4224: posts small blind $0.10
CashMatteo: posts big blind $0.25
*** HOLE CARDS ***
Dealt to CashMatteo [Qs 2c]
blu3sage: folds 
DDoL: raises $0.50 to $0.75
lSmoothEFoldsl: folds 
1stedcharizard: folds 
sweetlou4224: calls $0.65
CashMatteo: folds 
*** FLOP *** [3h 5c 2s]
sweetlou4224: checks 
DDoL: bets $1.17
sweetlou4224: calls $1.17
*** TURN *** [3h 5c 2s] [8s]
sweetlou4224: checks 
DDoL: checks 
*** RIVER *** [3h 5c 2s 8s] [Jd]
sweetlou4224: bets $2.50
DDoL: calls $2.50
*** SHOW DOWN ***
sweetlou4224: shows [Qh Ks] (high card King)
DDoL: shows [4d 4s] (a pair of Fours)
DDoL collected $8.68 from pot
*** SUMMARY ***
Total pot $9.09 | Rake $0.41 
Board [3h 5c 2s 8s Jd]
Seat 1: lSmoothEFoldsl folded before Flop (didn't bet)
Seat 2: 1stedcharizard (button) folded before Flop (didn't bet)
Seat 3: sweetlou4224 (small blind) showed [Qh Ks] and lost with high card King
Seat 4: CashMatteo (big blind) folded before Flop
Seat 5: blu3sage folded before Flop (didn't bet)
Seat 6: DDoL showed [4d 4s] and won ($8.68) with a pair of Fours

Hand #1624: 

PokerStars Hand #246785586017:  Hold'em No Limit ($0.10/$0.25 CAD) - 2023/10/28 4:15:47 ET
Table 'Melanie' 6-max Seat #3 is the button
Seat 1: lSmoothEFoldsl ($33.49 in chips) 
Seat 2: 1stedcharizard ($33.89 in chips) 
Seat 3: sweetlou4224 ($3.16 in chips) 
Seat 4: CashMatteo ($11.59 in chips) 
Seat 5: blu3sage ($19.75 in chips) 
Seat 6: DDoL ($31.30 in chips) 
CashMatteo: posts small blind $0.10
blu3sage: posts big blind $0.25
*** HOLE CARDS ***
Dealt to CashMatteo [Qs 3d]
DDoL: folds 
lSmoothEFoldsl: raises $0.35 to $0.60
1stedcharizard: calls $0.60
sweetlou4224: folds 
CashMatteo: folds 
blu3sage: calls $0.35
*** FLOP *** [Kd 6c 9h]
blu3sage: bets $0.25
lSmoothEFoldsl: calls $0.25
1stedcharizard: calls $0.25
*** TURN *** [Kd 6c 9h] [8s]
blu3sage: bets $0.25
lSmoothEFoldsl: calls $0.25
1stedcharizard: calls $0.25
*** RIVER *** [Kd 6c 9h 8s] [4s]
blu3sage: bets $0.25
lSmoothEFoldsl: calls $0.25
1stedcharizard: raises $3 to $3.25
blu3sage: calls $3
lSmoothEFoldsl: folds 
*** SHOW DOWN ***
1stedcharizard: shows [4c 4d] (three of a kind, Fours)
blu3sage: mucks hand 
1stedcharizard collected $9.69 from pot
lSmoothEFoldsl leaves the table
*** SUMMARY ***
Total pot $10.15 | Rake $0.46 
Board [Kd 6c 9h 8s 4s]
Seat 1: lSmoothEFoldsl folded on the River
Seat 2: 1stedcharizard showed [4c 4d] and won ($9.69) with three of a kind, Fours
Seat 3: sweetlou4224 (button) folded before Flop (didn't bet)
Seat 4: CashMatteo (small blind) folded before Flop
Seat 5: blu3sage (big blind) mucked [Ah Kh]
Seat 6: DDoL folded before Flop (didn't bet)

Hand #1625: 

PokerStars Hand #246785594595:  Hold'em No Limit ($0.10/$0.25 CAD) - 2023/10/28 4:16:59 ET
Table 'Melanie' 6-max Seat #4 is the button
Seat 2: 1stedcharizard ($39.23 in chips) 
Seat 3: sweetlou4224 ($3.16 in chips) 
Seat 4: CashMatteo ($11.49 in chips) 
Seat 5: blu3sage ($15.40 in chips) 
Seat 6: DDoL ($31.30 in chips) 
blu3sage: posts small blind $0.10
DDoL: posts big blind $0.25
*** HOLE CARDS ***
Dealt to CashMatteo [Ts 9d]
1stedcharizard: folds 
sweetlou4224: raises $2.91 to $3.16 and is all-in
CashMatteo: folds 
blu3sage: calls $3.06
DDoL: folds 
*** FLOP *** [5d 2d Th]
*** TURN *** [5d 2d Th] [Ks]
*** RIVER *** [5d 2d Th Ks] [Td]
*** SHOW DOWN ***
blu3sage: shows [Ah 4c] (a pair of Tens)
sweetlou4224: shows [As Kd] (two pair, Kings and Tens)
sweetlou4224 collected $6.27 from pot
*** SUMMARY ***
Total pot $6.57 | Rake $0.30 
Board [5d 2d Th Ks Td]
Seat 2: 1stedcharizard folded before Flop (didn't bet)
Seat 3: sweetlou4224 showed [As Kd] and won ($6.27) with two pair, Kings and Tens
Seat 4: CashMatteo (button) folded before Flop (didn't bet)
Seat 5: blu3sage (small blind) showed [Ah 4c] and lost with a pair of Tens
Seat 6: DDoL (big blind) folded before Flop

Hand #1626: 

PokerStars Hand #246785597066:  Hold'em No Limit ($0.10/$0.25 CAD) - 2023/10/28 4:17:21 ET
Table 'Melanie' 6-max Seat #5 is the button
Seat 2: 1stedcharizard ($39.23 in chips) 
Seat 3: sweetlou4224 ($6.27 in chips) 
Seat 4: CashMatteo ($11.49 in chips) 
Seat 5: blu3sage ($12.24 in chips) 
Seat 6: DDoL ($31.05 in chips) 
DDoL: posts small blind $0.10
1stedcharizard: posts big blind $0.25
*** HOLE CARDS ***
Dealt to CashMatteo [Kd 9c]
sweetlou4224: calls $0.25
CashMatteo: calls $0.25
blu3sage: calls $0.25
DDoL: calls $0.15
1stedcharizard: checks 
*** FLOP *** [Ts 2d 9s]
DDoL: checks 
1stedcharizard: checks 
sweetlou4224: checks 
CashMatteo: checks 
blu3sage: checks 
*** TURN *** [Ts 2d 9s] [6s]
DDoL: checks 
1stedcharizard: checks 
sweetlou4224: bets $0.25
CashMatteo: calls $0.25
blu3sage: calls $0.25
DDoL: calls $0.25
1stedcharizard: folds 
*** RIVER *** [Ts 2d 9s 6s] [Qh]
DDoL: checks 
sweetlou4224: checks 
CashMatteo: checks 
blu3sage: checks 
*** SHOW DOWN ***
DDoL: shows [Jd Qc] (a pair of Queens)
sweetlou4224: mucks hand 
CashMatteo: mucks hand 
blu3sage: mucks hand 
DDoL collected $2.15 from pot
*** SUMMARY ***
Total pot $2.25 | Rake $0.10 
Board [Ts 2d 9s 6s Qh]
Seat 2: 1stedcharizard (big blind) folded on the Turn
Seat 3: sweetlou4224 mucked [3d 3c]
Seat 4: CashMatteo mucked [Kd 9c]
Seat 5: blu3sage (button) mucked [As 7h]
Seat 6: DDoL (small blind) showed [Jd Qc] and won ($2.15) with a pair of Queens

Hand #1627: 

PokerStars Hand #246785607121:  Hold'em No Limit ($0.10/$0.25 CAD) - 2023/10/28 4:18:45 ET
Table 'Melanie' 6-max Seat #6 is the button
Seat 2: 1stedcharizard ($38.98 in chips) 
Seat 3: sweetlou4224 ($5.77 in chips) 
Seat 4: CashMatteo ($10.99 in chips) 
Seat 5: blu3sage ($11.74 in chips) 
Seat 6: DDoL ($32.70 in chips) 
1stedcharizard: posts small blind $0.10
sweetlou4224: posts big blind $0.25
*** HOLE CARDS ***
Dealt to CashMatteo [Qc Th]
CashMatteo: raises $0.37 to $0.62
blu3sage: folds 
DDoL: folds 
1stedcharizard: folds 
sweetlou4224: calls $0.37
*** FLOP *** [6s As Qd]
sweetlou4224: bets $1
CashMatteo: folds 
Uncalled bet ($1) returned to sweetlou4224
sweetlou4224 collected $1.28 from pot
*** SUMMARY ***
Total pot $1.34 | Rake $0.06 
Board [6s As Qd]
Seat 2: 1stedcharizard (small blind) folded before Flop
Seat 3: sweetlou4224 (big blind) collected ($1.28)
Seat 4: CashMatteo folded on the Flop
Seat 5: blu3sage folded before Flop (didn't bet)
Seat 6: DDoL (button) folded before Flop (didn't bet)

Hand #1628: 

PokerStars Hand #246785610701:  Hold'em No Limit ($0.10/$0.25 CAD) - 2023/10/28 4:19:15 ET
Table 'Melanie' 6-max Seat #2 is the button
Seat 2: 1stedcharizard ($38.88 in chips) 
Seat 3: sweetlou4224 ($6.43 in chips) 
Seat 4: CashMatteo ($10.37 in chips) 
Seat 5: blu3sage ($11.74 in chips) 
Seat 6: DDoL ($32.70 in chips) 
sweetlou4224: posts small blind $0.10
CashMatteo: posts big blind $0.25
*** HOLE CARDS ***
Dealt to CashMatteo [5s 8h]
blu3sage: raises $0.25 to $0.50
DDoL: folds 
1stedcharizard: folds 
sweetlou4224: calls $0.40
CashMatteo: calls $0.25
*** FLOP *** [6h Th 2s]
sweetlou4224: checks 
CashMatteo: checks 
blu3sage: bets $0.25
sweetlou4224: calls $0.25
CashMatteo: folds 
*** TURN *** [6h Th 2s] [Ac]
BeefnBroccoli joins the table at seat #1 
sweetlou4224: checks 
blu3sage: bets $10.99 and is all-in
sweetlou4224: folds 
Uncalled bet ($10.99) returned to blu3sage
blu3sage collected $1.91 from pot
blu3sage: doesn't show hand 
*** SUMMARY ***
Total pot $2 | Rake $0.09 
Board [6h Th 2s Ac]
Seat 2: 1stedcharizard (button) folded before Flop (didn't bet)
Seat 3: sweetlou4224 (small blind) folded on the Turn
Seat 4: CashMatteo (big blind) folded on the Flop
Seat 5: blu3sage collected ($1.91)
Seat 6: DDoL folded before Flop (didn't bet)

Hand #1629: 

PokerStars Hand #246785618256:  Hold'em No Limit ($0.10/$0.25 CAD) - 2023/10/28 4:20:19 ET
Table 'Melanie' 6-max Seat #3 is the button
Seat 1: BeefnBroccoli ($41.92 in chips) 
Seat 2: 1stedcharizard ($38.88 in chips) 
Seat 3: sweetlou4224 ($5.68 in chips) 
Seat 4: CashMatteo ($9.87 in chips) 
Seat 5: blu3sage ($12.90 in chips) 
Seat 6: DDoL ($32.70 in chips) 
CashMatteo: posts small blind $0.10
blu3sage: posts big blind $0.25
BeefnBroccoli: posts big blind $0.25
*** HOLE CARDS ***
Dealt to CashMatteo [9h Kd]
DDoL: folds 
BeefnBroccoli: checks 
1stedcharizard: folds 
sweetlou4224: calls $0.25
CashMatteo: calls $0.15
blu3sage: checks 
*** FLOP *** [2d 4d 3h]
CashMatteo: checks 
blu3sage: checks 
BeefnBroccoli: checks 
sweetlou4224: checks 
*** TURN *** [2d 4d 3h] [8d]
CashMatteo: checks 
blu3sage: checks 
BeefnBroccoli: checks 
sweetlou4224: bets $0.75
CashMatteo: calls $0.75
blu3sage: calls $0.75
BeefnBroccoli: folds 
*** RIVER *** [2d 4d 3h 8d] [Ad]
CashMatteo: checks 
blu3sage: bets $11.90 and is all-in
sweetlou4224: folds 
CashMatteo: calls $8.87 and is all-in
Uncalled bet ($3.03) returned to blu3sage
*** SHOW DOWN ***
blu3sage: shows [2c Ac] (two pair, Aces and Deuces)
CashMatteo: shows [9h Kd] (a flush, Ace high)
CashMatteo collected $20.05 from pot
*** SUMMARY ***
Total pot $20.99 | Rake $0.94 
Board [2d 4d 3h 8d Ad]
Seat 1: BeefnBroccoli folded on the Turn (didn't bet)
Seat 2: 1stedcharizard folded before Flop (didn't bet)
Seat 3: sweetlou4224 (button) folded on the River
Seat 4: CashMatteo (small blind) showed [9h Kd] and won ($20.05) with a flush, Ace high
Seat 5: blu3sage (big blind) showed [2c Ac] and lost with two pair, Aces and Deuces
Seat 6: DDoL folded before Flop (didn't bet)

Hand #1630: 

PokerStars Hand #246785626800:  Hold'em No Limit ($0.10/$0.25 CAD) - 2023/10/28 4:21:30 ET
Table 'Melanie' 6-max Seat #4 is the button
Seat 1: BeefnBroccoli ($41.67 in chips) 
Seat 2: 1stedcharizard ($38.88 in chips) 
Seat 3: sweetlou4224 ($4.68 in chips) 
Seat 4: CashMatteo ($20.05 in chips) 
Seat 5: blu3sage ($3.03 in chips) 
Seat 6: DDoL ($32.70 in chips) 
blu3sage: posts small blind $0.10
DDoL: posts big blind $0.25
*** HOLE CARDS ***
Dealt to CashMatteo [8h 7d]
BeefnBroccoli: folds 
1stedcharizard: folds 
sweetlou4224: calls $0.25
CashMatteo: raises $0.37 to $0.62
blu3sage: folds 
DDoL: folds 
sweetlou4224: calls $0.37
*** FLOP *** [Kh Ad 6c]
blu3sage leaves the table
sweetlou4224: checks 
CashMatteo: checks 
*** TURN *** [Kh Ad 6c] [Qd]
sweetlou4224: bets $4.06 and is all-in
CashMatteo: folds 
Uncalled bet ($4.06) returned to sweetlou4224
sweetlou4224 collected $1.52 from pot
*** SUMMARY ***
Total pot $1.59 | Rake $0.07 
Board [Kh Ad 6c Qd]
Seat 1: BeefnBroccoli folded before Flop (didn't bet)
Seat 2: 1stedcharizard folded before Flop (didn't bet)
Seat 3: sweetlou4224 collected ($1.52)
Seat 4: CashMatteo (button) folded on the Turn
Seat 5: blu3sage (small blind) folded before Flop
Seat 6: DDoL (big blind) folded before Flop

Hand #1631: 

PokerStars Hand #246785631984:  Hold'em No Limit ($0.10/$0.25 CAD) - 2023/10/28 4:22:12 ET
Table 'Melanie' 6-max Seat #6 is the button
Seat 1: BeefnBroccoli ($41.67 in chips) 
Seat 2: 1stedcharizard ($38.88 in chips) 
Seat 3: sweetlou4224 ($5.58 in chips) 
Seat 4: CashMatteo ($19.43 in chips) 
Seat 6: DDoL ($32.45 in chips) 
BeefnBroccoli: posts small blind $0.10
1stedcharizard: posts big blind $0.25
*** HOLE CARDS ***
Dealt to CashMatteo [4c 6d]
sweetlou4224: calls $0.25
CashMatteo: folds 
DDoL: folds 
BeefnBroccoli: calls $0.15
1stedcharizard: checks 
*** FLOP *** [As 5c Kh]
BeefnBroccoli: checks 
1stedcharizard: checks 
sweetlou4224: bets $0.25
BeefnBroccoli: folds 
1stedcharizard: folds 
Uncalled bet ($0.25) returned to sweetlou4224
sweetlou4224 collected $0.72 from pot
*** SUMMARY ***
Total pot $0.75 | Rake $0.03 
Board [As 5c Kh]
Seat 1: BeefnBroccoli (small blind) folded on the Flop
Seat 2: 1stedcharizard (big blind) folded on the Flop
Seat 3: sweetlou4224 collected ($0.72)
Seat 4: CashMatteo folded before Flop (didn't bet)
Seat 6: DDoL (button) folded before Flop (didn't bet)

Hand #1632: 

PokerStars Hand #246785637939:  Hold'em No Limit ($0.10/$0.25 CAD) - 2023/10/28 4:23:02 ET
Table 'Melanie' 6-max Seat #1 is the button
Seat 1: BeefnBroccoli ($41.42 in chips) 
Seat 2: 1stedcharizard ($38.63 in chips) 
Seat 3: sweetlou4224 ($6.05 in chips) 
Seat 4: CashMatteo ($19.43 in chips) 
Seat 6: DDoL ($32.45 in chips) 
1stedcharizard: posts small blind $0.10
sweetlou4224: posts big blind $0.25
*** HOLE CARDS ***
Dealt to CashMatteo [8d Qh]
CashMatteo: raises $0.37 to $0.62
DDoL: folds 
BeefnBroccoli: folds 
1stedcharizard: folds 
sweetlou4224: raises $0.37 to $0.99
CashMatteo: calls $0.37
*** FLOP *** [Th Jc Jh]
sweetlou4224: checks 
CashMatteo: checks 
*** TURN *** [Th Jc Jh] [2h]
sweetlou4224: bets $2
CashMatteo: calls $2
*** RIVER *** [Th Jc Jh 2h] [4h]
sweetlou4224: checks 
CashMatteo: checks 
*** SHOW DOWN ***
sweetlou4224: shows [Jd Kd] (three of a kind, Jacks)
CashMatteo: shows [8d Qh] (a flush, Queen high)
CashMatteo collected $5.81 from pot
*** SUMMARY ***
Total pot $6.08 | Rake $0.27 
Board [Th Jc Jh 2h 4h]
Seat 1: BeefnBroccoli (button) folded before Flop (didn't bet)
Seat 2: 1stedcharizard (small blind) folded before Flop
Seat 3: sweetlou4224 (big blind) showed [Jd Kd] and lost with three of a kind, Jacks
Seat 4: CashMatteo showed [8d Qh] and won ($5.81) with a flush, Queen high
Seat 6: DDoL folded before Flop (didn't bet)

Hand #1633: 

PokerStars Hand #246785644339:  Hold'em No Limit ($0.10/$0.25 CAD) - 2023/10/28 4:23:54 ET
Table 'Melanie' 6-max Seat #2 is the button
Seat 1: BeefnBroccoli ($41.42 in chips) 
Seat 2: 1stedcharizard ($38.53 in chips) 
Seat 3: sweetlou4224 ($3.06 in chips) 
Seat 4: CashMatteo ($22.25 in chips) 
Seat 6: DDoL ($32.45 in chips) 
sweetlou4224: posts small blind $0.10
CashMatteo: posts big blind $0.25
*** HOLE CARDS ***
Dealt to CashMatteo [7s Ac]
DDoL: folds 
BeefnBroccoli: calls $0.25
1stedcharizard: folds 
sweetlou4224: calls $0.15
CashMatteo: checks 
*** FLOP *** [Jc 6h 4s]
sweetlou4224: checks 
CashMatteo: checks 
BeefnBroccoli: checks 
*** TURN *** [Jc 6h 4s] [2c]
sweetlou4224: checks 
CashMatteo: checks 
BeefnBroccoli: bets $0.25
sweetlou4224: calls $0.25
CashMatteo: calls $0.25
*** RIVER *** [Jc 6h 4s 2c] [5c]
sweetlou4224: bets $2.56 and is all-in
CashMatteo: folds 
BeefnBroccoli: calls $2.56
*** SHOW DOWN ***
sweetlou4224: shows [Ts 4h] (a pair of Fours)
BeefnBroccoli: shows [4c 8c] (a flush, Jack high)
dgomez0429 joins the table at seat #5 
BeefnBroccoli collected $6.32 from pot
*** SUMMARY ***
Total pot $6.62 | Rake $0.30 
Board [Jc 6h 4s 2c 5c]
Seat 1: BeefnBroccoli showed [4c 8c] and won ($6.32) with a flush, Jack high
Seat 2: 1stedcharizard (button) folded before Flop (didn't bet)
Seat 3: sweetlou4224 (small blind) showed [Ts 4h] and lost with a pair of Fours
Seat 4: CashMatteo (big blind) folded on the River
Seat 6: DDoL folded before Flop (didn't bet)

Hand #1634: 

PokerStars Hand #246785650918:  Hold'em No Limit ($0.10/$0.25 CAD) - 2023/10/28 4:24:49 ET
Table 'Melanie' 6-max Seat #4 is the button
Seat 1: BeefnBroccoli ($44.68 in chips) 
Seat 2: 1stedcharizard ($38.53 in chips) 
Seat 4: CashMatteo ($21.75 in chips) 
Seat 6: DDoL ($32.45 in chips) 
dgomez0429 will be allowed to play after the button
DDoL: posts small blind $0.10
BeefnBroccoli: posts big blind $0.25
*** HOLE CARDS ***
Dealt to CashMatteo [8h 4c]
1stedcharizard: folds 
CashMatteo: folds 
DDoL: calls $0.15
BeefnBroccoli: checks 
*** FLOP *** [3d Jc 7s]
sweetlou4224 leaves the table
DDoL: checks 
BeefnBroccoli: checks 
*** TURN *** [3d Jc 7s] [6s]
DDoL: checks 
BeefnBroccoli: bets $0.25
DDoL: folds 
Uncalled bet ($0.25) returned to BeefnBroccoli
BeefnBroccoli collected $0.48 from pot
*** SUMMARY ***
Total pot $0.50 | Rake $0.02 
Board [3d Jc 7s 6s]
Seat 1: BeefnBroccoli (big blind) collected ($0.48)
Seat 2: 1stedcharizard folded before Flop (didn't bet)
Seat 4: CashMatteo (button) folded before Flop (didn't bet)
Seat 6: DDoL (small blind) folded on the Turn

Hand #1635: 

PokerStars Hand #246785654110:  Hold'em No Limit ($0.10/$0.25 CAD) - 2023/10/28 4:25:15 ET
Table 'Melanie' 6-max Seat #6 is the button
Seat 1: BeefnBroccoli ($44.91 in chips) 
Seat 2: 1stedcharizard ($38.53 in chips) 
Seat 4: CashMatteo ($21.75 in chips) 
Seat 5: dgomez0429 ($25 in chips) 
Seat 6: DDoL ($32.20 in chips) 
BeefnBroccoli: posts small blind $0.10
1stedcharizard: posts big blind $0.25
dgomez0429: posts big blind $0.25
*** HOLE CARDS ***
Dealt to CashMatteo [5h 2s]
CashMatteo: folds 
dgomez0429: checks 
DDoL: raises $0.85 to $1.10
BeefnBroccoli: calls $1
1stedcharizard: folds 
dgomez0429: folds 
*** FLOP *** [2c Js Qc]
BeefnBroccoli: bets $0.50
DDoL: raises $2 to $2.50
BeefnBroccoli: calls $2
*** TURN *** [2c Js Qc] [7h]
BeefnBroccoli: bets $0.75
DDoL: calls $0.75
*** RIVER *** [2c Js Qc 7h] [Kd]
BeefnBroccoli: checks 
DDoL: bets $5.50
BeefnBroccoli: raises $6 to $11.50
DDoL: folds 
Uncalled bet ($6) returned to BeefnBroccoli
BeefnBroccoli collected $19.29 from pot
BeefnBroccoli: doesn't show hand 
*** SUMMARY ***
Total pot $20.20 | Rake $0.91 
Board [2c Js Qc 7h Kd]
Seat 1: BeefnBroccoli (small blind) collected ($19.29)
Seat 2: 1stedcharizard (big blind) folded before Flop
Seat 4: CashMatteo folded before Flop (didn't bet)
Seat 5: dgomez0429 folded before Flop (didn't bet)
Seat 6: DDoL (button) folded on the River

Hand #1636: 

PokerStars Hand #246785667140:  Hold'em No Limit ($0.10/$0.25 CAD) - 2023/10/28 4:27:02 ET
Table 'Melanie' 6-max Seat #1 is the button
Seat 1: BeefnBroccoli ($54.35 in chips) 
Seat 2: 1stedcharizard ($38.28 in chips) 
Seat 4: CashMatteo ($21.75 in chips) 
Seat 5: dgomez0429 ($24.75 in chips) 
Seat 6: DDoL ($25 in chips) 
1stedcharizard: posts small blind $0.10
CashMatteo: posts big blind $0.25
*** HOLE CARDS ***
Dealt to CashMatteo [9h Tc]
dgomez0429: calls $0.25
DDoL: raises $0.85 to $1.10
BeefnBroccoli: folds 
1stedcharizard: folds 
CashMatteo: calls $0.85
dgomez0429: calls $0.85
*** FLOP *** [9d Ah Th]
CashMatteo: checks 
dgomez0429: bets $0.25
DDoL: raises $2.75 to $3
CashMatteo: calls $3
dgomez0429: folds 
*** TURN *** [9d Ah Th] [3c]
CashMatteo: checks 
DDoL: checks 
*** RIVER *** [9d Ah Th 3c] [5h]
CashMatteo: bets $4.61
FinT_3171 joins the table at seat #3 
DDoL: folds 
Uncalled bet ($4.61) returned to CashMatteo
CashMatteo collected $9.22 from pot
CashMatteo: doesn't show hand 
*** SUMMARY ***
Total pot $9.65 | Rake $0.43 
Board [9d Ah Th 3c 5h]
Seat 1: BeefnBroccoli (button) folded before Flop (didn't bet)
Seat 2: 1stedcharizard (small blind) folded before Flop
Seat 4: CashMatteo (big blind) collected ($9.22)
Seat 5: dgomez0429 folded on the Flop
Seat 6: DDoL folded on the River

Hand #1637: 

PokerStars Hand #246785675305:  Hold'em No Limit ($0.10/$0.25 CAD) - 2023/10/28 4:28:10 ET
Table 'Melanie' 6-max Seat #2 is the button
Seat 1: BeefnBroccoli ($54.35 in chips) 
Seat 2: 1stedcharizard ($38.18 in chips) 
Seat 4: CashMatteo ($26.87 in chips) 
Seat 5: dgomez0429 ($23.40 in chips) 
Seat 6: DDoL ($25 in chips) 
FinT_3171 will be allowed to play after the button
CashMatteo: posts small blind $0.10
dgomez0429: posts big blind $0.25
*** HOLE CARDS ***
Dealt to CashMatteo [Qs Tc]
DDoL: folds 
BeefnBroccoli: calls $0.25
1stedcharizard: raises $0.75 to $1
CashMatteo: calls $0.90
dgomez0429: folds 
BeefnBroccoli: calls $0.75
*** FLOP *** [4h 6d Ac]
CashMatteo: checks 
BeefnBroccoli: checks 
1stedcharizard: bets $1.02
CashMatteo: folds 
BeefnBroccoli: calls $1.02
*** TURN *** [4h 6d Ac] [7c]
BeefnBroccoli: checks 
1stedcharizard: checks 
*** RIVER *** [4h 6d Ac 7c] [Th]
BeefnBroccoli: checks 
1stedcharizard: checks 
*** SHOW DOWN ***
BeefnBroccoli: shows [5d 7h] (a pair of Sevens)
1stedcharizard: shows [9d 9s] (a pair of Nines)
1stedcharizard collected $5.05 from pot
*** SUMMARY ***
Total pot $5.29 | Rake $0.24 
Board [4h 6d Ac 7c Th]
Seat 1: BeefnBroccoli showed [5d 7h] and lost with a pair of Sevens
Seat 2: 1stedcharizard (button) showed [9d 9s] and won ($5.05) with a pair of Nines
Seat 4: CashMatteo (small blind) folded on the Flop
Seat 5: dgomez0429 (big blind) folded before Flop
Seat 6: DDoL folded before Flop (didn't bet)

Hand #1638: 

PokerStars Hand #246785680886:  Hold'em No Limit ($0.10/$0.25 CAD) - 2023/10/28 4:28:56 ET
Table 'Melanie' 6-max Seat #4 is the button
Seat 1: BeefnBroccoli ($52.33 in chips) 
Seat 2: 1stedcharizard ($41.21 in chips) 
Seat 4: CashMatteo ($25.87 in chips) 
Seat 5: dgomez0429 ($23.15 in chips) 
dgomez0429: posts small blind $0.10
DDoL: is sitting out 
BeefnBroccoli: posts big blind $0.25
FinT_3171: sits out 
*** HOLE CARDS ***
Dealt to CashMatteo [4d 5d]
1stedcharizard: folds 
CashMatteo: raises $0.37 to $0.62
dgomez0429: calls $0.52
BeefnBroccoli: calls $0.37
*** FLOP *** [Qd Ad 9h]
dgomez0429: checks 
BeefnBroccoli: checks 
CashMatteo: checks 
*** TURN *** [Qd Ad 9h] [Tc]
dgomez0429: checks 
BeefnBroccoli: checks 
CashMatteo: checks 
*** RIVER *** [Qd Ad 9h Tc] [2d]
dgomez0429: bets $1.78
BeefnBroccoli: folds 
CashMatteo: calls $1.78
*** SHOW DOWN ***
dgomez0429: shows [6c 7s] (high card Ace)
CashMatteo: shows [4d 5d] (a flush, Ace high)
CashMatteo collected $5.18 from pot
*** SUMMARY ***
Total pot $5.42 | Rake $0.24 
Board [Qd Ad 9h Tc 2d]
Seat 1: BeefnBroccoli (big blind) folded on the River
Seat 2: 1stedcharizard folded before Flop (didn't bet)
Seat 4: CashMatteo (button) showed [4d 5d] and won ($5.18) with a flush, Ace high
Seat 5: dgomez0429 (small blind) showed [6c 7s] and lost with high card Ace

Hand #1639: 

PokerStars Hand #246785687404:  Hold'em No Limit ($0.10/$0.25 CAD) - 2023/10/28 4:29:51 ET
Table 'Melanie' 6-max Seat #5 is the button
Seat 1: BeefnBroccoli ($51.71 in chips) 
Seat 2: 1stedcharizard ($41.21 in chips) 
Seat 4: CashMatteo ($28.65 in chips) 
Seat 5: dgomez0429 ($20.75 in chips) 
BeefnBroccoli: posts small blind $0.10
1stedcharizard: posts big blind $0.25
FinT_3171: sits out 
*** HOLE CARDS ***
Dealt to CashMatteo [Ts 4c]
CashMatteo: folds 
dgomez0429: folds 
BeefnBroccoli: calls $0.15
1stedcharizard: raises $1 to $1.25
BeefnBroccoli: folds 
Uncalled bet ($1) returned to 1stedcharizard
1stedcharizard collected $0.50 from pot
1stedcharizard: doesn't show hand 
*** SUMMARY ***
Total pot $0.50 | Rake $0 
Seat 1: BeefnBroccoli (small blind) folded before Flop
Seat 2: 1stedcharizard (big blind) collected ($0.50)
Seat 4: CashMatteo folded before Flop (didn't bet)
Seat 5: dgomez0429 (button) folded before Flop (didn't bet)

Hand #1640: 

PokerStars Hand #246785690003:  Hold'em No Limit ($0.10/$0.25 CAD) - 2023/10/28 4:30:13 ET
Table 'Melanie' 6-max Seat #1 is the button
Seat 1: BeefnBroccoli ($51.46 in chips) 
Seat 2: 1stedcharizard ($41.46 in chips) 
Seat 3: FinT_3171 ($25 in chips) 
Seat 4: CashMatteo ($28.65 in chips) 
Seat 5: dgomez0429 ($20.75 in chips) 
1stedcharizard: posts small blind $0.10
FinT_3171: posts big blind $0.25
DDoL: sits out 
*** HOLE CARDS ***
Dealt to CashMatteo [2c Qs]
CashMatteo: folds 
dgomez0429: calls $0.25
BeefnBroccoli: calls $0.25
1stedcharizard: raises $0.62 to $0.87
FinT_3171: folds 
dgomez0429: calls $0.62
BeefnBroccoli: calls $0.62
*** FLOP *** [4c 4s 5s]
1stedcharizard: checks 
dgomez0429: bets $2.73
BeefnBroccoli: folds 
1stedcharizard: folds 
Uncalled bet ($2.73) returned to dgomez0429
dgomez0429 collected $2.73 from pot
*** SUMMARY ***
Total pot $2.86 | Rake $0.13 
Board [4c 4s 5s]
Seat 1: BeefnBroccoli (button) folded on the Flop
Seat 2: 1stedcharizard (small blind) folded on the Flop
Seat 3: FinT_3171 (big blind) folded before Flop
Seat 4: CashMatteo folded before Flop (didn't bet)
Seat 5: dgomez0429 collected ($2.73)

Hand #1641: 

PokerStars Hand #246785697967:  Hold'em No Limit ($0.10/$0.25 CAD) - 2023/10/28 4:31:19 ET
Table 'Melanie' 6-max Seat #2 is the button
Seat 1: BeefnBroccoli ($50.59 in chips) 
Seat 2: 1stedcharizard ($40.59 in chips) 
Seat 3: FinT_3171 ($25 in chips) 
Seat 4: CashMatteo ($28.65 in chips) 
Seat 5: dgomez0429 ($22.61 in chips) 
FinT_3171: posts small blind $0.10
CashMatteo: posts big blind $0.25
DDoL: sits out 
*** HOLE CARDS ***
Dealt to CashMatteo [Ad Ts]
dgomez0429: calls $0.25
BeefnBroccoli: folds 
1stedcharizard: raises $0.62 to $0.87
FinT_3171: folds 
CashMatteo: calls $0.62
dgomez0429: calls $0.62
*** FLOP *** [9c 7s Ah]
CashMatteo: checks 
dgomez0429: checks 
1stedcharizard: bets $1.30
CashMatteo: calls $1.30
dgomez0429: folds 
*** TURN *** [9c 7s Ah] [9d]
CashMatteo: checks 
1stedcharizard: checks 
*** RIVER *** [9c 7s Ah 9d] [Ks]
CashMatteo: checks 
1stedcharizard: bets $3.79
CashMatteo: calls $3.79
*** SHOW DOWN ***
1stedcharizard: shows [As 4d] (two pair, Aces and Nines)
CashMatteo: shows [Ad Ts] (two pair, Aces and Nines)
CashMatteo collected $6.16 from pot
1stedcharizard collected $6.15 from pot
*** SUMMARY ***
Total pot $12.89 | Rake $0.58 
Board [9c 7s Ah 9d Ks]
Seat 1: BeefnBroccoli folded before Flop (didn't bet)
Seat 2: 1stedcharizard (button) showed [As 4d] and won ($6.15) with two pair, Aces and Nines
Seat 3: FinT_3171 (small blind) folded before Flop
Seat 4: CashMatteo (big blind) showed [Ad Ts] and won ($6.16) with two pair, Aces and Nines
Seat 5: dgomez0429 folded on the Flop

Hand #1642: 

PokerStars Hand #246785706113:  Hold'em No Limit ($0.10/$0.25 CAD) - 2023/10/28 4:32:26 ET
Table 'Melanie' 6-max Seat #3 is the button
Seat 1: BeefnBroccoli ($50.59 in chips) 
Seat 2: 1stedcharizard ($40.78 in chips) 
Seat 3: FinT_3171 ($25 in chips) 
Seat 4: CashMatteo ($28.85 in chips) 
Seat 5: dgomez0429 ($21.74 in chips) 
CashMatteo: posts small blind $0.10
dgomez0429: posts big blind $0.25
DDoL: sits out 
*** HOLE CARDS ***
Dealt to CashMatteo [7h 7s]
BeefnBroccoli: folds 
1stedcharizard: raises $0.50 to $0.75
FinT_3171: calls $0.75
CashMatteo: calls $0.65
dgomez0429: calls $0.50
*** FLOP *** [8s 3c 9c]
CashMatteo: checks 
dgomez0429: bets $0.25
1stedcharizard: raises $1.68 to $1.93
FinT_3171: calls $1.93
CashMatteo: calls $1.93
dgomez0429: calls $1.68
*** TURN *** [8s 3c 9c] [Tc]
CashMatteo: checks 
dgomez0429: bets $10.24
1stedcharizard: folds 
FinT_3171: folds 
CashMatteo: folds 
Uncalled bet ($10.24) returned to dgomez0429
dgomez0429 collected $10.24 from pot
*** SUMMARY ***
Total pot $10.72 | Rake $0.48 
Board [8s 3c 9c Tc]
Seat 1: BeefnBroccoli folded before Flop (didn't bet)
Seat 2: 1stedcharizard folded on the Turn
Seat 3: FinT_3171 (button) folded on the Turn
Seat 4: CashMatteo (small blind) folded on the Turn
Seat 5: dgomez0429 (big blind) collected ($10.24)

Hand #1643: 

PokerStars Hand #246785715421:  Hold'em No Limit ($0.10/$0.25 CAD) - 2023/10/28 4:33:45 ET
Table 'Melanie' 6-max Seat #4 is the button
Seat 1: BeefnBroccoli ($50.59 in chips) 
Seat 2: 1stedcharizard ($38.10 in chips) 
Seat 3: FinT_3171 ($25 in chips) 
Seat 4: CashMatteo ($26.17 in chips) 
Seat 5: dgomez0429 ($29.30 in chips) 
Seat 6: DDoL ($25 in chips) 
dgomez0429: posts small blind $0.10
DDoL: posts big blind $0.25
*** HOLE CARDS ***
Dealt to CashMatteo [5d Qd]
BeefnBroccoli: calls $0.25
1stedcharizard: folds 
FinT_3171: raises $0.75 to $1
CashMatteo: folds 
dgomez0429: calls $0.90
DDoL: calls $0.75
BeefnBroccoli: calls $0.75
*** FLOP *** [Qc Td 8s]
dgomez0429: bets $0.25
DDoL: raises $2.75 to $3
BeefnBroccoli: folds 
FinT_3171: calls $3
dgomez0429: calls $2.75
*** TURN *** [Qc Td 8s] [4h]
dgomez0429: checks 
DDoL: bets $8.80
FinT_3171: calls $8.80
dgomez0429: folds 
*** RIVER *** [Qc Td 8s 4h] [Jc]
DDoL: bets $12.20 and is all-in
FinT_3171: folds 
Uncalled bet ($12.20) returned to DDoL
DDoL collected $29.22 from pot
DDoL: doesn't show hand 
*** SUMMARY ***
Total pot $30.60 | Rake $1.38 
Board [Qc Td 8s 4h Jc]
Seat 1: BeefnBroccoli folded on the Flop
Seat 2: 1stedcharizard folded before Flop (didn't bet)
Seat 3: FinT_3171 folded on the River
Seat 4: CashMatteo (button) folded before Flop (didn't bet)
Seat 5: dgomez0429 (small blind) folded on the Turn
Seat 6: DDoL (big blind) collected ($29.22)

Hand #1644: 

PokerStars Hand #246785730590:  Hold'em No Limit ($0.10/$0.25 CAD) - 2023/10/28 4:35:52 ET
Table 'Melanie' 6-max Seat #5 is the button
Seat 1: BeefnBroccoli ($49.59 in chips) 
Seat 2: 1stedcharizard ($38.10 in chips) 
Seat 3: FinT_3171 ($25 in chips) 
Seat 4: CashMatteo ($26.17 in chips) 
Seat 5: dgomez0429 ($25.30 in chips) 
Seat 6: DDoL ($41.42 in chips) 
DDoL: posts small blind $0.10
BeefnBroccoli: posts big blind $0.25
*** HOLE CARDS ***
Dealt to CashMatteo [Jc Kd]
1stedcharizard: folds 
FinT_3171: raises $0.50 to $0.75
CashMatteo: calls $0.75
dgomez0429: folds 
DDoL: folds 
BeefnBroccoli: calls $0.50
*** FLOP *** [Th 7h 3h]
BeefnBroccoli: bets $0.50
FinT_3171: folds 
CashMatteo: folds 
Uncalled bet ($0.50) returned to BeefnBroccoli
BeefnBroccoli collected $2.24 from pot
BeefnBroccoli: shows [4h Ah] (a flush, Ace high)
*** SUMMARY ***
Total pot $2.35 | Rake $0.11 
Board [Th 7h 3h]
Seat 1: BeefnBroccoli (big blind) collected ($2.24)
Seat 2: 1stedcharizard folded before Flop (didn't bet)
Seat 3: FinT_3171 folded on the Flop
Seat 4: CashMatteo folded on the Flop
Seat 5: dgomez0429 (button) folded before Flop (didn't bet)
Seat 6: DDoL (small blind) folded before Flop

Hand #1645: 

PokerStars Hand #246785733929:  Hold'em No Limit ($0.10/$0.25 CAD) - 2023/10/28 4:36:20 ET
Table 'Melanie' 6-max Seat #6 is the button
Seat 1: BeefnBroccoli ($51.08 in chips) 
Seat 2: 1stedcharizard ($38.10 in chips) 
Seat 3: FinT_3171 ($25 in chips) 
Seat 4: CashMatteo ($25.42 in chips) 
Seat 5: dgomez0429 ($25.30 in chips) 
Seat 6: DDoL ($41.32 in chips) 
BeefnBroccoli: posts small blind $0.10
1stedcharizard: posts big blind $0.25
*** HOLE CARDS ***
Dealt to CashMatteo [Jh 4d]
FinT_3171: folds 
CashMatteo: folds 
dgomez0429: calls $0.25
DDoL: raises $0.85 to $1.10
BeefnBroccoli: calls $1
1stedcharizard: folds 
dgomez0429: calls $0.85
*** FLOP *** [Jc 8c 8h]
BeefnBroccoli: checks 
dgomez0429: bets $1.70
DDoL: raises $3.40 to $5.10
BeefnBroccoli: folds 
dgomez0429: folds 
Uncalled bet ($3.40) returned to DDoL
DDoL collected $6.64 from pot
DDoL: doesn't show hand 
*** SUMMARY ***
Total pot $6.95 | Rake $0.31 
Board [Jc 8c 8h]
Seat 1: BeefnBroccoli (small blind) folded on the Flop
Seat 2: 1stedcharizard (big blind) folded before Flop
Seat 3: FinT_3171 folded before Flop (didn't bet)
Seat 4: CashMatteo folded before Flop (didn't bet)
Seat 5: dgomez0429 folded on the Flop
Seat 6: DDoL (button) collected ($6.64)

Hand #1646: 

PokerStars Hand #246785741095:  Hold'em No Limit ($0.10/$0.25 CAD) - 2023/10/28 4:37:20 ET
Table 'Melanie' 6-max Seat #1 is the button
Seat 1: BeefnBroccoli ($49.98 in chips) 
Seat 2: 1stedcharizard ($37.85 in chips) 
Seat 3: FinT_3171 ($25 in chips) 
Seat 4: CashMatteo ($25.42 in chips) 
Seat 5: dgomez0429 ($22.50 in chips) 
Seat 6: DDoL ($45.16 in chips) 
1stedcharizard: posts small blind $0.10
FinT_3171: posts big blind $0.25
*** HOLE CARDS ***
Dealt to CashMatteo [Qc Jc]
CashMatteo: raises $0.37 to $0.62
dgomez0429: calls $0.62
DDoL: folds 
BeefnBroccoli: folds 
1stedcharizard: folds 
FinT_3171: folds 
*** FLOP *** [3d 5c 2s]
CashMatteo: checks 
dgomez0429: checks 
*** TURN *** [3d 5c 2s] [2h]
CashMatteo: bets $0.76
dgomez0429: calls $0.76
*** RIVER *** [3d 5c 2s 2h] [Ad]
CashMatteo: bets $1.49
dgomez0429: folds 
Uncalled bet ($1.49) returned to CashMatteo
CashMatteo collected $2.97 from pot
CashMatteo: doesn't show hand 
*** SUMMARY ***
Total pot $3.11 | Rake $0.14 
Board [3d 5c 2s 2h Ad]
Seat 1: BeefnBroccoli (button) folded before Flop (didn't bet)
Seat 2: 1stedcharizard (small blind) folded before Flop
Seat 3: FinT_3171 (big blind) folded before Flop
Seat 4: CashMatteo collected ($2.97)
Seat 5: dgomez0429 folded on the River
Seat 6: DDoL folded before Flop (didn't bet)

Hand #1647: 

PokerStars Hand #246785747558:  Hold'em No Limit ($0.10/$0.25 CAD) - 2023/10/28 4:38:13 ET
Table 'Melanie' 6-max Seat #2 is the button
Seat 1: BeefnBroccoli ($49.98 in chips) 
Seat 2: 1stedcharizard ($37.75 in chips) 
Seat 3: FinT_3171 ($25 in chips) 
Seat 4: CashMatteo ($27.01 in chips) 
Seat 5: dgomez0429 ($21.12 in chips) 
Seat 6: DDoL ($45.16 in chips) 
FinT_3171: posts small blind $0.10
CashMatteo: posts big blind $0.25
*** HOLE CARDS ***
Dealt to CashMatteo [8h Ts]
dgomez0429: folds 
DDoL: folds 
BeefnBroccoli: calls $0.25
1stedcharizard: raises $0.62 to $0.87
FinT_3171: folds 
CashMatteo: calls $0.62
BeefnBroccoli: calls $0.62
*** FLOP *** [2s Ac 6s]
CashMatteo: checks 
BeefnBroccoli: checks 
1stedcharizard: bets $0.85
CashMatteo: folds 
BeefnBroccoli: folds 
Uncalled bet ($0.85) returned to 1stedcharizard
1stedcharizard collected $2.59 from pot
1stedcharizard: doesn't show hand 
*** SUMMARY ***
Total pot $2.71 | Rake $0.12 
Board [2s Ac 6s]
Seat 1: BeefnBroccoli folded on the Flop
Seat 2: 1stedcharizard (button) collected ($2.59)
Seat 3: FinT_3171 (small blind) folded before Flop
Seat 4: CashMatteo (big blind) folded on the Flop
Seat 5: dgomez0429 folded before Flop (didn't bet)
Seat 6: DDoL folded before Flop (didn't bet)

Hand #1648: 

PokerStars Hand #246785752878:  Hold'em No Limit ($0.10/$0.25 CAD) - 2023/10/28 4:38:58 ET
Table 'Melanie' 6-max Seat #3 is the button
Seat 1: BeefnBroccoli ($49.11 in chips) 
Seat 2: 1stedcharizard ($39.47 in chips) 
Seat 3: FinT_3171 ($25 in chips) 
Seat 4: CashMatteo ($26.14 in chips) 
Seat 5: dgomez0429 ($21.12 in chips) 
Seat 6: DDoL ($45.16 in chips) 
CashMatteo: posts small blind $0.10
dgomez0429: posts big blind $0.25
*** HOLE CARDS ***
Dealt to CashMatteo [3h Kh]
DDoL: folds 
BeefnBroccoli: folds 
1stedcharizard: folds 
FinT_3171: folds 
CashMatteo: calls $0.15
dgomez0429: checks 
*** FLOP *** [Qs 9s Jh]
CashMatteo: checks 
dgomez0429: checks 
*** TURN *** [Qs 9s Jh] [4h]
CashMatteo: bets $0.25
dgomez0429: calls $0.25
*** RIVER *** [Qs 9s Jh 4h] [7h]
CashMatteo: bets $0.96
dgomez0429: folds 
Uncalled bet ($0.96) returned to CashMatteo
CashMatteo collected $0.96 from pot
CashMatteo: doesn't show hand 
*** SUMMARY ***
Total pot $1 | Rake $0.04 
Board [Qs 9s Jh 4h 7h]
Seat 1: BeefnBroccoli folded before Flop (didn't bet)
Seat 2: 1stedcharizard folded before Flop (didn't bet)
Seat 3: FinT_3171 (button) folded before Flop (didn't bet)
Seat 4: CashMatteo (small blind) collected ($0.96)
Seat 5: dgomez0429 (big blind) folded on the River
Seat 6: DDoL folded before Flop (didn't bet)

Hand #1649: 

PokerStars Hand #246785758735:  Hold'em No Limit ($0.10/$0.25 CAD) - 2023/10/28 4:39:46 ET
Table 'Melanie' 6-max Seat #4 is the button
Seat 1: BeefnBroccoli ($49.11 in chips) 
Seat 2: 1stedcharizard ($39.47 in chips) 
Seat 3: FinT_3171 ($25 in chips) 
Seat 4: CashMatteo ($26.60 in chips) 
Seat 5: dgomez0429 ($20.62 in chips) 
Seat 6: DDoL ($45.16 in chips) 
dgomez0429: posts small blind $0.10
DDoL: posts big blind $0.25
*** HOLE CARDS ***
Dealt to CashMatteo [Kc 5s]
BeefnBroccoli: calls $0.25
1stedcharizard: folds 
FinT_3171: folds 
CashMatteo: folds 
dgomez0429: calls $0.15
DDoL: checks 
*** FLOP *** [3s 3d 5d]
dgomez0429: bets $0.25
DDoL: folds 
BeefnBroccoli: folds 
Uncalled bet ($0.25) returned to dgomez0429
dgomez0429 collected $0.72 from pot
dgomez0429: doesn't show hand 
*** SUMMARY ***
Total pot $0.75 | Rake $0.03 
Board [3s 3d 5d]
Seat 1: BeefnBroccoli folded on the Flop
Seat 2: 1stedcharizard folded before Flop (didn't bet)
Seat 3: FinT_3171 folded before Flop (didn't bet)
Seat 4: CashMatteo (button) folded before Flop (didn't bet)
Seat 5: dgomez0429 (small blind) collected ($0.72)
Seat 6: DDoL (big blind) folded on the Flop

Hand #1650: 

PokerStars Hand #246785762998:  Hold'em No Limit ($0.10/$0.25 CAD) - 2023/10/28 4:40:21 ET
Table 'Melanie' 6-max Seat #5 is the button
Seat 1: BeefnBroccoli ($48.86 in chips) 
Seat 2: 1stedcharizard ($39.47 in chips) 
Seat 3: FinT_3171 ($25 in chips) 
Seat 4: CashMatteo ($26.60 in chips) 
Seat 5: dgomez0429 ($21.09 in chips) 
Seat 6: DDoL ($44.91 in chips) 
DDoL: posts small blind $0.10
BeefnBroccoli: posts big blind $0.25
*** HOLE CARDS ***
Dealt to CashMatteo [6d Qs]
1stedcharizard: folds 
FinT_3171: folds 
CashMatteo: folds 
dgomez0429: calls $0.25
DDoL: raises $0.75 to $1
BeefnBroccoli: folds 
dgomez0429: calls $0.75
*** FLOP *** [As 4c 8c]
DDoL: bets $1.08
dgomez0429: calls $1.08
*** TURN *** [As 4c 8c] [Js]
DDoL: bets $2.50
dgomez0429: calls $2.50
*** RIVER *** [As 4c 8c Js] [Kd]
DDoL: checks 
dgomez0429: bets $4.50
DDoL: calls $4.50
*** SHOW DOWN ***
dgomez0429: shows [4d 4h] (three of a kind, Fours)
DDoL: mucks hand 
dgomez0429 collected $17.58 from pot
*** SUMMARY ***
Total pot $18.41 | Rake $0.83 
Board [As 4c 8c Js Kd]
Seat 1: BeefnBroccoli (big blind) folded before Flop
Seat 2: 1stedcharizard folded before Flop (didn't bet)
Seat 3: FinT_3171 folded before Flop (didn't bet)
Seat 4: CashMatteo folded before Flop (didn't bet)
Seat 5: dgomez0429 (button) showed [4d 4h] and won ($17.58) with three of a kind, Fours
Seat 6: DDoL (small blind) mucked [Qc Kc]

Hand #1651: 

PokerStars Hand #246785773068:  Hold'em No Limit ($0.10/$0.25 CAD) - 2023/10/28 4:41:42 ET
Table 'Melanie' 6-max Seat #6 is the button
Seat 1: BeefnBroccoli ($48.61 in chips) 
Seat 2: 1stedcharizard ($39.47 in chips) 
Seat 3: FinT_3171 ($25 in chips) 
Seat 4: CashMatteo ($26.60 in chips) 
Seat 5: dgomez0429 ($29.59 in chips) 
Seat 6: DDoL ($35.83 in chips) 
BeefnBroccoli: posts small blind $0.10
1stedcharizard: posts big blind $0.25
*** HOLE CARDS ***
Dealt to CashMatteo [8d Kh]
FinT_3171: folds 
CashMatteo: folds 
dgomez0429: calls $0.25
DDoL: calls $0.25
BeefnBroccoli: calls $0.15
1stedcharizard: checks 
*** FLOP *** [2s 2d Th]
BeefnBroccoli: checks 
1stedcharizard: checks 
dgomez0429: checks 
DDoL: checks 
*** TURN *** [2s 2d Th] [Js]
BeefnBroccoli: checks 
1stedcharizard: checks 
dgomez0429: bets $0.25
DDoL: folds 
BeefnBroccoli: folds 
BeefnBroccoli leaves the table
1stedcharizard: folds 
Uncalled bet ($0.25) returned to dgomez0429
dgomez0429 collected $0.96 from pot
*** SUMMARY ***
Total pot $1 | Rake $0.04 
Board [2s 2d Th Js]
Seat 1: BeefnBroccoli (small blind) folded on the Turn
Seat 2: 1stedcharizard (big blind) folded on the Turn
Seat 3: FinT_3171 folded before Flop (didn't bet)
Seat 4: CashMatteo folded before Flop (didn't bet)
Seat 5: dgomez0429 collected ($0.96)
Seat 6: DDoL (button) folded on the Turn

Hand #1652: 

PokerStars Hand #246785779753:  Hold'em No Limit ($0.10/$0.25 CAD) - 2023/10/28 4:42:36 ET
Table 'Melanie' 6-max Seat #2 is the button
Seat 2: 1stedcharizard ($39.22 in chips) 
Seat 3: FinT_3171 ($25 in chips) 
Seat 4: CashMatteo ($26.60 in chips) 
Seat 5: dgomez0429 ($30.30 in chips) 
Seat 6: DDoL ($35.58 in chips) 
FinT_3171: posts small blind $0.10
CashMatteo: posts big blind $0.25
*** HOLE CARDS ***
Dealt to CashMatteo [8s 2d]
dgomez0429: folds 
DDoL: raises $0.37 to $0.62
1stedcharizard: folds 
FinT_3171: folds 
CashMatteo: folds 
Uncalled bet ($0.37) returned to DDoL
DDoL collected $0.60 from pot
DDoL: doesn't show hand 
*** SUMMARY ***
Total pot $0.60 | Rake $0 
Seat 2: 1stedcharizard (button) folded before Flop (didn't bet)
Seat 3: FinT_3171 (small blind) folded before Flop
Seat 4: CashMatteo (big blind) folded before Flop
Seat 5: dgomez0429 folded before Flop (didn't bet)
Seat 6: DDoL collected ($0.60)

Hand #1653: 

PokerStars Hand #246785781744:  Hold'em No Limit ($0.10/$0.25 CAD) - 2023/10/28 4:42:52 ET
Table 'Melanie' 6-max Seat #3 is the button
Seat 2: 1stedcharizard ($39.22 in chips) 
Seat 3: FinT_3171 ($25 in chips) 
Seat 4: CashMatteo ($26.35 in chips) 
Seat 5: dgomez0429 ($30.30 in chips) 
Seat 6: DDoL ($35.93 in chips) 
CashMatteo: posts small blind $0.10
dgomez0429: posts big blind $0.25
*** HOLE CARDS ***
Dealt to CashMatteo [Kh 6d]
DDoL: raises $0.50 to $0.75
1stedcharizard: folds 
FinT_3171: folds 
CashMatteo: folds 
dgomez0429: folds 
Uncalled bet ($0.50) returned to DDoL
DDoL collected $0.60 from pot
DDoL: doesn't show hand 
*** SUMMARY ***
Total pot $0.60 | Rake $0 
Seat 2: 1stedcharizard folded before Flop (didn't bet)
Seat 3: FinT_3171 (button) folded before Flop (didn't bet)
Seat 4: CashMatteo (small blind) folded before Flop
Seat 5: dgomez0429 (big blind) folded before Flop
Seat 6: DDoL collected ($0.60)

Hand #1654: 

PokerStars Hand #246785784117:  Hold'em No Limit ($0.10/$0.25 CAD) - 2023/10/28 4:43:11 ET
Table 'Melanie' 6-max Seat #4 is the button
Seat 2: 1stedcharizard ($39.22 in chips) 
Seat 3: FinT_3171 ($25 in chips) 
Seat 4: CashMatteo ($26.25 in chips) 
Seat 5: dgomez0429 ($30.05 in chips) 
Seat 6: DDoL ($36.28 in chips) 
dgomez0429: posts small blind $0.10
DDoL: posts big blind $0.25
*** HOLE CARDS ***
Dealt to CashMatteo [7c Ac]
1stedcharizard: folds 
FinT_3171: folds 
CashMatteo: raises $0.50 to $0.75
dgomez0429: calls $0.65
DDoL: folds 
*** FLOP *** [4h 6d 2d]
dgomez0429: bets $0.50
CashMatteo: calls $0.50
*** TURN *** [4h 6d 2d] [Ad]
dgomez0429: checks 
CashMatteo: checks 
*** RIVER *** [4h 6d 2d Ad] [4s]
dgomez0429: bets $1.32
CashMatteo: calls $1.32
*** SHOW DOWN ***
dgomez0429: shows [8s 2s] (two pair, Fours and Deuces)
CashMatteo: shows [7c Ac] (two pair, Aces and Fours)
CashMatteo collected $5.15 from pot
*** SUMMARY ***
Total pot $5.39 | Rake $0.24 
Board [4h 6d 2d Ad 4s]
Seat 2: 1stedcharizard folded before Flop (didn't bet)
Seat 3: FinT_3171 folded before Flop (didn't bet)
Seat 4: CashMatteo (button) showed [7c Ac] and won ($5.15) with two pair, Aces and Fours
Seat 5: dgomez0429 (small blind) showed [8s 2s] and lost with two pair, Fours and Deuces
Seat 6: DDoL (big blind) folded before Flop

Hand #1655: 

PokerStars Hand #246785790439:  Hold'em No Limit ($0.10/$0.25 CAD) - 2023/10/28 4:44:01 ET
Table 'Melanie' 6-max Seat #5 is the button
Seat 2: 1stedcharizard ($39.22 in chips) 
Seat 3: FinT_3171 ($25 in chips) 
Seat 4: CashMatteo ($28.83 in chips) 
Seat 5: dgomez0429 ($27.48 in chips) 
Seat 6: DDoL ($36.03 in chips) 
DDoL: posts small blind $0.10
1stedcharizard: posts big blind $0.25
*** HOLE CARDS ***
Dealt to CashMatteo [Js 2c]
FinT_3171: folds 
CashMatteo: folds 
dgomez0429: folds 
DDoL: folds 
Uncalled bet ($0.15) returned to 1stedcharizard
1stedcharizard collected $0.20 from pot
1stedcharizard: doesn't show hand 
*** SUMMARY ***
Total pot $0.20 | Rake $0 
Seat 2: 1stedcharizard (big blind) collected ($0.20)
Seat 3: FinT_3171 folded before Flop (didn't bet)
Seat 4: CashMatteo folded before Flop (didn't bet)
Seat 5: dgomez0429 (button) folded before Flop (didn't bet)
Seat 6: DDoL (small blind) folded before Flop

Hand #1656: 

PokerStars Hand #246785792476:  Hold'em No Limit ($0.10/$0.25 CAD) - 2023/10/28 4:44:19 ET
Table 'Melanie' 6-max Seat #6 is the button
Seat 2: 1stedcharizard ($39.32 in chips) 
Seat 3: FinT_3171 ($25 in chips) 
Seat 4: CashMatteo ($28.83 in chips) 
Seat 5: dgomez0429 ($27.48 in chips) 
Seat 6: DDoL ($35.93 in chips) 
1stedcharizard: posts small blind $0.10
FinT_3171: posts big blind $0.25
*** HOLE CARDS ***
Dealt to CashMatteo [6s Ts]
CashMatteo: raises $0.37 to $0.62
dgomez0429: folds 
DDoL: calls $0.62
1stedcharizard: folds 
FinT_3171: raises $2.46 to $3.08
CashMatteo: folds 
DDoL: folds 
Uncalled bet ($2.46) returned to FinT_3171
paytotheorder19 joins the table at seat #1 
FinT_3171 collected $1.96 from pot
FinT_3171: doesn't show hand 
*** SUMMARY ***
Total pot $1.96 | Rake $0 
Seat 2: 1stedcharizard (small blind) folded before Flop
Seat 3: FinT_3171 (big blind) collected ($1.96)
Seat 4: CashMatteo folded before Flop
Seat 5: dgomez0429 folded before Flop (didn't bet)
Seat 6: DDoL (button) folded before Flop

Hand #1657: 

PokerStars Hand #246785797497:  Hold'em No Limit ($0.10/$0.25 CAD) - 2023/10/28 4:44:59 ET
Table 'Melanie' 6-max Seat #2 is the button
Seat 2: 1stedcharizard ($39.22 in chips) 
Seat 3: FinT_3171 ($26.34 in chips) 
Seat 4: CashMatteo ($28.21 in chips) 
Seat 5: dgomez0429 ($27.48 in chips) 
Seat 6: DDoL ($35.31 in chips) 
FinT_3171: posts small blind $0.10
CashMatteo: posts big blind $0.25
paytotheorder19: sits out 
*** HOLE CARDS ***
Dealt to CashMatteo [2d Js]
dgomez0429: calls $0.25
DDoL: folds 
1stedcharizard: folds 
FinT_3171: folds 
CashMatteo: checks 
*** FLOP *** [Tc Jc 4s]
CashMatteo: checks 
dgomez0429: checks 
*** TURN *** [Tc Jc 4s] [3d]
CashMatteo: bets $0.25
FinT_3171 is disconnected 
dgomez0429: calls $0.25
*** RIVER *** [Tc Jc 4s 3d] [As]
CashMatteo: bets $1.05
dgomez0429: calls $1.05
*** SHOW DOWN ***
CashMatteo: shows [2d Js] (a pair of Jacks)
dgomez0429: mucks hand 
CashMatteo collected $3.06 from pot
*** SUMMARY ***
Total pot $3.20 | Rake $0.14 
Board [Tc Jc 4s 3d As]
Seat 2: 1stedcharizard (button) folded before Flop (didn't bet)
Seat 3: FinT_3171 (small blind) folded before Flop
Seat 4: CashMatteo (big blind) showed [2d Js] and won ($3.06) with a pair of Jacks
Seat 5: dgomez0429 mucked [7h 7d]
Seat 6: DDoL folded before Flop (didn't bet)

Hand #1658: 

PokerStars Hand #246785803346:  Hold'em No Limit ($0.10/$0.25 CAD) - 2023/10/28 4:45:45 ET
Table 'Melanie' 6-max Seat #4 is the button
Seat 2: 1stedcharizard ($39.22 in chips) 
Seat 4: CashMatteo ($29.72 in chips) 
Seat 5: dgomez0429 ($25.93 in chips) 
Seat 6: DDoL ($35.31 in chips) 
dgomez0429: posts small blind $0.10
DDoL: posts big blind $0.25
paytotheorder19: sits out 
*** HOLE CARDS ***
Dealt to CashMatteo [As Qd]
1stedcharizard: folds 
CashMatteo: raises $0.37 to $0.62
dgomez0429: folds 
DDoL: raises $1.78 to $2.40
CashMatteo: calls $1.78
*** FLOP *** [4h 3d 7d]
DDoL: checks 
CashMatteo: bets $2.34
DDoL: folds 
Uncalled bet ($2.34) returned to CashMatteo
CashMatteo collected $4.68 from pot
CashMatteo: doesn't show hand 
*** SUMMARY ***
Total pot $4.90 | Rake $0.22 
Board [4h 3d 7d]
Seat 2: 1stedcharizard folded before Flop (didn't bet)
Seat 4: CashMatteo (button) collected ($4.68)
Seat 5: dgomez0429 (small blind) folded before Flop
Seat 6: DDoL (big blind) folded on the Flop

Hand #1659: 

PokerStars Hand #246785808326:  Hold'em No Limit ($0.10/$0.25 CAD) - 2023/10/28 4:46:26 ET
Table 'Melanie' 6-max Seat #5 is the button
Seat 1: paytotheorder19 ($25 in chips) 
Seat 2: 1stedcharizard ($39.22 in chips) 
Seat 4: CashMatteo ($32 in chips) 
Seat 5: dgomez0429 ($25.83 in chips) 
Seat 6: DDoL ($32.91 in chips) 
DDoL: posts small blind $0.10
paytotheorder19: posts big blind $0.25
*** HOLE CARDS ***
Dealt to CashMatteo [Ac 9d]
1stedcharizard: folds 
CashMatteo: raises $0.37 to $0.62
dgomez0429: calls $0.62
DDoL: folds 
paytotheorder19: folds 
*** FLOP *** [2d Tc Kh]
CashMatteo: checks 
dgomez0429: checks 
*** TURN *** [2d Tc Kh] [6s]
CashMatteo: bets $0.76
dgomez0429: calls $0.76
*** RIVER *** [2d Tc Kh 6s] [6d]
CashMatteo: checks 
dgomez0429: bets $0.49
CashMatteo: calls $0.49
*** SHOW DOWN ***
dgomez0429: shows [Js Kc] (two pair, Kings and Sixes)
CashMatteo: mucks hand 
dgomez0429 collected $3.91 from pot
*** SUMMARY ***
Total pot $4.09 | Rake $0.18 
Board [2d Tc Kh 6s 6d]
Seat 1: paytotheorder19 (big blind) folded before Flop
Seat 2: 1stedcharizard folded before Flop (didn't bet)
Seat 4: CashMatteo mucked [Ac 9d]
Seat 5: dgomez0429 (button) showed [Js Kc] and won ($3.91) with two pair, Kings and Sixes
Seat 6: DDoL (small blind) folded before Flop

Hand #1660: 

PokerStars Hand #246785814599:  Hold'em No Limit ($0.10/$0.25 CAD) - 2023/10/28 4:47:15 ET
Table 'Melanie' 6-max Seat #6 is the button
Seat 1: paytotheorder19 ($24.75 in chips) 
Seat 2: 1stedcharizard ($39.22 in chips) 
Seat 4: CashMatteo ($30.13 in chips) 
Seat 5: dgomez0429 ($27.87 in chips) 
Seat 6: DDoL ($32.81 in chips) 
paytotheorder19: posts small blind $0.10
1stedcharizard: posts big blind $0.25
*** HOLE CARDS ***
Dealt to CashMatteo [9d 3h]
CashMatteo: folds 
dgomez0429: calls $0.25
DDoL: folds 
paytotheorder19: folds 
1stedcharizard: checks 
*** FLOP *** [2d Qh 6h]
1stedcharizard: checks 
dgomez0429: bets $0.25
1stedcharizard: calls $0.25
*** TURN *** [2d Qh 6h] [As]
1stedcharizard: checks 
dgomez0429: bets $0.50
1stedcharizard: folds 
Uncalled bet ($0.50) returned to dgomez0429
dgomez0429 collected $1.05 from pot
dgomez0429: doesn't show hand 
*** SUMMARY ***
Total pot $1.10 | Rake $0.05 
Board [2d Qh 6h As]
Seat 1: paytotheorder19 (small blind) folded before Flop
Seat 2: 1stedcharizard (big blind) folded on the Turn
Seat 4: CashMatteo folded before Flop (didn't bet)
Seat 5: dgomez0429 collected ($1.05)
Seat 6: DDoL (button) folded before Flop (didn't bet)

Hand #1661: 

PokerStars Hand #246785820838:  Hold'em No Limit ($0.10/$0.25 CAD) - 2023/10/28 4:48:04 ET
Table 'Melanie' 6-max Seat #1 is the button
Seat 1: paytotheorder19 ($24.65 in chips) 
Seat 2: 1stedcharizard ($38.72 in chips) 
Seat 4: CashMatteo ($30.13 in chips) 
Seat 5: dgomez0429 ($28.42 in chips) 
Seat 6: DDoL ($32.81 in chips) 
1stedcharizard: posts small blind $0.10
CashMatteo: posts big blind $0.25
*** HOLE CARDS ***
Dealt to CashMatteo [6s 8d]
dgomez0429: calls $0.25
DDoL: folds 
paytotheorder19: calls $0.25
1stedcharizard: folds 
CashMatteo: checks 
*** FLOP *** [6c 4s Jc]
CashMatteo: checks 
dgomez0429: bets $0.25
paytotheorder19: raises $0.25 to $0.50
CashMatteo: calls $0.50
dgomez0429: folds 
*** TURN *** [6c 4s Jc] [7c]
CashMatteo: checks 
paytotheorder19: checks 
*** RIVER *** [6c 4s Jc 7c] [7d]
CashMatteo: checks 
paytotheorder19: checks 
*** SHOW DOWN ***
CashMatteo: shows [6s 8d] (two pair, Sevens and Sixes)
paytotheorder19: shows [Jh Qh] (two pair, Jacks and Sevens)
paytotheorder19 collected $2.01 from pot
*** SUMMARY ***
Total pot $2.10 | Rake $0.09 
Board [6c 4s Jc 7c 7d]
Seat 1: paytotheorder19 (button) showed [Jh Qh] and won ($2.01) with two pair, Jacks and Sevens
Seat 2: 1stedcharizard (small blind) folded before Flop
Seat 4: CashMatteo (big blind) showed [6s 8d] and lost with two pair, Sevens and Sixes
Seat 5: dgomez0429 folded on the Flop
Seat 6: DDoL folded before Flop (didn't bet)

Hand #1662: 

PokerStars Hand #246785828054:  Hold'em No Limit ($0.10/$0.25 CAD) - 2023/10/28 4:49:02 ET
Table 'Melanie' 6-max Seat #2 is the button
Seat 1: paytotheorder19 ($25.91 in chips) 
Seat 2: 1stedcharizard ($38.62 in chips) 
Seat 4: CashMatteo ($29.38 in chips) 
Seat 5: dgomez0429 ($27.92 in chips) 
Seat 6: DDoL ($32.81 in chips) 
CashMatteo: posts small blind $0.10
dgomez0429: posts big blind $0.25
*** HOLE CARDS ***
Dealt to CashMatteo [5h 9h]
DDoL: folds 
paytotheorder19: folds 
1stedcharizard: raises $0.37 to $0.62
CashMatteo: calls $0.52
dgomez0429: folds 
*** FLOP *** [7h Ad Jd]
CashMatteo: checks 
1stedcharizard: bets $0.71
CashMatteo: folds 
Uncalled bet ($0.71) returned to 1stedcharizard
1stedcharizard collected $1.42 from pot
1stedcharizard: doesn't show hand 
*** SUMMARY ***
Total pot $1.49 | Rake $0.07 
Board [7h Ad Jd]
Seat 1: paytotheorder19 folded before Flop (didn't bet)
Seat 2: 1stedcharizard (button) collected ($1.42)
Seat 4: CashMatteo (small blind) folded on the Flop
Seat 5: dgomez0429 (big blind) folded before Flop
Seat 6: DDoL folded before Flop (didn't bet)

Hand #1663: 

PokerStars Hand #246785833314:  Hold'em No Limit ($0.10/$0.25 CAD) - 2023/10/28 4:49:43 ET
Table 'Melanie' 6-max Seat #4 is the button
Seat 1: paytotheorder19 ($25.91 in chips) 
Seat 2: 1stedcharizard ($39.42 in chips) 
Seat 4: CashMatteo ($28.76 in chips) 
Seat 5: dgomez0429 ($27.67 in chips) 
Seat 6: DDoL ($32.81 in chips) 
dgomez0429: posts small blind $0.10
DDoL: posts big blind $0.25
*** HOLE CARDS ***
Dealt to CashMatteo [Jh 7h]
paytotheorder19: folds 
1stedcharizard: folds 
CashMatteo: raises $0.37 to $0.62
dgomez0429: folds 
DDoL: calls $0.37
*** FLOP *** [5h Js 4s]
DDoL: checks 
CashMatteo: bets $0.64
DDoL: folds 
Uncalled bet ($0.64) returned to CashMatteo
CashMatteo collected $1.28 from pot
CashMatteo: doesn't show hand 
*** SUMMARY ***
Total pot $1.34 | Rake $0.06 
Board [5h Js 4s]
Seat 1: paytotheorder19 folded before Flop (didn't bet)
Seat 2: 1stedcharizard folded before Flop (didn't bet)
Seat 4: CashMatteo (button) collected ($1.28)
Seat 5: dgomez0429 (small blind) folded before Flop
Seat 6: DDoL (big blind) folded on the Flop

Hand #1664: 

PokerStars Hand #246785837827:  Hold'em No Limit ($0.10/$0.25 CAD) - 2023/10/28 4:50:18 ET
Table 'Melanie' 6-max Seat #5 is the button
Seat 1: paytotheorder19 ($25.91 in chips) 
Seat 2: 1stedcharizard ($39.42 in chips) 
Seat 4: CashMatteo ($29.42 in chips) 
Seat 5: dgomez0429 ($27.57 in chips) 
Seat 6: DDoL ($32.19 in chips) 
DDoL: posts small blind $0.10
paytotheorder19: posts big blind $0.25
*** HOLE CARDS ***
Dealt to CashMatteo [Td Ac]
1stedcharizard: raises $0.50 to $0.75
CashMatteo: raises $1.25 to $2
dgomez0429: folds 
DDoL: folds 
paytotheorder19: folds 
1stedcharizard: folds 
Uncalled bet ($1.25) returned to CashMatteo
CashMatteo collected $1.85 from pot
CashMatteo: doesn't show hand 
*** SUMMARY ***
Total pot $1.85 | Rake $0 
Seat 1: paytotheorder19 (big blind) folded before Flop
Seat 2: 1stedcharizard folded before Flop
Seat 4: CashMatteo collected ($1.85)
Seat 5: dgomez0429 (button) folded before Flop (didn't bet)
Seat 6: DDoL (small blind) folded before Flop

Hand #1665: 

PokerStars Hand #246785840942:  Hold'em No Limit ($0.10/$0.25 CAD) - 2023/10/28 4:50:43 ET
Table 'Melanie' 6-max Seat #6 is the button
Seat 1: paytotheorder19 ($25.66 in chips) 
Seat 2: 1stedcharizard ($38.67 in chips) 
Seat 4: CashMatteo ($30.52 in chips) 
Seat 5: dgomez0429 ($27.57 in chips) 
Seat 6: DDoL ($32.09 in chips) 
paytotheorder19: posts small blind $0.10
1stedcharizard: posts big blind $0.25
*** HOLE CARDS ***
Dealt to CashMatteo [Tc Ad]
CashMatteo: raises $0.37 to $0.62
dgomez0429: folds 
DDoL: folds 
paytotheorder19: folds 
1stedcharizard: calls $0.37
*** FLOP *** [Jc 4h 2d]
1stedcharizard: bets $0.42
CashMatteo: calls $0.42
*** TURN *** [Jc 4h 2d] [Qd]
1stedcharizard: bets $1.04
CashMatteo: calls $1.04
*** RIVER *** [Jc 4h 2d Qd] [8d]
1stedcharizard: checks 
CashMatteo: bets $3.37
1stedcharizard: folds 
Uncalled bet ($3.37) returned to CashMatteo
CashMatteo collected $4.07 from pot
CashMatteo: doesn't show hand 
*** SUMMARY ***
Total pot $4.26 | Rake $0.19 
Board [Jc 4h 2d Qd 8d]
Seat 1: paytotheorder19 (small blind) folded before Flop
Seat 2: 1stedcharizard (big blind) folded on the River
Seat 4: CashMatteo collected ($4.07)
Seat 5: dgomez0429 folded before Flop (didn't bet)
Seat 6: DDoL (button) folded before Flop (didn't bet)

Hand #1666: 

PokerStars Hand #246785848076:  Hold'em No Limit ($0.10/$0.25 CAD) - 2023/10/28 4:51:39 ET
Table 'Melanie' 6-max Seat #1 is the button
Seat 1: paytotheorder19 ($25.56 in chips) 
Seat 2: 1stedcharizard ($36.59 in chips) 
Seat 4: CashMatteo ($32.51 in chips) 
Seat 5: dgomez0429 ($27.57 in chips) 
Seat 6: DDoL ($32.09 in chips) 
1stedcharizard: posts small blind $0.10
CashMatteo: posts big blind $0.25
*** HOLE CARDS ***
Dealt to CashMatteo [Qc 7s]
dgomez0429: folds 
DDoL: folds 
paytotheorder19: calls $0.25
1stedcharizard: folds 
CashMatteo: checks 
*** FLOP *** [4d Kd Ad]
CashMatteo: checks 
paytotheorder19: checks 
*** TURN *** [4d Kd Ad] [3s]
CashMatteo: checks 
paytotheorder19: bets $0.25
CashMatteo: calls $0.25
*** RIVER *** [4d Kd Ad 3s] [7d]
CashMatteo: checks 
paytotheorder19: checks 
*** SHOW DOWN ***
CashMatteo: shows [Qc 7s] (a pair of Sevens)
paytotheorder19: shows [9h Jd] (a flush, Ace high)
paytotheorder19 collected $1.05 from pot
*** SUMMARY ***
Total pot $1.10 | Rake $0.05 
Board [4d Kd Ad 3s 7d]
Seat 1: paytotheorder19 (button) showed [9h Jd] and won ($1.05) with a flush, Ace high
Seat 2: 1stedcharizard (small blind) folded before Flop
Seat 4: CashMatteo (big blind) showed [Qc 7s] and lost with a pair of Sevens
Seat 5: dgomez0429 folded before Flop (didn't bet)
Seat 6: DDoL folded before Flop (didn't bet)

Hand #1667: 

PokerStars Hand #246785851686:  Hold'em No Limit ($0.10/$0.25 CAD) - 2023/10/28 4:52:08 ET
Table 'Melanie' 6-max Seat #2 is the button
Seat 1: paytotheorder19 ($26.11 in chips) 
Seat 2: 1stedcharizard ($36.49 in chips) 
Seat 4: CashMatteo ($32.01 in chips) 
Seat 5: dgomez0429 ($27.57 in chips) 
Seat 6: DDoL ($32.09 in chips) 
CashMatteo: posts small blind $0.10
dgomez0429: posts big blind $0.25
*** HOLE CARDS ***
Dealt to CashMatteo [6d Tc]
DDoL: folds 
paytotheorder19: calls $0.25
1stedcharizard: raises $0.75 to $1
CashMatteo: folds 
dgomez0429: calls $0.75
paytotheorder19: calls $0.75
*** FLOP *** [4h Qd 6s]
dgomez0429: bets $0.25
paytotheorder19: calls $0.25
1stedcharizard: raises $1.86 to $2.11
dgomez0429 has timed out
dgomez0429: folds 
paytotheorder19: folds 
Uncalled bet ($1.86) returned to 1stedcharizard
1stedcharizard collected $3.68 from pot
1stedcharizard: doesn't show hand 
*** SUMMARY ***
Total pot $3.85 | Rake $0.17 
Board [4h Qd 6s]
Seat 1: paytotheorder19 folded on the Flop
Seat 2: 1stedcharizard (button) collected ($3.68)
Seat 4: CashMatteo (small blind) folded before Flop
Seat 5: dgomez0429 (big blind) folded on the Flop
Seat 6: DDoL folded before Flop (didn't bet)

Hand #1668: 

PokerStars Hand #246785862818:  Hold'em No Limit ($0.10/$0.25 CAD) - 2023/10/28 4:53:35 ET
Table 'Melanie' 6-max Seat #4 is the button
Seat 1: paytotheorder19 ($24.86 in chips) 
Seat 2: 1stedcharizard ($38.92 in chips) 
Seat 4: CashMatteo ($31.91 in chips) 
Seat 6: DDoL ($32.09 in chips) 
DDoL: posts small blind $0.10
paytotheorder19: posts big blind $0.25
*** HOLE CARDS ***
Dealt to CashMatteo [5d Kc]
1stedcharizard: raises $0.50 to $0.75
CashMatteo: folds 
DDoL: folds 
paytotheorder19: calls $0.50
*** FLOP *** [4s Qc 5s]
paytotheorder19: bets $1
1stedcharizard: folds 
Uncalled bet ($1) returned to paytotheorder19
paytotheorder19 collected $1.53 from pot
*** SUMMARY ***
Total pot $1.60 | Rake $0.07 
Board [4s Qc 5s]
Seat 1: paytotheorder19 (big blind) collected ($1.53)
Seat 2: 1stedcharizard folded on the Flop
Seat 4: CashMatteo (button) folded before Flop (didn't bet)
Seat 6: DDoL (small blind) folded before Flop

Hand #1669: 

PokerStars Hand #246785868535:  Hold'em No Limit ($0.10/$0.25 CAD) - 2023/10/28 4:54:21 ET
Table 'Melanie' 6-max Seat #6 is the button
Seat 1: paytotheorder19 ($25.64 in chips) 
Seat 2: 1stedcharizard ($38.17 in chips) 
Seat 4: CashMatteo ($31.91 in chips) 
Seat 5: dgomez0429 ($26.32 in chips) 
Seat 6: DDoL ($31.99 in chips) 
paytotheorder19: posts small blind $0.10
1stedcharizard: posts big blind $0.25
dgomez0429: posts small blind $0.10
*** HOLE CARDS ***
Dealt to CashMatteo [Qs 7h]
CashMatteo: folds 
dgomez0429 has timed out
dgomez0429: folds 
DDoL: folds 
paytotheorder19: calls $0.15
1stedcharizard: checks 
*** FLOP *** [Ks Jd 2s]
paytotheorder19: checks 
1stedcharizard: checks 
*** TURN *** [Ks Jd 2s] [5d]
FinT_3171 was removed from the table for failing to post
FinT_3171 leaves the table
paytotheorder19: bets $0.25
1stedcharizard: folds 
Uncalled bet ($0.25) returned to paytotheorder19
paytotheorder19 collected $0.57 from pot
*** SUMMARY ***
Total pot $0.60 | Rake $0.03 
Board [Ks Jd 2s 5d]
Seat 1: paytotheorder19 (small blind) collected ($0.57)
Seat 2: 1stedcharizard (big blind) folded on the Turn
Seat 4: CashMatteo folded before Flop (didn't bet)
Seat 5: dgomez0429 folded before Flop (didn't bet)
Seat 6: DDoL (button) folded before Flop (didn't bet)

Hand #1670: 

PokerStars Hand #246785877069:  Hold'em No Limit ($0.10/$0.25 CAD) - 2023/10/28 4:55:31 ET
Table 'Melanie' 6-max Seat #1 is the button
Seat 1: paytotheorder19 ($25.96 in chips) 
Seat 2: 1stedcharizard ($37.92 in chips) 
Seat 4: CashMatteo ($31.91 in chips) 
Seat 5: dgomez0429 ($26.22 in chips) 
Seat 6: DDoL ($31.99 in chips) 
1stedcharizard: posts small blind $0.10
CashMatteo: posts big blind $0.25
*** HOLE CARDS ***
Dealt to CashMatteo [5h 8c]
dgomez0429 has timed out
dgomez0429: folds 
DDoL: folds 
paytotheorder19: folds 
1stedcharizard: raises $0.62 to $0.87
CashMatteo: folds 
Uncalled bet ($0.62) returned to 1stedcharizard
1stedcharizard collected $0.50 from pot
1stedcharizard: doesn't show hand 
*** SUMMARY ***
Total pot $0.50 | Rake $0 
Seat 1: paytotheorder19 (button) folded before Flop (didn't bet)
Seat 2: 1stedcharizard (small blind) collected ($0.50)
Seat 4: CashMatteo (big blind) folded before Flop
Seat 5: dgomez0429 folded before Flop (didn't bet)
Seat 6: DDoL folded before Flop (didn't bet)

Hand #1671: 

PokerStars Hand #246785879300:  Hold'em No Limit ($0.10/$0.25 CAD) - 2023/10/28 4:55:51 ET
Table 'Melanie' 6-max Seat #2 is the button
Seat 1: paytotheorder19 ($25.96 in chips) 
Seat 2: 1stedcharizard ($38.17 in chips) 
Seat 4: CashMatteo ($31.66 in chips) 
Seat 6: DDoL ($31.99 in chips) 
CashMatteo: posts small blind $0.10
DDoL: posts big blind $0.25
*** HOLE CARDS ***
Dealt to CashMatteo [9s 4d]
paytotheorder19: folds 
1stedcharizard: folds 
CashMatteo: folds 
Uncalled bet ($0.15) returned to DDoL
DDoL collected $0.20 from pot
DDoL: doesn't show hand 
*** SUMMARY ***
Total pot $0.20 | Rake $0 
Seat 1: paytotheorder19 folded before Flop (didn't bet)
Seat 2: 1stedcharizard (button) folded before Flop (didn't bet)
Seat 4: CashMatteo (small blind) folded before Flop
Seat 6: DDoL (big blind) collected ($0.20)

Hand #1672: 

PokerStars Hand #246785880113:  Hold'em No Limit ($0.10/$0.25 CAD) - 2023/10/28 4:55:58 ET
Table 'Melanie' 6-max Seat #4 is the button
Seat 1: paytotheorder19 ($25.96 in chips) 
Seat 2: 1stedcharizard ($38.17 in chips) 
Seat 4: CashMatteo ($31.56 in chips) 
Seat 6: DDoL ($32.09 in chips) 
DDoL: posts small blind $0.10
paytotheorder19: posts big blind $0.25
*** HOLE CARDS ***
Dealt to CashMatteo [Jc 6d]
1stedcharizard: raises $0.50 to $0.75
CashMatteo: folds 
DDoL: folds 
paytotheorder19: calls $0.50
*** FLOP *** [Ks 8h 5d]
paytotheorder19: checks 
1stedcharizard: bets $0.77
paytotheorder19: calls $0.77
*** TURN *** [Ks 8h 5d] [2s]
paytotheorder19: checks 
1stedcharizard: checks 
*** RIVER *** [Ks 8h 5d 2s] [8c]
paytotheorder19: bets $3
1stedcharizard: folds 
Uncalled bet ($3) returned to paytotheorder19
paytotheorder19 collected $3 from pot
*** SUMMARY ***
Total pot $3.14 | Rake $0.14 
Board [Ks 8h 5d 2s 8c]
Seat 1: paytotheorder19 (big blind) collected ($3)
Seat 2: 1stedcharizard folded on the River
Seat 4: CashMatteo (button) folded before Flop (didn't bet)
Seat 6: DDoL (small blind) folded before Flop

Hand #1673: 

PokerStars Hand #246785884389:  Hold'em No Limit ($0.10/$0.25 CAD) - 2023/10/28 4:56:36 ET
Table 'Melanie' 6-max Seat #6 is the button
Seat 1: paytotheorder19 ($27.44 in chips) 
Seat 2: 1stedcharizard ($36.65 in chips) 
Seat 4: CashMatteo ($31.56 in chips) 
Seat 6: DDoL ($31.99 in chips) 
paytotheorder19: posts small blind $0.10
1stedcharizard: posts big blind $0.25
*** HOLE CARDS ***
Dealt to CashMatteo [As 7h]
CashMatteo: calls $0.25
DDoL: folds 
paytotheorder19: raises $0.50 to $0.75
1stedcharizard: folds 
CashMatteo: calls $0.50
*** FLOP *** [5c 8d 3s]
paytotheorder19: checks 
CashMatteo: checks 
*** TURN *** [5c 8d 3s] [Qc]
paytotheorder19: bets $0.84
CashMatteo: calls $0.84
*** RIVER *** [5c 8d 3s Qc] [3c]
paytotheorder19: checks 
CashMatteo: bets $1.64
paytotheorder19: calls $1.64
*** SHOW DOWN ***
CashMatteo: shows [As 7h] (a pair of Threes)
paytotheorder19: shows [Ad Jd] (a pair of Threes - Ace+Queen+Jack kicker)
paytotheorder19 collected $6.41 from pot
*** SUMMARY ***
Total pot $6.71 | Rake $0.30 
Board [5c 8d 3s Qc 3c]
Seat 1: paytotheorder19 (small blind) showed [Ad Jd] and won ($6.41) with a pair of Threes
Seat 2: 1stedcharizard (big blind) folded before Flop
Seat 4: CashMatteo showed [As 7h] and lost with a pair of Threes
Seat 6: DDoL (button) folded before Flop (didn't bet)

Hand #1674: 

PokerStars Hand #246785887729:  Hold'em No Limit ($0.10/$0.25 CAD) - 2023/10/28 4:57:06 ET
Table 'Melanie' 6-max Seat #1 is the button
Seat 1: paytotheorder19 ($30.62 in chips) 
Seat 2: 1stedcharizard ($36.40 in chips) 
Seat 4: CashMatteo ($28.33 in chips) 
Seat 6: DDoL ($31.99 in chips) 
1stedcharizard: posts small blind $0.10
CashMatteo: posts big blind $0.25
*** HOLE CARDS ***
Dealt to CashMatteo [5s 2c]
DDoL: folds 
paytotheorder19: folds 
1stedcharizard: folds 
Uncalled bet ($0.15) returned to CashMatteo
CashMatteo collected $0.20 from pot
CashMatteo: doesn't show hand 
*** SUMMARY ***
Total pot $0.20 | Rake $0 
Seat 1: paytotheorder19 (button) folded before Flop (didn't bet)
Seat 2: 1stedcharizard (small blind) folded before Flop
Seat 4: CashMatteo (big blind) collected ($0.20)
Seat 6: DDoL folded before Flop (didn't bet)

Hand #1675: 

PokerStars Hand #246785889343:  Hold'em No Limit ($0.10/$0.25 CAD) - 2023/10/28 4:57:21 ET
Table 'Melanie' 6-max Seat #2 is the button
Seat 1: paytotheorder19 ($30.62 in chips) 
Seat 2: 1stedcharizard ($36.30 in chips) 
Seat 4: CashMatteo ($28.43 in chips) 
Seat 6: DDoL ($31.99 in chips) 
CashMatteo: posts small blind $0.10
DDoL: posts big blind $0.25
*** HOLE CARDS ***
Dealt to CashMatteo [Jh Tc]
paytotheorder19: calls $0.25
1stedcharizard: raises $0.50 to $0.75
CashMatteo: calls $0.65
DDoL: folds 
paytotheorder19: calls $0.50
*** FLOP *** [8c Kh 6d]
CashMatteo: checks 
paytotheorder19: checks 
1stedcharizard: bets $1.20
CashMatteo: folds 
paytotheorder19: folds 
Uncalled bet ($1.20) returned to 1stedcharizard
1stedcharizard collected $2.39 from pot
1stedcharizard: doesn't show hand 
*** SUMMARY ***
Total pot $2.50 | Rake $0.11 
Board [8c Kh 6d]
Seat 1: paytotheorder19 folded on the Flop
Seat 2: 1stedcharizard (button) collected ($2.39)
Seat 4: CashMatteo (small blind) folded on the Flop
Seat 6: DDoL (big blind) folded before Flop

Hand #1676: 

PokerStars Hand #246785894060:  Hold'em No Limit ($0.10/$0.25 CAD) - 2023/10/28 4:58:03 ET
Table 'Melanie' 6-max Seat #4 is the button
Seat 1: paytotheorder19 ($29.87 in chips) 
Seat 2: 1stedcharizard ($37.94 in chips) 
Seat 4: CashMatteo ($27.68 in chips) 
Seat 6: DDoL ($31.74 in chips) 
DDoL: posts small blind $0.10
paytotheorder19: posts big blind $0.25
*** HOLE CARDS ***
Dealt to CashMatteo [Ah 5d]
1stedcharizard: raises $0.50 to $0.75
CashMatteo: calls $0.75
DDoL: folds 
paytotheorder19: calls $0.50
*** FLOP *** [3h 2c Qh]
paytotheorder19: checks 
1stedcharizard: checks 
CashMatteo: checks 
*** TURN *** [3h 2c Qh] [5s]
paytotheorder19: bets $0.25
1stedcharizard: calls $0.25
CashMatteo: calls $0.25
*** RIVER *** [3h 2c Qh 5s] [8d]
paytotheorder19: checks 
1stedcharizard: checks 
CashMatteo: checks 
*** SHOW DOWN ***
paytotheorder19: shows [Jd Ac] (high card Ace)
1stedcharizard: mucks hand 
CashMatteo: shows [Ah 5d] (a pair of Fives)
CashMatteo collected $2.96 from pot
*** SUMMARY ***
Total pot $3.10 | Rake $0.14 
Board [3h 2c Qh 5s 8d]
Seat 1: paytotheorder19 (big blind) showed [Jd Ac] and lost with high card Ace
Seat 2: 1stedcharizard mucked [6c 7c]
Seat 4: CashMatteo (button) showed [Ah 5d] and won ($2.96) with a pair of Fives
Seat 6: DDoL (small blind) folded before Flop

Hand #1677: 

PokerStars Hand #246785898889:  Hold'em No Limit ($0.10/$0.25 CAD) - 2023/10/28 4:58:46 ET
Table 'Melanie' 6-max Seat #6 is the button
Seat 1: paytotheorder19 ($28.87 in chips) 
Seat 2: 1stedcharizard ($36.94 in chips) 
Seat 4: CashMatteo ($29.64 in chips) 
Seat 6: DDoL ($31.64 in chips) 
paytotheorder19: posts small blind $0.10
1stedcharizard: posts big blind $0.25
*** HOLE CARDS ***
Dealt to CashMatteo [Tc 3d]
CashMatteo: folds 
DDoL: raises $0.50 to $0.75
paytotheorder19: folds 
1stedcharizard: calls $0.50
*** FLOP *** [Ac Jh 7s]
1stedcharizard: checks 
DDoL: checks 
*** TURN *** [Ac Jh 7s] [5h]
1stedcharizard: checks 
DDoL: bets $0.77
1stedcharizard: folds 
Uncalled bet ($0.77) returned to DDoL
DDoL collected $1.53 from pot
DDoL: doesn't show hand 
*** SUMMARY ***
Total pot $1.60 | Rake $0.07 
Board [Ac Jh 7s 5h]
Seat 1: paytotheorder19 (small blind) folded before Flop
Seat 2: 1stedcharizard (big blind) folded on the Turn
Seat 4: CashMatteo folded before Flop (didn't bet)
Seat 6: DDoL (button) collected ($1.53)

Hand #1678: 

PokerStars Hand #246785905716:  Hold'em No Limit ($0.10/$0.25 CAD) - 2023/10/28 4:59:46 ET
Table 'Melanie' 6-max Seat #1 is the button
Seat 1: paytotheorder19 ($28.77 in chips) 
Seat 2: 1stedcharizard ($36.19 in chips) 
Seat 4: CashMatteo ($29.64 in chips) 
Seat 6: DDoL ($32.42 in chips) 
1stedcharizard: posts small blind $0.10
CashMatteo: posts big blind $0.25
*** HOLE CARDS ***
Dealt to CashMatteo [Qd As]
DDoL: folds 
paytotheorder19: folds 
1stedcharizard: folds 
Uncalled bet ($0.15) returned to CashMatteo
CashMatteo collected $0.20 from pot
CashMatteo: doesn't show hand 
*** SUMMARY ***
Total pot $0.20 | Rake $0 
Seat 1: paytotheorder19 (button) folded before Flop (didn't bet)
Seat 2: 1stedcharizard (small blind) folded before Flop
Seat 4: CashMatteo (big blind) collected ($0.20)
Seat 6: DDoL folded before Flop (didn't bet)

Hand #1679: 

PokerStars Hand #246785906678:  Hold'em No Limit ($0.10/$0.25 CAD) - 2023/10/28 4:59:54 ET
Table 'Melanie' 6-max Seat #2 is the button
Seat 1: paytotheorder19 ($28.77 in chips) 
Seat 2: 1stedcharizard ($36.09 in chips) 
Seat 4: CashMatteo ($29.74 in chips) 
Seat 6: DDoL ($32.42 in chips) 
CashMatteo: posts small blind $0.10
DDoL: posts big blind $0.25
*** HOLE CARDS ***
Dealt to CashMatteo [Qc 9s]
paytotheorder19: calls $0.25
1stedcharizard: folds 
CashMatteo: calls $0.15
DDoL: checks 
*** FLOP *** [8d Jh 7d]
CashMatteo: checks 
DDoL: checks 
paytotheorder19: checks 
*** TURN *** [8d Jh 7d] [4s]
CashMatteo: checks 
DDoL: checks 
paytotheorder19: checks 
*** RIVER *** [8d Jh 7d 4s] [Kh]
CashMatteo: checks 
DDoL: checks 
paytotheorder19: checks 
*** SHOW DOWN ***
CashMatteo: shows [Qc 9s] (high card King)
DDoL: shows [5c 7h] (a pair of Sevens)
paytotheorder19: mucks hand 
DDoL collected $0.72 from pot
*** SUMMARY ***
Total pot $0.75 | Rake $0.03 
Board [8d Jh 7d 4s Kh]
Seat 1: paytotheorder19 mucked [6d Td]
Seat 2: 1stedcharizard (button) folded before Flop (didn't bet)
Seat 4: CashMatteo (small blind) showed [Qc 9s] and lost with high card King
Seat 6: DDoL (big blind) showed [5c 7h] and won ($0.72) with a pair of Sevens

Hand #1680: 

PokerStars Hand #246785911667:  Hold'em No Limit ($0.10/$0.25 CAD) - 2023/10/28 5:00:37 ET
Table 'Melanie' 6-max Seat #4 is the button
Seat 1: paytotheorder19 ($28.52 in chips) 
Seat 2: 1stedcharizard ($36.09 in chips) 
Seat 4: CashMatteo ($29.49 in chips) 
Seat 6: DDoL ($32.89 in chips) 
DDoL: posts small blind $0.10
paytotheorder19: posts big blind $0.25
*** HOLE CARDS ***
Dealt to CashMatteo [3c 8s]
1stedcharizard: raises $0.50 to $0.75
CashMatteo: folds 
DDoL: folds 
paytotheorder19: calls $0.50
*** FLOP *** [4d 9s Kh]
paytotheorder19: bets $0.25
CashMatteo leaves the table
1stedcharizard: raises $1.02 to $1.27
paytotheorder19: calls $1.02
*** TURN *** [4d 9s Kh] [9c]
paytotheorder19: checks 
1stedcharizard: checks 
*** RIVER *** [4d 9s Kh 9c] [Ks]
paytotheorder19: bets $3.95
1stedcharizard: folds 
Uncalled bet ($3.95) returned to paytotheorder19
paytotheorder19 collected $3.95 from pot
*** SUMMARY ***
Total pot $4.14 | Rake $0.19 
Board [4d 9s Kh 9c Ks]
Seat 1: paytotheorder19 (big blind) collected ($3.95)
Seat 2: 1stedcharizard folded on the River
Seat 4: CashMatteo (button) folded before Flop (didn't bet)
Seat 6: DDoL (small blind) folded before Flop

Hand #1681: 

PokerStars Hand #246785918645: Tournament #3664966358, $4.65+$0.35 CAD Hold'em No Limit - Level I (10/20) - 2023/10/28 5:01:33 ET
Table '3664966358 1' 3-max Seat #1 is the button
Seat 1: mastermine1973 (500 in chips) 
Seat 2: last 5 bucks (500 in chips) 
Seat 3: CashMatteo (500 in chips) 
last 5 bucks: posts small blind 10
CashMatteo: posts big blind 20
*** HOLE CARDS ***
Dealt to CashMatteo [2s 7h]
mastermine1973: calls 20
last 5 bucks: folds 
CashMatteo: checks 
*** FLOP *** [2d Qd Jd]
CashMatteo: checks 
mastermine1973: checks 
*** TURN *** [2d Qd Jd] [Ah]
CashMatteo: checks 
mastermine1973: checks 
*** RIVER *** [2d Qd Jd Ah] [Ad]
CashMatteo: checks 
mastermine1973: checks 
*** SHOW DOWN ***
CashMatteo: shows [2s 7h] (two pair, Aces and Deuces)
mastermine1973: shows [Qc 9d] (a flush, Ace high)
mastermine1973 collected 50 from pot
*** SUMMARY ***
Total pot 50 | Rake 0 
Board [2d Qd Jd Ah Ad]
Seat 1: mastermine1973 (button) showed [Qc 9d] and won (50) with a flush, Ace high
Seat 2: last 5 bucks (small blind) folded before Flop
Seat 3: CashMatteo (big blind) showed [2s 7h] and lost with two pair, Aces and Deuces

Hand #1682: 

PokerStars Hand #246785921214: Tournament #3664966358, $4.65+$0.35 CAD Hold'em No Limit - Level I (10/20) - 2023/10/28 5:01:53 ET
Table '3664966358 1' 3-max Seat #2 is the button
Seat 1: mastermine1973 (530 in chips) 
Seat 2: last 5 bucks (490 in chips) 
Seat 3: CashMatteo (480 in chips) 
CashMatteo: posts small blind 10
mastermine1973: posts big blind 20
*** HOLE CARDS ***
Dealt to CashMatteo [4c 9s]
last 5 bucks: raises 20 to 40
CashMatteo: folds 
mastermine1973: calls 20
*** FLOP *** [4h 5c 4s]
mastermine1973: checks 
last 5 bucks: bets 90
mastermine1973: calls 90
*** TURN *** [4h 5c 4s] [Kh]
mastermine1973: checks 
last 5 bucks: checks 
*** RIVER *** [4h 5c 4s Kh] [Td]
mastermine1973: checks 
last 5 bucks: bets 135
mastermine1973: folds 
Uncalled bet (135) returned to last 5 bucks
last 5 bucks collected 270 from pot
last 5 bucks: doesn't show hand 
*** SUMMARY ***
Total pot 270 | Rake 0 
Board [4h 5c 4s Kh Td]
Seat 1: mastermine1973 (big blind) folded on the River
Seat 2: last 5 bucks (button) collected (270)
Seat 3: CashMatteo (small blind) folded before Flop

Hand #1683: 

PokerStars Hand #246785925864: Tournament #3664966358, $4.65+$0.35 CAD Hold'em No Limit - Level I (10/20) - 2023/10/28 5:02:29 ET
Table '3664966358 1' 3-max Seat #3 is the button
Seat 1: mastermine1973 (400 in chips) 
Seat 2: last 5 bucks (630 in chips) 
Seat 3: CashMatteo (470 in chips) 
mastermine1973: posts small blind 10
last 5 bucks: posts big blind 20
*** HOLE CARDS ***
Dealt to CashMatteo [5d Qc]
CashMatteo: folds 
mastermine1973: calls 10
last 5 bucks: checks 
*** FLOP *** [7c 7s 3d]
mastermine1973: checks 
last 5 bucks: checks 
*** TURN *** [7c 7s 3d] [8d]
mastermine1973: checks 
last 5 bucks: checks 
*** RIVER *** [7c 7s 3d 8d] [9s]
mastermine1973: bets 40
last 5 bucks: folds 
Uncalled bet (40) returned to mastermine1973
mastermine1973 collected 40 from pot
*** SUMMARY ***
Total pot 40 | Rake 0 
Board [7c 7s 3d 8d 9s]
Seat 1: mastermine1973 (small blind) collected (40)
Seat 2: last 5 bucks (big blind) folded on the River
Seat 3: CashMatteo (button) folded before Flop (didn't bet)

Hand #1684: 

PokerStars Hand #246785929491: Tournament #3664966358, $4.65+$0.35 CAD Hold'em No Limit - Level I (10/20) - 2023/10/28 5:02:56 ET
Table '3664966358 1' 3-max Seat #1 is the button
Seat 1: mastermine1973 (420 in chips) 
Seat 2: last 5 bucks (610 in chips) 
Seat 3: CashMatteo (470 in chips) 
last 5 bucks: posts small blind 10
CashMatteo: posts big blind 20
*** HOLE CARDS ***
Dealt to CashMatteo [Jd 2s]
mastermine1973: calls 20
last 5 bucks: calls 10
CashMatteo: checks 
*** FLOP *** [5h Th Qc]
last 5 bucks: checks 
CashMatteo: checks 
mastermine1973: checks 
*** TURN *** [5h Th Qc] [9c]
last 5 bucks: bets 60
CashMatteo: calls 60
mastermine1973: calls 60
*** RIVER *** [5h Th Qc 9c] [Qh]
last 5 bucks: checks 
CashMatteo: bets 120
mastermine1973: folds 
last 5 bucks: folds 
Uncalled bet (120) returned to CashMatteo
CashMatteo collected 240 from pot
CashMatteo: doesn't show hand 
*** SUMMARY ***
Total pot 240 | Rake 0 
Board [5h Th Qc 9c Qh]
Seat 1: mastermine1973 (button) folded on the River
Seat 2: last 5 bucks (small blind) folded on the River
Seat 3: CashMatteo (big blind) collected (240)

Hand #1685: 

PokerStars Hand #246785933779: Tournament #3664966358, $4.65+$0.35 CAD Hold'em No Limit - Level I (10/20) - 2023/10/28 5:03:29 ET
Table '3664966358 1' 3-max Seat #2 is the button
Seat 1: mastermine1973 (340 in chips) 
Seat 2: last 5 bucks (530 in chips) 
Seat 3: CashMatteo (630 in chips) 
CashMatteo: posts small blind 10
mastermine1973: posts big blind 20
*** HOLE CARDS ***
Dealt to CashMatteo [Kd 3s]
last 5 bucks: folds 
CashMatteo: folds 
Uncalled bet (10) returned to mastermine1973
mastermine1973 collected 20 from pot
*** SUMMARY ***
Total pot 20 | Rake 0 
Seat 1: mastermine1973 (big blind) collected (20)
Seat 2: last 5 bucks (button) folded before Flop (didn't bet)
Seat 3: CashMatteo (small blind) folded before Flop

Hand #1686: 

PokerStars Hand #246785934428: Tournament #3664966358, $4.65+$0.35 CAD Hold'em No Limit - Level I (10/20) - 2023/10/28 5:03:34 ET
Table '3664966358 1' 3-max Seat #3 is the button
Seat 1: mastermine1973 (350 in chips) 
Seat 2: last 5 bucks (530 in chips) 
Seat 3: CashMatteo (620 in chips) 
mastermine1973: posts small blind 10
last 5 bucks: posts big blind 20
*** HOLE CARDS ***
Dealt to CashMatteo [Jh 9s]
CashMatteo: raises 30 to 50
mastermine1973: folds 
last 5 bucks: calls 30
*** FLOP *** [8c 9c 6d]
last 5 bucks: checks 
CashMatteo: bets 55
last 5 bucks: folds 
Uncalled bet (55) returned to CashMatteo
CashMatteo collected 110 from pot
CashMatteo: doesn't show hand 
*** SUMMARY ***
Total pot 110 | Rake 0 
Board [8c 9c 6d]
Seat 1: mastermine1973 (small blind) folded before Flop
Seat 2: last 5 bucks (big blind) folded on the Flop
Seat 3: CashMatteo (button) collected (110)

Hand #1687: 

PokerStars Hand #246785937668: Tournament #3664966358, $4.65+$0.35 CAD Hold'em No Limit - Level I (10/20) - 2023/10/28 5:03:59 ET
Table '3664966358 1' 3-max Seat #1 is the button
Seat 1: mastermine1973 (340 in chips) 
Seat 2: last 5 bucks (480 in chips) 
Seat 3: CashMatteo (680 in chips) 
last 5 bucks: posts small blind 10
CashMatteo: posts big blind 20
*** HOLE CARDS ***
Dealt to CashMatteo [7c 3c]
mastermine1973: raises 140 to 160
last 5 bucks: folds 
CashMatteo: folds 
Uncalled bet (140) returned to mastermine1973
mastermine1973 collected 50 from pot
*** SUMMARY ***
Total pot 50 | Rake 0 
Seat 1: mastermine1973 (button) collected (50)
Seat 2: last 5 bucks (small blind) folded before Flop
Seat 3: CashMatteo (big blind) folded before Flop

Hand #1688: 

PokerStars Hand #246785938849: Tournament #3664966358, $4.65+$0.35 CAD Hold'em No Limit - Level I (10/20) - 2023/10/28 5:04:08 ET
Table '3664966358 1' 3-max Seat #2 is the button
Seat 1: mastermine1973 (370 in chips) 
Seat 2: last 5 bucks (470 in chips) 
Seat 3: CashMatteo (660 in chips) 
CashMatteo: posts small blind 10
mastermine1973: posts big blind 20
*** HOLE CARDS ***
Dealt to CashMatteo [5c 8s]
last 5 bucks: folds 
CashMatteo: folds 
Uncalled bet (10) returned to mastermine1973
mastermine1973 collected 20 from pot
*** SUMMARY ***
Total pot 20 | Rake 0 
Seat 1: mastermine1973 (big blind) collected (20)
Seat 2: last 5 bucks (button) folded before Flop (didn't bet)
Seat 3: CashMatteo (small blind) folded before Flop

Hand #1689: 

PokerStars Hand #246785939688: Tournament #3664966358, $4.65+$0.35 CAD Hold'em No Limit - Level I (10/20) - 2023/10/28 5:04:14 ET
Table '3664966358 1' 3-max Seat #3 is the button
Seat 1: mastermine1973 (380 in chips) 
Seat 2: last 5 bucks (470 in chips) 
Seat 3: CashMatteo (650 in chips) 
mastermine1973: posts small blind 10
last 5 bucks: posts big blind 20
*** HOLE CARDS ***
Dealt to CashMatteo [6s 9d]
CashMatteo: calls 20
mastermine1973: calls 10
last 5 bucks: checks 
*** FLOP *** [Ah 7c 2h]
mastermine1973: checks 
last 5 bucks: checks 
CashMatteo: checks 
*** TURN *** [Ah 7c 2h] [2d]
mastermine1973: checks 
last 5 bucks: checks 
CashMatteo: checks 
*** RIVER *** [Ah 7c 2h 2d] [Ac]
mastermine1973: checks 
last 5 bucks: checks 
CashMatteo: checks 
*** SHOW DOWN ***
mastermine1973: shows [Td Jh] (two pair, Aces and Deuces)
last 5 bucks: shows [Qc Jc] (two pair, Aces and Deuces - Queen kicker)
CashMatteo: mucks hand 
last 5 bucks collected 60 from pot
*** SUMMARY ***
Total pot 60 | Rake 0 
Board [Ah 7c 2h 2d Ac]
Seat 1: mastermine1973 (small blind) showed [Td Jh] and lost with two pair, Aces and Deuces
Seat 2: last 5 bucks (big blind) showed [Qc Jc] and won (60) with two pair, Aces and Deuces
Seat 3: CashMatteo (button) mucked [6s 9d]

Hand #1690: 

PokerStars Hand #246785944231: Tournament #3664966358, $4.65+$0.35 CAD Hold'em No Limit - Level II (15/30) - 2023/10/28 5:04:48 ET
Table '3664966358 1' 3-max Seat #1 is the button
Seat 1: mastermine1973 (360 in chips) 
Seat 2: last 5 bucks (510 in chips) 
Seat 3: CashMatteo (630 in chips) 
last 5 bucks: posts small blind 15
CashMatteo: posts big blind 30
*** HOLE CARDS ***
Dealt to CashMatteo [4s 6d]
mastermine1973: calls 30
last 5 bucks: folds 
CashMatteo: checks 
*** FLOP *** [Qh Kh 8s]
CashMatteo: checks 
mastermine1973: checks 
*** TURN *** [Qh Kh 8s] [3s]
CashMatteo: bets 38
mastermine1973: calls 38
*** RIVER *** [Qh Kh 8s 3s] [5c]
CashMatteo: bets 151
mastermine1973: folds 
Uncalled bet (151) returned to CashMatteo
CashMatteo collected 151 from pot
CashMatteo: doesn't show hand 
*** SUMMARY ***
Total pot 151 | Rake 0 
Board [Qh Kh 8s 3s 5c]
Seat 1: mastermine1973 (button) folded on the River
Seat 2: last 5 bucks (small blind) folded before Flop
Seat 3: CashMatteo (big blind) collected (151)

Hand #1691: 

PokerStars Hand #246785947344: Tournament #3664966358, $4.65+$0.35 CAD Hold'em No Limit - Level II (15/30) - 2023/10/28 5:05:11 ET
Table '3664966358 1' 3-max Seat #2 is the button
Seat 1: mastermine1973 (292 in chips) 
Seat 2: last 5 bucks (495 in chips) 
Seat 3: CashMatteo (713 in chips) 
CashMatteo: posts small blind 15
mastermine1973: posts big blind 30
*** HOLE CARDS ***
Dealt to CashMatteo [4c Qs]
last 5 bucks: folds 
CashMatteo: folds 
Uncalled bet (15) returned to mastermine1973
mastermine1973 collected 30 from pot
*** SUMMARY ***
Total pot 30 | Rake 0 
Seat 1: mastermine1973 (big blind) collected (30)
Seat 2: last 5 bucks (button) folded before Flop (didn't bet)
Seat 3: CashMatteo (small blind) folded before Flop

Hand #1692: 

PokerStars Hand #246785948048: Tournament #3664966358, $4.65+$0.35 CAD Hold'em No Limit - Level II (15/30) - 2023/10/28 5:05:17 ET
Table '3664966358 1' 3-max Seat #3 is the button
Seat 1: mastermine1973 (307 in chips) 
Seat 2: last 5 bucks (495 in chips) 
Seat 3: CashMatteo (698 in chips) 
mastermine1973: posts small blind 15
last 5 bucks: posts big blind 30
*** HOLE CARDS ***
Dealt to CashMatteo [Kd 7h]
CashMatteo: folds 
mastermine1973: folds 
Uncalled bet (15) returned to last 5 bucks
last 5 bucks collected 30 from pot
last 5 bucks: doesn't show hand 
*** SUMMARY ***
Total pot 30 | Rake 0 
Seat 1: mastermine1973 (small blind) folded before Flop
Seat 2: last 5 bucks (big blind) collected (30)
Seat 3: CashMatteo (button) folded before Flop (didn't bet)

Hand #1693: 

PokerStars Hand #246785948749: Tournament #3664966358, $4.65+$0.35 CAD Hold'em No Limit - Level II (15/30) - 2023/10/28 5:05:22 ET
Table '3664966358 1' 3-max Seat #1 is the button
Seat 1: mastermine1973 (292 in chips) 
Seat 2: last 5 bucks (510 in chips) 
Seat 3: CashMatteo (698 in chips) 
last 5 bucks: posts small blind 15
CashMatteo: posts big blind 30
*** HOLE CARDS ***
Dealt to CashMatteo [Qd Th]
mastermine1973: calls 30
last 5 bucks: raises 30 to 60
CashMatteo: calls 30
mastermine1973: calls 30
*** FLOP *** [7s Td 5d]
last 5 bucks: checks 
CashMatteo: checks 
mastermine1973: checks 
*** TURN *** [7s Td 5d] [Js]
last 5 bucks: checks 
CashMatteo: bets 90
mastermine1973: calls 90
last 5 bucks: folds 
*** RIVER *** [7s Td 5d Js] [As]
CashMatteo: checks 
mastermine1973: checks 
*** SHOW DOWN ***
CashMatteo: shows [Qd Th] (a pair of Tens)
mastermine1973: mucks hand 
CashMatteo collected 360 from pot
*** SUMMARY ***
Total pot 360 | Rake 0 
Board [7s Td 5d Js As]
Seat 1: mastermine1973 (button) mucked [9s 4d]
Seat 2: last 5 bucks (small blind) folded on the Turn
Seat 3: CashMatteo (big blind) showed [Qd Th] and won (360) with a pair of Tens

Hand #1694: 

PokerStars Hand #246785955521: Tournament #3664966358, $4.65+$0.35 CAD Hold'em No Limit - Level II (15/30) - 2023/10/28 5:06:13 ET
Table '3664966358 1' 3-max Seat #2 is the button
Seat 1: mastermine1973 (142 in chips) 
Seat 2: last 5 bucks (450 in chips) 
Seat 3: CashMatteo (908 in chips) 
CashMatteo: posts small blind 15
mastermine1973: posts big blind 30
*** HOLE CARDS ***
Dealt to CashMatteo [2d 2h]
last 5 bucks: folds 
CashMatteo: raises 878 to 908 and is all-in
mastermine1973: calls 112 and is all-in
Uncalled bet (766) returned to CashMatteo
*** FLOP *** [4s 3h Jc]
*** TURN *** [4s 3h Jc] [Kd]
*** RIVER *** [4s 3h Jc Kd] [6d]
*** SHOW DOWN ***
CashMatteo: shows [2d 2h] (a pair of Deuces)
mastermine1973: shows [4d 2c] (a pair of Fours)
mastermine1973 collected 284 from pot
*** SUMMARY ***
Total pot 284 | Rake 0 
Board [4s 3h Jc Kd 6d]
Seat 1: mastermine1973 (big blind) showed [4d 2c] and won (284) with a pair of Fours
Seat 2: last 5 bucks (button) folded before Flop (didn't bet)
Seat 3: CashMatteo (small blind) showed [2d 2h] and lost with a pair of Deuces

Hand #1695: 

PokerStars Hand #246785957480: Tournament #3664966358, $4.65+$0.35 CAD Hold'em No Limit - Level II (15/30) - 2023/10/28 5:06:27 ET
Table '3664966358 1' 3-max Seat #3 is the button
Seat 1: mastermine1973 (284 in chips) 
Seat 2: last 5 bucks (450 in chips) 
Seat 3: CashMatteo (766 in chips) 
mastermine1973: posts small blind 15
last 5 bucks: posts big blind 30
*** HOLE CARDS ***
Dealt to CashMatteo [4d 9s]
CashMatteo: folds 
mastermine1973: calls 15
last 5 bucks: checks 
*** FLOP *** [Th 4s Kd]
mastermine1973: bets 60
last 5 bucks: folds 
Uncalled bet (60) returned to mastermine1973
mastermine1973 collected 60 from pot
*** SUMMARY ***
Total pot 60 | Rake 0 
Board [Th 4s Kd]
Seat 1: mastermine1973 (small blind) collected (60)
Seat 2: last 5 bucks (big blind) folded on the Flop
Seat 3: CashMatteo (button) folded before Flop (didn't bet)

Hand #1696: 

PokerStars Hand #246785959859: Tournament #3664966358, $4.65+$0.35 CAD Hold'em No Limit - Level II (15/30) - 2023/10/28 5:06:45 ET
Table '3664966358 1' 3-max Seat #1 is the button
Seat 1: mastermine1973 (314 in chips) 
Seat 2: last 5 bucks (420 in chips) 
Seat 3: CashMatteo (766 in chips) 
last 5 bucks: posts small blind 15
CashMatteo: posts big blind 30
*** HOLE CARDS ***
Dealt to CashMatteo [2d Qh]
mastermine1973: calls 30
last 5 bucks: folds 
CashMatteo: checks 
*** FLOP *** [6d 5s 4c]
CashMatteo: checks 
mastermine1973: checks 
*** TURN *** [6d 5s 4c] [Jh]
CashMatteo: checks 
mastermine1973: checks 
*** RIVER *** [6d 5s 4c Jh] [Ks]
CashMatteo: checks 
mastermine1973: checks 
*** SHOW DOWN ***
CashMatteo: shows [2d Qh] (high card King)
mastermine1973: mucks hand 
CashMatteo collected 75 from pot
*** SUMMARY ***
Total pot 75 | Rake 0 
Board [6d 5s 4c Jh Ks]
Seat 1: mastermine1973 (button) mucked [9h Th]
Seat 2: last 5 bucks (small blind) folded before Flop
Seat 3: CashMatteo (big blind) showed [2d Qh] and won (75) with high card King

Hand #1697: 

PokerStars Hand #246785962607: Tournament #3664966358, $4.65+$0.35 CAD Hold'em No Limit - Level II (15/30) - 2023/10/28 5:07:05 ET
Table '3664966358 1' 3-max Seat #2 is the button
Seat 1: mastermine1973 (284 in chips) 
Seat 2: last 5 bucks (405 in chips) 
Seat 3: CashMatteo (811 in chips) 
CashMatteo: posts small blind 15
mastermine1973: posts big blind 30
*** HOLE CARDS ***
Dealt to CashMatteo [9h 6c]
last 5 bucks: raises 30 to 60
CashMatteo: calls 45
mastermine1973: calls 30
*** FLOP *** [Ad Jd Kc]
CashMatteo: checks 
mastermine1973: checks 
last 5 bucks: checks 
*** TURN *** [Ad Jd Kc] [Jc]
CashMatteo: checks 
mastermine1973: checks 
last 5 bucks: checks 
*** RIVER *** [Ad Jd Kc Jc] [7h]
CashMatteo: checks 
mastermine1973: checks 
last 5 bucks: checks 
*** SHOW DOWN ***
CashMatteo: shows [9h 6c] (a pair of Jacks)
mastermine1973: mucks hand 
last 5 bucks: shows [5s 5h] (two pair, Jacks and Fives)
last 5 bucks collected 180 from pot
*** SUMMARY ***
Total pot 180 | Rake 0 
Board [Ad Jd Kc Jc 7h]
Seat 1: mastermine1973 (big blind) mucked [5c 8s]
Seat 2: last 5 bucks (button) showed [5s 5h] and won (180) with two pair, Jacks and Fives
Seat 3: CashMatteo (small blind) showed [9h 6c] and lost with a pair of Jacks

Hand #1698: 

PokerStars Hand #246785967116: Tournament #3664966358, $4.65+$0.35 CAD Hold'em No Limit - Level III (20/40) - 2023/10/28 5:07:39 ET
Table '3664966358 1' 3-max Seat #3 is the button
Seat 1: mastermine1973 (224 in chips) 
Seat 2: last 5 bucks (525 in chips) 
Seat 3: CashMatteo (751 in chips) 
mastermine1973: posts small blind 20
last 5 bucks: posts big blind 40
*** HOLE CARDS ***
Dealt to CashMatteo [3h 8d]
CashMatteo: folds 
mastermine1973: calls 20
last 5 bucks: raises 40 to 80
mastermine1973: calls 40
*** FLOP *** [Qs Jh Kd]
mastermine1973: checks 
last 5 bucks: bets 80
mastermine1973: folds 
Uncalled bet (80) returned to last 5 bucks
last 5 bucks collected 160 from pot
last 5 bucks: doesn't show hand 
*** SUMMARY ***
Total pot 160 | Rake 0 
Board [Qs Jh Kd]
Seat 1: mastermine1973 (small blind) folded on the Flop
Seat 2: last 5 bucks (big blind) collected (160)
Seat 3: CashMatteo (button) folded before Flop (didn't bet)

Hand #1699: 

PokerStars Hand #246785969239: Tournament #3664966358, $4.65+$0.35 CAD Hold'em No Limit - Level III (20/40) - 2023/10/28 5:07:56 ET
Table '3664966358 1' 3-max Seat #1 is the button
Seat 1: mastermine1973 (144 in chips) 
Seat 2: last 5 bucks (605 in chips) 
Seat 3: CashMatteo (751 in chips) 
last 5 bucks: posts small blind 20
CashMatteo: posts big blind 40
*** HOLE CARDS ***
Dealt to CashMatteo [6h 5c]
mastermine1973: raises 104 to 144 and is all-in
last 5 bucks: folds 
CashMatteo: calls 104
*** FLOP *** [8c Tc 2d]
*** TURN *** [8c Tc 2d] [Qd]
*** RIVER *** [8c Tc 2d Qd] [As]
*** SHOW DOWN ***
CashMatteo: shows [6h 5c] (high card Ace)
mastermine1973: shows [9h 8d] (a pair of Eights)
mastermine1973 collected 308 from pot
*** SUMMARY ***
Total pot 308 | Rake 0 
Board [8c Tc 2d Qd As]
Seat 1: mastermine1973 (button) showed [9h 8d] and won (308) with a pair of Eights
Seat 2: last 5 bucks (small blind) folded before Flop
Seat 3: CashMatteo (big blind) showed [6h 5c] and lost with high card Ace

Hand #1700: 

PokerStars Hand #246785973169: Tournament #3664966358, $4.65+$0.35 CAD Hold'em No Limit - Level III (20/40) - 2023/10/28 5:08:25 ET
Table '3664966358 1' 3-max Seat #2 is the button
Seat 1: mastermine1973 (308 in chips) 
Seat 2: last 5 bucks (585 in chips) 
Seat 3: CashMatteo (607 in chips) 
CashMatteo: posts small blind 20
mastermine1973: posts big blind 40
*** HOLE CARDS ***
Dealt to CashMatteo [6d Qc]
last 5 bucks: folds 
CashMatteo: calls 20
mastermine1973: checks 
*** FLOP *** [5c Kd Qh]
CashMatteo: checks 
mastermine1973: checks 
*** TURN *** [5c Kd Qh] [6s]
CashMatteo: bets 40
mastermine1973: calls 40
*** RIVER *** [5c Kd Qh 6s] [Td]
CashMatteo: bets 527 and is all-in
mastermine1973: folds 
Uncalled bet (527) returned to CashMatteo
CashMatteo collected 160 from pot
CashMatteo: doesn't show hand 
*** SUMMARY ***
Total pot 160 | Rake 0 
Board [5c Kd Qh 6s Td]
Seat 1: mastermine1973 (big blind) folded on the River
Seat 2: last 5 bucks (button) folded before Flop (didn't bet)
Seat 3: CashMatteo (small blind) collected (160)

Hand #1701: 

PokerStars Hand #246785975529: Tournament #3664966358, $4.65+$0.35 CAD Hold'em No Limit - Level III (20/40) - 2023/10/28 5:08:42 ET
Table '3664966358 1' 3-max Seat #3 is the button
Seat 1: mastermine1973 (228 in chips) 
Seat 2: last 5 bucks (585 in chips) 
Seat 3: CashMatteo (687 in chips) 
mastermine1973: posts small blind 20
last 5 bucks: posts big blind 40
*** HOLE CARDS ***
Dealt to CashMatteo [Ac 4d]
CashMatteo: raises 40 to 80
mastermine1973: raises 148 to 228 and is all-in
last 5 bucks: folds 
CashMatteo: calls 148
*** FLOP *** [5d 2d Ts]
*** TURN *** [5d 2d Ts] [3h]
*** RIVER *** [5d 2d Ts 3h] [Jh]
*** SHOW DOWN ***
mastermine1973: shows [9s Ah] (high card Ace)
CashMatteo: shows [Ac 4d] (a straight, Ace to Five)
CashMatteo collected 496 from pot
mastermine1973 finished the tournament in 3rd place
*** SUMMARY ***
Total pot 496 | Rake 0 
Board [5d 2d Ts 3h Jh]
Seat 1: mastermine1973 (small blind) showed [9s Ah] and lost with high card Ace
Seat 2: last 5 bucks (big blind) folded before Flop
Seat 3: CashMatteo (button) showed [Ac 4d] and won (496) with a straight, Ace to Five

Hand #1702: 

PokerStars Hand #246785978135: Tournament #3664966358, $4.65+$0.35 CAD Hold'em No Limit - Level III (20/40) - 2023/10/28 5:09:02 ET
Table '3664966358 1' 3-max Seat #2 is the button
Seat 2: last 5 bucks (545 in chips) 
Seat 3: CashMatteo (955 in chips) 
last 5 bucks: posts small blind 20
CashMatteo: posts big blind 40
*** HOLE CARDS ***
Dealt to CashMatteo [4s 2c]
last 5 bucks: folds 
Uncalled bet (20) returned to CashMatteo
CashMatteo collected 40 from pot
CashMatteo: doesn't show hand 
*** SUMMARY ***
Total pot 40 | Rake 0 
Seat 2: last 5 bucks (button) (small blind) folded before Flop
Seat 3: CashMatteo (big blind) collected (40)

Hand #1703: 

PokerStars Hand #246785978732: Tournament #3664966358, $4.65+$0.35 CAD Hold'em No Limit - Level III (20/40) - 2023/10/28 5:09:06 ET
Table '3664966358 1' 3-max Seat #3 is the button
Seat 2: last 5 bucks (525 in chips) 
Seat 3: CashMatteo (975 in chips) 
CashMatteo: posts small blind 20
last 5 bucks: posts big blind 40
*** HOLE CARDS ***
Dealt to CashMatteo [Qh 9s]
CashMatteo: calls 20
last 5 bucks: raises 485 to 525 and is all-in
CashMatteo: folds 
Uncalled bet (485) returned to last 5 bucks
last 5 bucks collected 80 from pot
last 5 bucks: doesn't show hand 
*** SUMMARY ***
Total pot 80 | Rake 0 
Seat 2: last 5 bucks (big blind) collected (80)
Seat 3: CashMatteo (button) (small blind) folded before Flop

Hand #1704: 

PokerStars Hand #246785980285: Tournament #3664966358, $4.65+$0.35 CAD Hold'em No Limit - Level III (20/40) - 2023/10/28 5:09:17 ET
Table '3664966358 1' 3-max Seat #2 is the button
Seat 2: last 5 bucks (565 in chips) 
Seat 3: CashMatteo (935 in chips) 
last 5 bucks: posts small blind 20
CashMatteo: posts big blind 40
*** HOLE CARDS ***
Dealt to CashMatteo [As 7h]
last 5 bucks: folds 
Uncalled bet (20) returned to CashMatteo
CashMatteo collected 40 from pot
CashMatteo: doesn't show hand 
*** SUMMARY ***
Total pot 40 | Rake 0 
Seat 2: last 5 bucks (button) (small blind) folded before Flop
Seat 3: CashMatteo (big blind) collected (40)

Hand #1705: 

PokerStars Hand #246785980975: Tournament #3664966358, $4.65+$0.35 CAD Hold'em No Limit - Level III (20/40) - 2023/10/28 5:09:23 ET
Table '3664966358 1' 3-max Seat #3 is the button
Seat 2: last 5 bucks (545 in chips) 
Seat 3: CashMatteo (955 in chips) 
CashMatteo: posts small blind 20
last 5 bucks: posts big blind 40
*** HOLE CARDS ***
Dealt to CashMatteo [Ts Ad]
CashMatteo: raises 915 to 955 and is all-in
last 5 bucks: calls 505 and is all-in
Uncalled bet (410) returned to CashMatteo
*** FLOP *** [3s 5h 7d]
*** TURN *** [3s 5h 7d] [Th]
*** RIVER *** [3s 5h 7d Th] [Kh]
*** SHOW DOWN ***
last 5 bucks: shows [Qc As] (high card Ace)
CashMatteo: shows [Ts Ad] (a pair of Tens)
CashMatteo collected 1090 from pot
last 5 bucks finished the tournament in 2nd place
CashMatteo wins the tournament and receives $15.00 - congratulations!
*** SUMMARY ***
Total pot 1090 | Rake 0 
Board [3s 5h 7d Th Kh]
Seat 2: last 5 bucks (big blind) showed [Qc As] and lost with high card Ace
Seat 3: CashMatteo (button) (small blind) showed [Ts Ad] and won (1090) with a pair of Tens

Hand #1706: 

PokerStars Hand #246785986743: Tournament #3664970779, $1.84+$0.16 CAD Hold'em No Limit - Level I (10/20) - 2023/10/28 5:10:05 ET
Table '3664970779 1' 3-max Seat #1 is the button
Seat 1: CashMatteo (500 in chips) 
Seat 2: stew the dog (500 in chips) 
Seat 3: toodarnlucky (500 in chips) 
stew the dog: posts small blind 10
toodarnlucky: posts big blind 20
*** HOLE CARDS ***
Dealt to CashMatteo [Qs 7s]
CashMatteo: raises 30 to 50
stew the dog: calls 40
toodarnlucky: calls 30
*** FLOP *** [3s Qh 3d]
stew the dog: checks 
toodarnlucky: checks 
CashMatteo: bets 75
stew the dog: calls 75
toodarnlucky: folds 
*** TURN *** [3s Qh 3d] [Ad]
stew the dog: checks 
CashMatteo: checks 
*** RIVER *** [3s Qh 3d Ad] [Ac]
stew the dog: checks 
CashMatteo: checks 
*** SHOW DOWN ***
stew the dog: shows [Ts 8s] (two pair, Aces and Threes)
CashMatteo: shows [Qs 7s] (two pair, Aces and Queens)
CashMatteo collected 300 from pot
*** SUMMARY ***
Total pot 300 | Rake 0 
Board [3s Qh 3d Ad Ac]
Seat 1: CashMatteo (button) showed [Qs 7s] and won (300) with two pair, Aces and Queens
Seat 2: stew the dog (small blind) showed [Ts 8s] and lost with two pair, Aces and Threes
Seat 3: toodarnlucky (big blind) folded on the Flop

Hand #1707: 

PokerStars Hand #246785995837: Tournament #3664970779, $1.84+$0.16 CAD Hold'em No Limit - Level I (10/20) - 2023/10/28 5:11:12 ET
Table '3664970779 1' 3-max Seat #2 is the button
Seat 1: CashMatteo (675 in chips) 
Seat 2: stew the dog (375 in chips) 
Seat 3: toodarnlucky (450 in chips) 
toodarnlucky: posts small blind 10
CashMatteo: posts big blind 20
*** HOLE CARDS ***
Dealt to CashMatteo [2s 3d]
stew the dog: calls 20
toodarnlucky: calls 10
CashMatteo: checks 
*** FLOP *** [Jc 7c 3s]
toodarnlucky: checks 
CashMatteo: checks 
stew the dog: bets 40
toodarnlucky: raises 390 to 430 and is all-in
CashMatteo: folds 
stew the dog: folds 
Uncalled bet (390) returned to toodarnlucky
toodarnlucky collected 140 from pot
toodarnlucky: doesn't show hand 
*** SUMMARY ***
Total pot 140 | Rake 0 
Board [Jc 7c 3s]
Seat 1: CashMatteo (big blind) folded on the Flop
Seat 2: stew the dog (button) folded on the Flop
Seat 3: toodarnlucky (small blind) collected (140)

Hand #1708: 

PokerStars Hand #246786003009: Tournament #3664970779, $1.84+$0.16 CAD Hold'em No Limit - Level I (10/20) - 2023/10/28 5:12:05 ET
Table '3664970779 1' 3-max Seat #3 is the button
Seat 1: CashMatteo (655 in chips) 
Seat 2: stew the dog (315 in chips) 
Seat 3: toodarnlucky (530 in chips) 
CashMatteo: posts small blind 10
stew the dog: posts big blind 20
*** HOLE CARDS ***
Dealt to CashMatteo [5h As]
toodarnlucky: calls 20
CashMatteo: raises 30 to 50
stew the dog: calls 30
toodarnlucky: calls 30
*** FLOP *** [Jd 8d 6h]
CashMatteo: checks 
stew the dog: bets 80
toodarnlucky: folds 
CashMatteo: folds 
Uncalled bet (80) returned to stew the dog
stew the dog collected 150 from pot
*** SUMMARY ***
Total pot 150 | Rake 0 
Board [Jd 8d 6h]
Seat 1: CashMatteo (small blind) folded on the Flop
Seat 2: stew the dog (big blind) collected (150)
Seat 3: toodarnlucky (button) folded on the Flop

Hand #1709: 

PokerStars Hand #246786007760: Tournament #3664970779, $1.84+$0.16 CAD Hold'em No Limit - Level I (10/20) - 2023/10/28 5:12:40 ET
Table '3664970779 1' 3-max Seat #1 is the button
Seat 1: CashMatteo (605 in chips) 
Seat 2: stew the dog (415 in chips) 
Seat 3: toodarnlucky (480 in chips) 
stew the dog: posts small blind 10
toodarnlucky: posts big blind 20
*** HOLE CARDS ***
Dealt to CashMatteo [9c 2d]
CashMatteo: folds 
stew the dog: calls 10
toodarnlucky has timed out
toodarnlucky: checks 
*** FLOP *** [Jh 9h Jc]
stew the dog: bets 20
toodarnlucky: raises 60 to 80
stew the dog: calls 60
*** TURN *** [Jh 9h Jc] [2h]
stew the dog: checks 
toodarnlucky: bets 140
stew the dog: calls 140
*** RIVER *** [Jh 9h Jc 2h] [Jd]
stew the dog: bets 60
toodarnlucky: folds 
Uncalled bet (60) returned to stew the dog
stew the dog collected 480 from pot
*** SUMMARY ***
Total pot 480 | Rake 0 
Board [Jh 9h Jc 2h Jd]
Seat 1: CashMatteo (button) folded before Flop (didn't bet)
Seat 2: stew the dog (small blind) collected (480)
Seat 3: toodarnlucky (big blind) folded on the River

Hand #1710: 

PokerStars Hand #246786014488: Tournament #3664970779, $1.84+$0.16 CAD Hold'em No Limit - Level II (15/30) - 2023/10/28 5:13:29 ET
Table '3664970779 1' 3-max Seat #2 is the button
Seat 1: CashMatteo (605 in chips) 
Seat 2: stew the dog (655 in chips) 
Seat 3: toodarnlucky (240 in chips) 
toodarnlucky: posts small blind 15
CashMatteo: posts big blind 30
*** HOLE CARDS ***
Dealt to CashMatteo [8h Ks]
stew the dog: calls 30
toodarnlucky: calls 15
CashMatteo: checks 
*** FLOP *** [As 6h 7h]
toodarnlucky: checks 
CashMatteo: checks 
stew the dog: bets 30
toodarnlucky: raises 180 to 210 and is all-in
CashMatteo: folds 
stew the dog: calls 180
*** TURN *** [As 6h 7h] [4h]
*** RIVER *** [As 6h 7h 4h] [3c]
*** SHOW DOWN ***
toodarnlucky: shows [7d 3d] (two pair, Sevens and Threes)
stew the dog: shows [Ah 6c] (two pair, Aces and Sixes)
stew the dog collected 510 from pot
toodarnlucky finished the tournament in 3rd place
*** SUMMARY ***
Total pot 510 | Rake 0 
Board [As 6h 7h 4h 3c]
Seat 1: CashMatteo (big blind) folded on the Flop
Seat 2: stew the dog (button) showed [Ah 6c] and won (510) with two pair, Aces and Sixes
Seat 3: toodarnlucky (small blind) showed [7d 3d] and lost with two pair, Sevens and Threes

Hand #1711: 

PokerStars Hand #246786018566: Tournament #3664970779, $1.84+$0.16 CAD Hold'em No Limit - Level II (15/30) - 2023/10/28 5:13:59 ET
Table '3664970779 1' 3-max Seat #1 is the button
Seat 1: CashMatteo (575 in chips) 
Seat 2: stew the dog (925 in chips) 
CashMatteo: posts small blind 15
stew the dog: posts big blind 30
*** HOLE CARDS ***
Dealt to CashMatteo [Jh 8d]
CashMatteo: calls 15
stew the dog: raises 30 to 60
CashMatteo: calls 30
*** FLOP *** [2c Ts 7d]
stew the dog: bets 30
CashMatteo: calls 30
*** TURN *** [2c Ts 7d] [7h]
stew the dog: bets 30
CashMatteo: calls 30
*** RIVER *** [2c Ts 7d 7h] [2d]
stew the dog: checks 
CashMatteo: bets 120
stew the dog: folds 
Uncalled bet (120) returned to CashMatteo
CashMatteo collected 240 from pot
CashMatteo: doesn't show hand 
*** SUMMARY ***
Total pot 240 | Rake 0 
Board [2c Ts 7d 7h 2d]
Seat 1: CashMatteo (button) (small blind) collected (240)
Seat 2: stew the dog (big blind) folded on the River

Hand #1712: 

PokerStars Hand #246786021758: Tournament #3664970779, $1.84+$0.16 CAD Hold'em No Limit - Level II (15/30) - 2023/10/28 5:14:22 ET
Table '3664970779 1' 3-max Seat #2 is the button
Seat 1: CashMatteo (695 in chips) 
Seat 2: stew the dog (805 in chips) 
stew the dog: posts small blind 15
CashMatteo: posts big blind 30
*** HOLE CARDS ***
Dealt to CashMatteo [As 3c]
stew the dog: calls 15
CashMatteo: checks 
*** FLOP *** [Tc 3s Kd]
CashMatteo: checks 
stew the dog: checks 
*** TURN *** [Tc 3s Kd] [2s]
CashMatteo: bets 30
stew the dog: calls 30
*** RIVER *** [Tc 3s Kd 2s] [Th]
CashMatteo: checks 
stew the dog: checks 
*** SHOW DOWN ***
CashMatteo: shows [As 3c] (two pair, Tens and Threes)
stew the dog: mucks hand 
CashMatteo collected 120 from pot
*** SUMMARY ***
Total pot 120 | Rake 0 
Board [Tc 3s Kd 2s Th]
Seat 1: CashMatteo (big blind) showed [As 3c] and won (120) with two pair, Tens and Threes
Seat 2: stew the dog (button) (small blind) mucked [Ah 9h]

Hand #1713: 

PokerStars Hand #246786024339: Tournament #3664970779, $1.84+$0.16 CAD Hold'em No Limit - Level II (15/30) - 2023/10/28 5:14:41 ET
Table '3664970779 1' 3-max Seat #1 is the button
Seat 1: CashMatteo (755 in chips) 
Seat 2: stew the dog (745 in chips) 
CashMatteo: posts small blind 15
stew the dog: posts big blind 30
*** HOLE CARDS ***
Dealt to CashMatteo [5s Kc]
CashMatteo: calls 15
stew the dog: checks 
*** FLOP *** [8d 4c 6d]
stew the dog: bets 60
CashMatteo: calls 60
*** TURN *** [8d 4c 6d] [6c]
stew the dog: checks 
CashMatteo: checks 
*** RIVER *** [8d 4c 6d 6c] [Ac]
stew the dog: checks 
CashMatteo: bets 135
stew the dog: folds 
Uncalled bet (135) returned to CashMatteo
CashMatteo collected 180 from pot
CashMatteo: doesn't show hand 
*** SUMMARY ***
Total pot 180 | Rake 0 
Board [8d 4c 6d 6c Ac]
Seat 1: CashMatteo (button) (small blind) collected (180)
Seat 2: stew the dog (big blind) folded on the River

Hand #1714: 

PokerStars Hand #246786028331: Tournament #3664970779, $1.84+$0.16 CAD Hold'em No Limit - Level II (15/30) - 2023/10/28 5:15:10 ET
Table '3664970779 1' 3-max Seat #2 is the button
Seat 1: CashMatteo (845 in chips) 
Seat 2: stew the dog (655 in chips) 
stew the dog: posts small blind 15
CashMatteo: posts big blind 30
*** HOLE CARDS ***
Dealt to CashMatteo [5d Kd]
stew the dog: calls 15
CashMatteo: raises 45 to 75
stew the dog: calls 45
*** FLOP *** [Td Jh 9h]
CashMatteo: checks 
stew the dog: checks 
*** TURN *** [Td Jh 9h] [2s]
CashMatteo: checks 
stew the dog: bets 30
CashMatteo: calls 30
*** RIVER *** [Td Jh 9h 2s] [7h]
CashMatteo: checks 
stew the dog: checks 
*** SHOW DOWN ***
CashMatteo: shows [5d Kd] (high card King)
stew the dog: shows [Qd 2c] (a pair of Deuces)
stew the dog collected 210 from pot
*** SUMMARY ***
Total pot 210 | Rake 0 
Board [Td Jh 9h 2s 7h]
Seat 1: CashMatteo (big blind) showed [5d Kd] and lost with high card King
Seat 2: stew the dog (button) (small blind) showed [Qd 2c] and won (210) with a pair of Deuces

Hand #1715: 

PokerStars Hand #246786032049: Tournament #3664970779, $1.84+$0.16 CAD Hold'em No Limit - Level II (15/30) - 2023/10/28 5:15:37 ET
Table '3664970779 1' 3-max Seat #1 is the button
Seat 1: CashMatteo (740 in chips) 
Seat 2: stew the dog (760 in chips) 
CashMatteo: posts small blind 15
stew the dog: posts big blind 30
*** HOLE CARDS ***
Dealt to CashMatteo [Ad Kc]
CashMatteo: raises 45 to 75
stew the dog: raises 45 to 120
CashMatteo: raises 45 to 165
stew the dog: calls 45
*** FLOP *** [9d 7s 3h]
stew the dog: bets 60
CashMatteo: raises 515 to 575 and is all-in
stew the dog: calls 515
*** TURN *** [9d 7s 3h] [2s]
*** RIVER *** [9d 7s 3h 2s] [9s]
*** SHOW DOWN ***
stew the dog: shows [Tc 9c] (three of a kind, Nines)
CashMatteo: shows [Ad Kc] (a pair of Nines)
stew the dog collected 1480 from pot
CashMatteo finished the tournament in 2nd place
stew the dog wins the tournament and receives $10.00 - congratulations!
*** SUMMARY ***
Total pot 1480 | Rake 0 
Board [9d 7s 3h 2s 9s]
Seat 1: CashMatteo (button) (small blind) showed [Ad Kc] and lost with a pair of Nines
Seat 2: stew the dog (big blind) showed [Tc 9c] and won (1480) with three of a kind, Nines

Hand #1716: 

PokerStars Hand #246794362495:  Hold'em No Limit ($0.10/$0.25 CAD) - 2023/10/28 15:17:56 ET
Table 'Tanga II' 6-max Seat #2 is the button
Seat 2: schenectady69 ($28.58 in chips) 
Seat 3: jj_rose_jj12 ($25 in chips) 
Seat 4: marner99 ($25.32 in chips) 
Seat 5: CashMatteo ($15 in chips) 
Seat 6: zViveXz ($23.29 in chips) 
jj_rose_jj12: posts small blind $0.10
marner99: posts big blind $0.25
CashMatteo: posts big blind $0.25
*** HOLE CARDS ***
Dealt to CashMatteo [Ad Jc]
CashMatteo: raises $0.37 to $0.62
zViveXz: folds 
schenectady69: folds 
jj_rose_jj12: folds 
marner99: folds 
Uncalled bet ($0.37) returned to CashMatteo
CashMatteo collected $0.60 from pot
CashMatteo: doesn't show hand 
*** SUMMARY ***
Total pot $0.60 | Rake $0 
Seat 2: schenectady69 (button) folded before Flop (didn't bet)
Seat 3: jj_rose_jj12 (small blind) folded before Flop
Seat 4: marner99 (big blind) folded before Flop
Seat 5: CashMatteo collected ($0.60)
Seat 6: zViveXz folded before Flop (didn't bet)

Hand #1717: 

PokerStars Hand #246794367485:  Hold'em No Limit ($0.10/$0.25 CAD) - 2023/10/28 15:18:11 ET
Table 'Tanga II' 6-max Seat #3 is the button
Seat 2: schenectady69 ($28.58 in chips) 
Seat 3: jj_rose_jj12 ($25 in chips) 
Seat 4: marner99 ($25.07 in chips) 
Seat 5: CashMatteo ($15.35 in chips) 
Seat 6: zViveXz ($23.29 in chips) 
marner99: posts small blind $0.10
CashMatteo: posts big blind $0.25
*** HOLE CARDS ***
Dealt to CashMatteo [Ks 4h]
zViveXz: folds 
schenectady69: folds 
jj_rose_jj12: folds 
marner99: folds 
Uncalled bet ($0.15) returned to CashMatteo
CashMatteo collected $0.20 from pot
CashMatteo: doesn't show hand 
*** SUMMARY ***
Total pot $0.20 | Rake $0 
Seat 2: schenectady69 folded before Flop (didn't bet)
Seat 3: jj_rose_jj12 (button) folded before Flop (didn't bet)
Seat 4: marner99 (small blind) folded before Flop
Seat 5: CashMatteo (big blind) collected ($0.20)
Seat 6: zViveXz folded before Flop (didn't bet)

Hand #1718: 

PokerStars Hand #246794370494:  Hold'em No Limit ($0.10/$0.25 CAD) - 2023/10/28 15:18:19 ET
Table 'Tanga II' 6-max Seat #4 is the button
Seat 2: schenectady69 ($28.58 in chips) 
Seat 3: jj_rose_jj12 ($25 in chips) 
Seat 4: marner99 ($25 in chips) 
Seat 5: CashMatteo ($15.45 in chips) 
Seat 6: zViveXz ($23.29 in chips) 
CashMatteo: posts small blind $0.10
zViveXz: posts big blind $0.25
*** HOLE CARDS ***
Dealt to CashMatteo [5d 3c]
schenectady69: folds 
jj_rose_jj12: folds 
marner99: folds 
CashMatteo: calls $0.15
zViveXz: raises $0.37 to $0.62
CashMatteo: folds 
Uncalled bet ($0.37) returned to zViveXz
zViveXz collected $0.50 from pot
zViveXz: doesn't show hand 
*** SUMMARY ***
Total pot $0.50 | Rake $0 
Seat 2: schenectady69 folded before Flop (didn't bet)
Seat 3: jj_rose_jj12 folded before Flop (didn't bet)
Seat 4: marner99 (button) folded before Flop (didn't bet)
Seat 5: CashMatteo (small blind) folded before Flop
Seat 6: zViveXz (big blind) collected ($0.50)

Hand #1719: 

PokerStars Hand #246794376350:  Hold'em No Limit ($0.10/$0.25 CAD) - 2023/10/28 15:18:37 ET
Table 'Tanga II' 6-max Seat #5 is the button
Seat 2: schenectady69 ($28.58 in chips) 
Seat 3: jj_rose_jj12 ($25 in chips) 
Seat 4: marner99 ($25 in chips) 
Seat 5: CashMatteo ($15.20 in chips) 
Seat 6: zViveXz ($23.54 in chips) 
zViveXz: posts small blind $0.10
schenectady69: posts big blind $0.25
*** HOLE CARDS ***
Dealt to CashMatteo [Kh Ah]
jj_rose_jj12: folds 
marner99: folds 
CashMatteo: raises $0.37 to $0.62
zViveXz: folds 
schenectady69: folds 
Uncalled bet ($0.37) returned to CashMatteo
CashMatteo collected $0.60 from pot
CashMatteo: doesn't show hand 
*** SUMMARY ***
Total pot $0.60 | Rake $0 
Seat 2: schenectady69 (big blind) folded before Flop
Seat 3: jj_rose_jj12 folded before Flop (didn't bet)
Seat 4: marner99 folded before Flop (didn't bet)
Seat 5: CashMatteo (button) collected ($0.60)
Seat 6: zViveXz (small blind) folded before Flop

Hand #1720: 

PokerStars Hand #246794382039:  Hold'em No Limit ($0.10/$0.25 CAD) - 2023/10/28 15:18:54 ET
Table 'Tanga II' 6-max Seat #6 is the button
Seat 2: schenectady69 ($28.33 in chips) 
Seat 3: jj_rose_jj12 ($25 in chips) 
Seat 4: marner99 ($25 in chips) 
Seat 5: CashMatteo ($15.55 in chips) 
Seat 6: zViveXz ($23.44 in chips) 
schenectady69: posts small blind $0.10
jj_rose_jj12: posts big blind $0.25
*** HOLE CARDS ***
Dealt to CashMatteo [Qh Th]
n01shome joins the table at seat #1 
marner99: folds 
CashMatteo: raises $0.37 to $0.62
zViveXz: folds 
schenectady69: folds 
jj_rose_jj12: calls $0.37
*** FLOP *** [2h 7h 6c]
jj_rose_jj12: checks 
CashMatteo: bets $0.64
jj_rose_jj12: calls $0.64
*** TURN *** [2h 7h 6c] [2c]
jj_rose_jj12: checks 
CashMatteo: checks 
*** RIVER *** [2h 7h 6c 2c] [9s]
jj_rose_jj12: checks 
CashMatteo: bets $1.87
jj_rose_jj12: folds 
Uncalled bet ($1.87) returned to CashMatteo
CashMatteo collected $2.50 from pot
CashMatteo: doesn't show hand 
*** SUMMARY ***
Total pot $2.62 | Rake $0.12 
Board [2h 7h 6c 2c 9s]
Seat 2: schenectady69 (small blind) folded before Flop
Seat 3: jj_rose_jj12 (big blind) folded on the River
Seat 4: marner99 folded before Flop (didn't bet)
Seat 5: CashMatteo collected ($2.50)
Seat 6: zViveXz (button) folded before Flop (didn't bet)

Hand #1721: 

PokerStars Hand #246794399465:  Hold'em No Limit ($0.10/$0.25 CAD) - 2023/10/28 15:19:44 ET
Table 'Tanga II' 6-max Seat #2 is the button
Seat 2: schenectady69 ($28.23 in chips) 
Seat 3: jj_rose_jj12 ($25 in chips) 
Seat 4: marner99 ($25 in chips) 
Seat 5: CashMatteo ($16.79 in chips) 
Seat 6: zViveXz ($23.44 in chips) 
jj_rose_jj12: posts small blind $0.10
marner99: posts big blind $0.25
n01shome: sits out 
*** HOLE CARDS ***
Dealt to CashMatteo [2h 5c]
CashMatteo: folds 
zViveXz: calls $0.25
schenectady69: raises $0.50 to $0.75
jj_rose_jj12: folds 
marner99: folds 
zViveXz: calls $0.50
*** FLOP *** [5h Js 8c]
zViveXz: checks 
schenectady69: bets $0.89
zViveXz: calls $0.89
*** TURN *** [5h Js 8c] [4d]
zViveXz: checks 
schenectady69: checks 
*** RIVER *** [5h Js 8c 4d] [Kc]
zViveXz: checks 
schenectady69: checks 
*** SHOW DOWN ***
zViveXz: shows [Td 9d] (high card King)
schenectady69: shows [6d Jd] (a pair of Jacks)
schenectady69 collected $3.47 from pot
*** SUMMARY ***
Total pot $3.63 | Rake $0.16 
Board [5h Js 8c 4d Kc]
Seat 2: schenectady69 (button) showed [6d Jd] and won ($3.47) with a pair of Jacks
Seat 3: jj_rose_jj12 (small blind) folded before Flop
Seat 4: marner99 (big blind) folded before Flop
Seat 5: CashMatteo folded before Flop (didn't bet)
Seat 6: zViveXz showed [Td 9d] and lost with high card King

Hand #1722: 

PokerStars Hand #246794421662:  Hold'em No Limit ($0.10/$0.25 CAD) - 2023/10/28 15:20:49 ET
Table 'Tanga II' 6-max Seat #3 is the button
Seat 1: n01shome ($25 in chips) 
Seat 2: schenectady69 ($30.06 in chips) 
Seat 3: jj_rose_jj12 ($25 in chips) 
Seat 4: marner99 ($25 in chips) 
Seat 5: CashMatteo ($16.79 in chips) 
Seat 6: zViveXz ($21.80 in chips) 
marner99: posts small blind $0.10
CashMatteo: posts big blind $0.25
n01shome: posts big blind $0.25
*** HOLE CARDS ***
Dealt to CashMatteo [3s 8c]
zViveXz: folds 
n01shome: checks 
schenectady69: folds 
jj_rose_jj12: folds 
marner99: raises $0.50 to $0.75
CashMatteo: folds 
n01shome: folds 
Uncalled bet ($0.50) returned to marner99
marner99 collected $0.75 from pot
marner99: doesn't show hand 
*** SUMMARY ***
Total pot $0.75 | Rake $0 
Seat 1: n01shome folded before Flop (didn't bet)
Seat 2: schenectady69 folded before Flop (didn't bet)
Seat 3: jj_rose_jj12 (button) folded before Flop (didn't bet)
Seat 4: marner99 (small blind) collected ($0.75)
Seat 5: CashMatteo (big blind) folded before Flop
Seat 6: zViveXz folded before Flop (didn't bet)

Hand #1723: 

PokerStars Hand #246794428939:  Hold'em No Limit ($0.10/$0.25 CAD) - 2023/10/28 15:21:11 ET
Table 'Tanga II' 6-max Seat #4 is the button
Seat 1: n01shome ($24.75 in chips) 
Seat 2: schenectady69 ($30.06 in chips) 
Seat 3: jj_rose_jj12 ($25 in chips) 
Seat 4: marner99 ($25.50 in chips) 
Seat 5: CashMatteo ($16.54 in chips) 
CashMatteo: posts small blind $0.10
zViveXz: is sitting out 
n01shome: posts big blind $0.25
*** HOLE CARDS ***
Dealt to CashMatteo [Ac Kc]
schenectady69: folds 
jj_rose_jj12: folds 
marner99: folds 
CashMatteo: raises $0.37 to $0.62
n01shome: folds 
Uncalled bet ($0.37) returned to CashMatteo
CashMatteo collected $0.50 from pot
CashMatteo: doesn't show hand 
*** SUMMARY ***
Total pot $0.50 | Rake $0 
Seat 1: n01shome (big blind) folded before Flop
Seat 2: schenectady69 folded before Flop (didn't bet)
Seat 3: jj_rose_jj12 folded before Flop (didn't bet)
Seat 4: marner99 (button) folded before Flop (didn't bet)
Seat 5: CashMatteo (small blind) collected ($0.50)

Hand #1724: 

PokerStars Hand #246794433910:  Hold'em No Limit ($0.10/$0.25 CAD) - 2023/10/28 15:21:25 ET
Table 'Tanga II' 6-max Seat #5 is the button
Seat 1: n01shome ($24.50 in chips) 
Seat 2: schenectady69 ($30.06 in chips) 
Seat 3: jj_rose_jj12 ($25 in chips) 
Seat 4: marner99 ($25.50 in chips) 
Seat 5: CashMatteo ($16.79 in chips) 
n01shome: posts small blind $0.10
schenectady69: posts big blind $0.25
*** HOLE CARDS ***
Dealt to CashMatteo [6s 7c]
jj_rose_jj12: folds 
marner99: folds 
CashMatteo: raises $0.37 to $0.62
n01shome: folds 
schenectady69: folds 
Uncalled bet ($0.37) returned to CashMatteo
CashMatteo collected $0.60 from pot
CashMatteo: doesn't show hand 
*** SUMMARY ***
Total pot $0.60 | Rake $0 
Seat 1: n01shome (small blind) folded before Flop
Seat 2: schenectady69 (big blind) folded before Flop
Seat 3: jj_rose_jj12 folded before Flop (didn't bet)
Seat 4: marner99 folded before Flop (didn't bet)
Seat 5: CashMatteo (button) collected ($0.60)

Hand #1725: 

PokerStars Hand #246794441373:  Hold'em No Limit ($0.10/$0.25 CAD) - 2023/10/28 15:21:47 ET
Table 'Tanga II' 6-max Seat #1 is the button
Seat 1: n01shome ($24.40 in chips) 
Seat 2: schenectady69 ($29.81 in chips) 
Seat 3: jj_rose_jj12 ($25 in chips) 
Seat 4: marner99 ($25.50 in chips) 
Seat 5: CashMatteo ($17.14 in chips) 
schenectady69: posts small blind $0.10
jj_rose_jj12: posts big blind $0.25
*** HOLE CARDS ***
Dealt to CashMatteo [9c 9d]
marner99: raises $0.37 to $0.62
CashMatteo: raises $1.38 to $2
n01shome: folds 
schenectady69: folds 
jj_rose_jj12: folds 
marner99: folds 
Uncalled bet ($1.38) returned to CashMatteo
CashMatteo collected $1.59 from pot
CashMatteo: doesn't show hand 
*** SUMMARY ***
Total pot $1.59 | Rake $0 
Seat 1: n01shome (button) folded before Flop (didn't bet)
Seat 2: schenectady69 (small blind) folded before Flop
Seat 3: jj_rose_jj12 (big blind) folded before Flop
Seat 4: marner99 folded before Flop
Seat 5: CashMatteo collected ($1.59)

Hand #1726: 

PokerStars Hand #246794452216:  Hold'em No Limit ($0.10/$0.25 CAD) - 2023/10/28 15:22:19 ET
Table 'Tanga II' 6-max Seat #2 is the button
Seat 1: n01shome ($24.40 in chips) 
Seat 2: schenectady69 ($29.71 in chips) 
Seat 3: jj_rose_jj12 ($25 in chips) 
Seat 4: marner99 ($25 in chips) 
Seat 5: CashMatteo ($18.11 in chips) 
jj_rose_jj12: posts small blind $0.10
marner99: posts big blind $0.25
*** HOLE CARDS ***
Dealt to CashMatteo [4s 2c]
CashMatteo: folds 
n01shome: folds 
schenectady69: folds 
jj_rose_jj12: folds 
Uncalled bet ($0.15) returned to marner99
marner99 collected $0.20 from pot
marner99: doesn't show hand 
*** SUMMARY ***
Total pot $0.20 | Rake $0 
Seat 1: n01shome folded before Flop (didn't bet)
Seat 2: schenectady69 (button) folded before Flop (didn't bet)
Seat 3: jj_rose_jj12 (small blind) folded before Flop
Seat 4: marner99 (big blind) collected ($0.20)
Seat 5: CashMatteo folded before Flop (didn't bet)

Hand #1727: 

PokerStars Hand #246794456084:  Hold'em No Limit ($0.10/$0.25 CAD) - 2023/10/28 15:22:30 ET
Table 'Tanga II' 6-max Seat #3 is the button
Seat 1: n01shome ($24.40 in chips) 
Seat 2: schenectady69 ($29.71 in chips) 
Seat 3: jj_rose_jj12 ($25 in chips) 
Seat 4: marner99 ($25.10 in chips) 
Seat 5: CashMatteo ($18.11 in chips) 
marner99: posts small blind $0.10
CashMatteo: posts big blind $0.25
*** HOLE CARDS ***
Dealt to CashMatteo [6h 4h]
n01shome: raises $0.25 to $0.50
schenectady69: folds 
jj_rose_jj12: folds 
marner99: folds 
CashMatteo: calls $0.25
*** FLOP *** [Kc Td 2s]
CashMatteo: checks 
n01shome: bets $0.53
CashMatteo: folds 
Uncalled bet ($0.53) returned to n01shome
n01shome collected $1.05 from pot
n01shome: doesn't show hand 
*** SUMMARY ***
Total pot $1.10 | Rake $0.05 
Board [Kc Td 2s]
Seat 1: n01shome collected ($1.05)
Seat 2: schenectady69 folded before Flop (didn't bet)
Seat 3: jj_rose_jj12 (button) folded before Flop (didn't bet)
Seat 4: marner99 (small blind) folded before Flop
Seat 5: CashMatteo (big blind) folded on the Flop

Hand #1728: 

PokerStars Hand #246794464348:  Hold'em No Limit ($0.10/$0.25 CAD) - 2023/10/28 15:22:55 ET
Table 'Tanga II' 6-max Seat #4 is the button
Seat 1: n01shome ($24.95 in chips) 
Seat 2: schenectady69 ($29.71 in chips) 
Seat 3: jj_rose_jj12 ($25 in chips) 
Seat 4: marner99 ($25 in chips) 
Seat 5: CashMatteo ($17.61 in chips) 
CashMatteo: posts small blind $0.10
n01shome: posts big blind $0.25
*** HOLE CARDS ***
Dealt to CashMatteo [5c Kd]
schenectady69: folds 
jj_rose_jj12: folds 
marner99: folds 
CashMatteo: folds 
Uncalled bet ($0.15) returned to n01shome
n01shome collected $0.20 from pot
n01shome: doesn't show hand 
*** SUMMARY ***
Total pot $0.20 | Rake $0 
Seat 1: n01shome (big blind) collected ($0.20)
Seat 2: schenectady69 folded before Flop (didn't bet)
Seat 3: jj_rose_jj12 folded before Flop (didn't bet)
Seat 4: marner99 (button) folded before Flop (didn't bet)
Seat 5: CashMatteo (small blind) folded before Flop

Hand #1729: 

PokerStars Hand #246794469783:  Hold'em No Limit ($0.10/$0.25 CAD) - 2023/10/28 15:23:11 ET
Table 'Tanga II' 6-max Seat #5 is the button
Seat 1: n01shome ($25.05 in chips) 
Seat 2: schenectady69 ($29.71 in chips) 
Seat 3: jj_rose_jj12 ($25 in chips) 
Seat 4: marner99 ($25 in chips) 
Seat 5: CashMatteo ($17.51 in chips) 
n01shome: posts small blind $0.10
schenectady69: posts big blind $0.25
*** HOLE CARDS ***
Dealt to CashMatteo [Ad 3c]
jj_rose_jj12: folds 
marner99: raises $0.50 to $0.75
CashMatteo: folds 
n01shome: calls $0.65
schenectady69: calls $0.50
*** FLOP *** [Ts 9c Jc]
n01shome: checks 
schenectady69: checks 
marner99: checks 
*** TURN *** [Ts 9c Jc] [Qc]
n01shome: checks 
schenectady69: checks 
marner99: bets $0.71
n01shome: calls $0.71
schenectady69: folds 
*** RIVER *** [Ts 9c Jc Qc] [8h]
n01shome: checks 
marner99: checks 
*** SHOW DOWN ***
n01shome: shows [Ac 2d] (a straight, Eight to Queen)
marner99: shows [Jd Qd] (a straight, Eight to Queen)
n01shome collected $1.75 from pot
marner99 collected $1.75 from pot
*** SUMMARY ***
Total pot $3.67 | Rake $0.17 
Board [Ts 9c Jc Qc 8h]
Seat 1: n01shome (small blind) showed [Ac 2d] and won ($1.75) with a straight, Eight to Queen
Seat 2: schenectady69 (big blind) folded on the Turn
Seat 3: jj_rose_jj12 folded before Flop (didn't bet)
Seat 4: marner99 showed [Jd Qd] and won ($1.75) with a straight, Eight to Queen
Seat 5: CashMatteo (button) folded before Flop (didn't bet)

Hand #1730: 

PokerStars Hand #246794485907:  Hold'em No Limit ($0.10/$0.25 CAD) - 2023/10/28 15:23:58 ET
Table 'Tanga II' 6-max Seat #1 is the button
Seat 1: n01shome ($25.34 in chips) 
Seat 2: schenectady69 ($28.96 in chips) 
Seat 3: jj_rose_jj12 ($25 in chips) 
Seat 4: marner99 ($25.29 in chips) 
Seat 5: CashMatteo ($17.51 in chips) 
schenectady69: posts small blind $0.10
jj_rose_jj12: posts big blind $0.25
*** HOLE CARDS ***
Dealt to CashMatteo [Jd 5c]
marner99: folds 
CashMatteo: folds 
n01shome: folds 
schenectady69: raises $0.50 to $0.75
jj_rose_jj12: calls $0.50
*** FLOP *** [4h 3d 7c]
schenectady69: checks 
jj_rose_jj12: bets $0.95
schenectady69: folds 
Uncalled bet ($0.95) returned to jj_rose_jj12
jj_rose_jj12 collected $1.43 from pot
jj_rose_jj12: doesn't show hand 
*** SUMMARY ***
Total pot $1.50 | Rake $0.07 
Board [4h 3d 7c]
Seat 1: n01shome (button) folded before Flop (didn't bet)
Seat 2: schenectady69 (small blind) folded on the Flop
Seat 3: jj_rose_jj12 (big blind) collected ($1.43)
Seat 4: marner99 folded before Flop (didn't bet)
Seat 5: CashMatteo folded before Flop (didn't bet)

Hand #1731: 

PokerStars Hand #246794496592:  Hold'em No Limit ($0.10/$0.25 CAD) - 2023/10/28 15:24:29 ET
Table 'Tanga II' 6-max Seat #2 is the button
Seat 1: n01shome ($25.34 in chips) 
Seat 2: schenectady69 ($28.21 in chips) 
Seat 3: jj_rose_jj12 ($25.68 in chips) 
Seat 4: marner99 ($25.29 in chips) 
Seat 5: CashMatteo ($17.51 in chips) 
jj_rose_jj12: posts small blind $0.10
marner99: posts big blind $0.25
*** HOLE CARDS ***
Dealt to CashMatteo [4d Qd]
CashMatteo: raises $0.37 to $0.62
n01shome: folds 
schenectady69: folds 
jj_rose_jj12: folds 
marner99: folds 
Uncalled bet ($0.37) returned to CashMatteo
CashMatteo collected $0.60 from pot
CashMatteo: doesn't show hand 
*** SUMMARY ***
Total pot $0.60 | Rake $0 
Seat 1: n01shome folded before Flop (didn't bet)
Seat 2: schenectady69 (button) folded before Flop (didn't bet)
Seat 3: jj_rose_jj12 (small blind) folded before Flop
Seat 4: marner99 (big blind) folded before Flop
Seat 5: CashMatteo collected ($0.60)

Hand #1732: 

PokerStars Hand #246794501858:  Hold'em No Limit ($0.10/$0.25 CAD) - 2023/10/28 15:24:44 ET
Table 'Tanga II' 6-max Seat #3 is the button
Seat 1: n01shome ($25.34 in chips) 
Seat 2: schenectady69 ($28.21 in chips) 
Seat 3: jj_rose_jj12 ($25.58 in chips) 
Seat 4: marner99 ($25.04 in chips) 
Seat 5: CashMatteo ($17.86 in chips) 
Seat 6: zViveXz ($21.80 in chips) 
marner99: posts small blind $0.10
CashMatteo: posts big blind $0.25
zViveXz: posts small & big blinds $0.35
*** HOLE CARDS ***
Dealt to CashMatteo [Kc Kh]
zViveXz: checks 
n01shome: folds 
schenectady69: raises $0.50 to $0.75
jj_rose_jj12: folds 
marner99: folds 
CashMatteo: raises $1.37 to $2.12
zViveXz: folds 
schenectady69: folds 
Uncalled bet ($1.37) returned to CashMatteo
CashMatteo collected $1.95 from pot
CashMatteo: doesn't show hand 
*** SUMMARY ***
Total pot $1.95 | Rake $0 
Seat 1: n01shome folded before Flop (didn't bet)
Seat 2: schenectady69 folded before Flop
Seat 3: jj_rose_jj12 (button) folded before Flop (didn't bet)
Seat 4: marner99 (small blind) folded before Flop
Seat 5: CashMatteo (big blind) collected ($1.95)
Seat 6: zViveXz folded before Flop (didn't bet)

Hand #1733: 

PokerStars Hand #246794517003:  Hold'em No Limit ($0.10/$0.25 CAD) - 2023/10/28 15:25:29 ET
Table 'Tanga II' 6-max Seat #4 is the button
Seat 1: n01shome ($25.34 in chips) 
Seat 2: schenectady69 ($27.46 in chips) 
Seat 3: jj_rose_jj12 ($25.58 in chips) 
Seat 4: marner99 ($25 in chips) 
Seat 5: CashMatteo ($19.06 in chips) 
Seat 6: zViveXz ($21.45 in chips) 
CashMatteo: posts small blind $0.10
zViveXz: posts big blind $0.25
*** HOLE CARDS ***
Dealt to CashMatteo [8d 4h]
n01shome: raises $0.25 to $0.50
schenectady69: folds 
jj_rose_jj12: folds 
marner99: folds 
CashMatteo: folds 
zViveXz: folds 
Uncalled bet ($0.25) returned to n01shome
n01shome collected $0.60 from pot
n01shome: doesn't show hand 
*** SUMMARY ***
Total pot $0.60 | Rake $0 
Seat 1: n01shome collected ($0.60)
Seat 2: schenectady69 folded before Flop (didn't bet)
Seat 3: jj_rose_jj12 folded before Flop (didn't bet)
Seat 4: marner99 (button) folded before Flop (didn't bet)
Seat 5: CashMatteo (small blind) folded before Flop
Seat 6: zViveXz (big blind) folded before Flop

Hand #1734: 

PokerStars Hand #246794522887:  Hold'em No Limit ($0.10/$0.25 CAD) - 2023/10/28 15:25:46 ET
Table 'Tanga II' 6-max Seat #5 is the button
Seat 1: n01shome ($25.69 in chips) 
Seat 2: schenectady69 ($27.46 in chips) 
Seat 3: jj_rose_jj12 ($25.58 in chips) 
Seat 4: marner99 ($25 in chips) 
Seat 5: CashMatteo ($18.96 in chips) 
Seat 6: zViveXz ($21.20 in chips) 
zViveXz: posts small blind $0.10
n01shome: posts big blind $0.25
*** HOLE CARDS ***
Dealt to CashMatteo [3d 9c]
schenectady69: folds 
jj_rose_jj12: folds 
marner99: folds 
CashMatteo: folds 
zViveXz: raises $0.37 to $0.62
n01shome: folds 
Uncalled bet ($0.37) returned to zViveXz
zViveXz collected $0.50 from pot
zViveXz: doesn't show hand 
*** SUMMARY ***
Total pot $0.50 | Rake $0 
Seat 1: n01shome (big blind) folded before Flop
Seat 2: schenectady69 folded before Flop (didn't bet)
Seat 3: jj_rose_jj12 folded before Flop (didn't bet)
Seat 4: marner99 folded before Flop (didn't bet)
Seat 5: CashMatteo (button) folded before Flop (didn't bet)
Seat 6: zViveXz (small blind) collected ($0.50)

Hand #1735: 

PokerStars Hand #246794528179:  Hold'em No Limit ($0.10/$0.25 CAD) - 2023/10/28 15:26:01 ET
Table 'Tanga II' 6-max Seat #6 is the button
Seat 1: n01shome ($25.44 in chips) 
Seat 2: schenectady69 ($27.46 in chips) 
Seat 3: jj_rose_jj12 ($25.58 in chips) 
Seat 4: marner99 ($25 in chips) 
Seat 5: CashMatteo ($18.96 in chips) 
Seat 6: zViveXz ($21.45 in chips) 
n01shome: posts small blind $0.10
schenectady69: posts big blind $0.25
*** HOLE CARDS ***
Dealt to CashMatteo [7c Ts]
jj_rose_jj12: folds 
marner99: folds 
CashMatteo: folds 
zViveXz: folds 
CashMatteo leaves the table
n01shome: calls $0.15
schenectady69: raises $0.50 to $0.75
n01shome: calls $0.50
*** FLOP *** [9c 9d Td]
n01shome: checks 
schenectady69: checks 
*** TURN *** [9c 9d Td] [8d]
n01shome: bets $0.95
schenectady69: folds 
Uncalled bet ($0.95) returned to n01shome
n01shome collected $1.43 from pot
n01shome: doesn't show hand 
*** SUMMARY ***
Total pot $1.50 | Rake $0.07 
Board [9c 9d Td 8d]
Seat 1: n01shome (small blind) collected ($1.43)
Seat 2: schenectady69 (big blind) folded on the Turn
Seat 3: jj_rose_jj12 folded before Flop (didn't bet)
Seat 4: marner99 folded before Flop (didn't bet)
Seat 5: CashMatteo folded before Flop (didn't bet)
Seat 6: zViveXz (button) folded before Flop (didn't bet)

Hand #1736: 

PokerStars Hand #246794572261:  Hold'em No Limit ($0.10/$0.25 CAD) - 2023/10/28 15:28:12 ET
Table 'Wallenquist II' 6-max Seat #4 is the button
Seat 1: n01shome ($25.19 in chips) 
Seat 2: jj_rose_jj12 ($25.36 in chips) 
Seat 3: CashMatteo ($18 in chips) 
Seat 4: mistasho ($17.82 in chips) 
Seat 5: scs314 ($38.73 in chips) 
Seat 6: InitialHC ($25 in chips) 
scs314: posts small blind $0.10
InitialHC: posts big blind $0.25
CashMatteo: posts big blind $0.25
*** HOLE CARDS ***
Dealt to CashMatteo [6d 3h]
n01shome: raises $0.85 to $1.10
jj_rose_jj12: folds 
CashMatteo: folds 
mistasho: folds 
scs314: folds 
InitialHC: folds 
Uncalled bet ($0.85) returned to n01shome
n01shome collected $0.85 from pot
n01shome: doesn't show hand 
*** SUMMARY ***
Total pot $0.85 | Rake $0 
Seat 1: n01shome collected ($0.85)
Seat 2: jj_rose_jj12 folded before Flop (didn't bet)
Seat 3: CashMatteo folded before Flop (didn't bet)
Seat 4: mistasho (button) folded before Flop (didn't bet)
Seat 5: scs314 (small blind) folded before Flop
Seat 6: InitialHC (big blind) folded before Flop

Hand #1737: 

PokerStars Hand #246794578944:  Hold'em No Limit ($0.10/$0.25 CAD) - 2023/10/28 15:28:32 ET
Table 'Wallenquist II' 6-max Seat #5 is the button
Seat 1: n01shome ($25.79 in chips) 
Seat 2: jj_rose_jj12 ($25.36 in chips) 
Seat 3: CashMatteo ($17.75 in chips) 
Seat 4: mistasho ($17.82 in chips) 
Seat 5: scs314 ($38.63 in chips) 
Seat 6: InitialHC ($25 in chips) 
InitialHC: posts small blind $0.10
n01shome: posts big blind $0.25
*** HOLE CARDS ***
Dealt to CashMatteo [Tc Ad]
jj_rose_jj12: folds 
CashMatteo: raises $0.37 to $0.62
mistasho: calls $0.62
scs314: calls $0.62
InitialHC: folds 
n01shome: folds 
*** FLOP *** [As 4s 2h]
CashMatteo: checks 
mistasho: bets $1.06
scs314: folds 
CashMatteo: folds 
Uncalled bet ($1.06) returned to mistasho
mistasho collected $2.11 from pot
mistasho: doesn't show hand 
*** SUMMARY ***
Total pot $2.21 | Rake $0.10 
Board [As 4s 2h]
Seat 1: n01shome (big blind) folded before Flop
Seat 2: jj_rose_jj12 folded before Flop (didn't bet)
Seat 3: CashMatteo folded on the Flop
Seat 4: mistasho collected ($2.11)
Seat 5: scs314 (button) folded on the Flop
Seat 6: InitialHC (small blind) folded before Flop

Hand #1738: 

PokerStars Hand #246794590529:  Hold'em No Limit ($0.10/$0.25 CAD) - 2023/10/28 15:29:05 ET
Table 'Wallenquist II' 6-max Seat #6 is the button
Seat 1: n01shome ($25.54 in chips) 
Seat 2: jj_rose_jj12 ($25.36 in chips) 
Seat 3: CashMatteo ($17.13 in chips) 
Seat 4: mistasho ($19.31 in chips) 
Seat 5: scs314 ($38.01 in chips) 
Seat 6: InitialHC ($25 in chips) 
n01shome: posts small blind $0.10
jj_rose_jj12: posts big blind $0.25
*** HOLE CARDS ***
Dealt to CashMatteo [4c 7s]
CashMatteo: folds 
mistasho: folds 
scs314: calls $0.25
InitialHC: folds 
n01shome: folds 
jj_rose_jj12: checks 
*** FLOP *** [7h Ac 8c]
jj_rose_jj12: checks 
scs314: checks 
*** TURN *** [7h Ac 8c] [Ks]
jj_rose_jj12: checks 
scs314: bets $0.50
jj_rose_jj12: folds 
Uncalled bet ($0.50) returned to scs314
scs314 collected $0.57 from pot
scs314: doesn't show hand 
*** SUMMARY ***
Total pot $0.60 | Rake $0.03 
Board [7h Ac 8c Ks]
Seat 1: n01shome (small blind) folded before Flop
Seat 2: jj_rose_jj12 (big blind) folded on the Turn
Seat 3: CashMatteo folded before Flop (didn't bet)
Seat 4: mistasho folded before Flop (didn't bet)
Seat 5: scs314 collected ($0.57)
Seat 6: InitialHC (button) folded before Flop (didn't bet)

Hand #1739: 

PokerStars Hand #246794605988:  Hold'em No Limit ($0.10/$0.25 CAD) - 2023/10/28 15:29:51 ET
Table 'Wallenquist II' 6-max Seat #1 is the button
Seat 1: n01shome ($25.44 in chips) 
Seat 2: jj_rose_jj12 ($25.11 in chips) 
Seat 3: CashMatteo ($17.13 in chips) 
Seat 4: mistasho ($19.31 in chips) 
Seat 5: scs314 ($38.33 in chips) 
Seat 6: InitialHC ($25 in chips) 
jj_rose_jj12: posts small blind $0.10
CashMatteo: posts big blind $0.25
*** HOLE CARDS ***
Dealt to CashMatteo [9h 6d]
mistasho: folds 
scs314: folds 
InitialHC: folds 
scs314 leaves the table
n01shome: raises $0.25 to $0.50
jj_rose_jj12: folds 
CashMatteo: calls $0.25
*** FLOP *** [Ad 4h Qc]
CashMatteo: checks 
BeefnBroccoli joins the table at seat #5 
n01shome: bets $0.53
CashMatteo: folds 
Uncalled bet ($0.53) returned to n01shome
n01shome collected $1.05 from pot
n01shome: doesn't show hand 
*** SUMMARY ***
Total pot $1.10 | Rake $0.05 
Board [Ad 4h Qc]
Seat 1: n01shome (button) collected ($1.05)
Seat 2: jj_rose_jj12 (small blind) folded before Flop
Seat 3: CashMatteo (big blind) folded on the Flop
Seat 4: mistasho folded before Flop (didn't bet)
Seat 5: scs314 folded before Flop (didn't bet)
Seat 6: InitialHC folded before Flop (didn't bet)

Hand #1740: 

PokerStars Hand #246794615844:  Hold'em No Limit ($0.10/$0.25 CAD) - 2023/10/28 15:30:20 ET
Table 'Wallenquist II' 6-max Seat #2 is the button
Seat 1: n01shome ($25.99 in chips) 
Seat 2: jj_rose_jj12 ($25.01 in chips) 
Seat 3: CashMatteo ($16.63 in chips) 
Seat 4: mistasho ($19.31 in chips) 
Seat 5: BeefnBroccoli ($20 in chips) 
Seat 6: InitialHC ($25 in chips) 
CashMatteo: posts small blind $0.10
mistasho: posts big blind $0.25
BeefnBroccoli: posts big blind $0.25
*** HOLE CARDS ***
Dealt to CashMatteo [3d 2h]
BeefnBroccoli: checks 
InitialHC: folds 
n01shome: folds 
jj_rose_jj12: folds 
CashMatteo: folds 
mistasho: checks 
*** FLOP *** [6d Ah 9d]
mistasho: checks 
BeefnBroccoli: checks 
*** TURN *** [6d Ah 9d] [2d]
mistasho: bets $0.29
BeefnBroccoli: calls $0.29
*** RIVER *** [6d Ah 9d 2d] [Qh]
mistasho: checks 
BeefnBroccoli: checks 
*** SHOW DOWN ***
mistasho: shows [Ks 2c] (a pair of Deuces)
BeefnBroccoli: shows [6c 5h] (a pair of Sixes)
BeefnBroccoli collected $1.13 from pot
*** SUMMARY ***
Total pot $1.18 | Rake $0.05 
Board [6d Ah 9d 2d Qh]
Seat 1: n01shome folded before Flop (didn't bet)
Seat 2: jj_rose_jj12 (button) folded before Flop (didn't bet)
Seat 3: CashMatteo (small blind) folded before Flop
Seat 4: mistasho (big blind) showed [Ks 2c] and lost with a pair of Deuces
Seat 5: BeefnBroccoli showed [6c 5h] and won ($1.13) with a pair of Sixes
Seat 6: InitialHC folded before Flop (didn't bet)

Hand #1741: 

PokerStars Hand #246794628286:  Hold'em No Limit ($0.10/$0.25 CAD) - 2023/10/28 15:30:58 ET
Table 'Wallenquist II' 6-max Seat #3 is the button
Seat 1: n01shome ($25.99 in chips) 
Seat 2: jj_rose_jj12 ($25.01 in chips) 
Seat 3: CashMatteo ($16.53 in chips) 
Seat 4: mistasho ($18.77 in chips) 
Seat 5: BeefnBroccoli ($20.59 in chips) 
Seat 6: InitialHC ($25 in chips) 
mistasho: posts small blind $0.10
BeefnBroccoli: posts big blind $0.25
*** HOLE CARDS ***
Dealt to CashMatteo [Ts Kh]
InitialHC: folds 
n01shome: folds 
jj_rose_jj12: folds 
CashMatteo: raises $0.37 to $0.62
mistasho: calls $0.52
BeefnBroccoli: calls $0.37
*** FLOP *** [Qc 3s Qh]
mistasho: bets $0.89
BeefnBroccoli: folds 
CashMatteo: calls $0.89
*** TURN *** [Qc 3s Qh] [Th]
mistasho: bets $3.48
CashMatteo: raises $3.48 to $6.96
mistasho: raises $10.30 to $17.26 and is all-in
CashMatteo: folds 
Uncalled bet ($10.30) returned to mistasho
mistasho collected $16.77 from pot
mistasho: doesn't show hand 
*** SUMMARY ***
Total pot $17.56 | Rake $0.79 
Board [Qc 3s Qh Th]
Seat 1: n01shome folded before Flop (didn't bet)
Seat 2: jj_rose_jj12 folded before Flop (didn't bet)
Seat 3: CashMatteo (button) folded on the Turn
Seat 4: mistasho (small blind) collected ($16.77)
Seat 5: BeefnBroccoli (big blind) folded on the Flop
Seat 6: InitialHC folded before Flop (didn't bet)

Hand #1742: 

PokerStars Hand #246794645602:  Hold'em No Limit ($0.10/$0.25 CAD) - 2023/10/28 15:31:49 ET
Table 'Wallenquist II' 6-max Seat #4 is the button
Seat 1: n01shome ($25.99 in chips) 
Seat 2: jj_rose_jj12 ($25.01 in chips) 
Seat 3: CashMatteo ($8.06 in chips) 
Seat 4: mistasho ($27.07 in chips) 
Seat 5: BeefnBroccoli ($19.97 in chips) 
Seat 6: InitialHC ($25 in chips) 
BeefnBroccoli: posts small blind $0.10
InitialHC: posts big blind $0.25
*** HOLE CARDS ***
Dealt to CashMatteo [8d Qc]
n01shome: raises $0.25 to $0.50
jj_rose_jj12: folds 
CashMatteo: calls $0.50
mistasho: folds 
BeefnBroccoli: calls $0.40
InitialHC: folds 
*** FLOP *** [8h Qd 7d]
BeefnBroccoli: bets $0.50
n01shome: raises $1.34 to $1.84
CashMatteo: calls $1.84
BeefnBroccoli: calls $1.34
*** TURN *** [8h Qd 7d] [4c]
BeefnBroccoli: checks 
n01shome: bets $4.63
CashMatteo: raises $1.09 to $5.72 and is all-in
BeefnBroccoli: calls $5.72
n01shome: calls $1.09
*** RIVER *** [8h Qd 7d 4c] [5d]
BeefnBroccoli: checks 
n01shome: checks 
*** SHOW DOWN ***
BeefnBroccoli: shows [7h 4h] (two pair, Sevens and Fours)
n01shome: mucks hand 
CashMatteo: shows [8d Qc] (two pair, Queens and Eights)
CashMatteo collected $23.33 from pot
*** SUMMARY ***
Total pot $24.43 | Rake $1.10 
Board [8h Qd 7d 4c 5d]
Seat 1: n01shome mucked [Kc Kh]
Seat 2: jj_rose_jj12 folded before Flop (didn't bet)
Seat 3: CashMatteo showed [8d Qc] and won ($23.33) with two pair, Queens and Eights
Seat 4: mistasho (button) folded before Flop (didn't bet)
Seat 5: BeefnBroccoli (small blind) showed [7h 4h] and lost with two pair, Sevens and Fours
Seat 6: InitialHC (big blind) folded before Flop

Hand #1743: 

PokerStars Hand #246794667038:  Hold'em No Limit ($0.10/$0.25 CAD) - 2023/10/28 15:32:53 ET
Table 'Wallenquist II' 6-max Seat #5 is the button
Seat 1: n01shome ($17.93 in chips) 
Seat 2: jj_rose_jj12 ($25.01 in chips) 
Seat 3: CashMatteo ($23.33 in chips) 
Seat 4: mistasho ($27.07 in chips) 
Seat 5: BeefnBroccoli ($11.91 in chips) 
Seat 6: InitialHC ($25 in chips) 
InitialHC: posts small blind $0.10
n01shome: posts big blind $0.25
*** HOLE CARDS ***
Dealt to CashMatteo [5d 3d]
jj_rose_jj12: folds 
CashMatteo: calls $0.25
mistasho: folds 
BeefnBroccoli: calls $0.25
InitialHC: raises $0.75 to $1
n01shome: calls $0.75
CashMatteo: calls $0.75
BeefnBroccoli: calls $0.75
*** FLOP *** [8h Ks 4h]
InitialHC: checks 
n01shome: checks 
CashMatteo: checks 
BeefnBroccoli: checks 
*** TURN *** [8h Ks 4h] [6h]
InitialHC: checks 
n01shome: bets $2.55
CashMatteo: folds 
BeefnBroccoli: folds 
InitialHC: folds 
Uncalled bet ($2.55) returned to n01shome
n01shome collected $3.82 from pot
n01shome: doesn't show hand 
*** SUMMARY ***
Total pot $4 | Rake $0.18 
Board [8h Ks 4h 6h]
Seat 1: n01shome (big blind) collected ($3.82)
Seat 2: jj_rose_jj12 folded before Flop (didn't bet)
Seat 3: CashMatteo folded on the Turn
Seat 4: mistasho folded before Flop (didn't bet)
Seat 5: BeefnBroccoli (button) folded on the Turn
Seat 6: InitialHC (small blind) folded on the Turn

Hand #1744: 

PokerStars Hand #246794684896:  Hold'em No Limit ($0.10/$0.25 CAD) - 2023/10/28 15:33:46 ET
Table 'Wallenquist II' 6-max Seat #6 is the button
Seat 1: n01shome ($25 in chips) 
Seat 2: jj_rose_jj12 ($25.01 in chips) 
Seat 3: CashMatteo ($22.33 in chips) 
Seat 4: mistasho ($27.07 in chips) 
Seat 5: BeefnBroccoli ($10.91 in chips) 
Seat 6: InitialHC ($25 in chips) 
n01shome: posts small blind $0.10
jj_rose_jj12: posts big blind $0.25
*** HOLE CARDS ***
Dealt to CashMatteo [Td 5s]
CashMatteo: folds 
mistasho: folds 
BeefnBroccoli: folds 
InitialHC: folds 
n01shome: folds 
Uncalled bet ($0.15) returned to jj_rose_jj12
jj_rose_jj12 collected $0.20 from pot
jj_rose_jj12: doesn't show hand 
*** SUMMARY ***
Total pot $0.20 | Rake $0 
Seat 1: n01shome (small blind) folded before Flop
Seat 2: jj_rose_jj12 (big blind) collected ($0.20)
Seat 3: CashMatteo folded before Flop (didn't bet)
Seat 4: mistasho folded before Flop (didn't bet)
Seat 5: BeefnBroccoli folded before Flop (didn't bet)
Seat 6: InitialHC (button) folded before Flop (didn't bet)

Hand #1745: 

PokerStars Hand #246794688635:  Hold'em No Limit ($0.10/$0.25 CAD) - 2023/10/28 15:33:57 ET
Table 'Wallenquist II' 6-max Seat #1 is the button
Seat 1: n01shome ($24.90 in chips) 
Seat 2: jj_rose_jj12 ($25.11 in chips) 
Seat 3: CashMatteo ($22.33 in chips) 
Seat 5: BeefnBroccoli ($10.91 in chips) 
Seat 6: InitialHC ($25 in chips) 
jj_rose_jj12: posts small blind $0.10
CashMatteo: posts big blind $0.25
*** HOLE CARDS ***
Dealt to CashMatteo [Jc Jh]
BeefnBroccoli: calls $0.25
InitialHC: folds 
n01shome: raises $0.85 to $1.10
jj_rose_jj12: folds 
CashMatteo: raises $2.05 to $3.15
BeefnBroccoli: calls $2.90
n01shome: calls $2.05
*** FLOP *** [4d Qc 5s]
CashMatteo: bets $4.56
BeefnBroccoli: folds 
n01shome: folds 
Uncalled bet ($4.56) returned to CashMatteo
CashMatteo collected $9.12 from pot
CashMatteo: doesn't show hand 
*** SUMMARY ***
Total pot $9.55 | Rake $0.43 
Board [4d Qc 5s]
Seat 1: n01shome (button) folded on the Flop
Seat 2: jj_rose_jj12 (small blind) folded before Flop
Seat 3: CashMatteo (big blind) collected ($9.12)
Seat 5: BeefnBroccoli folded on the Flop
Seat 6: InitialHC folded before Flop (didn't bet)

Hand #1746: 

PokerStars Hand #246794702962:  Hold'em No Limit ($0.10/$0.25 CAD) - 2023/10/28 15:34:40 ET
Table 'Wallenquist II' 6-max Seat #2 is the button
Seat 1: n01shome ($25 in chips) 
Seat 2: jj_rose_jj12 ($25.01 in chips) 
Seat 3: CashMatteo ($28.30 in chips) 
Seat 5: BeefnBroccoli ($7.76 in chips) 
Seat 6: InitialHC ($25 in chips) 
CashMatteo: posts small blind $0.10
BeefnBroccoli: posts big blind $0.25
*** HOLE CARDS ***
Dealt to CashMatteo [9s As]
InitialHC: folds 
n01shome: folds 
jj_rose_jj12: folds 
CashMatteo: raises $0.37 to $0.62
BeefnBroccoli: calls $0.37
*** FLOP *** [Qh 5d 3s]
CashMatteo: checks 
BeefnBroccoli: checks 
*** TURN *** [Qh 5d 3s] [9h]
CashMatteo: bets $0.59
BeefnBroccoli: calls $0.59
*** RIVER *** [Qh 5d 3s 9h] [3d]
CashMatteo: bets $1.16
BeefnBroccoli: calls $1.16
*** SHOW DOWN ***
CashMatteo: shows [9s As] (two pair, Nines and Threes)
BeefnBroccoli: mucks hand 
CashMatteo collected $4.53 from pot
*** SUMMARY ***
Total pot $4.74 | Rake $0.21 
Board [Qh 5d 3s 9h 3d]
Seat 1: n01shome folded before Flop (didn't bet)
Seat 2: jj_rose_jj12 (button) folded before Flop (didn't bet)
Seat 3: CashMatteo (small blind) showed [9s As] and won ($4.53) with two pair, Nines and Threes
Seat 5: BeefnBroccoli (big blind) mucked [9d Jh]
Seat 6: InitialHC folded before Flop (didn't bet)

Hand #1747: 

PokerStars Hand #246794712920:  Hold'em No Limit ($0.10/$0.25 CAD) - 2023/10/28 15:35:10 ET
Table 'Wallenquist II' 6-max Seat #3 is the button
Seat 1: n01shome ($25 in chips) 
Seat 2: jj_rose_jj12 ($25.01 in chips) 
Seat 3: CashMatteo ($30.46 in chips) 
Seat 5: BeefnBroccoli ($5.39 in chips) 
Seat 6: InitialHC ($25 in chips) 
mistasho will be allowed to play after the button
BeefnBroccoli: posts small blind $0.10
InitialHC: posts big blind $0.25
*** HOLE CARDS ***
Dealt to CashMatteo [7c 3h]
n01shome: folds 
jj_rose_jj12: folds 
CashMatteo: raises $0.37 to $0.62
BeefnBroccoli: calls $0.52
InitialHC: folds 
*** FLOP *** [7d 5h As]
BeefnBroccoli: checks 
CashMatteo: checks 
*** TURN *** [7d 5h As] [4d]
BeefnBroccoli: checks 
CashMatteo: checks 
*** RIVER *** [7d 5h As 4d] [7h]
BeefnBroccoli: checks 
CashMatteo: bets $1.42
BeefnBroccoli: folds 
Uncalled bet ($1.42) returned to CashMatteo
CashMatteo collected $1.42 from pot
CashMatteo: doesn't show hand 
*** SUMMARY ***
Total pot $1.49 | Rake $0.07 
Board [7d 5h As 4d 7h]
Seat 1: n01shome folded before Flop (didn't bet)
Seat 2: jj_rose_jj12 folded before Flop (didn't bet)
Seat 3: CashMatteo (button) collected ($1.42)
Seat 5: BeefnBroccoli (small blind) folded on the River
Seat 6: InitialHC (big blind) folded before Flop

Hand #1748: 

PokerStars Hand #246794723822:  Hold'em No Limit ($0.10/$0.25 CAD) - 2023/10/28 15:35:42 ET
Table 'Wallenquist II' 6-max Seat #5 is the button
Seat 1: n01shome ($25 in chips) 
Seat 2: jj_rose_jj12 ($25.01 in chips) 
Seat 3: CashMatteo ($31.26 in chips) 
Seat 5: BeefnBroccoli ($4.77 in chips) 
Seat 6: InitialHC ($25 in chips) 
InitialHC: posts small blind $0.10
n01shome: posts big blind $0.25
mistasho: sits out 
*** HOLE CARDS ***
Dealt to CashMatteo [Th Ad]
jj_rose_jj12: folds 
CashMatteo: raises $0.37 to $0.62
BeefnBroccoli: raises $0.37 to $0.99
InitialHC: folds 
n01shome: calls $0.74
CashMatteo: calls $0.37
*** FLOP *** [9c Ks Qs]
n01shome: checks 
CashMatteo: bets $1.47
BeefnBroccoli: raises $2.31 to $3.78 and is all-in
n01shome: raises $5.98 to $9.76
CashMatteo: folds 
Uncalled bet ($5.98) returned to n01shome
*** TURN *** [9c Ks Qs] [Qc]
*** RIVER *** [9c Ks Qs Qc] [6h]
*** SHOW DOWN ***
n01shome: shows [Qh Kh] (a full house, Queens full of Kings)
BeefnBroccoli: shows [As 5c] (a pair of Queens)
n01shome collected $11.56 from pot
*** SUMMARY ***
Total pot $12.10 | Rake $0.54 
Board [9c Ks Qs Qc 6h]
Seat 1: n01shome (big blind) showed [Qh Kh] and won ($11.56) with a full house, Queens full of Kings
Seat 2: jj_rose_jj12 folded before Flop (didn't bet)
Seat 3: CashMatteo folded on the Flop
Seat 5: BeefnBroccoli (button) showed [As 5c] and lost with a pair of Queens
Seat 6: InitialHC (small blind) folded before Flop

Hand #1749: 

PokerStars Hand #246794737420:  Hold'em No Limit ($0.10/$0.25 CAD) - 2023/10/28 15:36:22 ET
Table 'Wallenquist II' 6-max Seat #6 is the button
Seat 1: n01shome ($31.79 in chips) 
Seat 2: jj_rose_jj12 ($25.01 in chips) 
Seat 3: CashMatteo ($28.80 in chips) 
Seat 6: InitialHC ($25 in chips) 
n01shome: posts small blind $0.10
jj_rose_jj12: posts big blind $0.25
mistasho: sits out 
*** HOLE CARDS ***
Dealt to CashMatteo [Qd Qh]
CashMatteo: raises $0.37 to $0.62
InitialHC: folds 
n01shome: calls $0.52
BeefnBroccoli leaves the table
jj_rose_jj12: calls $0.37
*** FLOP *** [Ah 7d 2c]
n01shome: checks 
Miseky joins the table at seat #5 
jj_rose_jj12: checks 
CashMatteo: checks 
*** TURN *** [Ah 7d 2c] [6h]
n01shome: bets $1.19
jj_rose_jj12: raises $2.77 to $3.96
CashMatteo: folds 
n01shome: calls $2.77
*** RIVER *** [Ah 7d 2c 6h] [2h]
n01shome: checks 
jj_rose_jj12: bets $14.01
n01shome: folds 
Uncalled bet ($14.01) returned to jj_rose_jj12
jj_rose_jj12 collected $9.34 from pot
jj_rose_jj12: doesn't show hand 
*** SUMMARY ***
Total pot $9.78 | Rake $0.44 
Board [Ah 7d 2c 6h 2h]
Seat 1: n01shome (small blind) folded on the River
Seat 2: jj_rose_jj12 (big blind) collected ($9.34)
Seat 3: CashMatteo folded on the Turn
Seat 6: InitialHC (button) folded before Flop (didn't bet)

Hand #1750: 

PokerStars Hand #246794760339:  Hold'em No Limit ($0.10/$0.25 CAD) - 2023/10/28 15:37:30 ET
Table 'Wallenquist II' 6-max Seat #1 is the button
Seat 1: n01shome ($27.21 in chips) 
Seat 2: jj_rose_jj12 ($29.77 in chips) 
Seat 3: CashMatteo ($28.18 in chips) 
Seat 6: InitialHC ($25 in chips) 
jj_rose_jj12: posts small blind $0.10
CashMatteo: posts big blind $0.25
mistasho: sits out 
Miseky: sits out 
*** HOLE CARDS ***
Dealt to CashMatteo [2d 7d]
InitialHC: folds 
n01shome: folds 
jj_rose_jj12: folds 
Uncalled bet ($0.15) returned to CashMatteo
CashMatteo collected $0.20 from pot
CashMatteo: doesn't show hand 
*** SUMMARY ***
Total pot $0.20 | Rake $0 
Seat 1: n01shome (button) folded before Flop (didn't bet)
Seat 2: jj_rose_jj12 (small blind) folded before Flop
Seat 3: CashMatteo (big blind) collected ($0.20)
Seat 6: InitialHC folded before Flop (didn't bet)

Hand #1751: 

PokerStars Hand #246794763849:  Hold'em No Limit ($0.10/$0.25 CAD) - 2023/10/28 15:37:40 ET
Table 'Wallenquist II' 6-max Seat #2 is the button
Seat 1: n01shome ($27.21 in chips) 
Seat 2: jj_rose_jj12 ($29.67 in chips) 
Seat 3: CashMatteo ($28.28 in chips) 
Seat 4: mistasho ($27.07 in chips) 
Seat 6: InitialHC ($25 in chips) 
CashMatteo: posts small blind $0.10
mistasho: posts big blind $0.25
Miseky: sits out 
*** HOLE CARDS ***
Dealt to CashMatteo [5c Tc]
InitialHC: folds 
n01shome: folds 
jj_rose_jj12: folds 
CashMatteo: calls $0.15
mistasho: checks 
*** FLOP *** [Jc Jd 7c]
CashMatteo: checks 
mistasho: checks 
*** TURN *** [Jc Jd 7c] [8d]
CashMatteo: bets $0.25
mistasho: raises $0.29 to $0.54
CashMatteo: calls $0.29
*** RIVER *** [Jc Jd 7c 8d] [8c]
CashMatteo: checks 
mistasho: bets $1
CashMatteo: calls $1
*** SHOW DOWN ***
mistasho: shows [9s 6h] (two pair, Jacks and Eights)
CashMatteo: shows [5c Tc] (a flush, Jack high)
CashMatteo collected $3.42 from pot
*** SUMMARY ***
Total pot $3.58 | Rake $0.16 
Board [Jc Jd 7c 8d 8c]
Seat 1: n01shome folded before Flop (didn't bet)
Seat 2: jj_rose_jj12 (button) folded before Flop (didn't bet)
Seat 3: CashMatteo (small blind) showed [5c Tc] and won ($3.42) with a flush, Jack high
Seat 4: mistasho (big blind) showed [9s 6h] and lost with two pair, Jacks and Eights
Seat 6: InitialHC folded before Flop (didn't bet)

Hand #1752: 

PokerStars Hand #246794779101:  Hold'em No Limit ($0.10/$0.25 CAD) - 2023/10/28 15:38:25 ET
Table 'Wallenquist II' 6-max Seat #3 is the button
Seat 1: n01shome ($27.21 in chips) 
Seat 2: jj_rose_jj12 ($29.67 in chips) 
Seat 3: CashMatteo ($29.91 in chips) 
Seat 4: mistasho ($25.28 in chips) 
Seat 5: Miseky ($25 in chips) 
Seat 6: InitialHC ($25 in chips) 
mistasho: posts small blind $0.10
Miseky: posts big blind $0.25
*** HOLE CARDS ***
Dealt to CashMatteo [9h 5d]
InitialHC: folds 
n01shome: raises $0.25 to $0.50
jj_rose_jj12: calls $0.50
CashMatteo: folds 
mistasho: folds 
Miseky: calls $0.25
*** FLOP *** [4c 5s 3c]
Miseky: checks 
n01shome: checks 
jj_rose_jj12: checks 
*** TURN *** [4c 5s 3c] [Tc]
Miseky: checks 
n01shome: bets $1.02
jj_rose_jj12: folds 
Miseky: folds 
Uncalled bet ($1.02) returned to n01shome
n01shome collected $1.53 from pot
n01shome: doesn't show hand 
*** SUMMARY ***
Total pot $1.60 | Rake $0.07 
Board [4c 5s 3c Tc]
Seat 1: n01shome collected ($1.53)
Seat 2: jj_rose_jj12 folded on the Turn
Seat 3: CashMatteo (button) folded before Flop (didn't bet)
Seat 4: mistasho (small blind) folded before Flop
Seat 5: Miseky (big blind) folded on the Turn
Seat 6: InitialHC folded before Flop (didn't bet)

Hand #1753: 

PokerStars Hand #246794794591:  Hold'em No Limit ($0.10/$0.25 CAD) - 2023/10/28 15:39:10 ET
Table 'Wallenquist II' 6-max Seat #4 is the button
Seat 1: n01shome ($28.24 in chips) 
Seat 2: jj_rose_jj12 ($29.17 in chips) 
Seat 3: CashMatteo ($29.91 in chips) 
Seat 4: mistasho ($25.18 in chips) 
Seat 5: Miseky ($25 in chips) 
Seat 6: InitialHC ($25 in chips) 
Miseky: posts small blind $0.10
InitialHC: posts big blind $0.25
*** HOLE CARDS ***
Dealt to CashMatteo [3h Kh]
n01shome: raises $0.25 to $0.50
jj_rose_jj12: folds 
CashMatteo: calls $0.50
mistasho: raises $24.68 to $25.18 and is all-in
Miseky: folds 
InitialHC: folds 
n01shome: folds 
CashMatteo: folds 
Uncalled bet ($24.68) returned to mistasho
mistasho collected $1.85 from pot
mistasho: doesn't show hand 
*** SUMMARY ***
Total pot $1.85 | Rake $0 
Seat 1: n01shome folded before Flop
Seat 2: jj_rose_jj12 folded before Flop (didn't bet)
Seat 3: CashMatteo folded before Flop
Seat 4: mistasho (button) collected ($1.85)
Seat 5: Miseky (small blind) folded before Flop
Seat 6: InitialHC (big blind) folded before Flop

Hand #1754: 

PokerStars Hand #246794801400:  Hold'em No Limit ($0.10/$0.25 CAD) - 2023/10/28 15:39:31 ET
Table 'Wallenquist II' 6-max Seat #5 is the button
Seat 1: n01shome ($27.74 in chips) 
Seat 2: jj_rose_jj12 ($29.17 in chips) 
Seat 3: CashMatteo ($29.41 in chips) 
Seat 4: mistasho ($26.53 in chips) 
Seat 5: Miseky ($25 in chips) 
Seat 6: InitialHC ($25 in chips) 
InitialHC: posts small blind $0.10
n01shome: posts big blind $0.25
*** HOLE CARDS ***
Dealt to CashMatteo [Th 6c]
jj_rose_jj12: folds 
CashMatteo: folds 
mistasho: folds 
Miseky: folds 
InitialHC: raises $0.37 to $0.62
n01shome: calls $0.37
*** FLOP *** [9d 8s 4h]
InitialHC: bets $0.59
n01shome: folds 
Uncalled bet ($0.59) returned to InitialHC
InitialHC collected $1.18 from pot
InitialHC: doesn't show hand 
*** SUMMARY ***
Total pot $1.24 | Rake $0.06 
Board [9d 8s 4h]
Seat 1: n01shome (big blind) folded on the Flop
Seat 2: jj_rose_jj12 folded before Flop (didn't bet)
Seat 3: CashMatteo folded before Flop (didn't bet)
Seat 4: mistasho folded before Flop (didn't bet)
Seat 5: Miseky (button) folded before Flop (didn't bet)
Seat 6: InitialHC (small blind) collected ($1.18)

Hand #1755: 

PokerStars Hand #246794811810:  Hold'em No Limit ($0.10/$0.25 CAD) - 2023/10/28 15:40:01 ET
Table 'Wallenquist II' 6-max Seat #6 is the button
Seat 1: n01shome ($27.12 in chips) 
Seat 2: jj_rose_jj12 ($29.17 in chips) 
Seat 3: CashMatteo ($29.41 in chips) 
Seat 4: mistasho ($26.53 in chips) 
Seat 5: Miseky ($25 in chips) 
Seat 6: InitialHC ($25.56 in chips) 
n01shome: posts small blind $0.10
jj_rose_jj12: posts big blind $0.25
*** HOLE CARDS ***
Dealt to CashMatteo [Ks 6d]
CashMatteo: folds 
mistasho: folds 
Miseky: folds 
InitialHC: raises $0.37 to $0.62
n01shome: calls $0.52
jj_rose_jj12: folds 
*** FLOP *** [3c 6c Jc]
n01shome: checks 
InitialHC: bets $0.71
n01shome: folds 
Uncalled bet ($0.71) returned to InitialHC
InitialHC collected $1.42 from pot
InitialHC: doesn't show hand 
*** SUMMARY ***
Total pot $1.49 | Rake $0.07 
Board [3c 6c Jc]
Seat 1: n01shome (small blind) folded on the Flop
Seat 2: jj_rose_jj12 (big blind) folded before Flop
Seat 3: CashMatteo folded before Flop (didn't bet)
Seat 4: mistasho folded before Flop (didn't bet)
Seat 5: Miseky folded before Flop (didn't bet)
Seat 6: InitialHC (button) collected ($1.42)

Hand #1756: 

PokerStars Hand #246794824427:  Hold'em No Limit ($0.10/$0.25 CAD) - 2023/10/28 15:40:38 ET
Table 'Wallenquist II' 6-max Seat #1 is the button
Seat 1: n01shome ($26.50 in chips) 
Seat 2: jj_rose_jj12 ($28.92 in chips) 
Seat 3: CashMatteo ($29.41 in chips) 
Seat 4: mistasho ($26.53 in chips) 
Seat 5: Miseky ($25 in chips) 
Seat 6: InitialHC ($26.36 in chips) 
jj_rose_jj12: posts small blind $0.10
CashMatteo: posts big blind $0.25
*** HOLE CARDS ***
Dealt to CashMatteo [9s 2c]
mistasho: raises $0.50 to $0.75
Miseky: folds 
InitialHC: folds 
n01shome: folds 
jj_rose_jj12: folds 
CashMatteo: folds 
Uncalled bet ($0.50) returned to mistasho
mistasho collected $0.60 from pot
mistasho: doesn't show hand 
*** SUMMARY ***
Total pot $0.60 | Rake $0 
Seat 1: n01shome (button) folded before Flop (didn't bet)
Seat 2: jj_rose_jj12 (small blind) folded before Flop
Seat 3: CashMatteo (big blind) folded before Flop
Seat 4: mistasho collected ($0.60)
Seat 5: Miseky folded before Flop (didn't bet)
Seat 6: InitialHC folded before Flop (didn't bet)

Hand #1757: 

PokerStars Hand #246794831828:  Hold'em No Limit ($0.10/$0.25 CAD) - 2023/10/28 15:41:00 ET
Table 'Wallenquist II' 6-max Seat #2 is the button
Seat 1: n01shome ($26.50 in chips) 
Seat 2: jj_rose_jj12 ($28.82 in chips) 
Seat 3: CashMatteo ($29.16 in chips) 
Seat 4: mistasho ($26.88 in chips) 
Seat 5: Miseky ($25 in chips) 
Seat 6: InitialHC ($26.36 in chips) 
CashMatteo: posts small blind $0.10
mistasho: posts big blind $0.25
*** HOLE CARDS ***
Dealt to CashMatteo [3h 5h]
Miseky: raises $0.30 to $0.55
InitialHC: folds 
n01shome: raises $0.30 to $0.85
jj_rose_jj12: folds 
CashMatteo: folds 
mistasho: folds 
Miseky: calls $0.30
*** FLOP *** [Ac 2h 5d]
Miseky: checks 
n01shome: bets $0.98
Miseky: folds 
Uncalled bet ($0.98) returned to n01shome
n01shome collected $1.96 from pot
n01shome: doesn't show hand 
*** SUMMARY ***
Total pot $2.05 | Rake $0.09 
Board [Ac 2h 5d]
Seat 1: n01shome collected ($1.96)
Seat 2: jj_rose_jj12 (button) folded before Flop (didn't bet)
Seat 3: CashMatteo (small blind) folded before Flop
Seat 4: mistasho (big blind) folded before Flop
Seat 5: Miseky folded on the Flop
Seat 6: InitialHC folded before Flop (didn't bet)

Hand #1758: 

PokerStars Hand #246794846230:  Hold'em No Limit ($0.10/$0.25 CAD) - 2023/10/28 15:41:42 ET
Table 'Wallenquist II' 6-max Seat #3 is the button
Seat 1: n01shome ($27.61 in chips) 
Seat 2: jj_rose_jj12 ($28.82 in chips) 
Seat 3: CashMatteo ($29.06 in chips) 
Seat 4: mistasho ($26.63 in chips) 
Seat 5: Miseky ($25 in chips) 
Seat 6: InitialHC ($26.36 in chips) 
mistasho: posts small blind $0.10
Miseky: posts big blind $0.25
*** HOLE CARDS ***
Dealt to CashMatteo [5c 4d]
InitialHC: folds 
n01shome: raises $0.25 to $0.50
jj_rose_jj12: folds 
CashMatteo: calls $0.50
mistasho: folds 
Miseky: raises $2.75 to $3.25
n01shome: calls $2.75
CashMatteo: folds 
*** FLOP *** [Qc 9d Kc]
Miseky: bets $2.90
n01shome: calls $2.90
*** TURN *** [Qc 9d Kc] [3h]
Miseky: checks 
n01shome: checks 
*** RIVER *** [Qc 9d Kc 3h] [Tc]
Miseky: checks 
n01shome: bets $6.16
Miseky: folds 
Uncalled bet ($6.16) returned to n01shome
n01shome collected $12.32 from pot
n01shome: doesn't show hand 
*** SUMMARY ***
Total pot $12.90 | Rake $0.58 
Board [Qc 9d Kc 3h Tc]
Seat 1: n01shome collected ($12.32)
Seat 2: jj_rose_jj12 folded before Flop (didn't bet)
Seat 3: CashMatteo (button) folded before Flop
Seat 4: mistasho (small blind) folded before Flop
Seat 5: Miseky (big blind) folded on the River
Seat 6: InitialHC folded before Flop (didn't bet)

Hand #1759: 

PokerStars Hand #246794868492:  Hold'em No Limit ($0.10/$0.25 CAD) - 2023/10/28 15:42:48 ET
Table 'Wallenquist II' 6-max Seat #4 is the button
Seat 1: n01shome ($33.78 in chips) 
Seat 2: jj_rose_jj12 ($28.82 in chips) 
Seat 3: CashMatteo ($28.56 in chips) 
Seat 4: mistasho ($26.53 in chips) 
Seat 5: Miseky ($25 in chips) 
Seat 6: InitialHC ($26.36 in chips) 
Miseky: posts small blind $0.10
InitialHC: posts big blind $0.25
*** HOLE CARDS ***
Dealt to CashMatteo [8c 4s]
n01shome: raises $0.25 to $0.50
jj_rose_jj12: folds 
CashMatteo: folds 
mistasho: folds 
Miseky: calls $0.40
InitialHC: folds 
*** FLOP *** [4h Th 7h]
Miseky: checks 
n01shome: checks 
*** TURN *** [4h Th 7h] [5d]
Miseky: checks 
n01shome: checks 
*** RIVER *** [4h Th 7h 5d] [9c]
Miseky: bets $0.80
n01shome: folds 
Uncalled bet ($0.80) returned to Miseky
Miseky collected $1.19 from pot
*** SUMMARY ***
Total pot $1.25 | Rake $0.06 
Board [4h Th 7h 5d 9c]
Seat 1: n01shome folded on the River
Seat 2: jj_rose_jj12 folded before Flop (didn't bet)
Seat 3: CashMatteo folded before Flop (didn't bet)
Seat 4: mistasho (button) folded before Flop (didn't bet)
Seat 5: Miseky (small blind) collected ($1.19)
Seat 6: InitialHC (big blind) folded before Flop

Hand #1760: 

PokerStars Hand #246794882110:  Hold'em No Limit ($0.10/$0.25 CAD) - 2023/10/28 15:43:28 ET
Table 'Wallenquist II' 6-max Seat #5 is the button
Seat 1: n01shome ($33.28 in chips) 
Seat 2: jj_rose_jj12 ($28.82 in chips) 
Seat 3: CashMatteo ($28.56 in chips) 
Seat 4: mistasho ($26.53 in chips) 
Seat 5: Miseky ($25.69 in chips) 
Seat 6: InitialHC ($26.11 in chips) 
InitialHC: posts small blind $0.10
n01shome: posts big blind $0.25
*** HOLE CARDS ***
Dealt to CashMatteo [Th Ac]
jj_rose_jj12: folds 
CashMatteo: raises $0.37 to $0.62
mistasho: folds 
Miseky: folds 
InitialHC: raises $1.88 to $2.50
n01shome: calls $2.25
CashMatteo: calls $1.88
*** FLOP *** [Kc 4h 8h]
InitialHC: bets $2.25
n01shome: folds 
CashMatteo: calls $2.25
*** TURN *** [Kc 4h 8h] [4d]
InitialHC: checks 
CashMatteo: checks 
*** RIVER *** [Kc 4h 8h 4d] [2h]
InitialHC: bets $6.88
CashMatteo: folds 
Uncalled bet ($6.88) returned to InitialHC
InitialHC collected $11.46 from pot
InitialHC: doesn't show hand 
*** SUMMARY ***
Total pot $12 | Rake $0.54 
Board [Kc 4h 8h 4d 2h]
Seat 1: n01shome (big blind) folded on the Flop
Seat 2: jj_rose_jj12 folded before Flop (didn't bet)
Seat 3: CashMatteo folded on the River
Seat 4: mistasho folded before Flop (didn't bet)
Seat 5: Miseky (button) folded before Flop (didn't bet)
Seat 6: InitialHC (small blind) collected ($11.46)

Hand #1761: 

PokerStars Hand #246794903325:  Hold'em No Limit ($0.10/$0.25 CAD) - 2023/10/28 15:44:31 ET
Table 'Wallenquist II' 6-max Seat #6 is the button
Seat 1: n01shome ($30.78 in chips) 
Seat 2: jj_rose_jj12 ($28.82 in chips) 
Seat 3: CashMatteo ($23.81 in chips) 
Seat 4: mistasho ($26.53 in chips) 
Seat 5: Miseky ($25.69 in chips) 
Seat 6: InitialHC ($32.82 in chips) 
n01shome: posts small blind $0.10
jj_rose_jj12: posts big blind $0.25
*** HOLE CARDS ***
Dealt to CashMatteo [6h 5s]
CashMatteo: folds 
mistasho: folds 
Miseky: folds 
InitialHC: raises $0.37 to $0.62
n01shome: folds 
jj_rose_jj12: folds 
Uncalled bet ($0.37) returned to InitialHC
InitialHC collected $0.60 from pot
InitialHC: doesn't show hand 
*** SUMMARY ***
Total pot $0.60 | Rake $0 
Seat 1: n01shome (small blind) folded before Flop
Seat 2: jj_rose_jj12 (big blind) folded before Flop
Seat 3: CashMatteo folded before Flop (didn't bet)
Seat 4: mistasho folded before Flop (didn't bet)
Seat 5: Miseky folded before Flop (didn't bet)
Seat 6: InitialHC (button) collected ($0.60)

Hand #1762: 

PokerStars Hand #246794910192:  Hold'em No Limit ($0.10/$0.25 CAD) - 2023/10/28 15:44:52 ET
Table 'Wallenquist II' 6-max Seat #1 is the button
Seat 1: n01shome ($30.68 in chips) 
Seat 2: jj_rose_jj12 ($28.57 in chips) 
Seat 3: CashMatteo ($23.81 in chips) 
Seat 4: mistasho ($26.53 in chips) 
Seat 5: Miseky ($25.69 in chips) 
Seat 6: InitialHC ($33.17 in chips) 
jj_rose_jj12: posts small blind $0.10
CashMatteo: posts big blind $0.25
*** HOLE CARDS ***
Dealt to CashMatteo [9h Ad]
mistasho: folds 
Miseky: folds 
InitialHC: folds 
n01shome: folds 
jj_rose_jj12: folds 
Uncalled bet ($0.15) returned to CashMatteo
CashMatteo collected $0.20 from pot
CashMatteo: doesn't show hand 
*** SUMMARY ***
Total pot $0.20 | Rake $0 
Seat 1: n01shome (button) folded before Flop (didn't bet)
Seat 2: jj_rose_jj12 (small blind) folded before Flop
Seat 3: CashMatteo (big blind) collected ($0.20)
Seat 4: mistasho folded before Flop (didn't bet)
Seat 5: Miseky folded before Flop (didn't bet)
Seat 6: InitialHC folded before Flop (didn't bet)

Hand #1763: 

PokerStars Hand #246794914827:  Hold'em No Limit ($0.10/$0.25 CAD) - 2023/10/28 15:45:06 ET
Table 'Wallenquist II' 6-max Seat #2 is the button
Seat 1: n01shome ($30.68 in chips) 
Seat 2: jj_rose_jj12 ($28.47 in chips) 
Seat 3: CashMatteo ($23.91 in chips) 
Seat 4: mistasho ($26.53 in chips) 
Seat 5: Miseky ($25.69 in chips) 
Seat 6: InitialHC ($33.17 in chips) 
CashMatteo: posts small blind $0.10
mistasho: posts big blind $0.25
*** HOLE CARDS ***
Dealt to CashMatteo [As Qs]
Miseky: raises $0.30 to $0.55
InitialHC: folds 
n01shome: folds 
jj_rose_jj12: folds 
CashMatteo: raises $0.95 to $1.50
mistasho: folds 
Miseky: calls $0.95
*** FLOP *** [Kd Ad Jc]
CashMatteo: bets $1.55
Miseky: calls $1.55
*** TURN *** [Kd Ad Jc] [Ah]
CashMatteo: bets $3.03
Miseky: calls $3.03
*** RIVER *** [Kd Ad Jc Ah] [2h]
CashMatteo: checks 
Miseky: bets $5.40
CashMatteo: calls $5.40
*** SHOW DOWN ***
Miseky: shows [Ac Jd] (a full house, Aces full of Jacks)
CashMatteo: mucks hand 
Miseky collected $22.17 from pot
*** SUMMARY ***
Total pot $23.21 | Rake $1.04 
Board [Kd Ad Jc Ah 2h]
Seat 1: n01shome folded before Flop (didn't bet)
Seat 2: jj_rose_jj12 (button) folded before Flop (didn't bet)
Seat 3: CashMatteo (small blind) mucked [As Qs]
Seat 4: mistasho (big blind) folded before Flop
Seat 5: Miseky showed [Ac Jd] and won ($22.17) with a full house, Aces full of Jacks
Seat 6: InitialHC folded before Flop (didn't bet)

Hand #1764: 

PokerStars Hand #246794937869:  Hold'em No Limit ($0.10/$0.25 CAD) - 2023/10/28 15:46:14 ET
Table 'Wallenquist II' 6-max Seat #3 is the button
Seat 1: n01shome ($30.68 in chips) 
Seat 2: jj_rose_jj12 ($28.47 in chips) 
Seat 3: CashMatteo ($12.43 in chips) 
Seat 4: mistasho ($26.28 in chips) 
Seat 5: Miseky ($36.38 in chips) 
Seat 6: InitialHC ($33.17 in chips) 
mistasho: posts small blind $0.10
Miseky: posts big blind $0.25
*** HOLE CARDS ***
Dealt to CashMatteo [2h 3c]
InitialHC: raises $0.50 to $0.75
n01shome: folds 
jj_rose_jj12: folds 
CashMatteo: folds 
mistasho: folds 
Miseky: folds 
Uncalled bet ($0.50) returned to InitialHC
InitialHC collected $0.60 from pot
InitialHC: doesn't show hand 
*** SUMMARY ***
Total pot $0.60 | Rake $0 
Seat 1: n01shome folded before Flop (didn't bet)
Seat 2: jj_rose_jj12 folded before Flop (didn't bet)
Seat 3: CashMatteo (button) folded before Flop (didn't bet)
Seat 4: mistasho (small blind) folded before Flop
Seat 5: Miseky (big blind) folded before Flop
Seat 6: InitialHC collected ($0.60)

Hand #1765: 

PokerStars Hand #246794943814:  Hold'em No Limit ($0.10/$0.25 CAD) - 2023/10/28 15:46:32 ET
Table 'Wallenquist II' 6-max Seat #4 is the button
Seat 1: n01shome ($30.68 in chips) 
Seat 2: jj_rose_jj12 ($28.47 in chips) 
Seat 3: CashMatteo ($12.43 in chips) 
Seat 4: mistasho ($26.18 in chips) 
Seat 5: Miseky ($36.13 in chips) 
Seat 6: InitialHC ($33.52 in chips) 
Miseky: posts small blind $0.10
InitialHC: posts big blind $0.25
*** HOLE CARDS ***
Dealt to CashMatteo [2s Th]
n01shome: folds 
jj_rose_jj12: raises $0.37 to $0.62
CashMatteo: folds 
mistasho: folds 
Miseky: folds 
InitialHC: raises $1.88 to $2.50
jj_rose_jj12: calls $1.88
*** FLOP *** [9h 7d 5h]
InitialHC: checks 
jj_rose_jj12: checks 
*** TURN *** [9h 7d 5h] [4c]
InitialHC: checks 
jj_rose_jj12: bets $3.25
InitialHC: folds 
Uncalled bet ($3.25) returned to jj_rose_jj12
jj_rose_jj12 collected $4.87 from pot
jj_rose_jj12: doesn't show hand 
*** SUMMARY ***
Total pot $5.10 | Rake $0.23 
Board [9h 7d 5h 4c]
Seat 1: n01shome folded before Flop (didn't bet)
Seat 2: jj_rose_jj12 collected ($4.87)
Seat 3: CashMatteo folded before Flop (didn't bet)
Seat 4: mistasho (button) folded before Flop (didn't bet)
Seat 5: Miseky (small blind) folded before Flop
Seat 6: InitialHC (big blind) folded on the Turn

Hand #1766: 

PokerStars Hand #246794961415:  Hold'em No Limit ($0.10/$0.25 CAD) - 2023/10/28 15:47:25 ET
Table 'Wallenquist II' 6-max Seat #5 is the button
Seat 1: n01shome ($30.68 in chips) 
Seat 2: jj_rose_jj12 ($30.84 in chips) 
Seat 3: CashMatteo ($12.43 in chips) 
Seat 4: mistasho ($26.18 in chips) 
Seat 5: Miseky ($36.03 in chips) 
Seat 6: InitialHC ($31.02 in chips) 
InitialHC: posts small blind $0.10
n01shome: posts big blind $0.25
*** HOLE CARDS ***
Dealt to CashMatteo [Th 8d]
jj_rose_jj12: folds 
CashMatteo: raises $0.37 to $0.62
mistasho: folds 
Miseky: calls $0.62
InitialHC: folds 
n01shome: raises $1.96 to $2.58
CashMatteo: folds 
Miseky: folds 
Uncalled bet ($1.96) returned to n01shome
n01shome collected $1.96 from pot
n01shome: doesn't show hand 
*** SUMMARY ***
Total pot $1.96 | Rake $0 
Seat 1: n01shome (big blind) collected ($1.96)
Seat 2: jj_rose_jj12 folded before Flop (didn't bet)
Seat 3: CashMatteo folded before Flop
Seat 4: mistasho folded before Flop (didn't bet)
Seat 5: Miseky (button) folded before Flop
Seat 6: InitialHC (small blind) folded before Flop

Hand #1767: 

PokerStars Hand #246794971831:  Hold'em No Limit ($0.10/$0.25 CAD) - 2023/10/28 15:47:57 ET
Table 'Wallenquist II' 6-max Seat #6 is the button
Seat 2: jj_rose_jj12 ($30.84 in chips) 
Seat 3: CashMatteo ($11.81 in chips) 
Seat 4: mistasho ($26.18 in chips) 
Seat 5: Miseky ($35.41 in chips) 
Seat 6: InitialHC ($30.92 in chips) 
jj_rose_jj12: posts small blind $0.10
CashMatteo: posts big blind $0.25
*** HOLE CARDS ***
Dealt to CashMatteo [2c Th]
mistasho: folds 
Miseky: folds 
InitialHC: folds 
jj_rose_jj12: raises $0.50 to $0.75
CashMatteo: folds 
Uncalled bet ($0.50) returned to jj_rose_jj12
jj_rose_jj12 collected $0.50 from pot
jj_rose_jj12: doesn't show hand 
*** SUMMARY ***
Total pot $0.50 | Rake $0 
Seat 2: jj_rose_jj12 (small blind) collected ($0.50)
Seat 3: CashMatteo (big blind) folded before Flop
Seat 4: mistasho folded before Flop (didn't bet)
Seat 5: Miseky folded before Flop (didn't bet)
Seat 6: InitialHC (button) folded before Flop (didn't bet)

Hand #1768: 

PokerStars Hand #246794976939:  Hold'em No Limit ($0.10/$0.25 CAD) - 2023/10/28 15:48:12 ET
Table 'Wallenquist II' 6-max Seat #2 is the button
Seat 2: jj_rose_jj12 ($31.09 in chips) 
Seat 3: CashMatteo ($11.56 in chips) 
Seat 4: mistasho ($26.18 in chips) 
Seat 5: Miseky ($35.41 in chips) 
Seat 6: InitialHC ($30.92 in chips) 
CashMatteo: posts small blind $0.10
mistasho: posts big blind $0.25
*** HOLE CARDS ***
Dealt to CashMatteo [4s 7h]
Miseky: folds 
InitialHC: folds 
jj_rose_jj12: raises $0.37 to $0.62
CashMatteo: folds 
CashMatteo was removed from the table for failing to post
mistasho: raises $25.56 to $26.18 and is all-in
jj_rose_jj12: folds 
Uncalled bet ($25.56) returned to mistasho
CashMatteo leaves the table
mistasho collected $1.34 from pot
mistasho: doesn't show hand 
*** SUMMARY ***
Total pot $1.34 | Rake $0 
Seat 2: jj_rose_jj12 (button) folded before Flop
Seat 3: CashMatteo (small blind) folded before Flop
Seat 4: mistasho (big blind) collected ($1.34)
Seat 5: Miseky folded before Flop (didn't bet)
Seat 6: InitialHC folded before Flop (didn't bet)

Hand #1769: 

PokerStars Hand #246794987666:  Hold'em No Limit ($0.10/$0.25 CAD) - 2023/10/28 15:48:44 ET
Table 'Sadeya II' 6-max Seat #3 is the button
Seat 1: CashMatteo ($20 in chips) 
Seat 2: mistasho ($36.34 in chips) 
Seat 3: Hammertime1933 ($73.43 in chips) 
Seat 4: marner99 ($31.98 in chips) 
Seat 5: andmunn ($36.08 in chips) 
Seat 6: jj_rose_jj12 ($50.22 in chips) 
marner99: posts small blind $0.10
andmunn: posts big blind $0.25
CashMatteo: posts big blind $0.25
*** HOLE CARDS ***
Dealt to CashMatteo [Kd Tc]
jj_rose_jj12: folds 
CashMatteo: raises $0.37 to $0.62
mistasho: folds 
Hammertime1933: calls $0.62
marner99: folds 
andmunn: raises $2.88 to $3.50
CashMatteo: folds 
Hammertime1933: folds 
Uncalled bet ($2.88) returned to andmunn
andmunn collected $1.96 from pot
andmunn: doesn't show hand 
*** SUMMARY ***
Total pot $1.96 | Rake $0 
Seat 1: CashMatteo folded before Flop
Seat 2: mistasho folded before Flop (didn't bet)
Seat 3: Hammertime1933 (button) folded before Flop
Seat 4: marner99 (small blind) folded before Flop
Seat 5: andmunn (big blind) collected ($1.96)
Seat 6: jj_rose_jj12 folded before Flop (didn't bet)

Hand #1770: 

PokerStars Hand #246795001708:  Hold'em No Limit ($0.10/$0.25 CAD) - 2023/10/28 15:49:26 ET
Table 'Sadeya II' 6-max Seat #4 is the button
Seat 1: CashMatteo ($19.38 in chips) 
Seat 2: mistasho ($36.34 in chips) 
Seat 3: Hammertime1933 ($72.81 in chips) 
Seat 4: marner99 ($31.88 in chips) 
Seat 5: andmunn ($37.42 in chips) 
Seat 6: jj_rose_jj12 ($50.22 in chips) 
andmunn: posts small blind $0.10
jj_rose_jj12: posts big blind $0.25
*** HOLE CARDS ***
Dealt to CashMatteo [7d Kd]
CashMatteo: raises $0.37 to $0.62
mistasho: folds 
Hammertime1933: folds 
marner99: folds 
andmunn: folds 
jj_rose_jj12: calls $0.37
*** FLOP *** [3c Qs 5c]
jj_rose_jj12: checks 
CashMatteo: checks 
*** TURN *** [3c Qs 5c] [2h]
jj_rose_jj12: bets $0.85
CashMatteo: folds 
Uncalled bet ($0.85) returned to jj_rose_jj12
jj_rose_jj12 collected $1.28 from pot
jj_rose_jj12: doesn't show hand 
*** SUMMARY ***
Total pot $1.34 | Rake $0.06 
Board [3c Qs 5c 2h]
Seat 1: CashMatteo folded on the Turn
Seat 2: mistasho folded before Flop (didn't bet)
Seat 3: Hammertime1933 folded before Flop (didn't bet)
Seat 4: marner99 (button) folded before Flop (didn't bet)
Seat 5: andmunn (small blind) folded before Flop
Seat 6: jj_rose_jj12 (big blind) collected ($1.28)

Hand #1771: 

PokerStars Hand #246795015905:  Hold'em No Limit ($0.10/$0.25 CAD) - 2023/10/28 15:50:07 ET
Table 'Sadeya II' 6-max Seat #5 is the button
Seat 1: CashMatteo ($18.76 in chips) 
Seat 2: mistasho ($36.34 in chips) 
Seat 3: Hammertime1933 ($72.81 in chips) 
Seat 4: marner99 ($31.88 in chips) 
Seat 5: andmunn ($37.32 in chips) 
Seat 6: jj_rose_jj12 ($50.88 in chips) 
jj_rose_jj12: posts small blind $0.10
CashMatteo: posts big blind $0.25
*** HOLE CARDS ***
Dealt to CashMatteo [4h Qd]
mistasho: folds 
Hammertime1933: raises $0.25 to $0.50
marner99: calls $0.50
andmunn: folds 
jj_rose_jj12: folds 
CashMatteo: calls $0.25
*** FLOP *** [Js 7h 9d]
CashMatteo: checks 
Hammertime1933: bets $1.53
marner99: folds 
CashMatteo: folds 
Uncalled bet ($1.53) returned to Hammertime1933
Hammertime1933 collected $1.53 from pot
*** SUMMARY ***
Total pot $1.60 | Rake $0.07 
Board [Js 7h 9d]
Seat 1: CashMatteo (big blind) folded on the Flop
Seat 2: mistasho folded before Flop (didn't bet)
Seat 3: Hammertime1933 collected ($1.53)
Seat 4: marner99 folded on the Flop
Seat 5: andmunn (button) folded before Flop (didn't bet)
Seat 6: jj_rose_jj12 (small blind) folded before Flop

Hand #1772: 

PokerStars Hand #246795025611:  Hold'em No Limit ($0.10/$0.25 CAD) - 2023/10/28 15:50:36 ET
Table 'Sadeya II' 6-max Seat #6 is the button
Seat 1: CashMatteo ($18.26 in chips) 
Seat 2: mistasho ($36.34 in chips) 
Seat 3: Hammertime1933 ($73.84 in chips) 
Seat 4: marner99 ($31.38 in chips) 
Seat 5: andmunn ($37.32 in chips) 
Seat 6: jj_rose_jj12 ($50.78 in chips) 
CashMatteo: posts small blind $0.10
mistasho: posts big blind $0.25
*** HOLE CARDS ***
Dealt to CashMatteo [5c 5s]
Hammertime1933: folds 
marner99: raises $0.37 to $0.62
andmunn: raises $1.38 to $2
jj_rose_jj12: folds 
CashMatteo: folds 
mistasho: folds 
marner99: calls $1.38
*** FLOP *** [5h 7s 2s]
marner99: checks 
andmunn: checks 
*** TURN *** [5h 7s 2s] [4s]
marner99: checks 
andmunn: checks 
*** RIVER *** [5h 7s 2s 4s] [Qs]
marner99: checks 
andmunn: checks 
*** SHOW DOWN ***
marner99: shows [7c 8c] (a pair of Sevens)
andmunn: shows [Qd Ah] (a pair of Queens)
andmunn collected $4.15 from pot
*** SUMMARY ***
Total pot $4.35 | Rake $0.20 
Board [5h 7s 2s 4s Qs]
Seat 1: CashMatteo (small blind) folded before Flop
Seat 2: mistasho (big blind) folded before Flop
Seat 3: Hammertime1933 folded before Flop (didn't bet)
Seat 4: marner99 showed [7c 8c] and lost with a pair of Sevens
Seat 5: andmunn showed [Qd Ah] and won ($4.15) with a pair of Queens
Seat 6: jj_rose_jj12 (button) folded before Flop (didn't bet)

Hand #1773: 

PokerStars Hand #246795042568:  Hold'em No Limit ($0.10/$0.25 CAD) - 2023/10/28 15:51:27 ET
Table 'Sadeya II' 6-max Seat #1 is the button
Seat 1: CashMatteo ($18.16 in chips) 
Seat 2: mistasho ($36.09 in chips) 
Seat 3: Hammertime1933 ($73.84 in chips) 
Seat 4: marner99 ($29.38 in chips) 
Seat 5: andmunn ($39.47 in chips) 
Seat 6: jj_rose_jj12 ($50.78 in chips) 
mistasho: posts small blind $0.10
Hammertime1933: posts big blind $0.25
*** HOLE CARDS ***
Dealt to CashMatteo [6h 6s]
marner99: raises $0.30 to $0.55
andmunn: folds 
jj_rose_jj12: folds 
CashMatteo: calls $0.55
mistasho: raises $35.54 to $36.09 and is all-in
Hammertime1933: folds 
marner99: folds 
CashMatteo: folds 
Uncalled bet ($35.54) returned to mistasho
mistasho collected $1.90 from pot
mistasho: doesn't show hand 
*** SUMMARY ***
Total pot $1.90 | Rake $0 
Seat 1: CashMatteo (button) folded before Flop
Seat 2: mistasho (small blind) collected ($1.90)
Seat 3: Hammertime1933 (big blind) folded before Flop
Seat 4: marner99 folded before Flop
Seat 5: andmunn folded before Flop (didn't bet)
Seat 6: jj_rose_jj12 folded before Flop (didn't bet)

Hand #1774: 

PokerStars Hand #246795056352:  Hold'em No Limit ($0.10/$0.25 CAD) - 2023/10/28 15:52:07 ET
Table 'Sadeya II' 6-max Seat #2 is the button
Seat 1: CashMatteo ($17.61 in chips) 
Seat 2: mistasho ($37.44 in chips) 
Seat 3: Hammertime1933 ($73.59 in chips) 
Seat 4: marner99 ($28.83 in chips) 
Seat 5: andmunn ($39.47 in chips) 
Seat 6: jj_rose_jj12 ($50.78 in chips) 
Hammertime1933: posts small blind $0.10
marner99: posts big blind $0.25
*** HOLE CARDS ***
Dealt to CashMatteo [3c 9h]
andmunn: folds 
jj_rose_jj12: folds 
CashMatteo: folds 
mistasho: raises $0.50 to $0.75
Hammertime1933: folds 
marner99: folds 
Uncalled bet ($0.50) returned to mistasho
mistasho collected $0.60 from pot
mistasho: doesn't show hand 
*** SUMMARY ***
Total pot $0.60 | Rake $0 
Seat 1: CashMatteo folded before Flop (didn't bet)
Seat 2: mistasho (button) collected ($0.60)
Seat 3: Hammertime1933 (small blind) folded before Flop
Seat 4: marner99 (big blind) folded before Flop
Seat 5: andmunn folded before Flop (didn't bet)
Seat 6: jj_rose_jj12 folded before Flop (didn't bet)

Hand #1775: 

PokerStars Hand #246795062822:  Hold'em No Limit ($0.10/$0.25 CAD) - 2023/10/28 15:52:26 ET
Table 'Sadeya II' 6-max Seat #3 is the button
Seat 1: CashMatteo ($17.61 in chips) 
Seat 2: mistasho ($37.79 in chips) 
Seat 3: Hammertime1933 ($73.49 in chips) 
Seat 4: marner99 ($28.58 in chips) 
Seat 5: andmunn ($39.47 in chips) 
Seat 6: jj_rose_jj12 ($50.78 in chips) 
marner99: posts small blind $0.10
andmunn: posts big blind $0.25
*** HOLE CARDS ***
Dealt to CashMatteo [4c Kc]
jj_rose_jj12: folds 
CashMatteo: raises $0.37 to $0.62
mistasho: folds 
Hammertime1933: folds 
marner99: folds 
andmunn: folds 
Uncalled bet ($0.37) returned to CashMatteo
CashMatteo collected $0.60 from pot
CashMatteo: doesn't show hand 
*** SUMMARY ***
Total pot $0.60 | Rake $0 
Seat 1: CashMatteo collected ($0.60)
Seat 2: mistasho folded before Flop (didn't bet)
Seat 3: Hammertime1933 (button) folded before Flop (didn't bet)
Seat 4: marner99 (small blind) folded before Flop
Seat 5: andmunn (big blind) folded before Flop
Seat 6: jj_rose_jj12 folded before Flop (didn't bet)

Hand #1776: 

PokerStars Hand #246795068894:  Hold'em No Limit ($0.10/$0.25 CAD) - 2023/10/28 15:52:44 ET
Table 'Sadeya II' 6-max Seat #4 is the button
Seat 1: CashMatteo ($17.96 in chips) 
Seat 2: mistasho ($37.79 in chips) 
Seat 3: Hammertime1933 ($73.49 in chips) 
Seat 4: marner99 ($28.48 in chips) 
Seat 5: andmunn ($39.22 in chips) 
Seat 6: jj_rose_jj12 ($50.78 in chips) 
andmunn: posts small blind $0.10
jj_rose_jj12: posts big blind $0.25
*** HOLE CARDS ***
Dealt to CashMatteo [7d 9h]
CashMatteo: calls $0.25
mistasho: folds 
Hammertime1933: folds 
marner99: folds 
andmunn: folds 
jj_rose_jj12: checks 
*** FLOP *** [Js Th 6h]
jj_rose_jj12: checks 
CashMatteo: checks 
*** TURN *** [Js Th 6h] [Qc]
jj_rose_jj12: bets $0.38
CashMatteo: calls $0.38
*** RIVER *** [Js Th 6h Qc] [3s]
jj_rose_jj12: checks 
CashMatteo: bets $1.30
jj_rose_jj12: folds 
Uncalled bet ($1.30) returned to CashMatteo
CashMatteo collected $1.30 from pot
CashMatteo: doesn't show hand 
*** SUMMARY ***
Total pot $1.36 | Rake $0.06 
Board [Js Th 6h Qc 3s]
Seat 1: CashMatteo collected ($1.30)
Seat 2: mistasho folded before Flop (didn't bet)
Seat 3: Hammertime1933 folded before Flop (didn't bet)
Seat 4: marner99 (button) folded before Flop (didn't bet)
Seat 5: andmunn (small blind) folded before Flop
Seat 6: jj_rose_jj12 (big blind) folded on the River

Hand #1777: 

PokerStars Hand #246795087442:  Hold'em No Limit ($0.10/$0.25 CAD) - 2023/10/28 15:53:39 ET
Table 'Sadeya II' 6-max Seat #5 is the button
Seat 1: CashMatteo ($18.63 in chips) 
Seat 2: mistasho ($37.79 in chips) 
Seat 3: Hammertime1933 ($73.49 in chips) 
Seat 4: marner99 ($28.48 in chips) 
Seat 5: andmunn ($39.12 in chips) 
Seat 6: jj_rose_jj12 ($50.15 in chips) 
jj_rose_jj12: posts small blind $0.10
CashMatteo: posts big blind $0.25
*** HOLE CARDS ***
Dealt to CashMatteo [7h Qh]
mistasho: raises $0.50 to $0.75
Hammertime1933: folds 
marner99: folds 
andmunn: folds 
jj_rose_jj12: folds 
CashMatteo: calls $0.50
*** FLOP *** [Kc Ks 9d]
CashMatteo: checks 
mistasho: bets $0.77
CashMatteo: folds 
Uncalled bet ($0.77) returned to mistasho
mistasho collected $1.53 from pot
mistasho: doesn't show hand 
*** SUMMARY ***
Total pot $1.60 | Rake $0.07 
Board [Kc Ks 9d]
Seat 1: CashMatteo (big blind) folded on the Flop
Seat 2: mistasho collected ($1.53)
Seat 3: Hammertime1933 folded before Flop (didn't bet)
Seat 4: marner99 folded before Flop (didn't bet)
Seat 5: andmunn (button) folded before Flop (didn't bet)
Seat 6: jj_rose_jj12 (small blind) folded before Flop

Hand #1778: 

PokerStars Hand #246795095970:  Hold'em No Limit ($0.10/$0.25 CAD) - 2023/10/28 15:54:04 ET
Table 'Sadeya II' 6-max Seat #6 is the button
Seat 1: CashMatteo ($17.88 in chips) 
Seat 2: mistasho ($38.57 in chips) 
Seat 3: Hammertime1933 ($73.49 in chips) 
Seat 4: marner99 ($28.48 in chips) 
Seat 5: andmunn ($39.12 in chips) 
Seat 6: jj_rose_jj12 ($50.05 in chips) 
CashMatteo: posts small blind $0.10
mistasho: posts big blind $0.25
*** HOLE CARDS ***
Dealt to CashMatteo [9h 8s]
Hammertime1933: folds 
marner99: raises $0.37 to $0.62
andmunn: folds 
jj_rose_jj12: folds 
CashMatteo: calls $0.52
mistasho: folds 
*** FLOP *** [Ts 3s 8h]
CashMatteo: checks 
marner99: bets $1.07
CashMatteo: calls $1.07
*** TURN *** [Ts 3s 8h] [Js]
CashMatteo: checks 
marner99: bets $1.15
CashMatteo: calls $1.15
*** RIVER *** [Ts 3s 8h Js] [Qc]
CashMatteo: checks 
marner99: bets $3.05
CashMatteo: calls $3.05
*** SHOW DOWN ***
marner99: shows [As 9s] (a flush, Ace high)
CashMatteo: mucks hand 
marner99 collected $11.49 from pot
*** SUMMARY ***
Total pot $12.03 | Rake $0.54 
Board [Ts 3s 8h Js Qc]
Seat 1: CashMatteo (small blind) mucked [9h 8s]
Seat 2: mistasho (big blind) folded before Flop
Seat 3: Hammertime1933 folded before Flop (didn't bet)
Seat 4: marner99 showed [As 9s] and won ($11.49) with a flush, Ace high
Seat 5: andmunn folded before Flop (didn't bet)
Seat 6: jj_rose_jj12 (button) folded before Flop (didn't bet)

Hand #1779: 

PokerStars Hand #246795111010:  Hold'em No Limit ($0.10/$0.25 CAD) - 2023/10/28 15:54:48 ET
Table 'Sadeya II' 6-max Seat #1 is the button
Seat 1: CashMatteo ($11.99 in chips) 
Seat 2: mistasho ($38.32 in chips) 
Seat 3: Hammertime1933 ($73.49 in chips) 
Seat 4: marner99 ($34.08 in chips) 
Seat 5: andmunn ($39.12 in chips) 
Seat 6: jj_rose_jj12 ($50.05 in chips) 
mistasho: posts small blind $0.10
Hammertime1933: posts big blind $0.25
*** HOLE CARDS ***
Dealt to CashMatteo [Kh 6c]
marner99: folds 
andmunn: folds 
jj_rose_jj12: raises $0.37 to $0.62
CashMatteo: folds 
CashMatteo leaves the table
mistasho: folds 
Hammertime1933: raises $1.34 to $1.96
jj_rose_jj12: folds 
Uncalled bet ($1.34) returned to Hammertime1933
Hammertime1933 collected $1.34 from pot
*** SUMMARY ***
Total pot $1.34 | Rake $0 
Seat 1: CashMatteo (button) folded before Flop (didn't bet)
Seat 2: mistasho (small blind) folded before Flop
Seat 3: Hammertime1933 (big blind) collected ($1.34)
Seat 4: marner99 folded before Flop (didn't bet)
Seat 5: andmunn folded before Flop (didn't bet)
Seat 6: jj_rose_jj12 folded before Flop

Hand #1780: 

PokerStars Hand #246795142699:  Hold'em No Limit ($0.10/$0.25 CAD) - 2023/10/28 15:56:52 ET
Table 'Mandeville II' 6-max Seat #5 is the button
Seat 1: CashMatteo ($15 in chips) 
Seat 2: InitialHC ($26.57 in chips) 
Seat 3: jj_rose_jj12 ($39.59 in chips) 
Seat 4: BeLeery ($14.26 in chips) 
Seat 5: n01shome ($33.25 in chips) 
Seat 6: Hammertime1933 ($21.22 in chips) 
Hammertime1933: posts small blind $0.10
CashMatteo: posts big blind $0.25
*** HOLE CARDS ***
Dealt to CashMatteo [7c 8c]
InitialHC: folds 
jj_rose_jj12: folds 
BeLeery: folds 
n01shome: folds 
Hammertime1933: raises $0.25 to $0.50
CashMatteo: calls $0.25
*** FLOP *** [3h 5h 2c]
Hammertime1933: bets $0.50
CashMatteo: folds 
Uncalled bet ($0.50) returned to Hammertime1933
Hammertime1933 collected $0.96 from pot
*** SUMMARY ***
Total pot $1 | Rake $0.04 
Board [3h 5h 2c]
Seat 1: CashMatteo (big blind) folded on the Flop
Seat 2: InitialHC folded before Flop (didn't bet)
Seat 3: jj_rose_jj12 folded before Flop (didn't bet)
Seat 4: BeLeery folded before Flop (didn't bet)
Seat 5: n01shome (button) folded before Flop (didn't bet)
Seat 6: Hammertime1933 (small blind) collected ($0.96)

Hand #1781: 

PokerStars Hand #246795149271:  Hold'em No Limit ($0.10/$0.25 CAD) - 2023/10/28 15:57:19 ET
Table 'Mandeville II' 6-max Seat #6 is the button
Seat 1: CashMatteo ($14.50 in chips) 
Seat 2: InitialHC ($26.57 in chips) 
Seat 3: jj_rose_jj12 ($39.59 in chips) 
Seat 4: BeLeery ($14.26 in chips) 
Seat 5: n01shome ($33.25 in chips) 
Seat 6: Hammertime1933 ($21.68 in chips) 
CashMatteo: posts small blind $0.10
InitialHC: posts big blind $0.25
*** HOLE CARDS ***
Dealt to CashMatteo [Qc Jh]
jj_rose_jj12: folds 
BeLeery: raises $0.50 to $0.75
n01shome: calls $0.75
Hammertime1933: folds 
CashMatteo: calls $0.65
InitialHC: folds 
*** FLOP *** [Qs 4d Jc]
CashMatteo: checks 
BeLeery: bets $1.70
n01shome: folds 
CashMatteo: raises $1.90 to $3.60
BeLeery: calls $1.90
*** TURN *** [Qs 4d Jc] [2s]
CashMatteo: bets $4.63
BeLeery: calls $4.63
*** RIVER *** [Qs 4d Jc 2s] [5h]
BeLeery said, "AA right?"
CashMatteo: bets $5.52 and is all-in
BeLeery: calls $5.28 and is all-in
Uncalled bet ($0.24) returned to CashMatteo
*** SHOW DOWN ***
CashMatteo: shows [Qc Jh] (two pair, Queens and Jacks)
BeLeery: shows [Qd Ts] (a pair of Queens)
CashMatteo collected $28.19 from pot
*** SUMMARY ***
Total pot $29.52 | Rake $1.33 
Board [Qs 4d Jc 2s 5h]
Seat 1: CashMatteo (small blind) showed [Qc Jh] and won ($28.19) with two pair, Queens and Jacks
Seat 2: InitialHC (big blind) folded before Flop
Seat 3: jj_rose_jj12 folded before Flop (didn't bet)
Seat 4: BeLeery showed [Qd Ts] and lost with a pair of Queens
Seat 5: n01shome folded on the Flop
Seat 6: Hammertime1933 (button) folded before Flop (didn't bet)

Hand #1782: 

PokerStars Hand #246795176966:  Hold'em No Limit ($0.10/$0.25 CAD) - 2023/10/28 15:59:14 ET
Table 'Mandeville II' 6-max Seat #1 is the button
Seat 1: CashMatteo ($28.43 in chips) 
Seat 2: InitialHC ($26.32 in chips) 
Seat 3: jj_rose_jj12 ($39.59 in chips) 
Seat 5: n01shome ($32.50 in chips) 
Seat 6: Hammertime1933 ($21.68 in chips) 
InitialHC: posts small blind $0.10
jj_rose_jj12: posts big blind $0.25
*** HOLE CARDS ***
Dealt to CashMatteo [5s Js]
n01shome: folds 
Hammertime1933: raises $0.25 to $0.50
CashMatteo: calls $0.50
InitialHC: folds 
jj_rose_jj12: folds 
*** FLOP *** [4h Qh Td]
Hammertime1933: bets $1.29
CashMatteo: folds 
Uncalled bet ($1.29) returned to Hammertime1933
Hammertime1933 collected $1.29 from pot
*** SUMMARY ***
Total pot $1.35 | Rake $0.06 
Board [4h Qh Td]
Seat 1: CashMatteo (button) folded on the Flop
Seat 2: InitialHC (small blind) folded before Flop
Seat 3: jj_rose_jj12 (big blind) folded before Flop
Seat 5: n01shome folded before Flop (didn't bet)
Seat 6: Hammertime1933 collected ($1.29)

Hand #1783: 

PokerStars Hand #246795185965:  Hold'em No Limit ($0.10/$0.25 CAD) - 2023/10/28 15:59:51 ET
Table 'Mandeville II' 6-max Seat #2 is the button
Seat 1: CashMatteo ($27.93 in chips) 
Seat 2: InitialHC ($26.22 in chips) 
Seat 3: jj_rose_jj12 ($39.34 in chips) 
Seat 4: BeLeery ($10.25 in chips) 
Seat 5: n01shome ($32.50 in chips) 
Seat 6: Hammertime1933 ($22.47 in chips) 
jj_rose_jj12: posts small blind $0.10
BeLeery: posts big blind $0.25
*** HOLE CARDS ***
Dealt to CashMatteo [8d 3c]
n01shome: folds 
Hammertime1933: folds 
CashMatteo: folds 
InitialHC: folds 
jj_rose_jj12: raises $0.50 to $0.75
BeLeery: calls $0.50
*** FLOP *** [Qd 5h 2d]
jj_rose_jj12: bets $0.95
BeLeery: calls $0.95
*** TURN *** [Qd 5h 2d] [Qc]
jj_rose_jj12: checks 
BeLeery: checks 
*** RIVER *** [Qd 5h 2d Qc] [4d]
jj_rose_jj12: checks 
BeLeery: bets $1.63
jj_rose_jj12: folds 
Uncalled bet ($1.63) returned to BeLeery
BeLeery collected $3.25 from pot
BeLeery: doesn't show hand 
*** SUMMARY ***
Total pot $3.40 | Rake $0.15 
Board [Qd 5h 2d Qc 4d]
Seat 1: CashMatteo folded before Flop (didn't bet)
Seat 2: InitialHC (button) folded before Flop (didn't bet)
Seat 3: jj_rose_jj12 (small blind) folded on the River
Seat 4: BeLeery (big blind) collected ($3.25)
Seat 5: n01shome folded before Flop (didn't bet)
Seat 6: Hammertime1933 folded before Flop (didn't bet)

Hand #1784: 

PokerStars Hand #246795211002:  Hold'em No Limit ($0.10/$0.25 CAD) - 2023/10/28 16:01:22 ET
Table 'Mandeville II' 6-max Seat #3 is the button
Seat 1: CashMatteo ($27.93 in chips) 
Seat 2: InitialHC ($26.22 in chips) 
Seat 3: jj_rose_jj12 ($37.64 in chips) 
Seat 4: BeLeery ($11.80 in chips) 
Seat 5: n01shome ($32.50 in chips) 
Seat 6: Hammertime1933 ($22.47 in chips) 
BeLeery: posts small blind $0.10
n01shome: posts big blind $0.25
*** HOLE CARDS ***
Dealt to CashMatteo [Ad Js]
Hammertime1933: calls $0.25
CashMatteo: raises $0.37 to $0.62
InitialHC: folds 
jj_rose_jj12: folds 
BeLeery: calls $0.52
n01shome: calls $0.37
Hammertime1933: calls $0.37
*** FLOP *** [3s As Td]
BeLeery: checks 
n01shome: checks 
Hammertime1933: checks 
CashMatteo: bets $1.19
BeLeery: calls $1.19
n01shome: calls $1.19
Hammertime1933: folds 
*** TURN *** [3s As Td] [Qh]
BeLeery: checks 
n01shome: checks 
CashMatteo: checks 
*** RIVER *** [3s As Td Qh] [2c]
BeLeery: bets $0.25
n01shome: folds 
CashMatteo: raises $2.39 to $2.64
BeLeery: folds 
Uncalled bet ($2.39) returned to CashMatteo
CashMatteo collected $6.26 from pot
CashMatteo: doesn't show hand 
*** SUMMARY ***
Total pot $6.55 | Rake $0.29 
Board [3s As Td Qh 2c]
Seat 1: CashMatteo collected ($6.26)
Seat 2: InitialHC folded before Flop (didn't bet)
Seat 3: jj_rose_jj12 (button) folded before Flop (didn't bet)
Seat 4: BeLeery (small blind) folded on the River
Seat 5: n01shome (big blind) folded on the River
Seat 6: Hammertime1933 folded on the Flop

Hand #1785: 

PokerStars Hand #246795251639:  Hold'em No Limit ($0.10/$0.25 CAD) - 2023/10/28 16:03:24 ET
Table 'Mandeville II' 6-max Seat #4 is the button
Seat 1: CashMatteo ($32.13 in chips) 
Seat 2: InitialHC ($26.22 in chips) 
Seat 3: jj_rose_jj12 ($37.64 in chips) 
Seat 4: BeLeery ($9.74 in chips) 
Seat 5: n01shome ($30.69 in chips) 
Seat 6: Hammertime1933 ($21.85 in chips) 
n01shome: posts small blind $0.10
Hammertime1933: posts big blind $0.25
*** HOLE CARDS ***
Dealt to CashMatteo [Ks Kh]
CashMatteo: raises $0.37 to $0.62
InitialHC: folds 
jj_rose_jj12: calls $0.62
BeLeery: folds 
n01shome: calls $0.52
Hammertime1933: folds 
*** FLOP *** [7c 3c 5c]
n01shome: checks 
CashMatteo: bets $1.01
jj_rose_jj12: calls $1.01
n01shome: folds 
*** TURN *** [7c 3c 5c] [3s]
CashMatteo: bets $3.94
jj_rose_jj12: calls $3.94
*** RIVER *** [7c 3c 5c 3s] [Jh]
CashMatteo: checks 
jj_rose_jj12: bets $9.40
CashMatteo: calls $9.40
*** SHOW DOWN ***
jj_rose_jj12: shows [Jd Jc] (a full house, Jacks full of Threes)
CashMatteo: mucks hand 
jj_rose_jj12 collected $29.42 from pot
*** SUMMARY ***
Total pot $30.81 | Rake $1.39 
Board [7c 3c 5c 3s Jh]
Seat 1: CashMatteo mucked [Ks Kh]
Seat 2: InitialHC folded before Flop (didn't bet)
Seat 3: jj_rose_jj12 showed [Jd Jc] and won ($29.42) with a full house, Jacks full of Threes
Seat 4: BeLeery (button) folded before Flop (didn't bet)
Seat 5: n01shome (small blind) folded on the Flop
Seat 6: Hammertime1933 (big blind) folded before Flop

Hand #1786: 

PokerStars Hand #246795279317:  Hold'em No Limit ($0.10/$0.25 CAD) - 2023/10/28 16:04:45 ET
Table 'Mandeville II' 6-max Seat #5 is the button
Seat 1: CashMatteo ($17.16 in chips) 
Seat 2: InitialHC ($26.22 in chips) 
Seat 3: jj_rose_jj12 ($52.09 in chips) 
Seat 4: BeLeery ($9.74 in chips) 
Seat 5: n01shome ($30.07 in chips) 
Seat 6: Hammertime1933 ($21.60 in chips) 
Hammertime1933: posts small blind $0.10
CashMatteo: posts big blind $0.25
*** HOLE CARDS ***
Dealt to CashMatteo [Tc Ks]
InitialHC: folds 
jj_rose_jj12: folds 
BeLeery: raises $0.50 to $0.75
n01shome has timed out
n01shome: folds 
Hammertime1933: folds 
CashMatteo: calls $0.50
*** FLOP *** [9d 9s 4d]
CashMatteo: checks 
BeLeery: checks 
*** TURN *** [9d 9s 4d] [7d]
CashMatteo: checks 
BeLeery: bets $1.53
CashMatteo: folds 
Uncalled bet ($1.53) returned to BeLeery
BeLeery collected $1.53 from pot
BeLeery: doesn't show hand 
*** SUMMARY ***
Total pot $1.60 | Rake $0.07 
Board [9d 9s 4d 7d]
Seat 1: CashMatteo (big blind) folded on the Turn
Seat 2: InitialHC folded before Flop (didn't bet)
Seat 3: jj_rose_jj12 folded before Flop (didn't bet)
Seat 4: BeLeery collected ($1.53)
Seat 5: n01shome (button) folded before Flop (didn't bet)
Seat 6: Hammertime1933 (small blind) folded before Flop

Hand #1787: 

PokerStars Hand #246795287740: Tournament #3662938560, $0.94+$0.06 CAD Hold'em No Limit - Level I (15/30) - 2023/10/28 16:05:09 ET
Table '3662938560 1' 8-max Seat #2 is the button
Seat 2: Khab00m (3000 in chips) 
Seat 3: CashMatteo (3000 in chips) 
Seat 4: TowMadder (3000 in chips) 
Seat 5: ethancu1014 (3000 in chips) 
Seat 7: luck_vb1998 (3000 in chips) 
Seat 8: Huckleberry10 (3000 in chips) 
Khab00m: posts the ante 7
CashMatteo: posts the ante 7
TowMadder: posts the ante 7
ethancu1014: posts the ante 7
luck_vb1998: posts the ante 7
Huckleberry10: posts the ante 7
CashMatteo: posts small blind 15
TowMadder: posts big blind 30
*** HOLE CARDS ***
Dealt to CashMatteo [4s Qc]
ethancu1014: calls 30
luck_vb1998: folds 
Huckleberry10: folds 
Khab00m: folds 
CashMatteo: folds 
TowMadder: checks 
*** FLOP *** [2s Jc 9h]
TowMadder: checks 
ethancu1014: checks 
*** TURN *** [2s Jc 9h] [3d]
TowMadder: checks 
ethancu1014: checks 
*** RIVER *** [2s Jc 9h 3d] [Jh]
TowMadder: checks 
ethancu1014: checks 
*** SHOW DOWN ***
TowMadder: shows [6d 3h] (two pair, Jacks and Threes)
ethancu1014: mucks hand 
TowMadder collected 117 from pot
*** SUMMARY ***
Total pot 117 | Rake 0 
Board [2s Jc 9h 3d Jh]
Seat 2: Khab00m (button) folded before Flop (didn't bet)
Seat 3: CashMatteo (small blind) folded before Flop
Seat 4: TowMadder (big blind) showed [6d 3h] and won (117) with two pair, Jacks and Threes
Seat 5: ethancu1014 mucked [Kc As]
Seat 7: luck_vb1998 folded before Flop (didn't bet)
Seat 8: Huckleberry10 folded before Flop (didn't bet)

Hand #1788: 

PokerStars Hand #246795299301:  Hold'em No Limit ($0.10/$0.25 CAD) - 2023/10/28 16:05:43 ET
Table 'Mandeville II' 6-max Seat #6 is the button
Seat 1: CashMatteo ($16.41 in chips) 
Seat 2: InitialHC ($26.22 in chips) 
Seat 3: jj_rose_jj12 ($52.09 in chips) 
Seat 4: BeLeery ($10.52 in chips) 
Seat 6: Hammertime1933 ($21.50 in chips) 
CashMatteo: posts small blind $0.10
InitialHC: posts big blind $0.25
*** HOLE CARDS ***
Dealt to CashMatteo [Qc Jh]
jj_rose_jj12: folds 
BeLeery: folds 
Hammertime1933: folds 
CashMatteo: calls $0.15
InitialHC: raises $0.50 to $0.75
CashMatteo: calls $0.50
*** FLOP *** [9c 4s 7c]
CashMatteo: checks 
InitialHC: checks 
*** TURN *** [9c 4s 7c] [Qd]
CashMatteo: checks 
InitialHC: checks 
*** RIVER *** [9c 4s 7c Qd] [8c]
CashMatteo: bets $0.72
InitialHC: folds 
Uncalled bet ($0.72) returned to CashMatteo
CashMatteo collected $1.43 from pot
CashMatteo: doesn't show hand 
*** SUMMARY ***
Total pot $1.50 | Rake $0.07 
Board [9c 4s 7c Qd 8c]
Seat 1: CashMatteo (small blind) collected ($1.43)
Seat 2: InitialHC (big blind) folded on the River
Seat 3: jj_rose_jj12 folded before Flop (didn't bet)
Seat 4: BeLeery folded before Flop (didn't bet)
Seat 6: Hammertime1933 (button) folded before Flop (didn't bet)

Hand #1789: 

PokerStars Hand #246795306246: Tournament #3662938560, $0.94+$0.06 CAD Hold'em No Limit - Level I (15/30) - 2023/10/28 16:06:03 ET
Table '3662938560 1' 8-max Seat #3 is the button
Seat 2: Khab00m (2993 in chips) 
Seat 3: CashMatteo (2978 in chips) 
Seat 4: TowMadder (3080 in chips) 
Seat 5: ethancu1014 (2963 in chips) 
Seat 7: luck_vb1998 (2993 in chips) 
Seat 8: Huckleberry10 (2993 in chips) 
Khab00m: posts the ante 7
CashMatteo: posts the ante 7
TowMadder: posts the ante 7
ethancu1014: posts the ante 7
luck_vb1998: posts the ante 7
Huckleberry10: posts the ante 7
TowMadder: posts small blind 15
ethancu1014: posts big blind 30
*** HOLE CARDS ***
Dealt to CashMatteo [3h Qs]
luck_vb1998: folds 
Huckleberry10: folds 
Khab00m: raises 117 to 147
CashMatteo: folds 
TowMadder: calls 132
londong1978 is disconnected 
ethancu1014: folds 
*** FLOP *** [2h 7c Ah]
TowMadder: checks 
Khab00m: bets 183
TowMadder: folds 
Uncalled bet (183) returned to Khab00m
Khab00m collected 366 from pot
Khab00m: doesn't show hand 
*** SUMMARY ***
Total pot 366 | Rake 0 
Board [2h 7c Ah]
Seat 2: Khab00m collected (366)
Seat 3: CashMatteo (button) folded before Flop (didn't bet)
Seat 4: TowMadder (small blind) folded on the Flop
Seat 5: ethancu1014 (big blind) folded before Flop
Seat 7: luck_vb1998 folded before Flop (didn't bet)
Seat 8: Huckleberry10 folded before Flop (didn't bet)

Hand #1790: 

PokerStars Hand #246795315277:  Hold'em No Limit ($0.10/$0.25 CAD) - 2023/10/28 16:06:29 ET
Table 'Mandeville II' 6-max Seat #1 is the button
Seat 1: CashMatteo ($17.09 in chips) 
Seat 2: InitialHC ($25.47 in chips) 
Seat 3: jj_rose_jj12 ($52.09 in chips) 
Seat 4: BeLeery ($10.52 in chips) 
Seat 6: Hammertime1933 ($21.50 in chips) 
InitialHC: posts small blind $0.10
jj_rose_jj12: posts big blind $0.25
*** HOLE CARDS ***
Dealt to CashMatteo [Ah 9h]
BeLeery: raises $0.25 to $0.50
Hammertime1933: calls $0.50
CashMatteo: calls $0.50
InitialHC: folds 
jj_rose_jj12: calls $0.25
*** FLOP *** [Qs 9c Jd]
jj_rose_jj12: checks 
BeLeery: bets $2.01
Hammertime1933: folds 
CashMatteo: folds 
jj_rose_jj12: calls $2.01
*** TURN *** [Qs 9c Jd] [3d]
jj_rose_jj12: checks 
BeLeery: bets $5.84
jj_rose_jj12: folds 
Uncalled bet ($5.84) returned to BeLeery
BeLeery collected $5.84 from pot
BeLeery: doesn't show hand 
*** SUMMARY ***
Total pot $6.12 | Rake $0.28 
Board [Qs 9c Jd 3d]
Seat 1: CashMatteo (button) folded on the Flop
Seat 2: InitialHC (small blind) folded before Flop
Seat 3: jj_rose_jj12 (big blind) folded on the Turn
Seat 4: BeLeery collected ($5.84)
Seat 6: Hammertime1933 folded on the Flop

Hand #1791: 

PokerStars Hand #246795317145: Tournament #3662938560, $0.94+$0.06 CAD Hold'em No Limit - Level I (15/30) - 2023/10/28 16:06:34 ET
Table '3662938560 1' 8-max Seat #4 is the button
Seat 1: londong1978 (3000 in chips) 
Seat 2: Khab00m (3205 in chips) 
Seat 3: CashMatteo (2971 in chips) 
Seat 4: TowMadder (2926 in chips) 
Seat 5: ethancu1014 (2926 in chips) 
Seat 7: luck_vb1998 (2986 in chips) 
Seat 8: Huckleberry10 (2986 in chips) 
londong1978: posts the ante 7
Khab00m: posts the ante 7
CashMatteo: posts the ante 7
TowMadder: posts the ante 7
ethancu1014: posts the ante 7
luck_vb1998: posts the ante 7
Huckleberry10: posts the ante 7
ethancu1014: posts small blind 15
luck_vb1998: posts big blind 30
*** HOLE CARDS ***
Dealt to CashMatteo [6s 5d]
Huckleberry10: calls 30
londong1978: folds 
Khab00m: folds 
CashMatteo: folds 
TowMadder: calls 30
ethancu1014: calls 15
luck_vb1998: checks 
*** FLOP *** [5s 4d Ks]
ethancu1014: checks 
luck_vb1998: checks 
Huckleberry10: checks 
TowMadder: checks 
*** TURN *** [5s 4d Ks] [Js]
ethancu1014: bets 90
luck_vb1998: folds 
Huckleberry10: folds 
TowMadder: folds 
Uncalled bet (90) returned to ethancu1014
ethancu1014 collected 169 from pot
*** SUMMARY ***
Total pot 169 | Rake 0 
Board [5s 4d Ks Js]
Seat 1: londong1978 folded before Flop (didn't bet)
Seat 2: Khab00m folded before Flop (didn't bet)
Seat 3: CashMatteo folded before Flop (didn't bet)
Seat 4: TowMadder (button) folded on the Turn
Seat 5: ethancu1014 (small blind) collected (169)
Seat 7: luck_vb1998 (big blind) folded on the Turn
Seat 8: Huckleberry10 folded on the Turn

Hand #1792: 

PokerStars Hand #246795335948: Tournament #3662938560, $0.94+$0.06 CAD Hold'em No Limit - Level I (15/30) - 2023/10/28 16:07:29 ET
Table '3662938560 1' 8-max Seat #5 is the button
Seat 1: londong1978 (2993 in chips) 
Seat 2: Khab00m (3198 in chips) 
Seat 3: CashMatteo (2964 in chips) 
Seat 4: TowMadder (2889 in chips) 
Seat 5: ethancu1014 (3058 in chips) 
Seat 7: luck_vb1998 (2949 in chips) 
Seat 8: Huckleberry10 (2949 in chips) 
londong1978: posts the ante 7
Khab00m: posts the ante 7
CashMatteo: posts the ante 7
TowMadder: posts the ante 7
ethancu1014: posts the ante 7
luck_vb1998: posts the ante 7
Huckleberry10: posts the ante 7
luck_vb1998: posts small blind 15
Huckleberry10: posts big blind 30
*** HOLE CARDS ***
Dealt to CashMatteo [8c 5h]
londong1978: raises 120 to 150
Khab00m: folds 
CashMatteo: folds 
TowMadder: calls 150
ethancu1014: folds 
luck_vb1998: raises 180 to 330
Huckleberry10: folds 
londong1978: raises 2656 to 2986 and is all-in
TowMadder: folds 
luck_vb1998: calls 2612 and is all-in
Uncalled bet (44) returned to londong1978
*** FLOP *** [2h Qs 3d]
*** TURN *** [2h Qs 3d] [5d]
*** RIVER *** [2h Qs 3d 5d] [6c]
*** SHOW DOWN ***
luck_vb1998: shows [Jd Jc] (a pair of Jacks)
londong1978: shows [Ac Ah] (a pair of Aces)
londong1978 collected 6113 from pot
luck_vb1998 finished the tournament in 32nd place
*** SUMMARY ***
Total pot 6113 | Rake 0 
Board [2h Qs 3d 5d 6c]
Seat 1: londong1978 showed [Ac Ah] and won (6113) with a pair of Aces
Seat 2: Khab00m folded before Flop (didn't bet)
Seat 3: CashMatteo folded before Flop (didn't bet)
Seat 4: TowMadder folded before Flop
Seat 5: ethancu1014 (button) folded before Flop (didn't bet)
Seat 7: luck_vb1998 (small blind) showed [Jd Jc] and lost with a pair of Jacks
Seat 8: Huckleberry10 (big blind) folded before Flop

Hand #1793: 

PokerStars Hand #246795340833:  Hold'em No Limit ($0.10/$0.25 CAD) - 2023/10/28 16:07:43 ET
Table 'Mandeville II' 6-max Seat #2 is the button
Seat 1: CashMatteo ($16.59 in chips) 
Seat 2: InitialHC ($25.37 in chips) 
Seat 3: jj_rose_jj12 ($49.58 in chips) 
Seat 4: BeLeery ($13.85 in chips) 
Seat 6: Hammertime1933 ($21 in chips) 
jj_rose_jj12: posts small blind $0.10
BeLeery: posts big blind $0.25
*** HOLE CARDS ***
Dealt to CashMatteo [6c 2s]
Hammertime1933: folds 
CashMatteo: folds 
InitialHC: folds 
jj_rose_jj12: folds 
Uncalled bet ($0.15) returned to BeLeery
BeLeery collected $0.20 from pot
BeLeery: doesn't show hand 
*** SUMMARY ***
Total pot $0.20 | Rake $0 
Seat 1: CashMatteo folded before Flop (didn't bet)
Seat 2: InitialHC (button) folded before Flop (didn't bet)
Seat 3: jj_rose_jj12 (small blind) folded before Flop
Seat 4: BeLeery (big blind) collected ($0.20)
Seat 6: Hammertime1933 folded before Flop (didn't bet)

Hand #1794: 

PokerStars Hand #246795344720:  Hold'em No Limit ($0.10/$0.25 CAD) - 2023/10/28 16:07:54 ET
Table 'Mandeville II' 6-max Seat #3 is the button
Seat 1: CashMatteo ($16.59 in chips) 
Seat 2: InitialHC ($25.37 in chips) 
Seat 3: jj_rose_jj12 ($49.48 in chips) 
Seat 4: BeLeery ($13.95 in chips) 
Seat 6: Hammertime1933 ($21 in chips) 
BeLeery: posts small blind $0.10
Hammertime1933: posts big blind $0.25
*** HOLE CARDS ***
Dealt to CashMatteo [9d Js]
CashMatteo: calls $0.25
InitialHC: folds 
jj_rose_jj12: folds 
BeLeery: calls $0.15
Hammertime1933: raises $0.75 to $1
CashMatteo: calls $0.75
BeLeery: calls $0.75
*** FLOP *** [6h 5d Kd]
BeLeery: checks 
Hammertime1933: bets $1.43
CashMatteo: folds 
BeLeery: calls $1.43
*** TURN *** [6h 5d Kd] [Td]
BeLeery: checks 
Hammertime1933: checks 
*** RIVER *** [6h 5d Kd Td] [2c]
BeLeery: checks 
Hammertime1933: bets $2.80
BeLeery: folds 
Uncalled bet ($2.80) returned to Hammertime1933
Hammertime1933 collected $5.60 from pot
*** SUMMARY ***
Total pot $5.86 | Rake $0.26 
Board [6h 5d Kd Td 2c]
Seat 1: CashMatteo folded on the Flop
Seat 2: InitialHC folded before Flop (didn't bet)
Seat 3: jj_rose_jj12 (button) folded before Flop (didn't bet)
Seat 4: BeLeery (small blind) folded on the River
Seat 6: Hammertime1933 (big blind) collected ($5.60)

Hand #1795: 

PokerStars Hand #246795351190: Tournament #3662938560, $0.94+$0.06 CAD Hold'em No Limit - Level II (20/40) - 2023/10/28 16:08:13 ET
Table '3662938560 1' 8-max Seat #8 is the button
Seat 2: Khab00m (3191 in chips) 
Seat 3: CashMatteo (2957 in chips) 
Seat 4: TowMadder (2732 in chips) 
Seat 5: ethancu1014 (3051 in chips) 
Seat 6: thecheese42099 (3000 in chips) 
Seat 8: Huckleberry10 (2912 in chips) 
Khab00m: posts the ante 10
CashMatteo: posts the ante 10
TowMadder: posts the ante 10
ethancu1014: posts the ante 10
thecheese42099: posts the ante 10
Huckleberry10: posts the ante 10
Khab00m: posts small blind 20
CashMatteo: posts big blind 40
*** HOLE CARDS ***
Dealt to CashMatteo [2d Ac]
TowMadder: folds 
ethancu1014: calls 40
thecheese42099: calls 40
Huckleberry10: folds 
Khab00m: calls 20
CashMatteo: checks 
*** FLOP *** [Ts 5s 5h]
Khab00m: checks 
CashMatteo: checks 
ethancu1014: bets 40
thecheese42099: calls 40
Khab00m: calls 40
CashMatteo: folds 
*** TURN *** [Ts 5s 5h] [Kc]
Khab00m: checks 
ethancu1014: bets 170
thecheese42099: folds 
Khab00m: folds 
Uncalled bet (170) returned to ethancu1014
ethancu1014 collected 340 from pot
ethancu1014: doesn't show hand 
*** SUMMARY ***
Total pot 340 | Rake 0 
Board [Ts 5s 5h Kc]
Seat 2: Khab00m (small blind) folded on the Turn
Seat 3: CashMatteo (big blind) folded on the Flop
Seat 4: TowMadder folded before Flop (didn't bet)
Seat 5: ethancu1014 collected (340)
Seat 6: thecheese42099 folded on the Turn
Seat 8: Huckleberry10 (button) folded before Flop (didn't bet)

Hand #1796: 

PokerStars Hand #246795370876: Tournament #3662938560, $0.94+$0.06 CAD Hold'em No Limit - Level II (20/40) - 2023/10/28 16:09:11 ET
Table '3662938560 1' 8-max Seat #2 is the button
Seat 2: Khab00m (3101 in chips) 
Seat 3: CashMatteo (2907 in chips) 
Seat 4: TowMadder (2722 in chips) 
Seat 6: thecheese42099 (2910 in chips) 
Seat 8: Huckleberry10 (2902 in chips) 
Khab00m: posts the ante 10
CashMatteo: posts the ante 10
TowMadder: posts the ante 10
thecheese42099: posts the ante 10
Huckleberry10: posts the ante 10
CashMatteo: posts small blind 20
TowMadder: posts big blind 40
*** HOLE CARDS ***
Dealt to CashMatteo [2c Jh]
thecheese42099: folds 
Huckleberry10: folds 
Khab00m: folds 
CashMatteo: calls 20
TowMadder: checks 
*** FLOP *** [8d Jc 2d]
CashMatteo: checks 
TowMadder: bets 40
CashMatteo: calls 40
*** TURN *** [8d Jc 2d] [Td]
CashMatteo: checks 
TowMadder: bets 40
CashMatteo: calls 40
*** RIVER *** [8d Jc 2d Td] [Ts]
CashMatteo: checks 
TowMadder: bets 40
CashMatteo: calls 40
*** SHOW DOWN ***
TowMadder: shows [Kh Ks] (two pair, Kings and Tens)
CashMatteo: mucks hand 
TowMadder collected 370 from pot
*** SUMMARY ***
Total pot 370 | Rake 0 
Board [8d Jc 2d Td Ts]
Seat 2: Khab00m (button) folded before Flop (didn't bet)
Seat 3: CashMatteo (small blind) mucked [2c Jh]
Seat 4: TowMadder (big blind) showed [Kh Ks] and won (370) with two pair, Kings and Tens
Seat 6: thecheese42099 folded before Flop (didn't bet)
Seat 8: Huckleberry10 folded before Flop (didn't bet)

Hand #1797: 

PokerStars Hand #246795375452:  Hold'em No Limit ($0.10/$0.25 CAD) - 2023/10/28 16:09:24 ET
Table 'Mandeville II' 6-max Seat #4 is the button
Seat 1: CashMatteo ($15.59 in chips) 
Seat 2: InitialHC ($25.37 in chips) 
Seat 3: jj_rose_jj12 ($49.48 in chips) 
Seat 4: BeLeery ($11.52 in chips) 
Seat 6: Hammertime1933 ($24.17 in chips) 
Hammertime1933: posts small blind $0.10
CashMatteo: posts big blind $0.25
*** HOLE CARDS ***
Dealt to CashMatteo [As Tc]
InitialHC: folds 
jj_rose_jj12: folds 
BeLeery: folds 
Hammertime1933: folds 
Uncalled bet ($0.15) returned to CashMatteo
CashMatteo collected $0.20 from pot
CashMatteo: doesn't show hand 
*** SUMMARY ***
Total pot $0.20 | Rake $0 
Seat 1: CashMatteo (big blind) collected ($0.20)
Seat 2: InitialHC folded before Flop (didn't bet)
Seat 3: jj_rose_jj12 folded before Flop (didn't bet)
Seat 4: BeLeery (button) folded before Flop (didn't bet)
Seat 6: Hammertime1933 (small blind) folded before Flop

Hand #1798: 

PokerStars Hand #246795384477:  Hold'em No Limit ($0.10/$0.25 CAD) - 2023/10/28 16:09:51 ET
Table 'Mandeville II' 6-max Seat #6 is the button
Seat 1: CashMatteo ($15.69 in chips) 
Seat 2: InitialHC ($25.37 in chips) 
Seat 4: BeLeery ($11.52 in chips) 
Seat 6: Hammertime1933 ($24.07 in chips) 
CashMatteo: posts small blind $0.10
InitialHC: posts big blind $0.25
*** HOLE CARDS ***
Dealt to CashMatteo [6s Ks]
BeLeery: folds 
Hammertime1933: calls $0.25
CashMatteo: calls $0.15
InitialHC: checks 
*** FLOP *** [Ts Js Jd]
CashMatteo: bets $0.36
InitialHC: folds 
Hammertime1933: folds 
Uncalled bet ($0.36) returned to CashMatteo
CashMatteo collected $0.72 from pot
CashMatteo: doesn't show hand 
*** SUMMARY ***
Total pot $0.75 | Rake $0.03 
Board [Ts Js Jd]
Seat 1: CashMatteo (small blind) collected ($0.72)
Seat 2: InitialHC (big blind) folded on the Flop
Seat 4: BeLeery folded before Flop (didn't bet)
Seat 6: Hammertime1933 (button) folded on the Flop

Hand #1799: 

PokerStars Hand #246795384652: Tournament #3662938560, $0.94+$0.06 CAD Hold'em No Limit - Level II (20/40) - 2023/10/28 16:09:51 ET
Table '3662938560 1' 8-max Seat #3 is the button
Seat 2: Khab00m (3091 in chips) 
Seat 3: CashMatteo (2737 in chips) 
Seat 4: TowMadder (2922 in chips) 
Seat 6: thecheese42099 (2900 in chips) 
Seat 8: Huckleberry10 (2892 in chips) 
Khab00m: posts the ante 10
CashMatteo: posts the ante 10
TowMadder: posts the ante 10
thecheese42099: posts the ante 10
Huckleberry10: posts the ante 10
TowMadder: posts small blind 20
thecheese42099: posts big blind 40
*** HOLE CARDS ***
Dealt to CashMatteo [8h 8d]
Huckleberry10: calls 40
Khab00m: folds 
CashMatteo: raises 60 to 100
TowMadder: folds 
thecheese42099: folds 
Huckleberry10: calls 60
*** FLOP *** [5h 7s 7d]
Huckleberry10: checks 
CashMatteo: bets 155
Huckleberry10: folds 
Uncalled bet (155) returned to CashMatteo
CashMatteo collected 310 from pot
CashMatteo: doesn't show hand 
*** SUMMARY ***
Total pot 310 | Rake 0 
Board [5h 7s 7d]
Seat 2: Khab00m folded before Flop (didn't bet)
Seat 3: CashMatteo (button) collected (310)
Seat 4: TowMadder (small blind) folded before Flop
Seat 6: thecheese42099 (big blind) folded before Flop
Seat 8: Huckleberry10 folded on the Flop

Hand #1800: 

PokerStars Hand #246795392477: Tournament #3662938560, $0.94+$0.06 CAD Hold'em No Limit - Level II (20/40) - 2023/10/28 16:10:14 ET
Table '3662938560 1' 8-max Seat #4 is the button
Seat 2: Khab00m (3081 in chips) 
Seat 3: CashMatteo (2937 in chips) 
Seat 4: TowMadder (2892 in chips) 
Seat 6: thecheese42099 (2850 in chips) 
Seat 8: Huckleberry10 (2782 in chips) 
Khab00m: posts the ante 10
CashMatteo: posts the ante 10
TowMadder: posts the ante 10
thecheese42099: posts the ante 10
Huckleberry10: posts the ante 10
thecheese42099: posts small blind 20
Huckleberry10: posts big blind 40
*** HOLE CARDS ***
Dealt to CashMatteo [Jc 4d]
Khab00m: folds 
CashMatteo: folds 
TowMadder: folds 
thecheese42099: calls 20
Huckleberry10: checks 
*** FLOP *** [Qs 8h 2h]
thecheese42099: checks 
Huckleberry10: checks 
*** TURN *** [Qs 8h 2h] [2c]
thecheese42099: bets 40
Huckleberry10: folds 
Uncalled bet (40) returned to thecheese42099
thecheese42099 collected 130 from pot
*** SUMMARY ***
Total pot 130 | Rake 0 
Board [Qs 8h 2h 2c]
Seat 2: Khab00m folded before Flop (didn't bet)
Seat 3: CashMatteo folded before Flop (didn't bet)
Seat 4: TowMadder (button) folded before Flop (didn't bet)
Seat 6: thecheese42099 (small blind) collected (130)
Seat 8: Huckleberry10 (big blind) folded on the Turn

Hand #1801: 

PokerStars Hand #246795396646:  Hold'em No Limit ($0.10/$0.25 CAD) - 2023/10/28 16:10:26 ET
Table 'Mandeville II' 6-max Seat #1 is the button
Seat 1: CashMatteo ($16.16 in chips) 
Seat 2: InitialHC ($25.12 in chips) 
Seat 4: BeLeery ($11.52 in chips) 
Seat 6: Hammertime1933 ($23.82 in chips) 
InitialHC: posts small blind $0.10
BeLeery: posts big blind $0.25
*** HOLE CARDS ***
Dealt to CashMatteo [Kd 6d]
jj_rose_jj12 leaves the table
Hammertime1933: raises $0.25 to $0.50
CashMatteo: calls $0.50
InitialHC: folds 
BeLeery: folds 
*** FLOP *** [3h 8d 5h]
Hammertime1933: bets $0.65
CashMatteo: folds 
Uncalled bet ($0.65) returned to Hammertime1933
Hammertime1933 collected $1.29 from pot
*** SUMMARY ***
Total pot $1.35 | Rake $0.06 
Board [3h 8d 5h]
Seat 1: CashMatteo (button) folded on the Flop
Seat 2: InitialHC (small blind) folded before Flop
Seat 4: BeLeery (big blind) folded before Flop
Seat 6: Hammertime1933 collected ($1.29)

Hand #1802: 

PokerStars Hand #246795399748: Tournament #3662938560, $0.94+$0.06 CAD Hold'em No Limit - Level II (20/40) - 2023/10/28 16:10:35 ET
Table '3662938560 1' 8-max Seat #6 is the button
Seat 2: Khab00m (3071 in chips) 
Seat 3: CashMatteo (2927 in chips) 
Seat 4: TowMadder (2882 in chips) 
Seat 6: thecheese42099 (2930 in chips) 
Seat 8: Huckleberry10 (2732 in chips) 
Khab00m: posts the ante 10
CashMatteo: posts the ante 10
TowMadder: posts the ante 10
thecheese42099: posts the ante 10
Huckleberry10: posts the ante 10
Huckleberry10: posts small blind 20
Khab00m: posts big blind 40
*** HOLE CARDS ***
Dealt to CashMatteo [7h 6d]
CashMatteo: folds 
TowMadder: folds 
thecheese42099: calls 40
Huckleberry10: calls 20
Khab00m: checks 
*** FLOP *** [Jc Qs 2s]
Huckleberry10: checks 
Khab00m: checks 
thecheese42099: bets 40
Huckleberry10: folds 
Khab00m: folds 
Uncalled bet (40) returned to thecheese42099
thecheese42099 collected 170 from pot
*** SUMMARY ***
Total pot 170 | Rake 0 
Board [Jc Qs 2s]
Seat 2: Khab00m (big blind) folded on the Flop
Seat 3: CashMatteo folded before Flop (didn't bet)
Seat 4: TowMadder folded before Flop (didn't bet)
Seat 6: thecheese42099 (button) collected (170)
Seat 8: Huckleberry10 (small blind) folded on the Flop

Hand #1803: 

PokerStars Hand #246795406042:  Hold'em No Limit ($0.10/$0.25 CAD) - 2023/10/28 16:10:53 ET
Table 'Mandeville II' 6-max Seat #2 is the button
Seat 1: CashMatteo ($15.66 in chips) 
Seat 2: InitialHC ($25.02 in chips) 
Seat 4: BeLeery ($11.27 in chips) 
Seat 6: Hammertime1933 ($24.61 in chips) 
BeLeery: posts small blind $0.10
Hammertime1933: posts big blind $0.25
*** HOLE CARDS ***
Dealt to CashMatteo [9c Ac]
CashMatteo: calls $0.25
InitialHC: raises $0.50 to $0.75
Tyzk3 joins the table at seat #3 
BeLeery: folds 
Hammertime1933: calls $0.50
CashMatteo: calls $0.50
*** FLOP *** [Th 8c 4s]
Hammertime1933: bets $1.12
CashMatteo: folds 
InitialHC: calls $1.12
*** TURN *** [Th 8c 4s] [Qh]
Hammertime1933: bets $1.75
InitialHC: calls $1.75
*** RIVER *** [Th 8c 4s Qh] [5c]
Hammertime1933: bets $1.50
InitialHC: calls $1.50
*** SHOW DOWN ***
Hammertime1933: shows [9h 8d] (a pair of Eights)
InitialHC: shows [Ts Kd] (a pair of Tens)
InitialHC collected $10.59 from pot
*** SUMMARY ***
Total pot $11.09 | Rake $0.50 
Board [Th 8c 4s Qh 5c]
Seat 1: CashMatteo folded on the Flop
Seat 2: InitialHC (button) showed [Ts Kd] and won ($10.59) with a pair of Tens
Seat 4: BeLeery (small blind) folded before Flop
Seat 6: Hammertime1933 (big blind) showed [9h 8d] and lost with a pair of Eights

Hand #1804: 

PokerStars Hand #246795409681: Tournament #3662938560, $0.94+$0.06 CAD Hold'em No Limit - Level II (20/40) - 2023/10/28 16:11:03 ET
Table '3662938560 1' 8-max Seat #8 is the button
Seat 2: Khab00m (3021 in chips) 
Seat 3: CashMatteo (2917 in chips) 
Seat 4: TowMadder (2872 in chips) 
Seat 6: thecheese42099 (3050 in chips) 
Seat 8: Huckleberry10 (2682 in chips) 
Khab00m: posts the ante 10
CashMatteo: posts the ante 10
TowMadder: posts the ante 10
thecheese42099: posts the ante 10
Huckleberry10: posts the ante 10
Khab00m: posts small blind 20
CashMatteo: posts big blind 40
*** HOLE CARDS ***
Dealt to CashMatteo [6s 7d]
TowMadder: calls 40
thecheese42099: calls 40
Huckleberry10: calls 40
Khab00m: folds 
CashMatteo: checks 
*** FLOP *** [2h 2s 9c]
CashMatteo: checks 
TowMadder: checks 
thecheese42099: bets 40
Huckleberry10: calls 40
CashMatteo: folds 
TowMadder: calls 40
*** TURN *** [2h 2s 9c] [9h]
TowMadder: checks 
thecheese42099: checks 
Huckleberry10: bets 350
TowMadder: folds 
thecheese42099: folds 
Uncalled bet (350) returned to Huckleberry10
Huckleberry10 collected 350 from pot
*** SUMMARY ***
Total pot 350 | Rake 0 
Board [2h 2s 9c 9h]
Seat 2: Khab00m (small blind) folded before Flop
Seat 3: CashMatteo (big blind) folded on the Flop
Seat 4: TowMadder folded on the Turn
Seat 6: thecheese42099 folded on the Turn
Seat 8: Huckleberry10 (button) collected (350)

Hand #1805: 

PokerStars Hand #246795427174: Tournament #3662938560, $0.94+$0.06 CAD Hold'em No Limit - Level III (30/60) - 2023/10/28 16:11:54 ET
Table '3662938560 1' 8-max Seat #2 is the button
Seat 2: Khab00m (2991 in chips) 
Seat 3: CashMatteo (2867 in chips) 
Seat 4: TowMadder (2782 in chips) 
Seat 6: thecheese42099 (2960 in chips) 
Seat 8: Huckleberry10 (2942 in chips) 
Khab00m: posts the ante 15
CashMatteo: posts the ante 15
TowMadder: posts the ante 15
thecheese42099: posts the ante 15
Huckleberry10: posts the ante 15
CashMatteo: posts small blind 30
TowMadder: posts big blind 60
*** HOLE CARDS ***
Dealt to CashMatteo [3s 8s]
thecheese42099: calls 60
Huckleberry10: calls 60
Khab00m: folds 
CashMatteo: folds 
TowMadder: checks 
*** FLOP *** [3h 3c 2d]
TowMadder: checks 
thecheese42099: checks 
Huckleberry10: checks 
*** TURN *** [3h 3c 2d] [9s]
TowMadder: bets 60
thecheese42099: calls 60
Huckleberry10: folds 
*** RIVER *** [3h 3c 2d 9s] [4c]
TowMadder: bets 203
thecheese42099: folds 
Uncalled bet (203) returned to TowMadder
TowMadder collected 405 from pot
*** SUMMARY ***
Total pot 405 | Rake 0 
Board [3h 3c 2d 9s 4c]
Seat 2: Khab00m (button) folded before Flop (didn't bet)
Seat 3: CashMatteo (small blind) folded before Flop
Seat 4: TowMadder (big blind) collected (405)
Seat 6: thecheese42099 folded on the River
Seat 8: Huckleberry10 folded on the Turn

Hand #1806: 

PokerStars Hand #246795433404:  Hold'em No Limit ($0.10/$0.25 CAD) - 2023/10/28 16:12:12 ET
Table 'Mandeville II' 6-max Seat #4 is the button
Seat 1: CashMatteo ($14.91 in chips) 
Seat 2: InitialHC ($30.49 in chips) 
Seat 4: BeLeery ($11.17 in chips) 
Seat 6: Hammertime1933 ($19.49 in chips) 
Hammertime1933: posts small blind $0.10
CashMatteo: posts big blind $0.25
Tyzk3: sits out 
*** HOLE CARDS ***
Dealt to CashMatteo [4c 2h]
InitialHC: folds 
BeLeery: folds 
Hammertime1933: raises $0.25 to $0.50
CashMatteo: folds 
Uncalled bet ($0.25) returned to Hammertime1933
Hammertime1933 collected $0.50 from pot
*** SUMMARY ***
Total pot $0.50 | Rake $0 
Seat 1: CashMatteo (big blind) folded before Flop
Seat 2: InitialHC folded before Flop (didn't bet)
Seat 4: BeLeery (button) folded before Flop (didn't bet)
Seat 6: Hammertime1933 (small blind) collected ($0.50)

Hand #1807: 

PokerStars Hand #246795438290:  Hold'em No Limit ($0.10/$0.25 CAD) - 2023/10/28 16:12:26 ET
Table 'Mandeville II' 6-max Seat #6 is the button
Seat 1: CashMatteo ($14.66 in chips) 
Seat 2: InitialHC ($30.49 in chips) 
Seat 4: BeLeery ($11.17 in chips) 
Seat 6: Hammertime1933 ($19.74 in chips) 
CashMatteo: posts small blind $0.10
InitialHC: posts big blind $0.25
Tyzk3: sits out 
*** HOLE CARDS ***
Dealt to CashMatteo [5h Kd]
BeLeery: folds 
Hammertime1933: calls $0.25
CashMatteo: calls $0.15
InitialHC: raises $0.75 to $1
Hammertime1933: folds 
CashMatteo: folds 
Uncalled bet ($0.75) returned to InitialHC
InitialHC collected $0.75 from pot
InitialHC: doesn't show hand 
*** SUMMARY ***
Total pot $0.75 | Rake $0 
Seat 1: CashMatteo (small blind) folded before Flop
Seat 2: InitialHC (big blind) collected ($0.75)
Seat 4: BeLeery folded before Flop (didn't bet)
Seat 6: Hammertime1933 (button) folded before Flop

Hand #1808: 

PokerStars Hand #246795438929: Tournament #3662938560, $0.94+$0.06 CAD Hold'em No Limit - Level III (30/60) - 2023/10/28 16:12:28 ET
Table '3662938560 1' 8-max Seat #3 is the button
Seat 2: Khab00m (2976 in chips) 
Seat 3: CashMatteo (2822 in chips) 
Seat 4: TowMadder (3052 in chips) 
Seat 6: thecheese42099 (2825 in chips) 
Seat 8: Huckleberry10 (2867 in chips) 
Khab00m: posts the ante 15
CashMatteo: posts the ante 15
TowMadder: posts the ante 15
thecheese42099: posts the ante 15
Huckleberry10: posts the ante 15
TowMadder: posts small blind 30
thecheese42099: posts big blind 60
*** HOLE CARDS ***
Dealt to CashMatteo [As 2d]
Huckleberry10: folds 
Khab00m: folds 
CashMatteo: calls 60
TowMadder: calls 30
thecheese42099: checks 
*** FLOP *** [5d 2s 8h]
TowMadder: checks 
thecheese42099: checks 
CashMatteo: checks 
*** TURN *** [5d 2s 8h] [4c]
TowMadder: checks 
thecheese42099: checks 
CashMatteo: checks 
*** RIVER *** [5d 2s 8h 4c] [Td]
TowMadder: checks 
thecheese42099: checks 
CashMatteo: checks 
*** SHOW DOWN ***
TowMadder: shows [2h Th] (two pair, Tens and Deuces)
thecheese42099: mucks hand 
CashMatteo: mucks hand 
TowMadder collected 255 from pot
*** SUMMARY ***
Total pot 255 | Rake 0 
Board [5d 2s 8h 4c Td]
Seat 2: Khab00m folded before Flop (didn't bet)
Seat 3: CashMatteo (button) mucked [As 2d]
Seat 4: TowMadder (small blind) showed [2h Th] and won (255) with two pair, Tens and Deuces
Seat 6: thecheese42099 (big blind) mucked [9s 3c]
Seat 8: Huckleberry10 folded before Flop (didn't bet)

Hand #1809: 

PokerStars Hand #246795454421:  Hold'em No Limit ($0.10/$0.25 CAD) - 2023/10/28 16:13:13 ET
Table 'Mandeville II' 6-max Seat #1 is the button
Seat 1: CashMatteo ($14.41 in chips) 
Seat 2: InitialHC ($30.99 in chips) 
Seat 3: Tyzk3 ($25 in chips) 
Seat 4: BeLeery ($11.17 in chips) 
Seat 6: Hammertime1933 ($19.49 in chips) 
InitialHC: posts small blind $0.10
Tyzk3: posts big blind $0.25
*** HOLE CARDS ***
Dealt to CashMatteo [2c Ks]
BeLeery has timed out
BeLeery: folds 
Hammertime1933: folds 
CashMatteo: folds 
InitialHC: raises $0.37 to $0.62
Tyzk3: folds 
Uncalled bet ($0.37) returned to InitialHC
InitialHC collected $0.50 from pot
InitialHC: doesn't show hand 
*** SUMMARY ***
Total pot $0.50 | Rake $0 
Seat 1: CashMatteo (button) folded before Flop (didn't bet)
Seat 2: InitialHC (small blind) collected ($0.50)
Seat 3: Tyzk3 (big blind) folded before Flop
Seat 4: BeLeery folded before Flop (didn't bet)
Seat 6: Hammertime1933 folded before Flop (didn't bet)

Hand #1810: 

PokerStars Hand #246795455288: Tournament #3662938560, $0.94+$0.06 CAD Hold'em No Limit - Level III (30/60) - 2023/10/28 16:13:16 ET
Table '3662938560 1' 8-max Seat #4 is the button
Seat 2: Khab00m (2961 in chips) 
Seat 3: CashMatteo (2747 in chips) 
Seat 4: TowMadder (3232 in chips) 
Seat 6: thecheese42099 (2750 in chips) 
Seat 8: Huckleberry10 (2852 in chips) 
Khab00m: posts the ante 15
CashMatteo: posts the ante 15
TowMadder: posts the ante 15
thecheese42099: posts the ante 15
Huckleberry10: posts the ante 15
thecheese42099: posts small blind 30
Huckleberry10: posts big blind 60
*** HOLE CARDS ***
Dealt to CashMatteo [Qh 5s]
Khab00m: folds 
CashMatteo: calls 60
TowMadder: folds 
thecheese42099: calls 30
Huckleberry10: checks 
*** FLOP *** [8h 4s 8s]
thecheese42099: bets 60
Huckleberry10: folds 
CashMatteo: folds 
Uncalled bet (60) returned to thecheese42099
thecheese42099 collected 255 from pot
*** SUMMARY ***
Total pot 255 | Rake 0 
Board [8h 4s 8s]
Seat 2: Khab00m folded before Flop (didn't bet)
Seat 3: CashMatteo folded on the Flop
Seat 4: TowMadder (button) folded before Flop (didn't bet)
Seat 6: thecheese42099 (small blind) collected (255)
Seat 8: Huckleberry10 (big blind) folded on the Flop

Hand #1811: 

PokerStars Hand #246795462712: Tournament #3662938560, $0.94+$0.06 CAD Hold'em No Limit - Level III (30/60) - 2023/10/28 16:13:38 ET
Table '3662938560 1' 8-max Seat #6 is the button
Seat 2: Khab00m (2946 in chips) 
Seat 3: CashMatteo (2672 in chips) 
Seat 4: TowMadder (3217 in chips) 
Seat 6: thecheese42099 (2930 in chips) 
Seat 8: Huckleberry10 (2777 in chips) 
Khab00m: posts the ante 15
CashMatteo: posts the ante 15
TowMadder: posts the ante 15
thecheese42099: posts the ante 15
Huckleberry10: posts the ante 15
Huckleberry10: posts small blind 30
Khab00m: posts big blind 60
*** HOLE CARDS ***
Dealt to CashMatteo [6s 4s]
CashMatteo: calls 60
TowMadder: folds 
thecheese42099: folds 
Huckleberry10: calls 30
Khab00m: checks 
*** FLOP *** [9h 6d 8s]
Huckleberry10: bets 255
Khab00m: calls 255
CashMatteo: folds 
*** TURN *** [9h 6d 8s] [Ah]
Huckleberry10: checks 
Khab00m: bets 383
Huckleberry10: calls 383
*** RIVER *** [9h 6d 8s Ah] [4h]
Huckleberry10: checks 
Khab00m: bets 1531
Huckleberry10: folds 
Uncalled bet (1531) returned to Khab00m
Khab00m collected 1531 from pot
Khab00m: doesn't show hand 
*** SUMMARY ***
Total pot 1531 | Rake 0 
Board [9h 6d 8s Ah 4h]
Seat 2: Khab00m (big blind) collected (1531)
Seat 3: CashMatteo folded on the Flop
Seat 4: TowMadder folded before Flop (didn't bet)
Seat 6: thecheese42099 (button) folded before Flop (didn't bet)
Seat 8: Huckleberry10 (small blind) folded on the River

Hand #1812: 

PokerStars Hand #246795463096:  Hold'em No Limit ($0.10/$0.25 CAD) - 2023/10/28 16:13:39 ET
Table 'Mandeville II' 6-max Seat #2 is the button
Seat 1: CashMatteo ($14.41 in chips) 
Seat 2: InitialHC ($31.24 in chips) 
Seat 3: Tyzk3 ($25 in chips) 
Seat 4: BeLeery ($11.17 in chips) 
Seat 6: Hammertime1933 ($19.49 in chips) 
Tyzk3: posts small blind $0.10
BeLeery: posts big blind $0.25
*** HOLE CARDS ***
Dealt to CashMatteo [Qs 6c]
Hammertime1933: folds 
CashMatteo: folds 
InitialHC: folds 
Tyzk3: folds 
Uncalled bet ($0.15) returned to BeLeery
BeLeery collected $0.20 from pot
BeLeery: doesn't show hand 
*** SUMMARY ***
Total pot $0.20 | Rake $0 
Seat 1: CashMatteo folded before Flop (didn't bet)
Seat 2: InitialHC (button) folded before Flop (didn't bet)
Seat 3: Tyzk3 (small blind) folded before Flop
Seat 4: BeLeery (big blind) collected ($0.20)
Seat 6: Hammertime1933 folded before Flop (didn't bet)

Hand #1813: 

PokerStars Hand #246795470111:  Hold'em No Limit ($0.10/$0.25 CAD) - 2023/10/28 16:13:59 ET
Table 'Mandeville II' 6-max Seat #3 is the button
Seat 1: CashMatteo ($14.41 in chips) 
Seat 2: InitialHC ($31.24 in chips) 
Seat 3: Tyzk3 ($25 in chips) 
Seat 4: BeLeery ($11.27 in chips) 
Seat 6: Hammertime1933 ($19.49 in chips) 
BeLeery: posts small blind $0.10
Hammertime1933: posts big blind $0.25
*** HOLE CARDS ***
Dealt to CashMatteo [5d 3c]
CashMatteo: folds 
InitialHC: folds 
Tyzk3: raises $0.37 to $0.62
BeLeery: calls $0.52
Hammertime1933: calls $0.37
*** FLOP *** [9c 6h 5s]
BeLeery: checks 
Hammertime1933: checks 
Tyzk3: checks 
*** TURN *** [9c 6h 5s] [Ts]
BeLeery: bets $1.14
Hammertime1933: calls $1.14
Tyzk3: folds 
*** RIVER *** [9c 6h 5s Ts] [Jc]
BeLeery: bets $1.98
Hammertime1933: folds 
Uncalled bet ($1.98) returned to BeLeery
BeLeery collected $3.95 from pot
BeLeery: doesn't show hand 
*** SUMMARY ***
Total pot $4.14 | Rake $0.19 
Board [9c 6h 5s Ts Jc]
Seat 1: CashMatteo folded before Flop (didn't bet)
Seat 2: InitialHC folded before Flop (didn't bet)
Seat 3: Tyzk3 (button) folded on the Turn
Seat 4: BeLeery (small blind) collected ($3.95)
Seat 6: Hammertime1933 (big blind) folded on the River

Hand #1814: 

PokerStars Hand #246795475603: Tournament #3662938560, $0.94+$0.06 CAD Hold'em No Limit - Level IV (40/80) - 2023/10/28 16:14:15 ET
Table '3662938560 1' 8-max Seat #8 is the button
Seat 2: Khab00m (3764 in chips) 
Seat 3: CashMatteo (2597 in chips) 
Seat 4: TowMadder (3202 in chips) 
Seat 6: thecheese42099 (2915 in chips) 
Seat 8: Huckleberry10 (2064 in chips) 
Khab00m: posts the ante 20
CashMatteo: posts the ante 20
TowMadder: posts the ante 20
thecheese42099: posts the ante 20
Huckleberry10: posts the ante 20
Khab00m: posts small blind 40
CashMatteo: posts big blind 80
*** HOLE CARDS ***
Dealt to CashMatteo [4d Ah]
TowMadder: folds 
thecheese42099: raises 160 to 240
Huckleberry10: folds 
Khab00m: folds 
CashMatteo: calls 160
*** FLOP *** [5h 9h 2h]
CashMatteo: checks 
thecheese42099: bets 320
CashMatteo: calls 320
*** TURN *** [5h 9h 2h] [3c]
CashMatteo: checks 
thecheese42099: checks 
*** RIVER *** [5h 9h 2h 3c] [2d]
CashMatteo: bets 1260
thecheese42099: folds 
Uncalled bet (1260) returned to CashMatteo
CashMatteo collected 1260 from pot
CashMatteo: doesn't show hand 
*** SUMMARY ***
Total pot 1260 | Rake 0 
Board [5h 9h 2h 3c 2d]
Seat 2: Khab00m (small blind) folded before Flop
Seat 3: CashMatteo (big blind) collected (1260)
Seat 4: TowMadder folded before Flop (didn't bet)
Seat 6: thecheese42099 folded on the River
Seat 8: Huckleberry10 (button) folded before Flop (didn't bet)

Hand #1815: 

PokerStars Hand #246795495855:  Hold'em No Limit ($0.10/$0.25 CAD) - 2023/10/28 16:15:13 ET
Table 'Mandeville II' 6-max Seat #4 is the button
Seat 1: CashMatteo ($14.41 in chips) 
Seat 2: InitialHC ($31.24 in chips) 
Seat 3: Tyzk3 ($25 in chips) 
Seat 4: BeLeery ($13.46 in chips) 
Seat 6: Hammertime1933 ($17.73 in chips) 
Hammertime1933: posts small blind $0.10
CashMatteo: posts big blind $0.25
*** HOLE CARDS ***
Dealt to CashMatteo [Ks Jc]
InitialHC: folds 
Tyzk3: folds 
BeLeery: folds 
Hammertime1933: folds 
Uncalled bet ($0.15) returned to CashMatteo
CashMatteo collected $0.20 from pot
CashMatteo: doesn't show hand 
*** SUMMARY ***
Total pot $0.20 | Rake $0 
Seat 1: CashMatteo (big blind) collected ($0.20)
Seat 2: InitialHC folded before Flop (didn't bet)
Seat 3: Tyzk3 folded before Flop (didn't bet)
Seat 4: BeLeery (button) folded before Flop (didn't bet)
Seat 6: Hammertime1933 (small blind) folded before Flop

Hand #1816: 

PokerStars Hand #246795499550: Tournament #3662938560, $0.94+$0.06 CAD Hold'em No Limit - Level IV (40/80) - 2023/10/28 16:15:24 ET
Table '3662938560 1' 8-max Seat #2 is the button
Seat 1: thx4folding (3000 in chips) 
Seat 2: Khab00m (3704 in chips) 
Seat 3: CashMatteo (3277 in chips) 
Seat 4: TowMadder (3182 in chips) 
Seat 6: thecheese42099 (2335 in chips) 
Seat 8: Huckleberry10 (2044 in chips) 
thx4folding: posts the ante 20
Khab00m: posts the ante 20
CashMatteo: posts the ante 20
TowMadder: posts the ante 20
thecheese42099: posts the ante 20
Huckleberry10: posts the ante 20
CashMatteo: posts small blind 40
TowMadder: posts big blind 80
*** HOLE CARDS ***
Dealt to CashMatteo [2s 6c]
thecheese42099: folds 
Huckleberry10: raises 640 to 720
thx4folding: folds 
Khab00m: folds 
CashMatteo: folds 
TowMadder: folds 
Uncalled bet (640) returned to Huckleberry10
Huckleberry10 collected 320 from pot
*** SUMMARY ***
Total pot 320 | Rake 0 
Seat 1: thx4folding folded before Flop (didn't bet)
Seat 2: Khab00m (button) folded before Flop (didn't bet)
Seat 3: CashMatteo (small blind) folded before Flop
Seat 4: TowMadder (big blind) folded before Flop
Seat 6: thecheese42099 folded before Flop (didn't bet)
Seat 8: Huckleberry10 collected (320)

Hand #1817: 

PokerStars Hand #246795500796:  Hold'em No Limit ($0.10/$0.25 CAD) - 2023/10/28 16:15:28 ET
Table 'Mandeville II' 6-max Seat #6 is the button
Seat 1: CashMatteo ($14.51 in chips) 
Seat 2: InitialHC ($31.24 in chips) 
Seat 3: Tyzk3 ($25 in chips) 
Seat 4: BeLeery ($13.46 in chips) 
Seat 6: Hammertime1933 ($17.63 in chips) 
CashMatteo: posts small blind $0.10
InitialHC: posts big blind $0.25
*** HOLE CARDS ***
Dealt to CashMatteo [Qs 9d]
Tyzk3: folds 
BeLeery: raises $0.25 to $0.50
Hammertime1933: folds 
CashMatteo: folds 
InitialHC: calls $0.25
*** FLOP *** [8s 5s As]
InitialHC: checks 
BeLeery: checks 
*** TURN *** [8s 5s As] [Kd]
InitialHC: bets $0.84
BeLeery: calls $0.84
*** RIVER *** [8s 5s As Kd] [Kh]
InitialHC: bets $2.12
BeLeery: raises $6.89 to $9.01
InitialHC: calls $6.89
*** SHOW DOWN ***
BeLeery: shows [Kc 2c] (three of a kind, Kings)
InitialHC: shows [5d 5c] (a full house, Fives full of Kings)
InitialHC collected $19.86 from pot
*** SUMMARY ***
Total pot $20.80 | Rake $0.94 
Board [8s 5s As Kd Kh]
Seat 1: CashMatteo (small blind) folded before Flop
Seat 2: InitialHC (big blind) showed [5d 5c] and won ($19.86) with a full house, Fives full of Kings
Seat 3: Tyzk3 folded before Flop (didn't bet)
Seat 4: BeLeery showed [Kc 2c] and lost with three of a kind, Kings
Seat 6: Hammertime1933 (button) folded before Flop (didn't bet)

Hand #1818: 

PokerStars Hand #246795507632: Tournament #3662938560, $0.94+$0.06 CAD Hold'em No Limit - Level IV (40/80) - 2023/10/28 16:15:47 ET
Table '3662938560 1' 8-max Seat #3 is the button
Seat 1: thx4folding (2980 in chips) 
Seat 2: Khab00m (3684 in chips) 
Seat 3: CashMatteo (3217 in chips) 
Seat 4: TowMadder (3082 in chips) 
Seat 6: thecheese42099 (2315 in chips) 
Seat 8: Huckleberry10 (2264 in chips) 
thx4folding: posts the ante 20
Khab00m: posts the ante 20
CashMatteo: posts the ante 20
TowMadder: posts the ante 20
thecheese42099: posts the ante 20
Huckleberry10: posts the ante 20
TowMadder: posts small blind 40
thecheese42099: posts big blind 80
*** HOLE CARDS ***
Dealt to CashMatteo [Kh Qc]
Huckleberry10: folds 
thx4folding: folds 
Khab00m: folds 
CashMatteo: raises 120 to 200
TowMadder: calls 160
thecheese42099: calls 120
*** FLOP *** [8h 6c Ac]
TowMadder: checks 
thecheese42099: checks 
CashMatteo: bets 360
TowMadder: calls 360
thecheese42099: folds 
*** TURN *** [8h 6c Ac] [9h]
TowMadder: checks 
CashMatteo: checks 
*** RIVER *** [8h 6c Ac 9h] [8d]
TowMadder: checks 
CashMatteo: checks 
*** SHOW DOWN ***
TowMadder: shows [5s As] (two pair, Aces and Eights)
CashMatteo: mucks hand 
TowMadder collected 1440 from pot
*** SUMMARY ***
Total pot 1440 | Rake 0 
Board [8h 6c Ac 9h 8d]
Seat 1: thx4folding folded before Flop (didn't bet)
Seat 2: Khab00m folded before Flop (didn't bet)
Seat 3: CashMatteo (button) mucked [Kh Qc]
Seat 4: TowMadder (small blind) showed [5s As] and won (1440) with two pair, Aces and Eights
Seat 6: thecheese42099 (big blind) folded on the Flop
Seat 8: Huckleberry10 folded before Flop (didn't bet)

Hand #1819: 

PokerStars Hand #246795516738:  Hold'em No Limit ($0.10/$0.25 CAD) - 2023/10/28 16:16:14 ET
Table 'Mandeville II' 6-max Seat #1 is the button
Seat 1: CashMatteo ($14.41 in chips) 
Seat 2: InitialHC ($40.75 in chips) 
Seat 3: Tyzk3 ($25 in chips) 
Seat 4: BeLeery ($3.11 in chips) 
Seat 6: Hammertime1933 ($17.63 in chips) 
InitialHC: posts small blind $0.10
Tyzk3: posts big blind $0.25
*** HOLE CARDS ***
Dealt to CashMatteo [Qd 5s]
BeLeery: raises $0.25 to $0.50
Hammertime1933: calls $0.50
CashMatteo: folds 
InitialHC: folds 
Tyzk3: calls $0.25
*** FLOP *** [2d Jd 6d]
Tyzk3: checks 
BeLeery: bets $1.53
Hammertime1933: calls $1.53
Tyzk3: folds 
*** TURN *** [2d Jd 6d] [4d]
BeLeery: checks 
Hammertime1933: bets $1.98
BeLeery: calls $1.08 and is all-in
Uncalled bet ($0.90) returned to Hammertime1933
*** RIVER *** [2d Jd 6d 4d] [3d]
*** SHOW DOWN ***
BeLeery: shows [2c Ks] (a flush, Jack high)
Hammertime1933: shows [Ac 9d] (a flush, Jack high - Nine higher)
Hammertime1933 collected $6.51 from pot
*** SUMMARY ***
Total pot $6.82 | Rake $0.31 
Board [2d Jd 6d 4d 3d]
Seat 1: CashMatteo (button) folded before Flop (didn't bet)
Seat 2: InitialHC (small blind) folded before Flop
Seat 3: Tyzk3 (big blind) folded on the Flop
Seat 4: BeLeery showed [2c Ks] and lost with a flush, Jack high
Seat 6: Hammertime1933 showed [Ac 9d] and won ($6.51) with a flush, Jack high

Hand #1820: 

PokerStars Hand #246795525020: Tournament #3662938560, $0.94+$0.06 CAD Hold'em No Limit - Level IV (40/80) - 2023/10/28 16:16:37 ET
Table '3662938560 1' 8-max Seat #4 is the button
Seat 1: thx4folding (2960 in chips) 
Seat 2: Khab00m (3664 in chips) 
Seat 3: CashMatteo (2637 in chips) 
Seat 4: TowMadder (3942 in chips) 
Seat 6: thecheese42099 (2095 in chips) 
Seat 8: Huckleberry10 (2244 in chips) 
thx4folding: posts the ante 20
Khab00m: posts the ante 20
CashMatteo: posts the ante 20
TowMadder: posts the ante 20
thecheese42099: posts the ante 20
Huckleberry10: posts the ante 20
thecheese42099: posts small blind 40
Huckleberry10: posts big blind 80
*** HOLE CARDS ***
Dealt to CashMatteo [As Tc]
thx4folding: folds 
Khab00m: folds 
CashMatteo: calls 80
TowMadder: calls 80
thecheese42099: raises 240 to 320
Huckleberry10: folds 
CashMatteo: calls 240
TowMadder: folds 
*** FLOP *** [Kh Qc 3s]
thecheese42099: bets 1755 and is all-in
CashMatteo: folds 
Uncalled bet (1755) returned to thecheese42099
thecheese42099 collected 920 from pot
*** SUMMARY ***
Total pot 920 | Rake 0 
Board [Kh Qc 3s]
Seat 1: thx4folding folded before Flop (didn't bet)
Seat 2: Khab00m folded before Flop (didn't bet)
Seat 3: CashMatteo folded on the Flop
Seat 4: TowMadder (button) folded before Flop
Seat 6: thecheese42099 (small blind) collected (920)
Seat 8: Huckleberry10 (big blind) folded before Flop

Hand #1821: 

PokerStars Hand #246795532830:  Hold'em No Limit ($0.10/$0.25 CAD) - 2023/10/28 16:17:00 ET
Table 'Mandeville II' 6-max Seat #2 is the button
Seat 1: CashMatteo ($14.41 in chips) 
Seat 2: InitialHC ($40.65 in chips) 
Seat 3: Tyzk3 ($25 in chips) 
Seat 6: Hammertime1933 ($21.03 in chips) 
Tyzk3: posts small blind $0.10
Hammertime1933: posts big blind $0.25
*** HOLE CARDS ***
Dealt to CashMatteo [3h Kc]
CashMatteo: folds 
InitialHC: folds 
Tyzk3: folds 
Uncalled bet ($0.15) returned to Hammertime1933
Hammertime1933 collected $0.20 from pot
n01shome was removed from the table for failing to post
n01shome leaves the table
*** SUMMARY ***
Total pot $0.20 | Rake $0 
Seat 1: CashMatteo folded before Flop (didn't bet)
Seat 2: InitialHC (button) folded before Flop (didn't bet)
Seat 3: Tyzk3 (small blind) folded before Flop
Seat 6: Hammertime1933 (big blind) collected ($0.20)

Hand #1822: 

PokerStars Hand #246795535896:  Hold'em No Limit ($0.10/$0.25 CAD) - 2023/10/28 16:17:09 ET
Table 'Mandeville II' 6-max Seat #3 is the button
Seat 1: CashMatteo ($14.41 in chips) 
Seat 2: InitialHC ($40.65 in chips) 
Seat 3: Tyzk3 ($25 in chips) 
Seat 6: Hammertime1933 ($21.13 in chips) 
BeLeery will be allowed to play after the button
Hammertime1933: posts small blind $0.10
CashMatteo: posts big blind $0.25
*** HOLE CARDS ***
Dealt to CashMatteo [Ac 9c]
InitialHC: folds 
Tyzk3: raises $0.37 to $0.62
Hammertime1933: raises $1.49 to $2.11
BeLeery leaves the table
CashMatteo: folds 
Tyzk3: folds 
Uncalled bet ($1.49) returned to Hammertime1933
Hammertime1933 collected $1.49 from pot
*** SUMMARY ***
Total pot $1.49 | Rake $0 
Seat 1: CashMatteo (big blind) folded before Flop
Seat 2: InitialHC folded before Flop (didn't bet)
Seat 3: Tyzk3 (button) folded before Flop
Seat 6: Hammertime1933 (small blind) collected ($1.49)

Hand #1823: 

PokerStars Hand #246795541581: Tournament #3662938560, $0.94+$0.06 CAD Hold'em No Limit - Level V (50/100) - 2023/10/28 16:17:25 ET
Table '3662938560 1' 8-max Seat #6 is the button
Seat 1: thx4folding (2940 in chips) 
Seat 2: Khab00m (3644 in chips) 
Seat 3: CashMatteo (2297 in chips) 
Seat 4: TowMadder (3842 in chips) 
Seat 6: thecheese42099 (2675 in chips) 
Seat 8: Huckleberry10 (2144 in chips) 
thx4folding: posts the ante 25
Khab00m: posts the ante 25
CashMatteo: posts the ante 25
TowMadder: posts the ante 25
thecheese42099: posts the ante 25
Huckleberry10: posts the ante 25
Huckleberry10: posts small blind 50
thx4folding: posts big blind 100
*** HOLE CARDS ***
Dealt to CashMatteo [6s 8s]
Khab00m: folds 
CashMatteo: folds 
TowMadder: folds 
thecheese42099: raises 300 to 400
Huckleberry10: folds 
thx4folding: folds 
Uncalled bet (300) returned to thecheese42099
thecheese42099 collected 400 from pot
*** SUMMARY ***
Total pot 400 | Rake 0 
Seat 1: thx4folding (big blind) folded before Flop
Seat 2: Khab00m folded before Flop (didn't bet)
Seat 3: CashMatteo folded before Flop (didn't bet)
Seat 4: TowMadder folded before Flop (didn't bet)
Seat 6: thecheese42099 (button) collected (400)
Seat 8: Huckleberry10 (small blind) folded before Flop

Hand #1824: 

PokerStars Hand #246795543983:  Hold'em No Limit ($0.10/$0.25 CAD) - 2023/10/28 16:17:32 ET
Table 'Mandeville II' 6-max Seat #6 is the button
Seat 1: CashMatteo ($14.16 in chips) 
Seat 2: InitialHC ($40.65 in chips) 
Seat 3: Tyzk3 ($25 in chips) 
Seat 6: Hammertime1933 ($22 in chips) 
CashMatteo: posts small blind $0.10
InitialHC: posts big blind $0.25
*** HOLE CARDS ***
Dealt to CashMatteo [2s 8d]
Tyzk3: raises $0.37 to $0.62
Hammertime1933: folds 
CashMatteo: folds 
InitialHC: folds 
Uncalled bet ($0.37) returned to Tyzk3
Tyzk3 collected $0.60 from pot
Tyzk3: doesn't show hand 
*** SUMMARY ***
Total pot $0.60 | Rake $0 
Seat 1: CashMatteo (small blind) folded before Flop
Seat 2: InitialHC (big blind) folded before Flop
Seat 3: Tyzk3 collected ($0.60)
Seat 6: Hammertime1933 (button) folded before Flop (didn't bet)

Hand #1825: 

PokerStars Hand #246795548067: Tournament #3662938560, $0.94+$0.06 CAD Hold'em No Limit - Level V (50/100) - 2023/10/28 16:17:43 ET
Table '3662938560 1' 8-max Seat #8 is the button
Seat 1: thx4folding (2815 in chips) 
Seat 2: Khab00m (3619 in chips) 
Seat 3: CashMatteo (2272 in chips) 
Seat 4: TowMadder (3817 in chips) 
Seat 6: thecheese42099 (2950 in chips) 
Seat 8: Huckleberry10 (2069 in chips) 
thx4folding: posts the ante 25
Khab00m: posts the ante 25
CashMatteo: posts the ante 25
TowMadder: posts the ante 25
thecheese42099: posts the ante 25
Huckleberry10: posts the ante 25
thx4folding: posts small blind 50
Khab00m: posts big blind 100
*** HOLE CARDS ***
Dealt to CashMatteo [Kd Ah]
CashMatteo: raises 150 to 250
TowMadder: folds 
thecheese42099: raises 450 to 700
Huckleberry10: folds 
thx4folding: folds 
Khab00m: calls 600
CashMatteo: raises 1547 to 2247 and is all-in
thecheese42099: raises 678 to 2925 and is all-in
Khab00m: calls 2225
*** FLOP *** [Qd Ts 5h]
*** TURN *** [Qd Ts 5h] [8d]
*** RIVER *** [Qd Ts 5h 8d] [Jc]
*** SHOW DOWN ***
Khab00m: shows [7d 7s] (a pair of Sevens)
thecheese42099: shows [Ad Ks] (a straight, Ten to Ace)
thecheese42099 collected 1356 from side pot
CashMatteo: shows [Kd Ah] (a straight, Ten to Ace)
CashMatteo collected 3471 from main pot
thecheese42099 collected 3470 from main pot
*** SUMMARY ***
Total pot 8297 Main pot 6941. Side pot 1356. | Rake 0 
Board [Qd Ts 5h 8d Jc]
Seat 1: thx4folding (small blind) folded before Flop
Seat 2: Khab00m (big blind) showed [7d 7s] and lost with a pair of Sevens
Seat 3: CashMatteo showed [Kd Ah] and won (3471) with a straight, Ten to Ace
Seat 4: TowMadder folded before Flop (didn't bet)
Seat 6: thecheese42099 showed [Ad Ks] and won (4826) with a straight, Ten to Ace
Seat 8: Huckleberry10 (button) folded before Flop (didn't bet)

Hand #1826: 

PokerStars Hand #246795548934:  Hold'em No Limit ($0.10/$0.25 CAD) - 2023/10/28 16:17:46 ET
Table 'Mandeville II' 6-max Seat #1 is the button
Seat 1: CashMatteo ($14.06 in chips) 
Seat 2: InitialHC ($40.40 in chips) 
Seat 6: Hammertime1933 ($22 in chips) 
InitialHC: posts small blind $0.10
Tyzk3: is sitting out 
Hammertime1933: posts big blind $0.25
*** HOLE CARDS ***
Dealt to CashMatteo [Ac 2h]
Tyzk3 leaves the table
CashMatteo: calls $0.25
InitialHC: raises $0.75 to $1
Hammertime1933: folds 
CashMatteo: calls $0.75
*** FLOP *** [Tc Qs Qd]
InitialHC: bets $1.08
CashMatteo: folds 
Uncalled bet ($1.08) returned to InitialHC
InitialHC collected $2.15 from pot
InitialHC: doesn't show hand 
*** SUMMARY ***
Total pot $2.25 | Rake $0.10 
Board [Tc Qs Qd]
Seat 1: CashMatteo (button) folded on the Flop
Seat 2: InitialHC (small blind) collected ($2.15)
Seat 6: Hammertime1933 (big blind) folded before Flop

Hand #1827: 

PokerStars Hand #246795557600: Tournament #3662938560, $0.94+$0.06 CAD Hold'em No Limit - Level V (50/100) - 2023/10/28 16:18:11 ET
Table '3662938560 1' 8-max Seat #1 is the button
Seat 1: thx4folding (2740 in chips) 
Seat 2: Khab00m (669 in chips) 
Seat 3: CashMatteo (3471 in chips) 
Seat 4: TowMadder (3792 in chips) 
Seat 5: TheGrinch1991 (3000 in chips) 
Seat 6: thecheese42099 (4826 in chips) 
Seat 8: Huckleberry10 (2044 in chips) 
thx4folding: posts the ante 25
Khab00m: posts the ante 25
CashMatteo: posts the ante 25
TowMadder: posts the ante 25
TheGrinch1991: posts the ante 25
thecheese42099: posts the ante 25
Huckleberry10: posts the ante 25
Khab00m: posts small blind 50
CashMatteo: posts big blind 100
*** HOLE CARDS ***
Dealt to CashMatteo [5d 2d]
TowMadder: folds 
TheGrinch1991: calls 100
thecheese42099: folds 
Huckleberry10: folds 
thx4folding: folds 
Khab00m: raises 544 to 644 and is all-in
CashMatteo: folds 
TheGrinch1991: calls 544
*** FLOP *** [6s Qd 3s]
*** TURN *** [6s Qd 3s] [Th]
*** RIVER *** [6s Qd 3s Th] [8h]
*** SHOW DOWN ***
Khab00m: shows [9s As] (high card Ace)
TheGrinch1991: shows [Ac Tc] (a pair of Tens)
TheGrinch1991 collected 1563 from pot
Khab00m finished the tournament in 31st place
*** SUMMARY ***
Total pot 1563 | Rake 0 
Board [6s Qd 3s Th 8h]
Seat 1: thx4folding (button) folded before Flop (didn't bet)
Seat 2: Khab00m (small blind) showed [9s As] and lost with high card Ace
Seat 3: CashMatteo (big blind) folded before Flop
Seat 4: TowMadder folded before Flop (didn't bet)
Seat 5: TheGrinch1991 showed [Ac Tc] and won (1563) with a pair of Tens
Seat 6: thecheese42099 folded before Flop (didn't bet)
Seat 8: Huckleberry10 folded before Flop (didn't bet)

Hand #1828: 

PokerStars Hand #246795560002:  Hold'em No Limit ($0.10/$0.25 CAD) - 2023/10/28 16:18:18 ET
Table 'Mandeville II' 6-max Seat #2 is the button
Seat 1: CashMatteo ($13.06 in chips) 
Seat 2: InitialHC ($41.55 in chips) 
Seat 6: Hammertime1933 ($21.75 in chips) 
Hammertime1933: posts small blind $0.10
CashMatteo: posts big blind $0.25
*** HOLE CARDS ***
Dealt to CashMatteo [8c Th]
InitialHC: folds 
Hammertime1933: folds 
Uncalled bet ($0.15) returned to CashMatteo
CashMatteo collected $0.20 from pot
CashMatteo: doesn't show hand 
*** SUMMARY ***
Total pot $0.20 | Rake $0 
Seat 1: CashMatteo (big blind) collected ($0.20)
Seat 2: InitialHC (button) folded before Flop (didn't bet)
Seat 6: Hammertime1933 (small blind) folded before Flop

Hand #1829: 

PokerStars Hand #246795563047:  Hold'em No Limit ($0.10/$0.25 CAD) - 2023/10/28 16:18:27 ET
Table 'Mandeville II' 6-max Seat #6 is the button
Seat 1: CashMatteo ($13.16 in chips) 
Seat 2: InitialHC ($41.55 in chips) 
Seat 6: Hammertime1933 ($21.65 in chips) 
CashMatteo: posts small blind $0.10
InitialHC: posts big blind $0.25
*** HOLE CARDS ***
Dealt to CashMatteo [3s Ah]
Hammertime1933: folds 
CashMatteo: raises $0.37 to $0.62
InitialHC: folds 
Uncalled bet ($0.37) returned to CashMatteo
CashMatteo collected $0.50 from pot
CashMatteo: doesn't show hand 
*** SUMMARY ***
Total pot $0.50 | Rake $0 
Seat 1: CashMatteo (small blind) collected ($0.50)
Seat 2: InitialHC (big blind) folded before Flop
Seat 6: Hammertime1933 (button) folded before Flop (didn't bet)

Hand #1830: 

PokerStars Hand #246795566423: Tournament #3662938560, $0.94+$0.06 CAD Hold'em No Limit - Level V (50/100) - 2023/10/28 16:18:37 ET
Table '3662938560 1' 8-max Seat #3 is the button
Seat 1: thx4folding (2715 in chips) 
Seat 3: CashMatteo (3346 in chips) 
Seat 4: TowMadder (3767 in chips) 
Seat 5: TheGrinch1991 (3894 in chips) 
Seat 6: thecheese42099 (4801 in chips) 
Seat 8: Huckleberry10 (2019 in chips) 
thx4folding: posts the ante 25
CashMatteo: posts the ante 25
TowMadder: posts the ante 25
TheGrinch1991: posts the ante 25
thecheese42099: posts the ante 25
Huckleberry10: posts the ante 25
TowMadder: posts small blind 50
TheGrinch1991: posts big blind 100
*** HOLE CARDS ***
Dealt to CashMatteo [Ah 9s]
thecheese42099: raises 300 to 400
Huckleberry10: calls 400
thx4folding: folds 
Khab00m is disconnected 
CashMatteo: folds 
TowMadder: folds 
TheGrinch1991: folds 
*** FLOP *** [3d Kd 6s]
thecheese42099: bets 4376 and is all-in
Huckleberry10: folds 
Uncalled bet (4376) returned to thecheese42099
thecheese42099 collected 1100 from pot
*** SUMMARY ***
Total pot 1100 | Rake 0 
Board [3d Kd 6s]
Seat 1: thx4folding folded before Flop (didn't bet)
Seat 3: CashMatteo (button) folded before Flop (didn't bet)
Seat 4: TowMadder (small blind) folded before Flop
Seat 5: TheGrinch1991 (big blind) folded before Flop
Seat 6: thecheese42099 collected (1100)
Seat 8: Huckleberry10 folded on the Flop

Hand #1831: 

PokerStars Hand #246795566953:  Hold'em No Limit ($0.10/$0.25 CAD) - 2023/10/28 16:18:38 ET
Table 'Mandeville II' 6-max Seat #1 is the button
Seat 1: CashMatteo ($13.41 in chips) 
Seat 2: InitialHC ($41.30 in chips) 
Seat 6: Hammertime1933 ($21.65 in chips) 
InitialHC: posts small blind $0.10
Hammertime1933: posts big blind $0.25
*** HOLE CARDS ***
Dealt to CashMatteo [9s 6c]
CashMatteo: raises $0.37 to $0.62
InitialHC: folds 
Hammertime1933: folds 
Uncalled bet ($0.37) returned to CashMatteo
CashMatteo collected $0.60 from pot
CashMatteo: doesn't show hand 
*** SUMMARY ***
Total pot $0.60 | Rake $0 
Seat 1: CashMatteo (button) collected ($0.60)
Seat 2: InitialHC (small blind) folded before Flop
Seat 6: Hammertime1933 (big blind) folded before Flop

Hand #1832: 

PokerStars Hand #246795570083:  Hold'em No Limit ($0.10/$0.25 CAD) - 2023/10/28 16:18:47 ET
Table 'Mandeville II' 6-max Seat #2 is the button
Seat 1: CashMatteo ($13.76 in chips) 
Seat 2: InitialHC ($41.20 in chips) 
Seat 6: Hammertime1933 ($21.40 in chips) 
Hammertime1933: posts small blind $0.10
CashMatteo: posts big blind $0.25
*** HOLE CARDS ***
Dealt to CashMatteo [Ac Jc]
InitialHC: folds 
Hammertime1933: raises $0.25 to $0.50
CashMatteo: raises $1.25 to $1.75
Hammertime1933: calls $1.25
*** FLOP *** [Ts Td 5c]
Hammertime1933: checks 
CashMatteo: bets $1.67
Hammertime1933: folds 
Uncalled bet ($1.67) returned to CashMatteo
CashMatteo collected $3.34 from pot
CashMatteo: doesn't show hand 
*** SUMMARY ***
Total pot $3.50 | Rake $0.16 
Board [Ts Td 5c]
Seat 1: CashMatteo (big blind) collected ($3.34)
Seat 2: InitialHC (button) folded before Flop (didn't bet)
Seat 6: Hammertime1933 (small blind) folded on the Flop

Hand #1833: 

PokerStars Hand #246795575947: Tournament #3662938560, $0.94+$0.06 CAD Hold'em No Limit - Level V (50/100) - 2023/10/28 16:19:04 ET
Table '3662938560 1' 8-max Seat #4 is the button
Seat 1: thx4folding (2690 in chips) 
Seat 3: CashMatteo (3321 in chips) 
Seat 4: TowMadder (3692 in chips) 
Seat 5: TheGrinch1991 (3769 in chips) 
Seat 6: thecheese42099 (5476 in chips) 
Seat 7: Khab00m (3000 in chips) 
Seat 8: Huckleberry10 (1594 in chips) 
thx4folding: posts the ante 25
CashMatteo: posts the ante 25
TowMadder: posts the ante 25
TheGrinch1991: posts the ante 25
thecheese42099: posts the ante 25
Khab00m: posts the ante 25
Huckleberry10: posts the ante 25
TheGrinch1991: posts small blind 50
thecheese42099: posts big blind 100
*** HOLE CARDS ***
Dealt to CashMatteo [3c 8d]
Khab00m: folds 
Huckleberry10: calls 100
thx4folding: folds 
CashMatteo: folds 
TowMadder: calls 100
TheGrinch1991: calls 50
thecheese42099: checks 
*** FLOP *** [3s 6c 2c]
TheGrinch1991: checks 
thecheese42099: checks 
Huckleberry10: checks 
TowMadder: checks 
*** TURN *** [3s 6c 2c] [Jd]
TheGrinch1991: checks 
thecheese42099: bets 100
Huckleberry10: calls 100
TowMadder: calls 100
TheGrinch1991: calls 100
*** RIVER *** [3s 6c 2c Jd] [Qc]
TheGrinch1991: checks 
thecheese42099: checks 
Huckleberry10: checks 
TowMadder: bets 488
TheGrinch1991: folds 
thecheese42099: raises 988 to 1476
Huckleberry10: folds 
TowMadder: calls 988
*** SHOW DOWN ***
thecheese42099: shows [7h Qh] (a pair of Queens)
TowMadder: shows [7c Kc] (a flush, King high)
TowMadder collected 3927 from pot
*** SUMMARY ***
Total pot 3927 | Rake 0 
Board [3s 6c 2c Jd Qc]
Seat 1: thx4folding folded before Flop (didn't bet)
Seat 3: CashMatteo folded before Flop (didn't bet)
Seat 4: TowMadder (button) showed [7c Kc] and won (3927) with a flush, King high
Seat 5: TheGrinch1991 (small blind) folded on the River
Seat 6: thecheese42099 (big blind) showed [7h Qh] and lost with a pair of Queens
Seat 7: Khab00m folded before Flop (didn't bet)
Seat 8: Huckleberry10 folded on the River

Hand #1834: 

PokerStars Hand #246795578987:  Hold'em No Limit ($0.10/$0.25 CAD) - 2023/10/28 16:19:13 ET
Table 'Mandeville II' 6-max Seat #6 is the button
Seat 1: CashMatteo ($15.35 in chips) 
Seat 2: InitialHC ($41.20 in chips) 
Seat 6: Hammertime1933 ($19.65 in chips) 
CashMatteo: posts small blind $0.10
InitialHC: posts big blind $0.25
*** HOLE CARDS ***
Dealt to CashMatteo [4h Ah]
Hammertime1933: folds 
CashMatteo: raises $0.37 to $0.62
InitialHC: folds 
Uncalled bet ($0.37) returned to CashMatteo
CashMatteo collected $0.50 from pot
CashMatteo: doesn't show hand 
*** SUMMARY ***
Total pot $0.50 | Rake $0 
Seat 1: CashMatteo (small blind) collected ($0.50)
Seat 2: InitialHC (big blind) folded before Flop
Seat 6: Hammertime1933 (button) folded before Flop (didn't bet)

Hand #1835: 

PokerStars Hand #246795582151:  Hold'em No Limit ($0.10/$0.25 CAD) - 2023/10/28 16:19:22 ET
Table 'Mandeville II' 6-max Seat #1 is the button
Seat 1: CashMatteo ($15.60 in chips) 
Seat 2: InitialHC ($40.95 in chips) 
Seat 6: Hammertime1933 ($19.65 in chips) 
InitialHC: posts small blind $0.10
Hammertime1933: posts big blind $0.25
*** HOLE CARDS ***
Dealt to CashMatteo [8c Ts]
CashMatteo: folds 
InitialHC: raises $0.37 to $0.62
Hammertime1933: folds 
Uncalled bet ($0.37) returned to InitialHC
InitialHC collected $0.50 from pot
InitialHC: doesn't show hand 
*** SUMMARY ***
Total pot $0.50 | Rake $0 
Seat 1: CashMatteo (button) folded before Flop (didn't bet)
Seat 2: InitialHC (small blind) collected ($0.50)
Seat 6: Hammertime1933 (big blind) folded before Flop

Hand #1836: 

PokerStars Hand #246795585926:  Hold'em No Limit ($0.10/$0.25 CAD) - 2023/10/28 16:19:33 ET
Table 'Mandeville II' 6-max Seat #2 is the button
Seat 1: CashMatteo ($15.60 in chips) 
Seat 2: InitialHC ($41.20 in chips) 
Seat 6: Hammertime1933 ($19.40 in chips) 
Hammertime1933: posts small blind $0.10
CashMatteo: posts big blind $0.25
*** HOLE CARDS ***
Dealt to CashMatteo [3h 2c]
InitialHC: folds 
Hammertime1933: folds 
Uncalled bet ($0.15) returned to CashMatteo
CashMatteo collected $0.20 from pot
CashMatteo: doesn't show hand 
*** SUMMARY ***
Total pot $0.20 | Rake $0 
Seat 1: CashMatteo (big blind) collected ($0.20)
Seat 2: InitialHC (button) folded before Flop (didn't bet)
Seat 6: Hammertime1933 (small blind) folded before Flop

Hand #1837: 

PokerStars Hand #246795589965:  Hold'em No Limit ($0.10/$0.25 CAD) - 2023/10/28 16:19:45 ET
Table 'Mandeville II' 6-max Seat #6 is the button
Seat 1: CashMatteo ($15.70 in chips) 
Seat 2: InitialHC ($41.20 in chips) 
Seat 6: Hammertime1933 ($19.30 in chips) 
CashMatteo: posts small blind $0.10
InitialHC: posts big blind $0.25
*** HOLE CARDS ***
Dealt to CashMatteo [8d 3c]
Hammertime1933: folds 
CashMatteo: folds 
Uncalled bet ($0.15) returned to InitialHC
InitialHC collected $0.20 from pot
InitialHC: doesn't show hand 
*** SUMMARY ***
Total pot $0.20 | Rake $0 
Seat 1: CashMatteo (small blind) folded before Flop
Seat 2: InitialHC (big blind) collected ($0.20)
Seat 6: Hammertime1933 (button) folded before Flop (didn't bet)

Hand #1838: 

PokerStars Hand #246795594561: Tournament #3662938560, $0.94+$0.06 CAD Hold'em No Limit - Level V (50/100) - 2023/10/28 16:19:58 ET
Table '3662938560 1' 8-max Seat #5 is the button
Seat 1: thx4folding (2665 in chips) 
Seat 3: CashMatteo (3296 in chips) 
Seat 4: TowMadder (5918 in chips) 
Seat 5: TheGrinch1991 (3544 in chips) 
Seat 6: thecheese42099 (3775 in chips) 
Seat 7: Khab00m (2975 in chips) 
Seat 8: Huckleberry10 (1369 in chips) 
thx4folding: posts the ante 25
CashMatteo: posts the ante 25
TowMadder: posts the ante 25
TheGrinch1991: posts the ante 25
thecheese42099: posts the ante 25
Khab00m: posts the ante 25
Huckleberry10: posts the ante 25
thecheese42099: posts small blind 50
Khab00m: posts big blind 100
*** HOLE CARDS ***
Dealt to CashMatteo [8h 9h]
Huckleberry10: folds 
thx4folding: folds 
CashMatteo: calls 100
TowMadder: folds 
TheGrinch1991: folds 
thecheese42099: calls 50
Khab00m: checks 
*** FLOP *** [Td 6d 8c]
thecheese42099: checks 
Khab00m: checks 
CashMatteo: bets 238
thecheese42099: folds 
Khab00m: folds 
Uncalled bet (238) returned to CashMatteo
CashMatteo collected 475 from pot
CashMatteo: doesn't show hand 
*** SUMMARY ***
Total pot 475 | Rake 0 
Board [Td 6d 8c]
Seat 1: thx4folding folded before Flop (didn't bet)
Seat 3: CashMatteo collected (475)
Seat 4: TowMadder folded before Flop (didn't bet)
Seat 5: TheGrinch1991 (button) folded before Flop (didn't bet)
Seat 6: thecheese42099 (small blind) folded on the Flop
Seat 7: Khab00m (big blind) folded on the Flop
Seat 8: Huckleberry10 folded before Flop (didn't bet)

Hand #1839: 

PokerStars Hand #246795596287:  Hold'em No Limit ($0.10/$0.25 CAD) - 2023/10/28 16:20:03 ET
Table 'Mandeville II' 6-max Seat #1 is the button
Seat 1: CashMatteo ($15.60 in chips) 
Seat 2: InitialHC ($41.30 in chips) 
Seat 6: Hammertime1933 ($19.30 in chips) 
InitialHC: posts small blind $0.10
Hammertime1933: posts big blind $0.25
*** HOLE CARDS ***
Dealt to CashMatteo [7d Ac]
CashMatteo: calls $0.25
InitialHC: folds 
Hammertime1933: checks 
*** FLOP *** [6d Th Qh]
Hammertime1933: bets $0.50
CashMatteo: folds 
Uncalled bet ($0.50) returned to Hammertime1933
Hammertime1933 collected $0.57 from pot
*** SUMMARY ***
Total pot $0.60 | Rake $0.03 
Board [6d Th Qh]
Seat 1: CashMatteo (button) folded on the Flop
Seat 2: InitialHC (small blind) folded before Flop
Seat 6: Hammertime1933 (big blind) collected ($0.57)

Hand #1840: 

PokerStars Hand #246795603994:  Hold'em No Limit ($0.10/$0.25 CAD) - 2023/10/28 16:20:26 ET
Table 'Mandeville II' 6-max Seat #2 is the button
Seat 1: CashMatteo ($15.35 in chips) 
Seat 2: InitialHC ($41.20 in chips) 
Seat 6: Hammertime1933 ($19.62 in chips) 
Hammertime1933: posts small blind $0.10
CashMatteo: posts big blind $0.25
*** HOLE CARDS ***
Dealt to CashMatteo [3s 2d]
InitialHC: raises $0.37 to $0.62
Hammertime1933: folds 
CashMatteo: folds 
Uncalled bet ($0.37) returned to InitialHC
CashMatteo leaves the table
InitialHC collected $0.60 from pot
InitialHC: doesn't show hand 
*** SUMMARY ***
Total pot $0.60 | Rake $0 
Seat 1: CashMatteo (big blind) folded before Flop
Seat 2: InitialHC (button) collected ($0.60)
Seat 6: Hammertime1933 (small blind) folded before Flop

Hand #1841: 

PokerStars Hand #246795610986: Tournament #3662938560, $0.94+$0.06 CAD Hold'em No Limit - Level VI (60/120) - 2023/10/28 16:20:47 ET
Table '3662938560 1' 8-max Seat #6 is the button
Seat 1: thx4folding (2640 in chips) 
Seat 3: CashMatteo (3646 in chips) 
Seat 4: TowMadder (5893 in chips) 
Seat 5: TheGrinch1991 (3519 in chips) 
Seat 6: thecheese42099 (3650 in chips) 
Seat 7: Khab00m (2850 in chips) 
Seat 8: Huckleberry10 (1344 in chips) 
thx4folding: posts the ante 30
CashMatteo: posts the ante 30
TowMadder: posts the ante 30
TheGrinch1991: posts the ante 30
thecheese42099: posts the ante 30
Khab00m: posts the ante 30
Huckleberry10: posts the ante 30
Khab00m: posts small blind 60
Huckleberry10: posts big blind 120
*** HOLE CARDS ***
Dealt to CashMatteo [Qs Ts]
thx4folding: folds 
CashMatteo: raises 180 to 300
TowMadder: folds 
TheGrinch1991: folds 
thecheese42099: folds 
Khab00m: folds 
Huckleberry10: folds 
Uncalled bet (180) returned to CashMatteo
CashMatteo collected 510 from pot
CashMatteo: doesn't show hand 
*** SUMMARY ***
Total pot 510 | Rake 0 
Seat 1: thx4folding folded before Flop (didn't bet)
Seat 3: CashMatteo collected (510)
Seat 4: TowMadder folded before Flop (didn't bet)
Seat 5: TheGrinch1991 folded before Flop (didn't bet)
Seat 6: thecheese42099 (button) folded before Flop (didn't bet)
Seat 7: Khab00m (small blind) folded before Flop
Seat 8: Huckleberry10 (big blind) folded before Flop

Hand #1842: 

PokerStars Hand #246795616944: Tournament #3662938560, $0.94+$0.06 CAD Hold'em No Limit - Level VI (60/120) - 2023/10/28 16:21:04 ET
Table '3662938560 1' 8-max Seat #7 is the button
Seat 1: thx4folding (2610 in chips) 
Seat 3: CashMatteo (4006 in chips) 
Seat 4: TowMadder (5863 in chips) 
Seat 5: TheGrinch1991 (3489 in chips) 
Seat 6: thecheese42099 (3620 in chips) 
Seat 7: Khab00m (2760 in chips) 
Seat 8: Huckleberry10 (1194 in chips) 
thx4folding: posts the ante 30
CashMatteo: posts the ante 30
TowMadder: posts the ante 30
TheGrinch1991: posts the ante 30
thecheese42099: posts the ante 30
Khab00m: posts the ante 30
Huckleberry10: posts the ante 30
Huckleberry10: posts small blind 60
thx4folding: posts big blind 120
*** HOLE CARDS ***
Dealt to CashMatteo [9s Kh]
CashMatteo: folds 
TowMadder: calls 120
TheGrinch1991: folds 
thecheese42099: calls 120
Khab00m: folds 
Huckleberry10: raises 1044 to 1164 and is all-in
thx4folding: folds 
TowMadder: raises 4669 to 5833 and is all-in
thecheese42099: folds 
Uncalled bet (4669) returned to TowMadder
*** FLOP *** [4h 8s Qs]
*** TURN *** [4h 8s Qs] [Kc]
*** RIVER *** [4h 8s Qs Kc] [Ad]
*** SHOW DOWN ***
Huckleberry10: shows [Js Jc] (a pair of Jacks)
TowMadder: shows [Ac Tc] (a pair of Aces)
TowMadder collected 2778 from pot
Huckleberry10 finished the tournament in 30th place
*** SUMMARY ***
Total pot 2778 | Rake 0 
Board [4h 8s Qs Kc Ad]
Seat 1: thx4folding (big blind) folded before Flop
Seat 3: CashMatteo folded before Flop (didn't bet)
Seat 4: TowMadder showed [Ac Tc] and won (2778) with a pair of Aces
Seat 5: TheGrinch1991 folded before Flop (didn't bet)
Seat 6: thecheese42099 folded before Flop
Seat 7: Khab00m (button) folded before Flop (didn't bet)
Seat 8: Huckleberry10 (small blind) showed [Js Jc] and lost with a pair of Jacks

Hand #1843: 

PokerStars Hand #246795628700: Tournament #3662938560, $0.94+$0.06 CAD Hold'em No Limit - Level VI (60/120) - 2023/10/28 16:21:38 ET
Table '3662938560 1' 8-max Seat #1 is the button
Seat 1: thx4folding (2460 in chips) 
Seat 3: CashMatteo (3976 in chips) 
Seat 4: TowMadder (7447 in chips) 
Seat 5: TheGrinch1991 (3459 in chips) 
Seat 6: thecheese42099 (3470 in chips) 
Seat 7: Khab00m (2730 in chips) 
thx4folding: posts the ante 30
CashMatteo: posts the ante 30
TowMadder: posts the ante 30
TheGrinch1991: posts the ante 30
thecheese42099: posts the ante 30
Khab00m: posts the ante 30
CashMatteo: posts small blind 60
TowMadder: posts big blind 120
*** HOLE CARDS ***
Dealt to CashMatteo [3d Jc]
TheGrinch1991: folds 
thecheese42099: folds 
Khab00m: folds 
thx4folding: folds 
CashMatteo: folds 
Uncalled bet (60) returned to TowMadder
TowMadder collected 300 from pot
*** SUMMARY ***
Total pot 300 | Rake 0 
Seat 1: thx4folding (button) folded before Flop (didn't bet)
Seat 3: CashMatteo (small blind) folded before Flop
Seat 4: TowMadder (big blind) collected (300)
Seat 5: TheGrinch1991 folded before Flop (didn't bet)
Seat 6: thecheese42099 folded before Flop (didn't bet)
Seat 7: Khab00m folded before Flop (didn't bet)

Hand #1844: 

PokerStars Hand #246795634544: Tournament #3662938560, $0.94+$0.06 CAD Hold'em No Limit - Level VI (60/120) - 2023/10/28 16:21:55 ET
Table '3662938560 1' 8-max Seat #3 is the button
Seat 1: thx4folding (2430 in chips) 
Seat 3: CashMatteo (3886 in chips) 
Seat 4: TowMadder (7657 in chips) 
Seat 5: TheGrinch1991 (3429 in chips) 
Seat 6: thecheese42099 (3440 in chips) 
Seat 7: Khab00m (2700 in chips) 
thx4folding: posts the ante 30
CashMatteo: posts the ante 30
TowMadder: posts the ante 30
TheGrinch1991: posts the ante 30
thecheese42099: posts the ante 30
Khab00m: posts the ante 30
TowMadder: posts small blind 60
TheGrinch1991: posts big blind 120
*** HOLE CARDS ***
Dealt to CashMatteo [Jd 4h]
thecheese42099: folds 
Khab00m: folds 
thx4folding: folds 
CashMatteo: folds 
TowMadder: calls 60
TheGrinch1991: checks 
*** FLOP *** [5h 2s 9c]
TowMadder: checks 
TheGrinch1991: bets 120
TowMadder: calls 120
*** TURN *** [5h 2s 9c] [9d]
TowMadder: checks 
TheGrinch1991: bets 120
TowMadder: folds 
Uncalled bet (120) returned to TheGrinch1991
TheGrinch1991 collected 660 from pot
*** SUMMARY ***
Total pot 660 | Rake 0 
Board [5h 2s 9c 9d]
Seat 1: thx4folding folded before Flop (didn't bet)
Seat 3: CashMatteo (button) folded before Flop (didn't bet)
Seat 4: TowMadder (small blind) folded on the Turn
Seat 5: TheGrinch1991 (big blind) collected (660)
Seat 6: thecheese42099 folded before Flop (didn't bet)
Seat 7: Khab00m folded before Flop (didn't bet)

Hand #1845: 

PokerStars Hand #246795644617: Tournament #3662938560, $0.94+$0.06 CAD Hold'em No Limit - Level VI (60/120) - 2023/10/28 16:22:25 ET
Table '3662938560 1' 8-max Seat #4 is the button
Seat 1: thx4folding (2400 in chips) 
Seat 3: CashMatteo (3856 in chips) 
Seat 4: TowMadder (7387 in chips) 
Seat 5: TheGrinch1991 (3819 in chips) 
Seat 6: thecheese42099 (3410 in chips) 
Seat 7: Khab00m (2670 in chips) 
thx4folding: posts the ante 30
CashMatteo: posts the ante 30
TowMadder: posts the ante 30
TheGrinch1991: posts the ante 30
thecheese42099: posts the ante 30
Khab00m: posts the ante 30
TheGrinch1991: posts small blind 60
thecheese42099: posts big blind 120
*** HOLE CARDS ***
Dealt to CashMatteo [As Qs]
Khab00m: folds 
thx4folding: folds 
88BaoBei88 is disconnected 
CashMatteo: raises 180 to 300
TowMadder: folds 
TheGrinch1991: folds 
thecheese42099: folds 
Uncalled bet (180) returned to CashMatteo
CashMatteo collected 480 from pot
CashMatteo: doesn't show hand 
*** SUMMARY ***
Total pot 480 | Rake 0 
Seat 1: thx4folding folded before Flop (didn't bet)
Seat 3: CashMatteo collected (480)
Seat 4: TowMadder (button) folded before Flop (didn't bet)
Seat 5: TheGrinch1991 (small blind) folded before Flop
Seat 6: thecheese42099 (big blind) folded before Flop
Seat 7: Khab00m folded before Flop (didn't bet)

Hand #1846: 

PokerStars Hand #246795651376: Tournament #3662938560, $0.94+$0.06 CAD Hold'em No Limit - Level VI (60/120) - 2023/10/28 16:22:44 ET
Table '3662938560 1' 8-max Seat #5 is the button
Seat 1: thx4folding (2370 in chips) 
Seat 2: 88BaoBei88 (3000 in chips) 
Seat 3: CashMatteo (4186 in chips) 
Seat 4: TowMadder (7357 in chips) 
Seat 5: TheGrinch1991 (3729 in chips) 
Seat 6: thecheese42099 (3260 in chips) 
Seat 7: Khab00m (2640 in chips) 
thx4folding: posts the ante 30
88BaoBei88: posts the ante 30
CashMatteo: posts the ante 30
TowMadder: posts the ante 30
TheGrinch1991: posts the ante 30
thecheese42099: posts the ante 30
Khab00m: posts the ante 30
thecheese42099: posts small blind 60
Khab00m: posts big blind 120
*** HOLE CARDS ***
Dealt to CashMatteo [Th 9h]
thx4folding: raises 2220 to 2340 and is all-in
88BaoBei88: calls 2340
CashMatteo: folds 
TowMadder: folds 
TheGrinch1991: folds 
thecheese42099: raises 890 to 3230 and is all-in
Khab00m: folds 
88BaoBei88: calls 630 and is all-in
Uncalled bet (260) returned to thecheese42099
*** FLOP *** [5d 4s 6c]
*** TURN *** [5d 4s 6c] [9s]
*** RIVER *** [5d 4s 6c 9s] [Ah]
*** SHOW DOWN ***
thecheese42099: shows [As Ad] (three of a kind, Aces)
88BaoBei88: shows [Tc Ks] (high card Ace)
thecheese42099 collected 1260 from side pot
thx4folding: shows [Qd 9d] (a pair of Nines)
thecheese42099 collected 7350 from main pot
88BaoBei88 finished the tournament in 27th place
thx4folding finished the tournament in 28th place
*** SUMMARY ***
Total pot 8610 Main pot 7350. Side pot 1260. | Rake 0 
Board [5d 4s 6c 9s Ah]
Seat 1: thx4folding showed [Qd 9d] and lost with a pair of Nines
Seat 2: 88BaoBei88 showed [Tc Ks] and lost with high card Ace
Seat 3: CashMatteo folded before Flop (didn't bet)
Seat 4: TowMadder folded before Flop (didn't bet)
Seat 5: TheGrinch1991 (button) folded before Flop (didn't bet)
Seat 6: thecheese42099 (small blind) showed [As Ad] and won (8610) with three of a kind, Aces
Seat 7: Khab00m (big blind) folded before Flop

Hand #1847: 

PokerStars Hand #246795661779: Tournament #3662938560, $0.94+$0.06 CAD Hold'em No Limit - Level VII (80/160) - 2023/10/28 16:23:15 ET
Table '3662938560 1' 8-max Seat #6 is the button
Seat 3: CashMatteo (4156 in chips) 
Seat 4: TowMadder (7327 in chips) 
Seat 5: TheGrinch1991 (3699 in chips) 
Seat 6: thecheese42099 (8870 in chips) 
Seat 7: Khab00m (2490 in chips) 
CashMatteo: posts the ante 40
TowMadder: posts the ante 40
TheGrinch1991: posts the ante 40
thecheese42099: posts the ante 40
Khab00m: posts the ante 40
Khab00m: posts small blind 80
CashMatteo: posts big blind 160
*** HOLE CARDS ***
Dealt to CashMatteo [Ks 6d]
88BaoBei88 is disconnected 
TowMadder: folds 
TheGrinch1991: folds 
thecheese42099: folds 
Khab00m: raises 2290 to 2450 and is all-in
CashMatteo: folds 
Uncalled bet (2290) returned to Khab00m
Khab00m collected 520 from pot
Khab00m: doesn't show hand 
*** SUMMARY ***
Total pot 520 | Rake 0 
Seat 3: CashMatteo (big blind) folded before Flop
Seat 4: TowMadder folded before Flop (didn't bet)
Seat 5: TheGrinch1991 folded before Flop (didn't bet)
Seat 6: thecheese42099 (button) folded before Flop (didn't bet)
Seat 7: Khab00m (small blind) collected (520)

Hand #1848: 

PokerStars Hand #246795667798: Tournament #3662938560, $0.94+$0.06 CAD Hold'em No Limit - Level VII (80/160) - 2023/10/28 16:23:33 ET
Table '3662938560 1' 8-max Seat #7 is the button
Seat 3: CashMatteo (3956 in chips) 
Seat 4: TowMadder (7287 in chips) 
Seat 5: TheGrinch1991 (3659 in chips) 
Seat 6: thecheese42099 (8830 in chips) 
Seat 7: Khab00m (2810 in chips) 
Seat 8: 88BaoBei88 (3000 in chips) out of hand (moved from another table into small blind)
88BaoBei88 will be allowed to play after the button
CashMatteo: posts the ante 40
TowMadder: posts the ante 40
TheGrinch1991: posts the ante 40
thecheese42099: posts the ante 40
Khab00m: posts the ante 40
CashMatteo: posts small blind 80
TowMadder: posts big blind 160
*** HOLE CARDS ***
Dealt to CashMatteo [6h 8c]
TheGrinch1991: calls 160
hotbellymoma is disconnected 
thecheese42099: calls 160
Khab00m: folds 
CashMatteo: folds 
TowMadder: checks 
*** FLOP *** [2c 2d 7s]
TowMadder: checks 
TheGrinch1991: bets 160
thecheese42099: raises 160 to 320
TowMadder: folds 
TheGrinch1991: calls 160
*** TURN *** [2c 2d 7s] [5s]
TheGrinch1991: bets 160
thecheese42099: calls 160
*** RIVER *** [2c 2d 7s 5s] [Qh]
TheGrinch1991: bets 160
thecheese42099: raises 640 to 800
TheGrinch1991: calls 640
*** SHOW DOWN ***
thecheese42099: shows [2h Ac] (three of a kind, Deuces)
TheGrinch1991: mucks hand 
thecheese42099 collected 3320 from pot
*** SUMMARY ***
Total pot 3320 | Rake 0 
Board [2c 2d 7s 5s Qh]
Seat 3: CashMatteo (small blind) folded before Flop
Seat 4: TowMadder (big blind) folded on the Flop
Seat 5: TheGrinch1991 mucked [8s 8d]
Seat 6: thecheese42099 showed [2h Ac] and won (3320) with three of a kind, Deuces
Seat 7: Khab00m (button) folded before Flop (didn't bet)

Hand #1849: 

PokerStars Hand #246795679223: Tournament #3662938560, $0.94+$0.06 CAD Hold'em No Limit - Level VII (80/160) - 2023/10/28 16:24:07 ET
Table '3662938560 1' 8-max Seat #3 is the button
Seat 1: hotbellymoma (3000 in chips) 
Seat 3: CashMatteo (3836 in chips) 
Seat 4: TowMadder (7087 in chips) 
Seat 5: TheGrinch1991 (2179 in chips) 
Seat 6: thecheese42099 (10670 in chips) 
Seat 7: Khab00m (2770 in chips) 
Seat 8: 88BaoBei88 (3000 in chips) 
hotbellymoma: posts the ante 40
CashMatteo: posts the ante 40
TowMadder: posts the ante 40
TheGrinch1991: posts the ante 40
thecheese42099: posts the ante 40
Khab00m: posts the ante 40
88BaoBei88: posts the ante 40
TowMadder: posts small blind 80
TheGrinch1991: posts big blind 160
*** HOLE CARDS ***
Dealt to CashMatteo [4d 7d]
thecheese42099: calls 160
Khab00m: folds 
88BaoBei88: calls 160
hotbellymoma: folds 
CashMatteo: folds 
TowMadder: calls 80
TheGrinch1991: raises 160 to 320
thecheese42099: calls 160
88BaoBei88: calls 160
TowMadder: calls 160
*** FLOP *** [4h 7s 6s]
TowMadder: checks 
TheGrinch1991: bets 1819 and is all-in
thecheese42099: calls 1819
88BaoBei88: calls 1819
TowMadder: folds 
*** TURN *** [4h 7s 6s] [2h]
thecheese42099: checks 
88BaoBei88: checks 
*** RIVER *** [4h 7s 6s 2h] [Ts]
thecheese42099: checks 
88BaoBei88: checks 
*** SHOW DOWN ***
TheGrinch1991: shows [Tc Td] (three of a kind, Tens)
thecheese42099: mucks hand 
88BaoBei88: mucks hand 
TheGrinch1991 collected 7017 from pot
*** SUMMARY ***
Total pot 7017 | Rake 0 
Board [4h 7s 6s 2h Ts]
Seat 1: hotbellymoma folded before Flop (didn't bet)
Seat 3: CashMatteo (button) folded before Flop (didn't bet)
Seat 4: TowMadder (small blind) folded on the Flop
Seat 5: TheGrinch1991 (big blind) showed [Tc Td] and won (7017) with three of a kind, Tens
Seat 6: thecheese42099 mucked [Ad 5c]
Seat 7: Khab00m folded before Flop (didn't bet)
Seat 8: 88BaoBei88 mucked [6h Jd]

Hand #1850: 

PokerStars Hand #246795694647: Tournament #3662938560, $0.94+$0.06 CAD Hold'em No Limit - Level VII (80/160) - 2023/10/28 16:24:52 ET
Table '3662938560 1' 8-max Seat #4 is the button
Seat 1: hotbellymoma (2960 in chips) 
Seat 3: CashMatteo (3796 in chips) 
Seat 4: TowMadder (6727 in chips) 
Seat 5: TheGrinch1991 (7017 in chips) 
Seat 6: thecheese42099 (8491 in chips) 
Seat 7: Khab00m (2730 in chips) 
Seat 8: 88BaoBei88 (821 in chips) 
hotbellymoma: posts the ante 40
CashMatteo: posts the ante 40
TowMadder: posts the ante 40
TheGrinch1991: posts the ante 40
thecheese42099: posts the ante 40
Khab00m: posts the ante 40
88BaoBei88: posts the ante 40
TheGrinch1991: posts small blind 80
thecheese42099: posts big blind 160
*** HOLE CARDS ***
Dealt to CashMatteo [6s 9d]
Khab00m: raises 160 to 320
88BaoBei88: raises 461 to 781 and is all-in
hotbellymoma: folds 
CashMatteo: folds 
TowMadder: calls 781
TheGrinch1991: folds 
thecheese42099: folds 
Khab00m: calls 461
*** FLOP *** [7c 8s 7s]
Khab00m: checks 
TowMadder: checks 
*** TURN *** [7c 8s 7s] [Ac]
Khab00m: bets 1432
TowMadder: folds 
Uncalled bet (1432) returned to Khab00m
*** RIVER *** [7c 8s 7s Ac] [Tc]
*** SHOW DOWN ***
Khab00m: shows [3h 3c] (two pair, Sevens and Threes)
88BaoBei88: shows [Ad Qc] (two pair, Aces and Sevens)
88BaoBei88 collected 2863 from pot
*** SUMMARY ***
Total pot 2863 | Rake 0 
Board [7c 8s 7s Ac Tc]
Seat 1: hotbellymoma folded before Flop (didn't bet)
Seat 3: CashMatteo folded before Flop (didn't bet)
Seat 4: TowMadder (button) folded on the Turn
Seat 5: TheGrinch1991 (small blind) folded before Flop
Seat 6: thecheese42099 (big blind) folded before Flop
Seat 7: Khab00m showed [3h 3c] and lost with two pair, Sevens and Threes
Seat 8: 88BaoBei88 showed [Ad Qc] and won (2863) with two pair, Aces and Sevens

Hand #1851: 

PokerStars Hand #246795709695: Tournament #3662938560, $0.94+$0.06 CAD Hold'em No Limit - Level VII (80/160) - 2023/10/28 16:25:37 ET
Table '3662938560 1' 8-max Seat #5 is the button
Seat 3: CashMatteo (3756 in chips) 
Seat 4: TowMadder (5906 in chips) 
Seat 5: TheGrinch1991 (6897 in chips) 
Seat 6: thecheese42099 (8291 in chips) 
Seat 7: Khab00m (1909 in chips) 
Seat 8: 88BaoBei88 (2863 in chips) 
CashMatteo: posts the ante 40
TowMadder: posts the ante 40
TheGrinch1991: posts the ante 40
thecheese42099: posts the ante 40
Khab00m: posts the ante 40
88BaoBei88: posts the ante 40
thecheese42099: posts small blind 80
Khab00m: posts big blind 160
*** HOLE CARDS ***
Dealt to CashMatteo [Th 3d]
88BaoBei88: calls 160
CashMatteo: folds 
TowMadder: folds 
TheGrinch1991: folds 
thecheese42099: calls 80
Khab00m: checks 
*** FLOP *** [4s 5h Kc]
thecheese42099: checks 
Khab00m: checks 
88BaoBei88: checks 
*** TURN *** [4s 5h Kc] [6h]
thecheese42099: checks 
Khab00m: checks 
88BaoBei88: checks 
*** RIVER *** [4s 5h Kc 6h] [Qc]
koolcanuck33 is disconnected 
thecheese42099: bets 160
Khab00m: folds 
88BaoBei88: folds 
Uncalled bet (160) returned to thecheese42099
thecheese42099 collected 720 from pot
*** SUMMARY ***
Total pot 720 | Rake 0 
Board [4s 5h Kc 6h Qc]
Seat 3: CashMatteo folded before Flop (didn't bet)
Seat 4: TowMadder folded before Flop (didn't bet)
Seat 5: TheGrinch1991 (button) folded before Flop (didn't bet)
Seat 6: thecheese42099 (small blind) collected (720)
Seat 7: Khab00m (big blind) folded on the River
Seat 8: 88BaoBei88 folded on the River

Hand #1852: 

PokerStars Hand #246795719365: Tournament #3662938560, $0.94+$0.06 CAD Hold'em No Limit - Level VII (80/160) - 2023/10/28 16:26:06 ET
Table '3662938560 1' 8-max Seat #6 is the button
Seat 1: koolcanuck33 (3000 in chips) 
Seat 3: CashMatteo (3716 in chips) 
Seat 4: TowMadder (5866 in chips) 
Seat 5: TheGrinch1991 (6857 in chips) 
Seat 6: thecheese42099 (8811 in chips) 
Seat 7: Khab00m (1709 in chips) 
Seat 8: 88BaoBei88 (2663 in chips) 
koolcanuck33: posts the ante 40
CashMatteo: posts the ante 40
TowMadder: posts the ante 40
TheGrinch1991: posts the ante 40
thecheese42099: posts the ante 40
Khab00m: posts the ante 40
88BaoBei88: posts the ante 40
Khab00m: posts small blind 80
88BaoBei88: posts big blind 160
*** HOLE CARDS ***
Dealt to CashMatteo [7d 4h]
koolcanuck33: folds 
CashMatteo: folds 
TowMadder: folds 
TheGrinch1991: folds 
thecheese42099: raises 480 to 640
Khab00m: raises 1029 to 1669 and is all-in
88BaoBei88: folds 
thecheese42099: calls 1029
*** FLOP *** [Tc Ac 2d]
*** TURN *** [Tc Ac 2d] [Qs]
*** RIVER *** [Tc Ac 2d Qs] [5d]
*** SHOW DOWN ***
Khab00m: shows [Ad Ts] (two pair, Aces and Tens)
thecheese42099: shows [5c 5s] (three of a kind, Fives)
thecheese42099 collected 3778 from pot
Khab00m finished the tournament in 24th place
*** SUMMARY ***
Total pot 3778 | Rake 0 
Board [Tc Ac 2d Qs 5d]
Seat 1: koolcanuck33 folded before Flop (didn't bet)
Seat 3: CashMatteo folded before Flop (didn't bet)
Seat 4: TowMadder folded before Flop (didn't bet)
Seat 5: TheGrinch1991 folded before Flop (didn't bet)
Seat 6: thecheese42099 (button) showed [5c 5s] and won (3778) with three of a kind, Fives
Seat 7: Khab00m (small blind) showed [Ad Ts] and lost with two pair, Aces and Tens
Seat 8: 88BaoBei88 (big blind) folded before Flop

Hand #1853: 

PokerStars Hand #246795728646: Tournament #3662938560, $0.94+$0.06 CAD Hold'em No Limit - Level VIII (100/200) - 2023/10/28 16:26:34 ET
Table '3662938560 1' 8-max Seat #8 is the button
Seat 1: koolcanuck33 (2960 in chips) 
Seat 3: CashMatteo (3676 in chips) 
Seat 4: TowMadder (5826 in chips) 
Seat 5: TheGrinch1991 (6817 in chips) 
Seat 6: thecheese42099 (10880 in chips) 
Seat 8: 88BaoBei88 (2463 in chips) 
koolcanuck33: posts the ante 50
CashMatteo: posts the ante 50
TowMadder: posts the ante 50
TheGrinch1991: posts the ante 50
thecheese42099: posts the ante 50
88BaoBei88: posts the ante 50
koolcanuck33: posts small blind 100
CashMatteo: posts big blind 200
*** HOLE CARDS ***
Dealt to CashMatteo [Kc Td]
TowMadder: calls 200
TheGrinch1991: folds 
thecheese42099: folds 
88BaoBei88: folds 
koolcanuck33: calls 100
CashMatteo: raises 300 to 500
TowMadder: calls 300
koolcanuck33: folds 
*** FLOP *** [5h 9d 7c]
CashMatteo: checks 
TowMadder: checks 
*** TURN *** [5h 9d 7c] [6h]
CashMatteo: bets 750
TowMadder: raises 750 to 1500
CashMatteo: folds 
Uncalled bet (750) returned to TowMadder
TowMadder collected 3000 from pot
*** SUMMARY ***
Total pot 3000 | Rake 0 
Board [5h 9d 7c 6h]
Seat 1: koolcanuck33 (small blind) folded before Flop
Seat 3: CashMatteo (big blind) folded on the Turn
Seat 4: TowMadder collected (3000)
Seat 5: TheGrinch1991 folded before Flop (didn't bet)
Seat 6: thecheese42099 folded before Flop (didn't bet)
Seat 8: 88BaoBei88 (button) folded before Flop (didn't bet)

Hand #1854: 

PokerStars Hand #246795743341: Tournament #3662938560, $0.94+$0.06 CAD Hold'em No Limit - Level VIII (100/200) - 2023/10/28 16:27:17 ET
Table '3662938560 1' 8-max Seat #1 is the button
Seat 1: koolcanuck33 (2710 in chips) 
Seat 3: CashMatteo (2376 in chips) 
Seat 4: TowMadder (7526 in chips) 
Seat 5: TheGrinch1991 (6767 in chips) 
Seat 6: thecheese42099 (10830 in chips) 
Seat 8: 88BaoBei88 (2413 in chips) 
koolcanuck33: posts the ante 50
CashMatteo: posts the ante 50
TowMadder: posts the ante 50
TheGrinch1991: posts the ante 50
thecheese42099: posts the ante 50
88BaoBei88: posts the ante 50
CashMatteo: posts small blind 100
TowMadder: posts big blind 200
*** HOLE CARDS ***
Dealt to CashMatteo [6h Kc]
TheGrinch1991: folds 
thecheese42099: calls 200
88BaoBei88: calls 200
koolcanuck33: folds 
CashMatteo: calls 100
TowMadder: checks 
*** FLOP *** [Kd 3h 8h]
CashMatteo: bets 2126 and is all-in
teenap is disconnected 
TowMadder: folds 
thecheese42099: folds 
88BaoBei88: calls 2126
*** TURN *** [Kd 3h 8h] [Qc]
*** RIVER *** [Kd 3h 8h Qc] [Ks]
*** SHOW DOWN ***
CashMatteo: shows [6h Kc] (three of a kind, Kings)
88BaoBei88: shows [9h Th] (a pair of Kings)
CashMatteo collected 5352 from pot
*** SUMMARY ***
Total pot 5352 | Rake 0 
Board [Kd 3h 8h Qc Ks]
Seat 1: koolcanuck33 (button) folded before Flop (didn't bet)
Seat 3: CashMatteo (small blind) showed [6h Kc] and won (5352) with three of a kind, Kings
Seat 4: TowMadder (big blind) folded on the Flop
Seat 5: TheGrinch1991 folded before Flop (didn't bet)
Seat 6: thecheese42099 folded on the Flop
Seat 8: 88BaoBei88 showed [9h Th] and lost with a pair of Kings

Hand #1855: 

PokerStars Hand #246795753620: Tournament #3662938560, $0.94+$0.06 CAD Hold'em No Limit - Level VIII (100/200) - 2023/10/28 16:27:47 ET
Table '3662938560 1' 8-max Seat #3 is the button
Seat 1: koolcanuck33 (2660 in chips) 
Seat 2: teenap (3000 in chips) 
Seat 3: CashMatteo (5352 in chips) 
Seat 4: TowMadder (7276 in chips) 
Seat 5: TheGrinch1991 (6717 in chips) 
Seat 6: thecheese42099 (10580 in chips) 
Seat 8: 88BaoBei88 (37 in chips) 
koolcanuck33: posts the ante 50
teenap: posts the ante 50
CashMatteo: posts the ante 50
TowMadder: posts the ante 50
TheGrinch1991: posts the ante 50
thecheese42099: posts the ante 50
88BaoBei88: posts the ante 37 and is all-in
TowMadder: posts small blind 100
TheGrinch1991: posts big blind 200
*** HOLE CARDS ***
Dealt to CashMatteo [4s 2d]
thecheese42099: folds 
koolcanuck33: folds 
teenap: calls 200
CashMatteo: folds 
TowMadder: calls 100
TheGrinch1991: checks 
*** FLOP *** [Qc 6h As]
TowMadder: checks 
TheGrinch1991: checks 
teenap: bets 200
TowMadder: folds 
TheGrinch1991: folds 
Uncalled bet (200) returned to teenap
*** TURN *** [Qc 6h As] [Th]
*** RIVER *** [Qc 6h As Th] [Jc]
*** SHOW DOWN ***
teenap: shows [Ac 3h] (a pair of Aces)
teenap collected 678 from side pot
88BaoBei88: shows [Qh 3s] (a pair of Queens)
teenap collected 259 from main pot
88BaoBei88 finished the tournament in 22nd place
*** SUMMARY ***
Total pot 937 Main pot 259. Side pot 678. | Rake 0 
Board [Qc 6h As Th Jc]
Seat 1: koolcanuck33 folded before Flop (didn't bet)
Seat 2: teenap showed [Ac 3h] and won (937) with a pair of Aces
Seat 3: CashMatteo (button) folded before Flop (didn't bet)
Seat 4: TowMadder (small blind) folded on the Flop
Seat 5: TheGrinch1991 (big blind) folded on the Flop
Seat 6: thecheese42099 folded before Flop (didn't bet)
Seat 8: 88BaoBei88 showed [Qh 3s] and lost with a pair of Queens

Hand #1856: 

PokerStars Hand #246795762597: Tournament #3662938560, $0.94+$0.06 CAD Hold'em No Limit - Level VIII (100/200) - 2023/10/28 16:28:14 ET
Table '3662938560 1' 8-max Seat #4 is the button
Seat 1: koolcanuck33 (2610 in chips) 
Seat 2: teenap (3687 in chips) 
Seat 3: CashMatteo (5302 in chips) 
Seat 4: TowMadder (7026 in chips) 
Seat 5: TheGrinch1991 (6467 in chips) 
Seat 6: thecheese42099 (10530 in chips) 
koolcanuck33: posts the ante 50
teenap: posts the ante 50
CashMatteo: posts the ante 50
TowMadder: posts the ante 50
TheGrinch1991: posts the ante 50
thecheese42099: posts the ante 50
TheGrinch1991: posts small blind 100
thecheese42099: posts big blind 200
*** HOLE CARDS ***
Dealt to CashMatteo [Qh 7d]
koolcanuck33: folds 
teenap: calls 200
CashMatteo: folds 
TowMadder: folds 
TheGrinch1991: calls 100
thecheese42099: checks 
*** FLOP *** [4h Td Js]
88BaoBei88 is disconnected 
TheGrinch1991: checks 
thecheese42099: checks 
teenap: checks 
*** TURN *** [4h Td Js] [4c]
TheGrinch1991: checks 
thecheese42099: checks 
teenap: checks 
*** RIVER *** [4h Td Js 4c] [5c]
TheGrinch1991: checks 
thecheese42099: bets 200
teenap: calls 200
TheGrinch1991: folds 
*** SHOW DOWN ***
thecheese42099: shows [3d Kc] (a pair of Fours)
teenap: shows [5h 7h] (two pair, Fives and Fours)
teenap collected 1300 from pot
*** SUMMARY ***
Total pot 1300 | Rake 0 
Board [4h Td Js 4c 5c]
Seat 1: koolcanuck33 folded before Flop (didn't bet)
Seat 2: teenap showed [5h 7h] and won (1300) with two pair, Fives and Fours
Seat 3: CashMatteo folded before Flop (didn't bet)
Seat 4: TowMadder (button) folded before Flop (didn't bet)
Seat 5: TheGrinch1991 (small blind) folded on the River
Seat 6: thecheese42099 (big blind) showed [3d Kc] and lost with a pair of Fours

Hand #1857: 

PokerStars Hand #246795774682: Tournament #3662938560, $0.94+$0.06 CAD Hold'em No Limit - Level VIII (100/200) - 2023/10/28 16:28:50 ET
Table '3662938560 1' 8-max Seat #5 is the button
Seat 1: koolcanuck33 (2560 in chips) 
Seat 2: teenap (4537 in chips) 
Seat 3: CashMatteo (5252 in chips) 
Seat 4: TowMadder (6976 in chips) 
Seat 5: TheGrinch1991 (6217 in chips) 
Seat 6: thecheese42099 (10080 in chips) 
Seat 8: 88BaoBei88 (3000 in chips) 
koolcanuck33: posts the ante 50
teenap: posts the ante 50
CashMatteo: posts the ante 50
TowMadder: posts the ante 50
TheGrinch1991: posts the ante 50
thecheese42099: posts the ante 50
88BaoBei88: posts the ante 50
thecheese42099: posts small blind 100
88BaoBei88: posts big blind 200
*** HOLE CARDS ***
Dealt to CashMatteo [6c 6s]
koolcanuck33: folds 
teenap: folds 
CashMatteo: raises 300 to 500
TowMadder: folds 
TheGrinch1991: calls 500
thecheese42099: calls 400
88BaoBei88: calls 300
*** FLOP *** [6h 9h 4d]
thecheese42099: checks 
88BaoBei88: checks 
CashMatteo: bets 1175
TheGrinch1991: folds 
thecheese42099: calls 1175
88BaoBei88: folds 
*** TURN *** [6h 9h 4d] [5h]
thecheese42099: checks 
CashMatteo: checks 
*** RIVER *** [6h 9h 4d 5h] [5s]
thecheese42099: bets 1750
CashMatteo: raises 1777 to 3527 and is all-in
thecheese42099: calls 1777
*** SHOW DOWN ***
CashMatteo: shows [6c 6s] (a full house, Sixes full of Fives)
thecheese42099: shows [Th 7h] (a flush, Ten high)
CashMatteo collected 11754 from pot
*** SUMMARY ***
Total pot 11754 | Rake 0 
Board [6h 9h 4d 5h 5s]
Seat 1: koolcanuck33 folded before Flop (didn't bet)
Seat 2: teenap folded before Flop (didn't bet)
Seat 3: CashMatteo showed [6c 6s] and won (11754) with a full house, Sixes full of Fives
Seat 4: TowMadder folded before Flop (didn't bet)
Seat 5: TheGrinch1991 (button) folded on the Flop
Seat 6: thecheese42099 (small blind) showed [Th 7h] and lost with a flush, Ten high
Seat 8: 88BaoBei88 (big blind) folded on the Flop

Hand #1858: 

PokerStars Hand #246795799306: Tournament #3662938560, $0.94+$0.06 CAD Hold'em No Limit - Level IX (125/250) - 2023/10/28 16:30:03 ET
Table '3662938560 1' 8-max Seat #6 is the button
Seat 1: koolcanuck33 (2510 in chips) 
Seat 2: teenap (4487 in chips) 
Seat 3: CashMatteo (11754 in chips) 
Seat 4: TowMadder (6926 in chips) 
Seat 5: TheGrinch1991 (5667 in chips) 
Seat 6: thecheese42099 (4828 in chips) 
Seat 7: BF191919 (3000 in chips) out of hand (moved from another table into small blind)
Seat 8: 88BaoBei88 (2450 in chips) 
BF191919 will be allowed to play after the button
koolcanuck33: posts the ante 60
teenap: posts the ante 60
CashMatteo: posts the ante 60
TowMadder: posts the ante 60
TheGrinch1991: posts the ante 60
thecheese42099: posts the ante 60
88BaoBei88: posts the ante 60
88BaoBei88: posts small blind 125
koolcanuck33: posts big blind 250
*** HOLE CARDS ***
Dealt to CashMatteo [4c 3c]
teenap: calls 250
CashMatteo: folds 
TowMadder: folds 
TheGrinch1991: raises 5357 to 5607 and is all-in
thecheese42099: folds 
88BaoBei88: folds 
koolcanuck33: folds 
teenap: folds 
Uncalled bet (5357) returned to TheGrinch1991
TheGrinch1991 collected 1295 from pot
*** SUMMARY ***
Total pot 1295 | Rake 0 
Seat 1: koolcanuck33 (big blind) folded before Flop
Seat 2: teenap folded before Flop
Seat 3: CashMatteo folded before Flop (didn't bet)
Seat 4: TowMadder folded before Flop (didn't bet)
Seat 5: TheGrinch1991 collected (1295)
Seat 6: thecheese42099 (button) folded before Flop (didn't bet)
Seat 8: 88BaoBei88 (small blind) folded before Flop

Hand #1859: 

PokerStars Hand #246795806260: Tournament #3662938560, $0.94+$0.06 CAD Hold'em No Limit - Level IX (125/250) - 2023/10/28 16:30:24 ET
Table '3662938560 1' 8-max Seat #8 is the button
Seat 1: koolcanuck33 (2200 in chips) 
Seat 3: CashMatteo (11694 in chips) 
Seat 4: TowMadder (6866 in chips) 
Seat 5: TheGrinch1991 (6652 in chips) 
Seat 6: thecheese42099 (4768 in chips) 
Seat 7: BF191919 (3000 in chips) 
Seat 8: 88BaoBei88 (2265 in chips) 
koolcanuck33: posts the ante 60
CashMatteo: posts the ante 60
TowMadder: posts the ante 60
TheGrinch1991: posts the ante 60
thecheese42099: posts the ante 60
BF191919: posts the ante 60
88BaoBei88: posts the ante 60
koolcanuck33: posts small blind 125
CashMatteo: posts big blind 250
*** HOLE CARDS ***
Dealt to CashMatteo [5h Js]
TowMadder: calls 250
TheGrinch1991: folds 
thecheese42099: calls 250
BF191919: folds 
88BaoBei88: raises 250 to 500
koolcanuck33: raises 250 to 750
CashMatteo: folds 
TowMadder: folds 
thecheese42099: folds 
88BaoBei88: calls 250
*** FLOP *** [Qd 8h 2c]
koolcanuck33: bets 500
88BaoBei88: calls 500
*** TURN *** [Qd 8h 2c] [Kc]
koolcanuck33: bets 890 and is all-in
88BaoBei88: calls 890
*** RIVER *** [Qd 8h 2c Kc] [3h]
*** SHOW DOWN ***
koolcanuck33: shows [Ad Ac] (a pair of Aces)
88BaoBei88: shows [Kh Ah] (a pair of Kings)
koolcanuck33 collected 5450 from pot
*** SUMMARY ***
Total pot 5450 | Rake 0 
Board [Qd 8h 2c Kc 3h]
Seat 1: koolcanuck33 (small blind) showed [Ad Ac] and won (5450) with a pair of Aces
Seat 3: CashMatteo (big blind) folded before Flop
Seat 4: TowMadder folded before Flop
Seat 5: TheGrinch1991 folded before Flop (didn't bet)
Seat 6: thecheese42099 folded before Flop
Seat 7: BF191919 folded before Flop (didn't bet)
Seat 8: 88BaoBei88 (button) showed [Kh Ah] and lost with a pair of Kings

Hand #1860: 

PokerStars Hand #246795818764: Tournament #3662938560, $0.94+$0.06 CAD Hold'em No Limit - Level IX (125/250) - 2023/10/28 16:31:01 ET
Table '3662938560 1' 8-max Seat #1 is the button
Seat 1: koolcanuck33 (5450 in chips) 
Seat 3: CashMatteo (11384 in chips) 
Seat 4: TowMadder (6556 in chips) 
Seat 5: TheGrinch1991 (6592 in chips) 
Seat 7: BF191919 (2940 in chips) 
Seat 8: 88BaoBei88 (65 in chips) 
koolcanuck33: posts the ante 60
CashMatteo: posts the ante 60
TowMadder: posts the ante 60
TheGrinch1991: posts the ante 60
BF191919: posts the ante 60
88BaoBei88: posts the ante 60
CashMatteo: posts small blind 125
TowMadder: posts big blind 250
*** HOLE CARDS ***
Dealt to CashMatteo [6d Qc]
TheGrinch1991: calls 250
BF191919: raises 250 to 500
88BaoBei88: calls 5 and is all-in
koolcanuck33: folds 
CashMatteo: folds 
TowMadder: calls 250
TheGrinch1991: calls 250
*** FLOP *** [Kd 7h 3d]
TowMadder: checks 
TheGrinch1991: checks 
BF191919: checks 
*** TURN *** [Kd 7h 3d] [4s]
TowMadder: checks 
TheGrinch1991: checks 
BF191919: checks 
*** RIVER *** [Kd 7h 3d 4s] [Jh]
TowMadder: checks 
TheGrinch1991: checks 
BF191919: checks 
*** SHOW DOWN ***
TowMadder: shows [9c 9d] (a pair of Nines)
TheGrinch1991: mucks hand 
BF191919: mucks hand 
TowMadder collected 1605 from side pot
88BaoBei88: shows [Ks Td] (a pair of Kings)
88BaoBei88 collected 385 from main pot
*** SUMMARY ***
Total pot 1990 Main pot 385. Side pot 1605. | Rake 0 
Board [Kd 7h 3d 4s Jh]
Seat 1: koolcanuck33 (button) folded before Flop (didn't bet)
Seat 3: CashMatteo (small blind) folded before Flop
Seat 4: TowMadder (big blind) showed [9c 9d] and won (1605) with a pair of Nines
Seat 5: TheGrinch1991 mucked [Ah 8h]
Seat 7: BF191919 mucked [Ad 8d]
Seat 8: 88BaoBei88 showed [Ks Td] and won (385) with a pair of Kings

Hand #1861: 

PokerStars Hand #246795831750: Tournament #3662938560, $0.94+$0.06 CAD Hold'em No Limit - Level IX (125/250) - 2023/10/28 16:31:39 ET
Table '3662938560 1' 8-max Seat #3 is the button
Seat 1: koolcanuck33 (5390 in chips) 
Seat 3: CashMatteo (11199 in chips) 
Seat 4: TowMadder (7601 in chips) 
Seat 5: TheGrinch1991 (6032 in chips) 
Seat 7: BF191919 (2380 in chips) 
Seat 8: 88BaoBei88 (385 in chips) 
koolcanuck33: posts the ante 60
CashMatteo: posts the ante 60
TowMadder: posts the ante 60
TheGrinch1991: posts the ante 60
BF191919: posts the ante 60
88BaoBei88: posts the ante 60
TowMadder: posts small blind 125
TheGrinch1991: posts big blind 250
*** HOLE CARDS ***
Dealt to CashMatteo [3h Jc]
BF191919: folds 
88BaoBei88: raises 75 to 325 and is all-in
koolcanuck33: folds 
CashMatteo: folds 
TowMadder: folds 
TheGrinch1991: calls 75
*** FLOP *** [7s 9d 4s]
*** TURN *** [7s 9d 4s] [Qh]
*** RIVER *** [7s 9d 4s Qh] [7d]
*** SHOW DOWN ***
TheGrinch1991: shows [Kh 9s] (two pair, Nines and Sevens)
88BaoBei88: shows [9h 5d] (two pair, Nines and Sevens - lower kicker)
TheGrinch1991 collected 1135 from pot
88BaoBei88 finished the tournament in 21st place
*** SUMMARY ***
Total pot 1135 | Rake 0 
Board [7s 9d 4s Qh 7d]
Seat 1: koolcanuck33 folded before Flop (didn't bet)
Seat 3: CashMatteo (button) folded before Flop (didn't bet)
Seat 4: TowMadder (small blind) folded before Flop
Seat 5: TheGrinch1991 (big blind) showed [Kh 9s] and won (1135) with two pair, Nines and Sevens
Seat 7: BF191919 folded before Flop (didn't bet)
Seat 8: 88BaoBei88 showed [9h 5d] and lost with two pair, Nines and Sevens

Hand #1862: 

PokerStars Hand #246795839839: Tournament #3662938560, $0.94+$0.06 CAD Hold'em No Limit - Level IX (125/250) - 2023/10/28 16:32:04 ET
Table '3662938560 1' 8-max Seat #4 is the button
Seat 1: koolcanuck33 (5330 in chips) 
Seat 2: Jekl2002 (3000 in chips) 
Seat 3: CashMatteo (11139 in chips) 
Seat 4: TowMadder (7416 in chips) 
Seat 5: TheGrinch1991 (6782 in chips) 
Seat 7: BF191919 (2320 in chips) 
koolcanuck33: posts the ante 60
Jekl2002: posts the ante 60
CashMatteo: posts the ante 60
TowMadder: posts the ante 60
TheGrinch1991: posts the ante 60
BF191919: posts the ante 60
TheGrinch1991: posts small blind 125
BF191919: posts big blind 250
*** HOLE CARDS ***
Dealt to CashMatteo [2s Ah]
koolcanuck33: calls 250
Jekl2002: calls 250
CashMatteo: folds 
TowMadder: folds 
TheGrinch1991: calls 125
BF191919: checks 
*** FLOP *** [9h 9d 5d]
TheGrinch1991: checks 
BF191919: checks 
koolcanuck33: checks 
Jekl2002: checks 
*** TURN *** [9h 9d 5d] [6c]
TheGrinch1991: checks 
BF191919: checks 
koolcanuck33: checks 
Jekl2002: checks 
*** RIVER *** [9h 9d 5d 6c] [3d]
TheGrinch1991: checks 
BF191919: checks 
koolcanuck33: checks 
Jekl2002: bets 680
TheGrinch1991: folds 
BF191919: folds 
koolcanuck33: folds 
Uncalled bet (680) returned to Jekl2002
Jekl2002 collected 1360 from pot
Jekl2002: doesn't show hand 
*** SUMMARY ***
Total pot 1360 | Rake 0 
Board [9h 9d 5d 6c 3d]
Seat 1: koolcanuck33 folded on the River
Seat 2: Jekl2002 collected (1360)
Seat 3: CashMatteo folded before Flop (didn't bet)
Seat 4: TowMadder (button) folded before Flop (didn't bet)
Seat 5: TheGrinch1991 (small blind) folded on the River
Seat 7: BF191919 (big blind) folded on the River

Hand #1863: 

PokerStars Hand #246795859642: Tournament #3662938560, $0.94+$0.06 CAD Hold'em No Limit - Level X (150/300) - 2023/10/28 16:33:02 ET
Table '3662938560 1' 8-max Seat #5 is the button
Seat 1: koolcanuck33 (5020 in chips) 
Seat 2: Jekl2002 (4050 in chips) 
Seat 3: CashMatteo (11079 in chips) 
Seat 4: TowMadder (7356 in chips) 
Seat 5: TheGrinch1991 (6472 in chips) 
Seat 7: BF191919 (2010 in chips) 
koolcanuck33: posts the ante 75
Jekl2002: posts the ante 75
CashMatteo: posts the ante 75
TowMadder: posts the ante 75
TheGrinch1991: posts the ante 75
BF191919: posts the ante 75
BF191919: posts small blind 150
koolcanuck33: posts big blind 300
*** HOLE CARDS ***
Dealt to CashMatteo [Js 9h]
Jekl2002: folds 
CashMatteo: raises 450 to 750
TowMadder: folds 
TheGrinch1991: folds 
BF191919: folds 
koolcanuck33: calls 450
*** FLOP *** [Jc Kd Ah]
koolcanuck33: checks 
CashMatteo: bets 2100
koolcanuck33: raises 2095 to 4195 and is all-in
CashMatteo: calls 2095
*** TURN *** [Jc Kd Ah] [8s]
*** RIVER *** [Jc Kd Ah 8s] [6h]
*** SHOW DOWN ***
koolcanuck33: shows [Qs Ac] (a pair of Aces)
CashMatteo: shows [Js 9h] (a pair of Jacks)
koolcanuck33 collected 10490 from pot
*** SUMMARY ***
Total pot 10490 | Rake 0 
Board [Jc Kd Ah 8s 6h]
Seat 1: koolcanuck33 (big blind) showed [Qs Ac] and won (10490) with a pair of Aces
Seat 2: Jekl2002 folded before Flop (didn't bet)
Seat 3: CashMatteo showed [Js 9h] and lost with a pair of Jacks
Seat 4: TowMadder folded before Flop (didn't bet)
Seat 5: TheGrinch1991 (button) folded before Flop (didn't bet)
Seat 7: BF191919 (small blind) folded before Flop

Hand #1864: 

PokerStars Hand #246795875764: Tournament #3662938560, $0.94+$0.06 CAD Hold'em No Limit - Level X (150/300) - 2023/10/28 16:33:51 ET
Table '3662938560 1' 8-max Seat #7 is the button
Seat 1: koolcanuck33 (10490 in chips) 
Seat 2: Jekl2002 (3975 in chips) 
Seat 3: CashMatteo (6059 in chips) 
Seat 4: TowMadder (7281 in chips) 
Seat 5: TheGrinch1991 (6397 in chips) 
Seat 7: BF191919 (1785 in chips) 
koolcanuck33: posts the ante 75
Jekl2002: posts the ante 75
CashMatteo: posts the ante 75
TowMadder: posts the ante 75
TheGrinch1991: posts the ante 75
BF191919: posts the ante 75
koolcanuck33: posts small blind 150
Jekl2002: posts big blind 300
*** HOLE CARDS ***
Dealt to CashMatteo [Kc 3h]
CashMatteo: folds 
TowMadder: folds 
TheGrinch1991: folds 
BF191919: folds 
koolcanuck33: calls 150
Jekl2002: raises 3600 to 3900 and is all-in
koolcanuck33: folds 
Uncalled bet (3600) returned to Jekl2002
Jekl2002 collected 1050 from pot
Jekl2002: doesn't show hand 
*** SUMMARY ***
Total pot 1050 | Rake 0 
Seat 1: koolcanuck33 (small blind) folded before Flop
Seat 2: Jekl2002 (big blind) collected (1050)
Seat 3: CashMatteo folded before Flop (didn't bet)
Seat 4: TowMadder folded before Flop (didn't bet)
Seat 5: TheGrinch1991 folded before Flop (didn't bet)
Seat 7: BF191919 (button) folded before Flop (didn't bet)

Hand #1865: 

PokerStars Hand #246795881953: Tournament #3662938560, $0.94+$0.06 CAD Hold'em No Limit - Level X (150/300) - 2023/10/28 16:34:09 ET
Table '3662938560 1' 8-max Seat #1 is the button
Seat 1: koolcanuck33 (10115 in chips) 
Seat 2: Jekl2002 (4650 in chips) 
Seat 3: CashMatteo (5984 in chips) 
Seat 4: TowMadder (7206 in chips) 
Seat 5: TheGrinch1991 (6322 in chips) 
Seat 7: BF191919 (1710 in chips) 
koolcanuck33: posts the ante 75
Jekl2002: posts the ante 75
CashMatteo: posts the ante 75
TowMadder: posts the ante 75
TheGrinch1991: posts the ante 75
BF191919: posts the ante 75
Jekl2002: posts small blind 150
CashMatteo: posts big blind 300
*** HOLE CARDS ***
Dealt to CashMatteo [6d 7s]
TowMadder: folds 
TheGrinch1991: calls 300
BF191919: folds 
koolcanuck33: folds 
Jekl2002: calls 150
CashMatteo: checks 
*** FLOP *** [Qh 5c Ks]
Jekl2002: checks 
CashMatteo: checks 
TheGrinch1991: bets 300
Jekl2002: folds 
CashMatteo: folds 
Uncalled bet (300) returned to TheGrinch1991
TheGrinch1991 collected 1350 from pot
*** SUMMARY ***
Total pot 1350 | Rake 0 
Board [Qh 5c Ks]
Seat 1: koolcanuck33 (button) folded before Flop (didn't bet)
Seat 2: Jekl2002 (small blind) folded on the Flop
Seat 3: CashMatteo (big blind) folded on the Flop
Seat 4: TowMadder folded before Flop (didn't bet)
Seat 5: TheGrinch1991 collected (1350)
Seat 7: BF191919 folded before Flop (didn't bet)

Hand #1866: 

PokerStars Hand #246795890127: Tournament #3662938560, $0.94+$0.06 CAD Hold'em No Limit - Level X (150/300) - 2023/10/28 16:34:34 ET
Table '3662938560 1' 8-max Seat #2 is the button
Seat 1: koolcanuck33 (10040 in chips) 
Seat 2: Jekl2002 (4275 in chips) 
Seat 3: CashMatteo (5609 in chips) 
Seat 4: TowMadder (7131 in chips) 
Seat 5: TheGrinch1991 (7297 in chips) 
Seat 7: BF191919 (1635 in chips) 
koolcanuck33: posts the ante 75
Jekl2002: posts the ante 75
CashMatteo: posts the ante 75
TowMadder: posts the ante 75
TheGrinch1991: posts the ante 75
BF191919: posts the ante 75
CashMatteo: posts small blind 150
TowMadder: posts big blind 300
*** HOLE CARDS ***
Dealt to CashMatteo [9s Ks]
TheGrinch1991: folds 
BF191919: calls 300
koolcanuck33: folds 
Jekl2002: folds 
CashMatteo: calls 150
TowMadder: checks 
*** FLOP *** [5d 2s 6s]
CashMatteo: bets 675
TowMadder: folds 
BF191919: folds 
Uncalled bet (675) returned to CashMatteo
CashMatteo collected 1350 from pot
CashMatteo: doesn't show hand 
*** SUMMARY ***
Total pot 1350 | Rake 0 
Board [5d 2s 6s]
Seat 1: koolcanuck33 folded before Flop (didn't bet)
Seat 2: Jekl2002 (button) folded before Flop (didn't bet)
Seat 3: CashMatteo (small blind) collected (1350)
Seat 4: TowMadder (big blind) folded on the Flop
Seat 5: TheGrinch1991 folded before Flop (didn't bet)
Seat 7: BF191919 folded on the Flop

Hand #1867: 

PokerStars Hand #246795899101: Tournament #3662938560, $0.94+$0.06 CAD Hold'em No Limit - Level X (150/300) - 2023/10/28 16:35:01 ET
Table '3662938560 1' 8-max Seat #3 is the button
Seat 1: koolcanuck33 (9965 in chips) 
Seat 2: Jekl2002 (4200 in chips) 
Seat 3: CashMatteo (6584 in chips) 
Seat 4: TowMadder (6756 in chips) 
Seat 5: TheGrinch1991 (7222 in chips) 
Seat 7: BF191919 (1260 in chips) 
koolcanuck33: posts the ante 75
Jekl2002: posts the ante 75
CashMatteo: posts the ante 75
TowMadder: posts the ante 75
TheGrinch1991: posts the ante 75
BF191919: posts the ante 75
TowMadder: posts small blind 150
TheGrinch1991: posts big blind 300
*** HOLE CARDS ***
Dealt to CashMatteo [Th 5h]
BF191919: folds 
koolcanuck33: calls 300
Jekl2002: calls 300
CashMatteo: folds 
TowMadder: calls 150
TheGrinch1991: checks 
*** FLOP *** [7s Ks 3c]
TowMadder: checks 
TheGrinch1991: checks 
koolcanuck33: checks 
Jekl2002: checks 
*** TURN *** [7s Ks 3c] [6c]
TowMadder: checks 
TheGrinch1991: checks 
koolcanuck33: checks 
Jekl2002: checks 
*** RIVER *** [7s Ks 3c 6c] [3s]
TowMadder: checks 
TheGrinch1991: checks 
koolcanuck33: checks 
Jekl2002: bets 300
TowMadder: folds 
TheGrinch1991: folds 
koolcanuck33: folds 
Uncalled bet (300) returned to Jekl2002
Jekl2002 collected 1650 from pot
Jekl2002: doesn't show hand 
*** SUMMARY ***
Total pot 1650 | Rake 0 
Board [7s Ks 3c 6c 3s]
Seat 1: koolcanuck33 folded on the River
Seat 2: Jekl2002 collected (1650)
Seat 3: CashMatteo (button) folded before Flop (didn't bet)
Seat 4: TowMadder (small blind) folded on the River
Seat 5: TheGrinch1991 (big blind) folded on the River
Seat 7: BF191919 folded before Flop (didn't bet)

Hand #1868: 

PokerStars Hand #246795914309: Tournament #3662938560, $0.94+$0.06 CAD Hold'em No Limit - Level XI (200/400) - 2023/10/28 16:35:45 ET
Table '3662938560 1' 8-max Seat #4 is the button
Seat 1: koolcanuck33 (9590 in chips) 
Seat 2: Jekl2002 (5475 in chips) 
Seat 3: CashMatteo (6509 in chips) 
Seat 4: TowMadder (6381 in chips) 
Seat 5: TheGrinch1991 (6847 in chips) 
Seat 7: BF191919 (1185 in chips) 
koolcanuck33: posts the ante 100
Jekl2002: posts the ante 100
CashMatteo: posts the ante 100
TowMadder: posts the ante 100
TheGrinch1991: posts the ante 100
BF191919: posts the ante 100
TheGrinch1991: posts small blind 200
BF191919: posts big blind 400
*** HOLE CARDS ***
Dealt to CashMatteo [3h Kc]
koolcanuck33: calls 400
Jekl2002: calls 400
CashMatteo: folds 
TowMadder: folds 
TheGrinch1991: calls 200
BF191919: raises 685 to 1085 and is all-in
koolcanuck33: calls 685
Jekl2002: calls 685
TheGrinch1991: folds 
*** FLOP *** [9h 4h Qc]
koolcanuck33: checks 
Jekl2002: checks 
*** TURN *** [9h 4h Qc] [6c]
koolcanuck33: checks 
Jekl2002: checks 
*** RIVER *** [9h 4h Qc 6c] [5s]
koolcanuck33: checks 
Jekl2002: checks 
*** SHOW DOWN ***
BF191919: shows [Jc As] (high card Ace)
koolcanuck33: mucks hand 
Jekl2002: mucks hand 
BF191919 collected 4255 from pot
*** SUMMARY ***
Total pot 4255 | Rake 0 
Board [9h 4h Qc 6c 5s]
Seat 1: koolcanuck33 mucked [Th Ah]
Seat 2: Jekl2002 mucked [Ac 7h]
Seat 3: CashMatteo folded before Flop (didn't bet)
Seat 4: TowMadder (button) folded before Flop (didn't bet)
Seat 5: TheGrinch1991 (small blind) folded before Flop
Seat 7: BF191919 (big blind) showed [Jc As] and won (4255) with high card Ace

Hand #1869: 

PokerStars Hand #246795925047: Tournament #3662938560, $0.94+$0.06 CAD Hold'em No Limit - Level XI (200/400) - 2023/10/28 16:36:17 ET
Table '3662938560 1' 8-max Seat #5 is the button
Seat 1: koolcanuck33 (8405 in chips) 
Seat 2: Jekl2002 (4290 in chips) 
Seat 3: CashMatteo (6409 in chips) 
Seat 4: TowMadder (6281 in chips) 
Seat 5: TheGrinch1991 (6347 in chips) 
Seat 7: BF191919 (4255 in chips) 
koolcanuck33: posts the ante 100
Jekl2002: posts the ante 100
CashMatteo: posts the ante 100
TowMadder: posts the ante 100
TheGrinch1991: posts the ante 100
BF191919: posts the ante 100
BF191919: posts small blind 200
koolcanuck33: posts big blind 400
*** HOLE CARDS ***
Dealt to CashMatteo [Tc 4h]
Jekl2002: folds 
CashMatteo: folds 
TowMadder: folds 
TheGrinch1991: folds 
BF191919: folds 
Uncalled bet (200) returned to koolcanuck33
koolcanuck33 collected 1000 from pot
koolcanuck33: doesn't show hand 
*** SUMMARY ***
Total pot 1000 | Rake 0 
Seat 1: koolcanuck33 (big blind) collected (1000)
Seat 2: Jekl2002 folded before Flop (didn't bet)
Seat 3: CashMatteo folded before Flop (didn't bet)
Seat 4: TowMadder folded before Flop (didn't bet)
Seat 5: TheGrinch1991 (button) folded before Flop (didn't bet)
Seat 7: BF191919 (small blind) folded before Flop

Hand #1870: 

PokerStars Hand #246795930297: Tournament #3662938560, $0.94+$0.06 CAD Hold'em No Limit - Level XI (200/400) - 2023/10/28 16:36:34 ET
Table '3662938560 1' 8-max Seat #7 is the button
Seat 1: koolcanuck33 (9105 in chips) 
Seat 2: Jekl2002 (4190 in chips) 
Seat 3: CashMatteo (6309 in chips) 
Seat 4: TowMadder (6181 in chips) 
Seat 5: TheGrinch1991 (6247 in chips) 
Seat 7: BF191919 (3955 in chips) 
koolcanuck33: posts the ante 100
Jekl2002: posts the ante 100
CashMatteo: posts the ante 100
TowMadder: posts the ante 100
TheGrinch1991: posts the ante 100
BF191919: posts the ante 100
koolcanuck33: posts small blind 200
Jekl2002: posts big blind 400
*** HOLE CARDS ***
Dealt to CashMatteo [5h Qd]
CashMatteo: folds 
TowMadder: calls 400
TheGrinch1991: folds 
BF191919: raises 400 to 800
koolcanuck33: folds 
Jekl2002: calls 400
TowMadder: calls 400
*** FLOP *** [4c 7d 4s]
Jekl2002: checks 
TowMadder: checks 
BF191919: bets 800
Jekl2002: folds 
TowMadder: folds 
Uncalled bet (800) returned to BF191919
BF191919 collected 3200 from pot
BF191919: doesn't show hand 
*** SUMMARY ***
Total pot 3200 | Rake 0 
Board [4c 7d 4s]
Seat 1: koolcanuck33 (small blind) folded before Flop
Seat 2: Jekl2002 (big blind) folded on the Flop
Seat 3: CashMatteo folded before Flop (didn't bet)
Seat 4: TowMadder folded on the Flop
Seat 5: TheGrinch1991 folded before Flop (didn't bet)
Seat 7: BF191919 (button) collected (3200)

Hand #1871: 

PokerStars Hand #246795942629: Tournament #3662938560, $0.94+$0.06 CAD Hold'em No Limit - Level XI (200/400) - 2023/10/28 16:37:10 ET
Table '3662938560 1' 8-max Seat #1 is the button
Seat 1: koolcanuck33 (8805 in chips) 
Seat 2: Jekl2002 (3290 in chips) 
Seat 3: CashMatteo (6209 in chips) 
Seat 4: TowMadder (5281 in chips) 
Seat 5: TheGrinch1991 (6147 in chips) 
Seat 7: BF191919 (6255 in chips) 
koolcanuck33: posts the ante 100
Jekl2002: posts the ante 100
CashMatteo: posts the ante 100
TowMadder: posts the ante 100
TheGrinch1991: posts the ante 100
BF191919: posts the ante 100
Jekl2002: posts small blind 200
CashMatteo: posts big blind 400
*** HOLE CARDS ***
Dealt to CashMatteo [9c Tc]
TowMadder: folds 
TheGrinch1991: calls 400
BF191919: folds 
koolcanuck33: folds 
Jekl2002: calls 200
CashMatteo: checks 
*** FLOP *** [3s 5c 3d]
Jekl2002: checks 
CashMatteo: checks 
TheGrinch1991: bets 400
Jekl2002: calls 400
CashMatteo: calls 400
*** TURN *** [3s 5c 3d] [Ac]
Jekl2002: checks 
CashMatteo: checks 
TheGrinch1991: checks 
*** RIVER *** [3s 5c 3d Ac] [Jh]
Jekl2002: checks 
CashMatteo: checks 
TheGrinch1991: checks 
*** SHOW DOWN ***
Jekl2002: shows [4s 5s] (two pair, Fives and Threes)
CashMatteo: mucks hand 
TheGrinch1991: shows [Td Jd] (two pair, Jacks and Threes)
TheGrinch1991 collected 3000 from pot
*** SUMMARY ***
Total pot 3000 | Rake 0 
Board [3s 5c 3d Ac Jh]
Seat 1: koolcanuck33 (button) folded before Flop (didn't bet)
Seat 2: Jekl2002 (small blind) showed [4s 5s] and lost with two pair, Fives and Threes
Seat 3: CashMatteo (big blind) mucked [9c Tc]
Seat 4: TowMadder folded before Flop (didn't bet)
Seat 5: TheGrinch1991 showed [Td Jd] and won (3000) with two pair, Jacks and Threes
Seat 7: BF191919 folded before Flop (didn't bet)

Hand #1872: 

PokerStars Hand #246795955755: Tournament #3662938560, $0.94+$0.06 CAD Hold'em No Limit - Level XI (200/400) - 2023/10/28 16:37:50 ET
Table '3662938560 1' 8-max Seat #2 is the button
Seat 1: koolcanuck33 (8705 in chips) 
Seat 2: Jekl2002 (2390 in chips) 
Seat 3: CashMatteo (5309 in chips) 
Seat 4: TowMadder (5181 in chips) 
Seat 5: TheGrinch1991 (8247 in chips) 
Seat 7: BF191919 (6155 in chips) 
koolcanuck33: posts the ante 100
Jekl2002: posts the ante 100
CashMatteo: posts the ante 100
TowMadder: posts the ante 100
TheGrinch1991: posts the ante 100
BF191919: posts the ante 100
CashMatteo: posts small blind 200
TowMadder: posts big blind 400
*** HOLE CARDS ***
Dealt to CashMatteo [8d 4h]
TheGrinch1991: folds 
BF191919: calls 400
koolcanuck33: folds 
Jekl2002: raises 1890 to 2290 and is all-in
CashMatteo: folds 
TowMadder: folds 
BF191919: folds 
Uncalled bet (1890) returned to Jekl2002
Jekl2002 collected 2000 from pot
Jekl2002: doesn't show hand 
*** SUMMARY ***
Total pot 2000 | Rake 0 
Seat 1: koolcanuck33 folded before Flop (didn't bet)
Seat 2: Jekl2002 (button) collected (2000)
Seat 3: CashMatteo (small blind) folded before Flop
Seat 4: TowMadder (big blind) folded before Flop
Seat 5: TheGrinch1991 folded before Flop (didn't bet)
Seat 7: BF191919 folded before Flop

Hand #1873: 

PokerStars Hand #246795961009: Tournament #3662938560, $0.94+$0.06 CAD Hold'em No Limit - Level XI (200/400) - 2023/10/28 16:38:06 ET
Table '3662938560 1' 8-max Seat #3 is the button
Seat 1: koolcanuck33 (8605 in chips) 
Seat 2: Jekl2002 (3890 in chips) 
Seat 3: CashMatteo (5009 in chips) 
Seat 4: TowMadder (4681 in chips) 
Seat 5: TheGrinch1991 (8147 in chips) 
Seat 7: BF191919 (5655 in chips) 
koolcanuck33: posts the ante 100
Jekl2002: posts the ante 100
CashMatteo: posts the ante 100
TowMadder: posts the ante 100
TheGrinch1991: posts the ante 100
BF191919: posts the ante 100
TowMadder: posts small blind 200
TheGrinch1991: posts big blind 400
*** HOLE CARDS ***
Dealt to CashMatteo [Tc 3d]
BF191919: folds 
koolcanuck33: folds 
Jekl2002: raises 3390 to 3790 and is all-in
CashMatteo: folds 
TowMadder: folds 
TheGrinch1991: folds 
Uncalled bet (3390) returned to Jekl2002
Jekl2002 collected 1600 from pot
Jekl2002: doesn't show hand 
*** SUMMARY ***
Total pot 1600 | Rake 0 
Seat 1: koolcanuck33 folded before Flop (didn't bet)
Seat 2: Jekl2002 collected (1600)
Seat 3: CashMatteo (button) folded before Flop (didn't bet)
Seat 4: TowMadder (small blind) folded before Flop
Seat 5: TheGrinch1991 (big blind) folded before Flop
Seat 7: BF191919 folded before Flop (didn't bet)

Hand #1874: 

PokerStars Hand #246795968294: Tournament #3662938560, $0.94+$0.06 CAD Hold'em No Limit - Level XII (250/500) - 2023/10/28 16:38:28 ET
Table '3662938560 1' 8-max Seat #4 is the button
Seat 1: koolcanuck33 (8505 in chips) 
Seat 2: Jekl2002 (4990 in chips) 
Seat 3: CashMatteo (4909 in chips) 
Seat 4: TowMadder (4381 in chips) 
Seat 5: TheGrinch1991 (7647 in chips) 
Seat 7: BF191919 (5555 in chips) 
koolcanuck33: posts the ante 125
Jekl2002: posts the ante 125
CashMatteo: posts the ante 125
TowMadder: posts the ante 125
TheGrinch1991: posts the ante 125
BF191919: posts the ante 125
TheGrinch1991: posts small blind 250
BF191919: posts big blind 500
*** HOLE CARDS ***
Dealt to CashMatteo [8c As]
koolcanuck33: folds 
Jekl2002: folds 
CashMatteo: calls 500
TowMadder: folds 
TheGrinch1991: calls 250
BF191919: checks 
*** FLOP *** [7s 2d Tc]
TheGrinch1991: checks 
BF191919: bets 500
CashMatteo: folds 
BacardiShots is disconnected 
TheGrinch1991: folds 
Uncalled bet (500) returned to BF191919
BF191919 collected 2250 from pot
BF191919: doesn't show hand 
*** SUMMARY ***
Total pot 2250 | Rake 0 
Board [7s 2d Tc]
Seat 1: koolcanuck33 folded before Flop (didn't bet)
Seat 2: Jekl2002 folded before Flop (didn't bet)
Seat 3: CashMatteo folded on the Flop
Seat 4: TowMadder (button) folded before Flop (didn't bet)
Seat 5: TheGrinch1991 (small blind) folded on the Flop
Seat 7: BF191919 (big blind) collected (2250)

Hand #1875: 

PokerStars Hand #246795977379: Tournament #3662938560, $0.94+$0.06 CAD Hold'em No Limit - Level XII (250/500) - 2023/10/28 16:38:54 ET
Table '3662938560 1' 8-max Seat #5 is the button
Seat 1: koolcanuck33 (8380 in chips) 
Seat 2: Jekl2002 (4865 in chips) 
Seat 3: CashMatteo (4284 in chips) 
Seat 4: TowMadder (4256 in chips) 
Seat 5: TheGrinch1991 (7022 in chips) 
Seat 6: BacardiShots (11965 in chips) out of hand (moved from another table into small blind)
Seat 7: BF191919 (7180 in chips) 
Seat 8: kingozzy7 (90 in chips) 
BacardiShots will be allowed to play after the button
koolcanuck33: posts the ante 125
Jekl2002: posts the ante 125
CashMatteo: posts the ante 125
TowMadder: posts the ante 125
TheGrinch1991: posts the ante 125
BF191919: posts the ante 125
kingozzy7: posts the ante 90 and is all-in
BF191919: posts small blind 250
*** HOLE CARDS ***
Dealt to CashMatteo [4s 9d]
koolcanuck33: folds 
Jekl2002: folds 
CashMatteo: folds 
TowMadder: calls 500
TheGrinch1991: folds 
BF191919: calls 250
*** FLOP *** [Jd 5c Ks]
BF191919: checks 
TowMadder: checks 
*** TURN *** [Jd 5c Ks] [8d]
BF191919: checks 
TowMadder: checks 
*** RIVER *** [Jd 5c Ks 8d] [Ac]
BF191919: bets 500
TowMadder: raises 500 to 1000
BF191919: raises 1500 to 2500
TowMadder: folds 
Uncalled bet (1500) returned to BF191919
*** SHOW DOWN ***
BF191919: shows [Td Qs] (a straight, Ten to Ace)
BF191919 collected 3210 from side pot
kingozzy7: shows [Kd 8s] (two pair, Kings and Eights)
BF191919 collected 630 from main pot
kingozzy7 finished the tournament in 16th place
*** SUMMARY ***
Total pot 3840 Main pot 630. Side pot 3210. | Rake 0 
Board [Jd 5c Ks 8d Ac]
Seat 1: koolcanuck33 folded before Flop (didn't bet)
Seat 2: Jekl2002 folded before Flop (didn't bet)
Seat 3: CashMatteo folded before Flop (didn't bet)
Seat 4: TowMadder folded on the River
Seat 5: TheGrinch1991 (button) folded before Flop (didn't bet)
Seat 7: BF191919 (small blind) showed [Td Qs] and won (3840) with a straight, Ten to Ace
Seat 8: kingozzy7 showed [Kd 8s] and lost with two pair, Kings and Eights

Hand #1876: 

PokerStars Hand #246795994023: Tournament #3662938560, $0.94+$0.06 CAD Hold'em No Limit - Level XII (250/500) - 2023/10/28 16:39:45 ET
Table '3662938560 1' 8-max Seat #7 is the button
Seat 1: koolcanuck33 (8255 in chips) 
Seat 2: Jekl2002 (4740 in chips) 
Seat 3: CashMatteo (4159 in chips) 
Seat 4: TowMadder (2631 in chips) 
Seat 5: TheGrinch1991 (6897 in chips) 
Seat 6: BacardiShots (11965 in chips) 
Seat 7: BF191919 (9395 in chips) 
koolcanuck33: posts the ante 125
Jekl2002: posts the ante 125
CashMatteo: posts the ante 125
TowMadder: posts the ante 125
TheGrinch1991: posts the ante 125
BacardiShots: posts the ante 125
BF191919: posts the ante 125
koolcanuck33: posts small blind 250
Jekl2002: posts big blind 500
*** HOLE CARDS ***
Dealt to CashMatteo [2h Qd]
CashMatteo: folds 
TowMadder: calls 500
TheGrinch1991: folds 
BacardiShots: folds 
BF191919: folds 
koolcanuck33: folds 
Jekl2002: checks 
*** FLOP *** [Qc 5s 2s]
Jekl2002: checks 
TowMadder: checks 
*** TURN *** [Qc 5s 2s] [Ks]
Jekl2002: checks 
TowMadder: bets 500
Jekl2002: folds 
Uncalled bet (500) returned to TowMadder
TowMadder collected 2125 from pot
*** SUMMARY ***
Total pot 2125 | Rake 0 
Board [Qc 5s 2s Ks]
Seat 1: koolcanuck33 (small blind) folded before Flop
Seat 2: Jekl2002 (big blind) folded on the Turn
Seat 3: CashMatteo folded before Flop (didn't bet)
Seat 4: TowMadder collected (2125)
Seat 5: TheGrinch1991 folded before Flop (didn't bet)
Seat 6: BacardiShots folded before Flop (didn't bet)
Seat 7: BF191919 (button) folded before Flop (didn't bet)

Hand #1877: 

PokerStars Hand #246796003739: Tournament #3662938560, $0.94+$0.06 CAD Hold'em No Limit - Level XII (250/500) - 2023/10/28 16:40:14 ET
Table '3662938560 1' 8-max Seat #1 is the button
Seat 1: koolcanuck33 (7880 in chips) 
Seat 2: Jekl2002 (4115 in chips) 
Seat 3: CashMatteo (4034 in chips) 
Seat 4: TowMadder (4131 in chips) 
Seat 5: TheGrinch1991 (6772 in chips) 
Seat 6: BacardiShots (11840 in chips) 
Seat 7: BF191919 (9270 in chips) 
koolcanuck33: posts the ante 125
Jekl2002: posts the ante 125
CashMatteo: posts the ante 125
TowMadder: posts the ante 125
TheGrinch1991: posts the ante 125
BacardiShots: posts the ante 125
BF191919: posts the ante 125
Jekl2002: posts small blind 250
CashMatteo: posts big blind 500
*** HOLE CARDS ***
Dealt to CashMatteo [3s 8s]
TowMadder: folds 
TheGrinch1991: folds 
BacardiShots: raises 750 to 1250
BF191919: folds 
koolcanuck33: folds 
Jekl2002: folds 
CashMatteo: folds 
Uncalled bet (750) returned to BacardiShots
BacardiShots collected 2125 from pot
BacardiShots: doesn't show hand 
*** SUMMARY ***
Total pot 2125 | Rake 0 
Seat 1: koolcanuck33 (button) folded before Flop (didn't bet)
Seat 2: Jekl2002 (small blind) folded before Flop
Seat 3: CashMatteo (big blind) folded before Flop
Seat 4: TowMadder folded before Flop (didn't bet)
Seat 5: TheGrinch1991 folded before Flop (didn't bet)
Seat 6: BacardiShots collected (2125)
Seat 7: BF191919 folded before Flop (didn't bet)

Hand #1878: 

PokerStars Hand #246796011712: Tournament #3662938560, $0.94+$0.06 CAD Hold'em No Limit - Level XII (250/500) - 2023/10/28 16:40:38 ET
Table '3662938560 1' 8-max Seat #2 is the button
Seat 1: koolcanuck33 (7755 in chips) 
Seat 2: Jekl2002 (3740 in chips) 
Seat 3: CashMatteo (3409 in chips) 
Seat 4: TowMadder (4006 in chips) 
Seat 5: TheGrinch1991 (6647 in chips) 
Seat 6: BacardiShots (13340 in chips) 
Seat 7: BF191919 (9145 in chips) 
koolcanuck33: posts the ante 125
Jekl2002: posts the ante 125
CashMatteo: posts the ante 125
TowMadder: posts the ante 125
TheGrinch1991: posts the ante 125
BacardiShots: posts the ante 125
BF191919: posts the ante 125
CashMatteo: posts small blind 250
TowMadder: posts big blind 500
*** HOLE CARDS ***
Dealt to CashMatteo [Ad 2c]
TheGrinch1991: folds 
BacardiShots: folds 
BF191919: calls 500
koolcanuck33: folds 
Jekl2002: calls 500
CashMatteo: calls 250
TowMadder: checks 
*** FLOP *** [8d 5h 3c]
CashMatteo: checks 
TowMadder: checks 
BF191919: checks 
Jekl2002: checks 
*** TURN *** [8d 5h 3c] [5s]
CashMatteo: checks 
TowMadder: checks 
BF191919: checks 
Jekl2002: checks 
*** RIVER *** [8d 5h 3c 5s] [Kh]
CashMatteo: checks 
TowMadder: checks 
BF191919: checks 
Jekl2002: checks 
*** SHOW DOWN ***
CashMatteo: shows [Ad 2c] (a pair of Fives)
TowMadder: shows [Qc 3d] (two pair, Fives and Threes)
BF191919: mucks hand 
Jekl2002: mucks hand 
TowMadder collected 2875 from pot
*** SUMMARY ***
Total pot 2875 | Rake 0 
Board [8d 5h 3c 5s Kh]
Seat 1: koolcanuck33 folded before Flop (didn't bet)
Seat 2: Jekl2002 (button) mucked [9c Tc]
Seat 3: CashMatteo (small blind) showed [Ad 2c] and lost with a pair of Fives
Seat 4: TowMadder (big blind) showed [Qc 3d] and won (2875) with two pair, Fives and Threes
Seat 5: TheGrinch1991 folded before Flop (didn't bet)
Seat 6: BacardiShots folded before Flop (didn't bet)
Seat 7: BF191919 mucked [Ah 9s]

Hand #1879: 

PokerStars Hand #246796033862: Tournament #3662938560, $0.94+$0.06 CAD Hold'em No Limit - Level XIII (300/600) - 2023/10/28 16:41:47 ET
Table '3662938560 1' 8-max Seat #3 is the button
Seat 1: koolcanuck33 (7630 in chips) 
Seat 2: Jekl2002 (3115 in chips) 
Seat 3: CashMatteo (2784 in chips) 
Seat 4: TowMadder (6256 in chips) 
Seat 5: TheGrinch1991 (6522 in chips) 
Seat 6: BacardiShots (13215 in chips) 
Seat 7: BF191919 (8520 in chips) 
koolcanuck33: posts the ante 150
Jekl2002: posts the ante 150
CashMatteo: posts the ante 150
TowMadder: posts the ante 150
TheGrinch1991: posts the ante 150
BacardiShots: posts the ante 150
BF191919: posts the ante 150
TowMadder: posts small blind 300
TheGrinch1991: posts big blind 600
*** HOLE CARDS ***
Dealt to CashMatteo [8c 2h]
BacardiShots: raises 720 to 1320
BF191919: folds 
koolcanuck33: folds 
Jekl2002: folds 
CashMatteo: folds 
TowMadder: folds 
TheGrinch1991: folds 
Uncalled bet (720) returned to BacardiShots
BacardiShots collected 2550 from pot
BacardiShots: doesn't show hand 
*** SUMMARY ***
Total pot 2550 | Rake 0 
Seat 1: koolcanuck33 folded before Flop (didn't bet)
Seat 2: Jekl2002 folded before Flop (didn't bet)
Seat 3: CashMatteo (button) folded before Flop (didn't bet)
Seat 4: TowMadder (small blind) folded before Flop
Seat 5: TheGrinch1991 (big blind) folded before Flop
Seat 6: BacardiShots collected (2550)
Seat 7: BF191919 folded before Flop (didn't bet)

Hand #1880: 

PokerStars Hand #246796037735: Tournament #3662938560, $0.94+$0.06 CAD Hold'em No Limit - Level XIII (300/600) - 2023/10/28 16:41:58 ET
Table '3662938560 1' 8-max Seat #4 is the button
Seat 2: Jekl2002 (2965 in chips) 
Seat 3: CashMatteo (2634 in chips) 
Seat 4: TowMadder (5806 in chips) 
Seat 5: TheGrinch1991 (5772 in chips) 
Seat 6: BacardiShots (15015 in chips) 
Seat 7: BF191919 (8370 in chips) 
Jekl2002: posts the ante 150
CashMatteo: posts the ante 150
TowMadder: posts the ante 150
TheGrinch1991: posts the ante 150
BacardiShots: posts the ante 150
BF191919: posts the ante 150
TheGrinch1991: posts small blind 300
BacardiShots: posts big blind 600
*** HOLE CARDS ***
Dealt to CashMatteo [4d 3h]
BF191919: folds 
Jekl2002: raises 2215 to 2815 and is all-in
CashMatteo: folds 
TowMadder: folds 
TheGrinch1991: folds 
BacardiShots: folds 
Uncalled bet (2215) returned to Jekl2002
Jekl2002 collected 2400 from pot
Jekl2002: doesn't show hand 
*** SUMMARY ***
Total pot 2400 | Rake 0 
Seat 2: Jekl2002 collected (2400)
Seat 3: CashMatteo folded before Flop (didn't bet)
Seat 4: TowMadder (button) folded before Flop (didn't bet)
Seat 5: TheGrinch1991 (small blind) folded before Flop
Seat 6: BacardiShots (big blind) folded before Flop
Seat 7: BF191919 folded before Flop (didn't bet)

Hand #1881: 

PokerStars Hand #246796045916: Tournament #3662938560, $0.94+$0.06 CAD Hold'em No Limit - Level XIII (300/600) - 2023/10/28 16:42:24 ET
Table '3662938560 1' 8-max Seat #5 is the button
Seat 2: Jekl2002 (4615 in chips) 
Seat 3: CashMatteo (2484 in chips) 
Seat 4: TowMadder (5656 in chips) 
Seat 5: TheGrinch1991 (5322 in chips) 
Seat 6: BacardiShots (14265 in chips) 
Seat 7: BF191919 (8220 in chips) 
Jekl2002: posts the ante 150
CashMatteo: posts the ante 150
TowMadder: posts the ante 150
TheGrinch1991: posts the ante 150
BacardiShots: posts the ante 150
BF191919: posts the ante 150
BacardiShots: posts small blind 300
BF191919: posts big blind 600
*** HOLE CARDS ***
Dealt to CashMatteo [6c 5s]
Jekl2002: folds 
CashMatteo: folds 
TowMadder: folds 
TheGrinch1991: folds 
BacardiShots: raises 13515 to 14115 and is all-in
BF191919: folds 
Uncalled bet (13515) returned to BacardiShots
BacardiShots collected 2100 from pot
BacardiShots: doesn't show hand 
*** SUMMARY ***
Total pot 2100 | Rake 0 
Seat 2: Jekl2002 folded before Flop (didn't bet)
Seat 3: CashMatteo folded before Flop (didn't bet)
Seat 4: TowMadder folded before Flop (didn't bet)
Seat 5: TheGrinch1991 (button) folded before Flop (didn't bet)
Seat 6: BacardiShots (small blind) collected (2100)
Seat 7: BF191919 (big blind) folded before Flop

Hand #1882: 

PokerStars Hand #246796051883: Tournament #3662938560, $0.94+$0.06 CAD Hold'em No Limit - Level XIII (300/600) - 2023/10/28 16:42:42 ET
Table '3662938560 1' 8-max Seat #6 is the button
Seat 2: Jekl2002 (4465 in chips) 
Seat 3: CashMatteo (2334 in chips) 
Seat 4: TowMadder (5506 in chips) 
Seat 5: TheGrinch1991 (5172 in chips) 
Seat 6: BacardiShots (15615 in chips) 
Seat 7: BF191919 (7470 in chips) 
Jekl2002: posts the ante 150
CashMatteo: posts the ante 150
TowMadder: posts the ante 150
TheGrinch1991: posts the ante 150
BacardiShots: posts the ante 150
BF191919: posts the ante 150
BF191919: posts small blind 300
Jekl2002: posts big blind 600
*** HOLE CARDS ***
Dealt to CashMatteo [Kc Tc]
CashMatteo: raises 1584 to 2184 and is all-in
TowMadder: folds 
TheGrinch1991: folds 
BacardiShots: calls 2184
BF191919: folds 
Jekl2002: calls 1584
*** FLOP *** [8s 4h 7h]
Jekl2002: checks 
BacardiShots: bets 2400
Jekl2002: calls 2131 and is all-in
Uncalled bet (269) returned to BacardiShots
*** TURN *** [8s 4h 7h] [Qd]
*** RIVER *** [8s 4h 7h Qd] [Kd]
*** SHOW DOWN ***
Jekl2002: shows [Jc 6d] (high card King)
BacardiShots: shows [3s Ac] (high card Ace)
BacardiShots collected 4262 from side pot
CashMatteo: shows [Kc Tc] (a pair of Kings)
CashMatteo collected 7752 from main pot
Jekl2002 finished the tournament in 12th place
*** SUMMARY ***
Total pot 12014 Main pot 7752. Side pot 4262. | Rake 0 
Board [8s 4h 7h Qd Kd]
Seat 2: Jekl2002 (big blind) showed [Jc 6d] and lost with high card King
Seat 3: CashMatteo showed [Kc Tc] and won (7752) with a pair of Kings
Seat 4: TowMadder folded before Flop (didn't bet)
Seat 5: TheGrinch1991 folded before Flop (didn't bet)
Seat 6: BacardiShots (button) showed [3s Ac] and won (4262) with high card Ace
Seat 7: BF191919 (small blind) folded before Flop

Hand #1883: 

PokerStars Hand #246796063295: Tournament #3662938560, $0.94+$0.06 CAD Hold'em No Limit - Level XIII (300/600) - 2023/10/28 16:43:18 ET
Table '3662938560 1' 8-max Seat #7 is the button
Seat 3: CashMatteo (7752 in chips) 
Seat 4: TowMadder (5356 in chips) 
Seat 5: TheGrinch1991 (5022 in chips) 
Seat 6: BacardiShots (15412 in chips) 
Seat 7: BF191919 (7020 in chips) 
CashMatteo: posts the ante 150
TowMadder: posts the ante 150
TheGrinch1991: posts the ante 150
BacardiShots: posts the ante 150
BF191919: posts the ante 150
CashMatteo: posts small blind 300
TowMadder: posts big blind 600
*** HOLE CARDS ***
Dealt to CashMatteo [6d 4s]
TheGrinch1991: folds 
BacardiShots: raises 720 to 1320
BF191919: raises 1680 to 3000
CashMatteo: folds 
TowMadder: folds 
BacardiShots: folds 
Uncalled bet (1680) returned to BF191919
BF191919 collected 4290 from pot
BF191919: doesn't show hand 
*** SUMMARY ***
Total pot 4290 | Rake 0 
Seat 3: CashMatteo (small blind) folded before Flop
Seat 4: TowMadder (big blind) folded before Flop
Seat 5: TheGrinch1991 folded before Flop (didn't bet)
Seat 6: BacardiShots folded before Flop
Seat 7: BF191919 (button) collected (4290)

Hand #1884: 

PokerStars Hand #246796073082: Tournament #3662938560, $0.94+$0.06 CAD Hold'em No Limit - Level XIII (300/600) - 2023/10/28 16:43:48 ET
Table '3662938560 1' 8-max Seat #3 is the button
Seat 3: CashMatteo (7302 in chips) 
Seat 4: TowMadder (4606 in chips) 
Seat 5: TheGrinch1991 (4872 in chips) 
Seat 6: BacardiShots (13942 in chips) 
Seat 7: BF191919 (9840 in chips) 
CashMatteo: posts the ante 150
TowMadder: posts the ante 150
TheGrinch1991: posts the ante 150
BacardiShots: posts the ante 150
BF191919: posts the ante 150
TowMadder: posts small blind 300
TheGrinch1991: posts big blind 600
*** HOLE CARDS ***
Dealt to CashMatteo [7d 3d]
BacardiShots: folds 
BF191919: folds 
CashMatteo: folds 
TowMadder: folds 
Uncalled bet (300) returned to TheGrinch1991
TheGrinch1991 collected 1350 from pot
*** SUMMARY ***
Total pot 1350 | Rake 0 
Seat 3: CashMatteo (button) folded before Flop (didn't bet)
Seat 4: TowMadder (small blind) folded before Flop
Seat 5: TheGrinch1991 (big blind) collected (1350)
Seat 6: BacardiShots folded before Flop (didn't bet)
Seat 7: BF191919 folded before Flop (didn't bet)

Hand #1885: 

PokerStars Hand #246796076135: Tournament #3662938560, $0.94+$0.06 CAD Hold'em No Limit - Level XIII (300/600) - 2023/10/28 16:43:57 ET
Table '3662938560 1' 8-max Seat #4 is the button
Seat 3: CashMatteo (7152 in chips) 
Seat 4: TowMadder (4156 in chips) 
Seat 5: TheGrinch1991 (5772 in chips) 
Seat 6: BacardiShots (13792 in chips) 
Seat 7: BF191919 (9690 in chips) 
CashMatteo: posts the ante 150
TowMadder: posts the ante 150
TheGrinch1991: posts the ante 150
BacardiShots: posts the ante 150
BF191919: posts the ante 150
TheGrinch1991: posts small blind 300
BacardiShots: posts big blind 600
*** HOLE CARDS ***
Dealt to CashMatteo [8c Kc]
BF191919: folds 
CashMatteo: folds 
TowMadder: folds 
TheGrinch1991: calls 300
BacardiShots: raises 13042 to 13642 and is all-in
TheGrinch1991: folds 
Uncalled bet (13042) returned to BacardiShots
BacardiShots collected 1950 from pot
BacardiShots: doesn't show hand 
*** SUMMARY ***
Total pot 1950 | Rake 0 
Seat 3: CashMatteo folded before Flop (didn't bet)
Seat 4: TowMadder (button) folded before Flop (didn't bet)
Seat 5: TheGrinch1991 (small blind) folded before Flop
Seat 6: BacardiShots (big blind) collected (1950)
Seat 7: BF191919 folded before Flop (didn't bet)

Hand #1886: 

PokerStars Hand #246796085169: Tournament #3662938560, $0.94+$0.06 CAD Hold'em No Limit - Level XIV (400/800) - 2023/10/28 16:44:25 ET
Table '3662938560 1' 8-max Seat #5 is the button
Seat 3: CashMatteo (7002 in chips) 
Seat 4: TowMadder (4006 in chips) 
Seat 5: TheGrinch1991 (5022 in chips) 
Seat 6: BacardiShots (14992 in chips) 
Seat 7: BF191919 (9540 in chips) 
CashMatteo: posts the ante 200
TowMadder: posts the ante 200
TheGrinch1991: posts the ante 200
BacardiShots: posts the ante 200
BF191919: posts the ante 200
BacardiShots: posts small blind 400
BF191919: posts big blind 800
*** HOLE CARDS ***
Dealt to CashMatteo [Jh 4d]
CashMatteo: folds 
TowMadder: folds 
TheGrinch1991: folds 
BacardiShots: raises 960 to 1760
BF191919: calls 960
*** FLOP *** [9d 8d 4s]
BacardiShots: bets 2531
BF191919: folds 
Uncalled bet (2531) returned to BacardiShots
BacardiShots collected 4520 from pot
BacardiShots: doesn't show hand 
*** SUMMARY ***
Total pot 4520 | Rake 0 
Board [9d 8d 4s]
Seat 3: CashMatteo folded before Flop (didn't bet)
Seat 4: TowMadder folded before Flop (didn't bet)
Seat 5: TheGrinch1991 (button) folded before Flop (didn't bet)
Seat 6: BacardiShots (small blind) collected (4520)
Seat 7: BF191919 (big blind) folded on the Flop

Hand #1887: 

PokerStars Hand #246796098487: Tournament #3662938560, $0.94+$0.06 CAD Hold'em No Limit - Level XIV (400/800) - 2023/10/28 16:45:06 ET
Table '3662938560 2' 9-max Seat #1 is the button
Seat 1: BF191919 (7580 in chips) 
Seat 2: BacardiShots (17552 in chips) 
Seat 3: TheGrinch1991 (4822 in chips) 
Seat 4: TowMadder (3806 in chips) 
Seat 5: CashMatteo (6802 in chips) 
Seat 6: ethancu1014 (29358 in chips) 
Seat 7: turjles (12010 in chips) 
Seat 8: davey1972 (9540 in chips) 
Seat 9: koolcanuck33 (4530 in chips) 
BF191919: posts the ante 200
BacardiShots: posts the ante 200
TheGrinch1991: posts the ante 200
TowMadder: posts the ante 200
CashMatteo: posts the ante 200
ethancu1014: posts the ante 200
turjles: posts the ante 200
davey1972: posts the ante 200
koolcanuck33: posts the ante 200
BacardiShots: posts small blind 400
TheGrinch1991: posts big blind 800
*** HOLE CARDS ***
Dealt to CashMatteo [As 2h]
BacardiShots is disconnected 
TowMadder is connected 
TowMadder: folds 
CashMatteo: folds 
ethancu1014: folds 
turjles: folds 
davey1972: folds 
koolcanuck33: folds 
BF191919: raises 800 to 1600
BacardiShots: folds 
TheGrinch1991: calls 800
*** FLOP *** [Qs 6c 8d]
TheGrinch1991: bets 800
BF191919: raises 1200 to 2000
TheGrinch1991: raises 1022 to 3022 and is all-in
BF191919: calls 1022
*** TURN *** [Qs 6c 8d] [Kc]
*** RIVER *** [Qs 6c 8d Kc] [Kh]
*** SHOW DOWN ***
TheGrinch1991: shows [Qh Kd] (a full house, Kings full of Queens)
BF191919: shows [Ts 9s] (a pair of Kings)
TheGrinch1991 collected 11444 from pot
*** SUMMARY ***
Total pot 11444 | Rake 0 
Board [Qs 6c 8d Kc Kh]
Seat 1: BF191919 (button) showed [Ts 9s] and lost with a pair of Kings
Seat 2: BacardiShots (small blind) folded before Flop
Seat 3: TheGrinch1991 (big blind) showed [Qh Kd] and won (11444) with a full house, Kings full of Queens
Seat 4: TowMadder folded before Flop (didn't bet)
Seat 5: CashMatteo folded before Flop (didn't bet)
Seat 6: ethancu1014 folded before Flop (didn't bet)
Seat 7: turjles folded before Flop (didn't bet)
Seat 8: davey1972 folded before Flop (didn't bet)
Seat 9: koolcanuck33 folded before Flop (didn't bet)

Hand #1888: 

PokerStars Hand #246796111248: Tournament #3662938560, $0.94+$0.06 CAD Hold'em No Limit - Level XIV (400/800) - 2023/10/28 16:45:45 ET
Table '3662938560 2' 9-max Seat #2 is the button
Seat 1: BF191919 (2758 in chips) 
Seat 2: BacardiShots (16952 in chips) 
Seat 3: TheGrinch1991 (11444 in chips) 
Seat 4: TowMadder (3606 in chips) 
Seat 5: CashMatteo (6602 in chips) 
Seat 6: ethancu1014 (29158 in chips) 
Seat 7: turjles (11810 in chips) 
Seat 8: davey1972 (9340 in chips) 
Seat 9: koolcanuck33 (4330 in chips) 
BF191919: posts the ante 200
BacardiShots: posts the ante 200
TheGrinch1991: posts the ante 200
TowMadder: posts the ante 200
CashMatteo: posts the ante 200
ethancu1014: posts the ante 200
turjles: posts the ante 200
davey1972: posts the ante 200
koolcanuck33: posts the ante 200
TheGrinch1991: posts small blind 400
TowMadder: posts big blind 800
*** HOLE CARDS ***
Dealt to CashMatteo [8h 3d]
CashMatteo: folds 
ethancu1014: calls 800
turjles: folds 
davey1972: folds 
koolcanuck33: folds 
BF191919: folds 
BacardiShots: raises 2200 to 3000
TheGrinch1991: folds 
TowMadder: folds 
ethancu1014: calls 2200
*** FLOP *** [Ah 2d Kh]
ethancu1014: checks 
BacardiShots: bets 5040
ethancu1014: raises 20918 to 25958 and is all-in
BacardiShots: calls 8712 and is all-in
Uncalled bet (12206) returned to ethancu1014
*** TURN *** [Ah 2d Kh] [5c]
*** RIVER *** [Ah 2d Kh 5c] [8c]
*** SHOW DOWN ***
ethancu1014: shows [As Qd] (a pair of Aces)
BacardiShots: shows [Ac Qs] (a pair of Aces)
ethancu1014 collected 18252 from pot
BacardiShots collected 18252 from pot
*** SUMMARY ***
Total pot 36504 | Rake 0 
Board [Ah 2d Kh 5c 8c]
Seat 1: BF191919 folded before Flop (didn't bet)
Seat 2: BacardiShots (button) showed [Ac Qs] and won (18252) with a pair of Aces
Seat 3: TheGrinch1991 (small blind) folded before Flop
Seat 4: TowMadder (big blind) folded before Flop
Seat 5: CashMatteo folded before Flop (didn't bet)
Seat 6: ethancu1014 showed [As Qd] and won (18252) with a pair of Aces
Seat 7: turjles folded before Flop (didn't bet)
Seat 8: davey1972 folded before Flop (didn't bet)
Seat 9: koolcanuck33 folded before Flop (didn't bet)

Hand #1889: 

PokerStars Hand #246796125337: Tournament #3662938560, $0.94+$0.06 CAD Hold'em No Limit - Level XIV (400/800) - 2023/10/28 16:46:28 ET
Table '3662938560 2' 9-max Seat #3 is the button
Seat 1: BF191919 (2558 in chips) 
Seat 2: BacardiShots (18252 in chips) 
Seat 3: TheGrinch1991 (10844 in chips) 
Seat 4: TowMadder (2606 in chips) 
Seat 5: CashMatteo (6402 in chips) 
Seat 6: ethancu1014 (30458 in chips) 
Seat 7: turjles (11610 in chips) 
Seat 8: davey1972 (9140 in chips) 
Seat 9: koolcanuck33 (4130 in chips) 
BF191919: posts the ante 200
BacardiShots: posts the ante 200
TheGrinch1991: posts the ante 200
TowMadder: posts the ante 200
CashMatteo: posts the ante 200
ethancu1014: posts the ante 200
turjles: posts the ante 200
davey1972: posts the ante 200
koolcanuck33: posts the ante 200
TowMadder: posts small blind 400
CashMatteo: posts big blind 800
*** HOLE CARDS ***
Dealt to CashMatteo [Qh Ac]
ethancu1014: raises 800 to 1600
turjles: folds 
davey1972: folds 
koolcanuck33: folds 
BF191919: raises 758 to 2358 and is all-in
BacardiShots: folds 
TheGrinch1991: folds 
TowMadder: folds 
CashMatteo: raises 3844 to 6202 and is all-in
ethancu1014: folds 
Uncalled bet (3844) returned to CashMatteo
*** FLOP *** [5s Ks 8c]
*** TURN *** [5s Ks 8c] [Th]
*** RIVER *** [5s Ks 8c Th] [2d]
*** SHOW DOWN ***
CashMatteo: shows [Qh Ac] (high card Ace)
BF191919: shows [Ad Qc] (high card Ace)
CashMatteo collected 4258 from pot
BF191919 collected 4258 from pot
*** SUMMARY ***
Total pot 8516 | Rake 0 
Board [5s Ks 8c Th 2d]
Seat 1: BF191919 showed [Ad Qc] and won (4258) with high card Ace
Seat 2: BacardiShots folded before Flop (didn't bet)
Seat 3: TheGrinch1991 (button) folded before Flop (didn't bet)
Seat 4: TowMadder (small blind) folded before Flop
Seat 5: CashMatteo (big blind) showed [Qh Ac] and won (4258) with high card Ace
Seat 6: ethancu1014 folded before Flop
Seat 7: turjles folded before Flop (didn't bet)
Seat 8: davey1972 folded before Flop (didn't bet)
Seat 9: koolcanuck33 folded before Flop (didn't bet)

Hand #1890: 

PokerStars Hand #246796134065: Tournament #3662938560, $0.94+$0.06 CAD Hold'em No Limit - Level XIV (400/800) - 2023/10/28 16:46:55 ET
Table '3662938560 2' 9-max Seat #4 is the button
Seat 1: BF191919 (4258 in chips) 
Seat 2: BacardiShots (18052 in chips) 
Seat 3: TheGrinch1991 (10644 in chips) 
Seat 4: TowMadder (2006 in chips) 
Seat 5: CashMatteo (8102 in chips) 
Seat 6: ethancu1014 (28658 in chips) 
Seat 7: turjles (11410 in chips) 
Seat 8: davey1972 (8940 in chips) 
Seat 9: koolcanuck33 (3930 in chips) 
BF191919: posts the ante 200
BacardiShots: posts the ante 200
TheGrinch1991: posts the ante 200
TowMadder: posts the ante 200
CashMatteo: posts the ante 200
ethancu1014: posts the ante 200
turjles: posts the ante 200
davey1972: posts the ante 200
koolcanuck33: posts the ante 200
CashMatteo: posts small blind 400
ethancu1014: posts big blind 800
*** HOLE CARDS ***
Dealt to CashMatteo [Kd Ah]
turjles: folds 
davey1972: folds 
koolcanuck33: folds 
BF191919: folds 
BacardiShots: raises 960 to 1760
TheGrinch1991: folds 
TowMadder: folds 
CashMatteo: raises 6142 to 7902 and is all-in
ethancu1014: folds 
BacardiShots: folds 
Uncalled bet (6142) returned to CashMatteo
CashMatteo collected 6120 from pot
CashMatteo: doesn't show hand 
*** SUMMARY ***
Total pot 6120 | Rake 0 
Seat 1: BF191919 folded before Flop (didn't bet)
Seat 2: BacardiShots folded before Flop
Seat 3: TheGrinch1991 folded before Flop (didn't bet)
Seat 4: TowMadder (button) folded before Flop (didn't bet)
Seat 5: CashMatteo (small blind) collected (6120)
Seat 6: ethancu1014 (big blind) folded before Flop
Seat 7: turjles folded before Flop (didn't bet)
Seat 8: davey1972 folded before Flop (didn't bet)
Seat 9: koolcanuck33 folded before Flop (didn't bet)

Hand #1891: 

PokerStars Hand #246796141128: Tournament #3662938560, $0.94+$0.06 CAD Hold'em No Limit - Level XV (500/1000) - 2023/10/28 16:47:16 ET
Table '3662938560 2' 9-max Seat #5 is the button
Seat 1: BF191919 (4058 in chips) 
Seat 2: BacardiShots (16092 in chips) 
Seat 3: TheGrinch1991 (10444 in chips) 
Seat 4: TowMadder (1806 in chips) 
Seat 5: CashMatteo (12262 in chips) 
Seat 6: ethancu1014 (27658 in chips) 
Seat 7: turjles (11210 in chips) 
Seat 8: davey1972 (8740 in chips) 
Seat 9: koolcanuck33 (3730 in chips) 
BF191919: posts the ante 250
BacardiShots: posts the ante 250
TheGrinch1991: posts the ante 250
TowMadder: posts the ante 250
CashMatteo: posts the ante 250
ethancu1014: posts the ante 250
turjles: posts the ante 250
davey1972: posts the ante 250
koolcanuck33: posts the ante 250
ethancu1014: posts small blind 500
turjles: posts big blind 1000
*** HOLE CARDS ***
Dealt to CashMatteo [Jh Ac]
davey1972: folds 
koolcanuck33: folds 
BF191919: raises 2808 to 3808 and is all-in
BacardiShots: calls 3808
TheGrinch1991: folds 
TowMadder: folds 
CashMatteo: folds 
ethancu1014: calls 3308
turjles: folds 
*** FLOP *** [3h 8h 8d]
ethancu1014: checks 
BacardiShots: bets 12034 and is all-in
ethancu1014: folds 
Uncalled bet (12034) returned to BacardiShots
*** TURN *** [3h 8h 8d] [Td]
*** RIVER *** [3h 8h 8d Td] [Kd]
*** SHOW DOWN ***
BF191919: shows [Ad 7c] (a pair of Eights)
BacardiShots: shows [6s 6d] (two pair, Eights and Sixes)
BacardiShots collected 14674 from pot
BF191919 finished the tournament in 9th place
*** SUMMARY ***
Total pot 14674 | Rake 0 
Board [3h 8h 8d Td Kd]
Seat 1: BF191919 showed [Ad 7c] and lost with a pair of Eights
Seat 2: BacardiShots showed [6s 6d] and won (14674) with two pair, Eights and Sixes
Seat 3: TheGrinch1991 folded before Flop (didn't bet)
Seat 4: TowMadder folded before Flop (didn't bet)
Seat 5: CashMatteo (button) folded before Flop (didn't bet)
Seat 6: ethancu1014 (small blind) folded on the Flop
Seat 7: turjles (big blind) folded before Flop
Seat 8: davey1972 folded before Flop (didn't bet)
Seat 9: koolcanuck33 folded before Flop (didn't bet)

Hand #1892: 

PokerStars Hand #246796157010: Tournament #3662938560, $0.94+$0.06 CAD Hold'em No Limit - Level XV (500/1000) - 2023/10/28 16:48:04 ET
Table '3662938560 2' 9-max Seat #6 is the button
Seat 2: BacardiShots (26708 in chips) 
Seat 3: TheGrinch1991 (10194 in chips) 
Seat 4: TowMadder (1556 in chips) 
Seat 5: CashMatteo (12012 in chips) 
Seat 6: ethancu1014 (23600 in chips) 
Seat 7: turjles (9960 in chips) 
Seat 8: davey1972 (8490 in chips) 
Seat 9: koolcanuck33 (3480 in chips) 
BacardiShots: posts the ante 250
TheGrinch1991: posts the ante 250
TowMadder: posts the ante 250
CashMatteo: posts the ante 250
ethancu1014: posts the ante 250
turjles: posts the ante 250
davey1972: posts the ante 250
koolcanuck33: posts the ante 250
turjles: posts small blind 500
davey1972: posts big blind 1000
*** HOLE CARDS ***
Dealt to CashMatteo [Kh 3c]
koolcanuck33: folds 
BacardiShots: folds 
TheGrinch1991: folds 
TowMadder: folds 
CashMatteo: folds 
ethancu1014: folds 
turjles: calls 500
davey1972: raises 7240 to 8240 and is all-in
turjles: folds 
Uncalled bet (7240) returned to davey1972
davey1972 collected 4000 from pot
*** SUMMARY ***
Total pot 4000 | Rake 0 
Seat 2: BacardiShots folded before Flop (didn't bet)
Seat 3: TheGrinch1991 folded before Flop (didn't bet)
Seat 4: TowMadder folded before Flop (didn't bet)
Seat 5: CashMatteo folded before Flop (didn't bet)
Seat 6: ethancu1014 (button) folded before Flop (didn't bet)
Seat 7: turjles (small blind) folded before Flop
Seat 8: davey1972 (big blind) collected (4000)
Seat 9: koolcanuck33 folded before Flop (didn't bet)

Hand #1893: 

PokerStars Hand #246796163329: Tournament #3662938560, $0.94+$0.06 CAD Hold'em No Limit - Level XV (500/1000) - 2023/10/28 16:48:23 ET
Table '3662938560 2' 9-max Seat #7 is the button
Seat 2: BacardiShots (26458 in chips) 
Seat 3: TheGrinch1991 (9944 in chips) 
Seat 4: TowMadder (1306 in chips) 
Seat 5: CashMatteo (11762 in chips) 
Seat 6: ethancu1014 (23350 in chips) 
Seat 7: turjles (8710 in chips) 
Seat 8: davey1972 (11240 in chips) 
Seat 9: koolcanuck33 (3230 in chips) 
BacardiShots: posts the ante 250
TheGrinch1991: posts the ante 250
TowMadder: posts the ante 250
CashMatteo: posts the ante 250
ethancu1014: posts the ante 250
turjles: posts the ante 250
davey1972: posts the ante 250
koolcanuck33: posts the ante 250
davey1972: posts small blind 500
koolcanuck33: posts big blind 1000
*** HOLE CARDS ***
Dealt to CashMatteo [Td Jd]
BacardiShots: folds 
TheGrinch1991: folds 
TowMadder: folds 
CashMatteo: raises 1000 to 2000
ethancu1014: raises 1000 to 3000
turjles: folds 
davey1972: folds 
koolcanuck33: folds 
CashMatteo: calls 1000
*** FLOP *** [9c Kd 8c]
CashMatteo: bets 8512 and is all-in
ethancu1014: calls 8512
*** TURN *** [9c Kd 8c] [3h]
*** RIVER *** [9c Kd 8c 3h] [6h]
*** SHOW DOWN ***
CashMatteo: shows [Td Jd] (high card King)
ethancu1014: shows [Th Qd] (high card King - Queen kicker)
ethancu1014 collected 26524 from pot
CashMatteo finished the tournament in 8th place
*** SUMMARY ***
Total pot 26524 | Rake 0 
Board [9c Kd 8c 3h 6h]
Seat 2: BacardiShots folded before Flop (didn't bet)
Seat 3: TheGrinch1991 folded before Flop (didn't bet)
Seat 4: TowMadder folded before Flop (didn't bet)
Seat 5: CashMatteo showed [Td Jd] and lost with high card King
Seat 6: ethancu1014 showed [Th Qd] and won (26524) with high card King
Seat 7: turjles (button) folded before Flop (didn't bet)
Seat 8: davey1972 (small blind) folded before Flop
Seat 9: koolcanuck33 (big blind) folded before Flop

Hand #1894: 

PokerStars Hand #246799277912: Tournament #3665278687, $0.92+$0.08 CAD Hold'em No Limit - Level I (10/20) - 2023/10/28 19:14:44 ET
Table '3665278687 1' 3-max Seat #1 is the button
Seat 1: CashMatteo (500 in chips) 
Seat 2: what_rhi_said (500 in chips) 
Seat 3: Nini1948 (500 in chips) 
what_rhi_said: posts small blind 10
Nini1948: posts big blind 20
*** HOLE CARDS ***
Dealt to CashMatteo [Th 9d]
CashMatteo: folds 
what_rhi_said: calls 10
Nini1948: checks 
*** FLOP *** [7s 2c 6d]
what_rhi_said: checks 
Nini1948: checks 
*** TURN *** [7s 2c 6d] [3h]
what_rhi_said: checks 
Nini1948: checks 
*** RIVER *** [7s 2c 6d 3h] [8s]
what_rhi_said: checks 
Nini1948: checks 
*** SHOW DOWN ***
what_rhi_said: shows [5h Jd] (high card Jack)
Nini1948: shows [Js 9c] (high card Jack - Nine kicker)
Nini1948 collected 40 from pot
*** SUMMARY ***
Total pot 40 | Rake 0 
Board [7s 2c 6d 3h 8s]
Seat 1: CashMatteo (button) folded before Flop (didn't bet)
Seat 2: what_rhi_said (small blind) showed [5h Jd] and lost with high card Jack
Seat 3: Nini1948 (big blind) showed [Js 9c] and won (40) with high card Jack

Hand #1895: 

PokerStars Hand #246799285151: Tournament #3665278687, $0.92+$0.08 CAD Hold'em No Limit - Level I (10/20) - 2023/10/28 19:15:13 ET
Table '3665278687 1' 3-max Seat #2 is the button
Seat 1: CashMatteo (500 in chips) 
Seat 2: what_rhi_said (480 in chips) 
Seat 3: Nini1948 (520 in chips) 
Nini1948: posts small blind 10
CashMatteo: posts big blind 20
*** HOLE CARDS ***
Dealt to CashMatteo [2c 4d]
what_rhi_said: raises 40 to 60
Nini1948: folds 
CashMatteo: folds 
Uncalled bet (40) returned to what_rhi_said
what_rhi_said collected 50 from pot
what_rhi_said: doesn't show hand 
*** SUMMARY ***
Total pot 50 | Rake 0 
Seat 1: CashMatteo (big blind) folded before Flop
Seat 2: what_rhi_said (button) collected (50)
Seat 3: Nini1948 (small blind) folded before Flop

Hand #1896: 

PokerStars Hand #246799287506: Tournament #3665278687, $0.92+$0.08 CAD Hold'em No Limit - Level I (10/20) - 2023/10/28 19:15:22 ET
Table '3665278687 1' 3-max Seat #3 is the button
Seat 1: CashMatteo (480 in chips) 
Seat 2: what_rhi_said (510 in chips) 
Seat 3: Nini1948 (510 in chips) 
CashMatteo: posts small blind 10
what_rhi_said: posts big blind 20
*** HOLE CARDS ***
Dealt to CashMatteo [4d Qs]
Nini1948: folds 
CashMatteo: folds 
Uncalled bet (10) returned to what_rhi_said
what_rhi_said collected 20 from pot
what_rhi_said: doesn't show hand 
*** SUMMARY ***
Total pot 20 | Rake 0 
Seat 1: CashMatteo (small blind) folded before Flop
Seat 2: what_rhi_said (big blind) collected (20)
Seat 3: Nini1948 (button) folded before Flop (didn't bet)

Hand #1897: 

PokerStars Hand #246799290364: Tournament #3665278687, $0.92+$0.08 CAD Hold'em No Limit - Level I (10/20) - 2023/10/28 19:15:34 ET
Table '3665278687 1' 3-max Seat #1 is the button
Seat 1: CashMatteo (470 in chips) 
Seat 2: what_rhi_said (520 in chips) 
Seat 3: Nini1948 (510 in chips) 
what_rhi_said: posts small blind 10
Nini1948: posts big blind 20
*** HOLE CARDS ***
Dealt to CashMatteo [Td 6d]
CashMatteo: folds 
what_rhi_said: calls 10
Nini1948: checks 
*** FLOP *** [Kh Js 3s]
what_rhi_said: checks 
Nini1948: checks 
*** TURN *** [Kh Js 3s] [Tc]
what_rhi_said: bets 40
Nini1948: folds 
Uncalled bet (40) returned to what_rhi_said
what_rhi_said collected 40 from pot
what_rhi_said: doesn't show hand 
*** SUMMARY ***
Total pot 40 | Rake 0 
Board [Kh Js 3s Tc]
Seat 1: CashMatteo (button) folded before Flop (didn't bet)
Seat 2: what_rhi_said (small blind) collected (40)
Seat 3: Nini1948 (big blind) folded on the Turn

Hand #1898: 

PokerStars Hand #246799299143: Tournament #3665278687, $0.92+$0.08 CAD Hold'em No Limit - Level I (10/20) - 2023/10/28 19:16:09 ET
Table '3665278687 1' 3-max Seat #2 is the button
Seat 1: CashMatteo (470 in chips) 
Seat 2: what_rhi_said (540 in chips) 
Seat 3: Nini1948 (490 in chips) 
Nini1948: posts small blind 10
CashMatteo: posts big blind 20
*** HOLE CARDS ***
Dealt to CashMatteo [4d 8h]
what_rhi_said: calls 20
Nini1948: calls 10
CashMatteo: checks 
*** FLOP *** [Kh Th Td]
Nini1948: checks 
CashMatteo: checks 
what_rhi_said: checks 
*** TURN *** [Kh Th Td] [9h]
Nini1948: checks 
CashMatteo: checks 
what_rhi_said: checks 
*** RIVER *** [Kh Th Td 9h] [5d]
Nini1948: checks 
CashMatteo: checks 
what_rhi_said: checks 
*** SHOW DOWN ***
Nini1948: shows [7h 5c] (two pair, Tens and Fives)
CashMatteo: mucks hand 
what_rhi_said: mucks hand 
Nini1948 collected 60 from pot
*** SUMMARY ***
Total pot 60 | Rake 0 
Board [Kh Th Td 9h 5d]
Seat 1: CashMatteo (big blind) mucked [4d 8h]
Seat 2: what_rhi_said (button) mucked [Qh 4c]
Seat 3: Nini1948 (small blind) showed [7h 5c] and won (60) with two pair, Tens and Fives

Hand #1899: 

PokerStars Hand #246799305382: Tournament #3665278687, $0.92+$0.08 CAD Hold'em No Limit - Level I (10/20) - 2023/10/28 19:16:34 ET
Table '3665278687 1' 3-max Seat #3 is the button
Seat 1: CashMatteo (450 in chips) 
Seat 2: what_rhi_said (520 in chips) 
Seat 3: Nini1948 (530 in chips) 
CashMatteo: posts small blind 10
what_rhi_said: posts big blind 20
*** HOLE CARDS ***
Dealt to CashMatteo [Ac Qc]
Nini1948: folds 
CashMatteo: raises 30 to 50
what_rhi_said: folds 
Uncalled bet (30) returned to CashMatteo
CashMatteo collected 40 from pot
CashMatteo: doesn't show hand 
*** SUMMARY ***
Total pot 40 | Rake 0 
Seat 1: CashMatteo (small blind) collected (40)
Seat 2: what_rhi_said (big blind) folded before Flop
Seat 3: Nini1948 (button) folded before Flop (didn't bet)

Hand #1900: 

PokerStars Hand #246799309576: Tournament #3665278687, $0.92+$0.08 CAD Hold'em No Limit - Level II (15/30) - 2023/10/28 19:16:51 ET
Table '3665278687 1' 3-max Seat #1 is the button
Seat 1: CashMatteo (470 in chips) 
Seat 2: what_rhi_said (500 in chips) 
Seat 3: Nini1948 (530 in chips) 
what_rhi_said: posts small blind 15
Nini1948: posts big blind 30
*** HOLE CARDS ***
Dealt to CashMatteo [Js 6c]
CashMatteo: folds 
what_rhi_said: raises 60 to 90
Nini1948: folds 
Uncalled bet (60) returned to what_rhi_said
what_rhi_said collected 60 from pot
what_rhi_said: doesn't show hand 
*** SUMMARY ***
Total pot 60 | Rake 0 
Seat 1: CashMatteo (button) folded before Flop (didn't bet)
Seat 2: what_rhi_said (small blind) collected (60)
Seat 3: Nini1948 (big blind) folded before Flop

Hand #1901: 

PokerStars Hand #246799314076: Tournament #3665278687, $0.92+$0.08 CAD Hold'em No Limit - Level II (15/30) - 2023/10/28 19:17:09 ET
Table '3665278687 1' 3-max Seat #2 is the button
Seat 1: CashMatteo (470 in chips) 
Seat 2: what_rhi_said (530 in chips) 
Seat 3: Nini1948 (500 in chips) 
Nini1948: posts small blind 15
CashMatteo: posts big blind 30
*** HOLE CARDS ***
Dealt to CashMatteo [9s 4c]
what_rhi_said: raises 30 to 60
Nini1948: calls 45
CashMatteo: folds 
*** FLOP *** [Jh Ac As]
Nini1948: checks 
what_rhi_said: checks 
*** TURN *** [Jh Ac As] [5d]
Nini1948: checks 
what_rhi_said: bets 75
Nini1948: folds 
Uncalled bet (75) returned to what_rhi_said
what_rhi_said collected 150 from pot
what_rhi_said: doesn't show hand 
*** SUMMARY ***
Total pot 150 | Rake 0 
Board [Jh Ac As 5d]
Seat 1: CashMatteo (big blind) folded before Flop
Seat 2: what_rhi_said (button) collected (150)
Seat 3: Nini1948 (small blind) folded on the Turn

Hand #1902: 

PokerStars Hand #246799319791: Tournament #3665278687, $0.92+$0.08 CAD Hold'em No Limit - Level II (15/30) - 2023/10/28 19:17:32 ET
Table '3665278687 1' 3-max Seat #3 is the button
Seat 1: CashMatteo (440 in chips) 
Seat 2: what_rhi_said (620 in chips) 
Seat 3: Nini1948 (440 in chips) 
CashMatteo: posts small blind 15
what_rhi_said: posts big blind 30
*** HOLE CARDS ***
Dealt to CashMatteo [3h 7d]
Nini1948: calls 30
CashMatteo: folds 
what_rhi_said: checks 
*** FLOP *** [Kd Ah Kc]
what_rhi_said: checks 
Nini1948: checks 
*** TURN *** [Kd Ah Kc] [Ks]
what_rhi_said: checks 
Nini1948: bets 90
what_rhi_said: folds 
Uncalled bet (90) returned to Nini1948
Nini1948 collected 75 from pot
Nini1948: doesn't show hand 
*** SUMMARY ***
Total pot 75 | Rake 0 
Board [Kd Ah Kc Ks]
Seat 1: CashMatteo (small blind) folded before Flop
Seat 2: what_rhi_said (big blind) folded on the Turn
Seat 3: Nini1948 (button) collected (75)

Hand #1903: 

PokerStars Hand #246799329001: Tournament #3665278687, $0.92+$0.08 CAD Hold'em No Limit - Level II (15/30) - 2023/10/28 19:18:09 ET
Table '3665278687 1' 3-max Seat #1 is the button
Seat 1: CashMatteo (425 in chips) 
Seat 2: what_rhi_said (590 in chips) 
Seat 3: Nini1948 (485 in chips) 
what_rhi_said: posts small blind 15
Nini1948: posts big blind 30
*** HOLE CARDS ***
Dealt to CashMatteo [3c 9s]
CashMatteo: folds 
what_rhi_said: folds 
Uncalled bet (15) returned to Nini1948
Nini1948 collected 30 from pot
Nini1948: doesn't show hand 
*** SUMMARY ***
Total pot 30 | Rake 0 
Seat 1: CashMatteo (button) folded before Flop (didn't bet)
Seat 2: what_rhi_said (small blind) folded before Flop
Seat 3: Nini1948 (big blind) collected (30)

Hand #1904: 

PokerStars Hand #246799331491: Tournament #3665278687, $0.92+$0.08 CAD Hold'em No Limit - Level II (15/30) - 2023/10/28 19:18:19 ET
Table '3665278687 1' 3-max Seat #2 is the button
Seat 1: CashMatteo (425 in chips) 
Seat 2: what_rhi_said (575 in chips) 
Seat 3: Nini1948 (500 in chips) 
Nini1948: posts small blind 15
CashMatteo: posts big blind 30
*** HOLE CARDS ***
Dealt to CashMatteo [Qs 8d]
what_rhi_said: folds 
Nini1948: calls 15
CashMatteo: raises 30 to 60
Nini1948: calls 30
*** FLOP *** [4h 7h 9d]
Nini1948: checks 
CashMatteo: checks 
*** TURN *** [4h 7h 9d] [2d]
Nini1948: checks 
CashMatteo: bets 60
Nini1948: calls 60
*** RIVER *** [4h 7h 9d 2d] [3h]
Nini1948: checks 
CashMatteo: checks 
*** SHOW DOWN ***
Nini1948: shows [6h Jh] (a flush, Jack high)
CashMatteo: mucks hand 
Nini1948 collected 240 from pot
*** SUMMARY ***
Total pot 240 | Rake 0 
Board [4h 7h 9d 2d 3h]
Seat 1: CashMatteo (big blind) mucked [Qs 8d]
Seat 2: what_rhi_said (button) folded before Flop (didn't bet)
Seat 3: Nini1948 (small blind) showed [6h Jh] and won (240) with a flush, Jack high

Hand #1905: 

PokerStars Hand #246799340517: Tournament #3665278687, $0.92+$0.08 CAD Hold'em No Limit - Level III (20/40) - 2023/10/28 19:18:55 ET
Table '3665278687 1' 3-max Seat #3 is the button
Seat 1: CashMatteo (305 in chips) 
Seat 2: what_rhi_said (575 in chips) 
Seat 3: Nini1948 (620 in chips) 
CashMatteo: posts small blind 20
what_rhi_said: posts big blind 40
*** HOLE CARDS ***
Dealt to CashMatteo [5c 9d]
Nini1948: folds 
CashMatteo: folds 
Uncalled bet (20) returned to what_rhi_said
what_rhi_said collected 40 from pot
what_rhi_said: doesn't show hand 
*** SUMMARY ***
Total pot 40 | Rake 0 
Seat 1: CashMatteo (small blind) folded before Flop
Seat 2: what_rhi_said (big blind) collected (40)
Seat 3: Nini1948 (button) folded before Flop (didn't bet)

Hand #1906: 

PokerStars Hand #246799343711: Tournament #3665278687, $0.92+$0.08 CAD Hold'em No Limit - Level III (20/40) - 2023/10/28 19:19:08 ET
Table '3665278687 1' 3-max Seat #1 is the button
Seat 1: CashMatteo (285 in chips) 
Seat 2: what_rhi_said (595 in chips) 
Seat 3: Nini1948 (620 in chips) 
what_rhi_said: posts small blind 20
Nini1948: posts big blind 40
*** HOLE CARDS ***
Dealt to CashMatteo [3s 8c]
CashMatteo: folds 
what_rhi_said: raises 40 to 80
Nini1948: folds 
Uncalled bet (40) returned to what_rhi_said
what_rhi_said collected 80 from pot
what_rhi_said: doesn't show hand 
*** SUMMARY ***
Total pot 80 | Rake 0 
Seat 1: CashMatteo (button) folded before Flop (didn't bet)
Seat 2: what_rhi_said (small blind) collected (80)
Seat 3: Nini1948 (big blind) folded before Flop

Hand #1907: 

PokerStars Hand #246799346039: Tournament #3665278687, $0.92+$0.08 CAD Hold'em No Limit - Level III (20/40) - 2023/10/28 19:19:18 ET
Table '3665278687 1' 3-max Seat #2 is the button
Seat 1: CashMatteo (285 in chips) 
Seat 2: what_rhi_said (635 in chips) 
Seat 3: Nini1948 (580 in chips) 
Nini1948: posts small blind 20
CashMatteo: posts big blind 40
*** HOLE CARDS ***
Dealt to CashMatteo [Td Kh]
what_rhi_said: raises 80 to 120
Nini1948: folds 
CashMatteo: raises 165 to 285 and is all-in
what_rhi_said: calls 165
*** FLOP *** [7s Js 2s]
*** TURN *** [7s Js 2s] [Ks]
*** RIVER *** [7s Js 2s Ks] [4d]
*** SHOW DOWN ***
CashMatteo: shows [Td Kh] (a pair of Kings)
what_rhi_said: shows [Ad 5d] (high card Ace)
CashMatteo collected 590 from pot
*** SUMMARY ***
Total pot 590 | Rake 0 
Board [7s Js 2s Ks 4d]
Seat 1: CashMatteo (big blind) showed [Td Kh] and won (590) with a pair of Kings
Seat 2: what_rhi_said (button) showed [Ad 5d] and lost with high card Ace
Seat 3: Nini1948 (small blind) folded before Flop

Hand #1908: 

PokerStars Hand #246799351243: Tournament #3665278687, $0.92+$0.08 CAD Hold'em No Limit - Level III (20/40) - 2023/10/28 19:19:38 ET
Table '3665278687 1' 3-max Seat #3 is the button
Seat 1: CashMatteo (590 in chips) 
Seat 2: what_rhi_said (350 in chips) 
Seat 3: Nini1948 (560 in chips) 
CashMatteo: posts small blind 20
what_rhi_said: posts big blind 40
*** HOLE CARDS ***
Dealt to CashMatteo [3c Ks]
Nini1948: calls 40
CashMatteo: folds 
what_rhi_said: checks 
*** FLOP *** [Ac Qs 7d]
what_rhi_said: checks 
Nini1948: checks 
*** TURN *** [Ac Qs 7d] [4h]
what_rhi_said: checks 
Nini1948: bets 40
what_rhi_said: folds 
Uncalled bet (40) returned to Nini1948
Nini1948 collected 100 from pot
Nini1948: doesn't show hand 
*** SUMMARY ***
Total pot 100 | Rake 0 
Board [Ac Qs 7d 4h]
Seat 1: CashMatteo (small blind) folded before Flop
Seat 2: what_rhi_said (big blind) folded on the Turn
Seat 3: Nini1948 (button) collected (100)

Hand #1909: 

PokerStars Hand #246799357453: Tournament #3665278687, $0.92+$0.08 CAD Hold'em No Limit - Level III (20/40) - 2023/10/28 19:20:03 ET
Table '3665278687 1' 3-max Seat #1 is the button
Seat 1: CashMatteo (570 in chips) 
Seat 2: what_rhi_said (310 in chips) 
Seat 3: Nini1948 (620 in chips) 
what_rhi_said: posts small blind 20
Nini1948: posts big blind 40
*** HOLE CARDS ***
Dealt to CashMatteo [Ks 3d]
CashMatteo has timed out
CashMatteo: folds 
CashMatteo is sitting out
what_rhi_said: calls 20
Nini1948: checks 
*** FLOP *** [7h Jh 4d]
CashMatteo is disconnected 
what_rhi_said: bets 80
Nini1948: calls 80
*** TURN *** [7h Jh 4d] [6d]
what_rhi_said: bets 120
Nini1948: calls 120
*** RIVER *** [7h Jh 4d 6d] [5d]
what_rhi_said: bets 70 and is all-in
Nini1948: calls 70
*** SHOW DOWN ***
what_rhi_said: shows [Js 6s] (two pair, Jacks and Sixes)
Nini1948: shows [7c 3h] (a straight, Three to Seven)
Nini1948 collected 620 from pot
what_rhi_said finished the tournament in 3rd place
*** SUMMARY ***
Total pot 620 | Rake 0 
Board [7h Jh 4d 6d 5d]
Seat 1: CashMatteo (button) folded before Flop (didn't bet)
Seat 2: what_rhi_said (small blind) showed [Js 6s] and lost with two pair, Jacks and Sixes
Seat 3: Nini1948 (big blind) showed [7c 3h] and won (620) with a straight, Three to Seven

Hand #1910: 

PokerStars Hand #246799372523: Tournament #3665278687, $0.92+$0.08 CAD Hold'em No Limit - Level IV (30/60) - 2023/10/28 19:21:04 ET
Table '3665278687 1' 3-max Seat #3 is the button
Seat 1: CashMatteo (570 in chips) is sitting out
Seat 3: Nini1948 (930 in chips) 
Nini1948: posts small blind 30
CashMatteo: posts big blind 60
*** HOLE CARDS ***
Dealt to CashMatteo [7d 9c]
Nini1948: calls 30
CashMatteo: folds 
Nini1948 collected 120 from pot
Nini1948: doesn't show hand 
*** SUMMARY ***
Total pot 120 | Rake 0 
Seat 1: CashMatteo (big blind) folded before Flop
Seat 3: Nini1948 (button) (small blind) collected (120)

Hand #1911: 

PokerStars Hand #246799374381: Tournament #3665278687, $0.92+$0.08 CAD Hold'em No Limit - Level IV (30/60) - 2023/10/28 19:21:11 ET
Table '3665278687 1' 3-max Seat #1 is the button
Seat 1: CashMatteo (510 in chips) is sitting out
Seat 3: Nini1948 (990 in chips) 
CashMatteo: posts small blind 30
Nini1948: posts big blind 60
*** HOLE CARDS ***
Dealt to CashMatteo [Qh Ad]
CashMatteo: folds 
Uncalled bet (30) returned to Nini1948
Nini1948 collected 60 from pot
Nini1948: doesn't show hand 
*** SUMMARY ***
Total pot 60 | Rake 0 
Seat 1: CashMatteo (button) (small blind) folded before Flop
Seat 3: Nini1948 (big blind) collected (60)

Hand #1912: 

PokerStars Hand #246799374858: Tournament #3665278687, $0.92+$0.08 CAD Hold'em No Limit - Level IV (30/60) - 2023/10/28 19:21:13 ET
Table '3665278687 1' 3-max Seat #3 is the button
Seat 1: CashMatteo (480 in chips) is sitting out
Seat 3: Nini1948 (1020 in chips) 
Nini1948: posts small blind 30
CashMatteo: posts big blind 60
*** HOLE CARDS ***
Dealt to CashMatteo [2c Ks]
Nini1948: raises 60 to 120
CashMatteo: folds 
Uncalled bet (60) returned to Nini1948
Nini1948 collected 120 from pot
Nini1948: doesn't show hand 
*** SUMMARY ***
Total pot 120 | Rake 0 
Seat 1: CashMatteo (big blind) folded before Flop
Seat 3: Nini1948 (button) (small blind) collected (120)

Hand #1913: 

PokerStars Hand #246799376398: Tournament #3665278687, $0.92+$0.08 CAD Hold'em No Limit - Level IV (30/60) - 2023/10/28 19:21:19 ET
Table '3665278687 1' 3-max Seat #1 is the button
Seat 1: CashMatteo (420 in chips) is sitting out
Seat 3: Nini1948 (1080 in chips) 
CashMatteo: posts small blind 30
Nini1948: posts big blind 60
*** HOLE CARDS ***
Dealt to CashMatteo [Jc Jd]
CashMatteo: folds 
Uncalled bet (30) returned to Nini1948
Nini1948 collected 60 from pot
Nini1948: doesn't show hand 
*** SUMMARY ***
Total pot 60 | Rake 0 
Seat 1: CashMatteo (button) (small blind) folded before Flop
Seat 3: Nini1948 (big blind) collected (60)

Hand #1914: 

PokerStars Hand #246799376847: Tournament #3665278687, $0.92+$0.08 CAD Hold'em No Limit - Level IV (30/60) - 2023/10/28 19:21:21 ET
Table '3665278687 1' 3-max Seat #3 is the button
Seat 1: CashMatteo (390 in chips) is sitting out
Seat 3: Nini1948 (1110 in chips) 
Nini1948: posts small blind 30
CashMatteo: posts big blind 60
*** HOLE CARDS ***
Dealt to CashMatteo [Jh Kc]
Nini1948: calls 30
CashMatteo: folds 
Nini1948 collected 120 from pot
Nini1948: doesn't show hand 
*** SUMMARY ***
Total pot 120 | Rake 0 
Seat 1: CashMatteo (big blind) folded before Flop
Seat 3: Nini1948 (button) (small blind) collected (120)

Hand #1915: 

PokerStars Hand #246799378431: Tournament #3665278687, $0.92+$0.08 CAD Hold'em No Limit - Level IV (30/60) - 2023/10/28 19:21:28 ET
Table '3665278687 1' 3-max Seat #1 is the button
Seat 1: CashMatteo (330 in chips) is sitting out
Seat 3: Nini1948 (1170 in chips) 
CashMatteo: posts small blind 30
Nini1948: posts big blind 60
*** HOLE CARDS ***
Dealt to CashMatteo [3c 6d]
CashMatteo: folds 
Uncalled bet (30) returned to Nini1948
Nini1948 collected 60 from pot
Nini1948: doesn't show hand 
CashMatteo has returned
*** SUMMARY ***
Total pot 60 | Rake 0 
Seat 1: CashMatteo (button) (small blind) folded before Flop
Seat 3: Nini1948 (big blind) collected (60)

Hand #1916: 

PokerStars Hand #246799378930: Tournament #3665278687, $0.92+$0.08 CAD Hold'em No Limit - Level IV (30/60) - 2023/10/28 19:21:30 ET
Table '3665278687 1' 3-max Seat #3 is the button
Seat 1: CashMatteo (300 in chips) 
Seat 3: Nini1948 (1200 in chips) 
Nini1948: posts small blind 30
CashMatteo: posts big blind 60
*** HOLE CARDS ***
Dealt to CashMatteo [2c Ks]
Nini1948: calls 30
CashMatteo: checks 
*** FLOP *** [2d 9s Kc]
CashMatteo: checks 
Nini1948: checks 
*** TURN *** [2d 9s Kc] [4c]
CashMatteo: checks 
Nini1948: bets 60
CashMatteo: raises 180 to 240 and is all-in
Nini1948: folds 
Uncalled bet (180) returned to CashMatteo
CashMatteo collected 240 from pot
CashMatteo: doesn't show hand 
*** SUMMARY ***
Total pot 240 | Rake 0 
Board [2d 9s Kc 4c]
Seat 1: CashMatteo (big blind) collected (240)
Seat 3: Nini1948 (button) (small blind) folded on the Turn

Hand #1917: 

PokerStars Hand #246799385294: Tournament #3665278687, $0.92+$0.08 CAD Hold'em No Limit - Level IV (30/60) - 2023/10/28 19:21:55 ET
Table '3665278687 1' 3-max Seat #1 is the button
Seat 1: CashMatteo (420 in chips) 
Seat 3: Nini1948 (1080 in chips) 
CashMatteo: posts small blind 30
Nini1948: posts big blind 60
*** HOLE CARDS ***
Dealt to CashMatteo [3c 9s]
CashMatteo: folds 
Uncalled bet (30) returned to Nini1948
Nini1948 collected 60 from pot
Nini1948: doesn't show hand 
*** SUMMARY ***
Total pot 60 | Rake 0 
Seat 1: CashMatteo (button) (small blind) folded before Flop
Seat 3: Nini1948 (big blind) collected (60)

Hand #1918: 

PokerStars Hand #246799386418: Tournament #3665278687, $0.92+$0.08 CAD Hold'em No Limit - Level IV (30/60) - 2023/10/28 19:22:00 ET
Table '3665278687 1' 3-max Seat #3 is the button
Seat 1: CashMatteo (390 in chips) 
Seat 3: Nini1948 (1110 in chips) 
Nini1948: posts small blind 30
CashMatteo: posts big blind 60
*** HOLE CARDS ***
Dealt to CashMatteo [2c 5h]
Nini1948: folds 
Uncalled bet (30) returned to CashMatteo
CashMatteo collected 60 from pot
CashMatteo: doesn't show hand 
*** SUMMARY ***
Total pot 60 | Rake 0 
Seat 1: CashMatteo (big blind) collected (60)
Seat 3: Nini1948 (button) (small blind) folded before Flop

Hand #1919: 

PokerStars Hand #246799387738: Tournament #3665278687, $0.92+$0.08 CAD Hold'em No Limit - Level IV (30/60) - 2023/10/28 19:22:05 ET
Table '3665278687 1' 3-max Seat #1 is the button
Seat 1: CashMatteo (420 in chips) 
Seat 3: Nini1948 (1080 in chips) 
CashMatteo: posts small blind 30
Nini1948: posts big blind 60
*** HOLE CARDS ***
Dealt to CashMatteo [4s Kc]
CashMatteo: calls 30
Nini1948: raises 1020 to 1080 and is all-in
CashMatteo: folds 
Uncalled bet (1020) returned to Nini1948
Nini1948 collected 120 from pot
Nini1948: doesn't show hand 
*** SUMMARY ***
Total pot 120 | Rake 0 
Seat 1: CashMatteo (button) (small blind) folded before Flop
Seat 3: Nini1948 (big blind) collected (120)

Hand #1920: 

PokerStars Hand #246799391242: Tournament #3665278687, $0.92+$0.08 CAD Hold'em No Limit - Level IV (30/60) - 2023/10/28 19:22:20 ET
Table '3665278687 1' 3-max Seat #3 is the button
Seat 1: CashMatteo (360 in chips) 
Seat 3: Nini1948 (1140 in chips) 
Nini1948: posts small blind 30
CashMatteo: posts big blind 60
*** HOLE CARDS ***
Dealt to CashMatteo [Th Jc]
Nini1948: folds 
Uncalled bet (30) returned to CashMatteo
CashMatteo collected 60 from pot
CashMatteo: doesn't show hand 
*** SUMMARY ***
Total pot 60 | Rake 0 
Seat 1: CashMatteo (big blind) collected (60)
Seat 3: Nini1948 (button) (small blind) folded before Flop

Hand #1921: 

PokerStars Hand #246799393040: Tournament #3665278687, $0.92+$0.08 CAD Hold'em No Limit - Level IV (30/60) - 2023/10/28 19:22:27 ET
Table '3665278687 1' 3-max Seat #1 is the button
Seat 1: CashMatteo (390 in chips) 
Seat 3: Nini1948 (1110 in chips) 
CashMatteo: posts small blind 30
Nini1948: posts big blind 60
*** HOLE CARDS ***
Dealt to CashMatteo [2c 8s]
CashMatteo: folds 
Uncalled bet (30) returned to Nini1948
Nini1948 collected 60 from pot
Nini1948: doesn't show hand 
*** SUMMARY ***
Total pot 60 | Rake 0 
Seat 1: CashMatteo (button) (small blind) folded before Flop
Seat 3: Nini1948 (big blind) collected (60)

Hand #1922: 

PokerStars Hand #246799394169: Tournament #3665278687, $0.92+$0.08 CAD Hold'em No Limit - Level IV (30/60) - 2023/10/28 19:22:31 ET
Table '3665278687 1' 3-max Seat #3 is the button
Seat 1: CashMatteo (360 in chips) 
Seat 3: Nini1948 (1140 in chips) 
Nini1948: posts small blind 30
CashMatteo: posts big blind 60
*** HOLE CARDS ***
Dealt to CashMatteo [Jd Kh]
Nini1948: folds 
Uncalled bet (30) returned to CashMatteo
CashMatteo collected 60 from pot
CashMatteo: doesn't show hand 
*** SUMMARY ***
Total pot 60 | Rake 0 
Seat 1: CashMatteo (big blind) collected (60)
Seat 3: Nini1948 (button) (small blind) folded before Flop

Hand #1923: 

PokerStars Hand #246799395560: Tournament #3665278687, $0.92+$0.08 CAD Hold'em No Limit - Level IV (30/60) - 2023/10/28 19:22:37 ET
Table '3665278687 1' 3-max Seat #1 is the button
Seat 1: CashMatteo (390 in chips) 
Seat 3: Nini1948 (1110 in chips) 
CashMatteo: posts small blind 30
Nini1948: posts big blind 60
*** HOLE CARDS ***
Dealt to CashMatteo [8c 6c]
CashMatteo: folds 
Uncalled bet (30) returned to Nini1948
Nini1948 collected 60 from pot
Nini1948: doesn't show hand 
*** SUMMARY ***
Total pot 60 | Rake 0 
Seat 1: CashMatteo (button) (small blind) folded before Flop
Seat 3: Nini1948 (big blind) collected (60)

Hand #1924: 

PokerStars Hand #246799397437: Tournament #3665278687, $0.92+$0.08 CAD Hold'em No Limit - Level IV (30/60) - 2023/10/28 19:22:44 ET
Table '3665278687 1' 3-max Seat #3 is the button
Seat 1: CashMatteo (360 in chips) 
Seat 3: Nini1948 (1140 in chips) 
Nini1948: posts small blind 30
CashMatteo: posts big blind 60
*** HOLE CARDS ***
Dealt to CashMatteo [7h 6s]
Nini1948: calls 30
CashMatteo: checks 
*** FLOP *** [2d 4c Ah]
CashMatteo: checks 
Nini1948: bets 180
CashMatteo: folds 
Uncalled bet (180) returned to Nini1948
Nini1948 collected 120 from pot
Nini1948: doesn't show hand 
*** SUMMARY ***
Total pot 120 | Rake 0 
Board [2d 4c Ah]
Seat 1: CashMatteo (big blind) folded on the Flop
Seat 3: Nini1948 (button) (small blind) collected (120)

Hand #1925: 

PokerStars Hand #246799402423: Tournament #3665278687, $0.92+$0.08 CAD Hold'em No Limit - Level V (40/80) - 2023/10/28 19:23:05 ET
Table '3665278687 1' 3-max Seat #1 is the button
Seat 1: CashMatteo (300 in chips) 
Seat 3: Nini1948 (1200 in chips) 
CashMatteo: posts small blind 40
Nini1948: posts big blind 80
*** HOLE CARDS ***
Dealt to CashMatteo [4h 7s]
CashMatteo: raises 220 to 300 and is all-in
Nini1948: calls 220
*** FLOP *** [Kc 6d Kd]
*** TURN *** [Kc 6d Kd] [5d]
*** RIVER *** [Kc 6d Kd 5d] [8c]
*** SHOW DOWN ***
Nini1948: shows [5h Ks] (a full house, Kings full of Fives)
CashMatteo: shows [4h 7s] (a straight, Four to Eight)
Nini1948 collected 600 from pot
CashMatteo finished the tournament in 2nd place
Nini1948 wins the tournament and receives $2.00 - congratulations!
*** SUMMARY ***
Total pot 600 | Rake 0 
Board [Kc 6d Kd 5d 8c]
Seat 1: CashMatteo (button) (small blind) showed [4h 7s] and lost with a straight, Four to Eight
Seat 3: Nini1948 (big blind) showed [5h Ks] and won (600) with a full house, Kings full of Fives

Hand #1926: 

PokerStars Hand #246799691820:  Hold'em No Limit ($0.05/$0.10 CAD) - 2023/10/28 19:43:12 ET
Table 'Mavis II' 6-max Seat #3 is the button
Seat 2: zow4005 ($10 in chips) 
Seat 3: CashMatteo ($10 in chips) 
Seat 4: Sylvester170 ($8.70 in chips) 
Sylvester170: posts small blind $0.05
zow4005: posts big blind $0.10
*** HOLE CARDS ***
Dealt to CashMatteo [5h 3h]
CashMatteo: folds 
Sylvester170: calls $0.05
zow4005: raises $0.30 to $0.40
Sylvester170: calls $0.30
*** FLOP *** [Kc 6d Th]
roadrunner1992 joins the table at seat #6 
Sylvester170: checks 
zow4005: bets $0.40
Sylvester170: folds 
Uncalled bet ($0.40) returned to zow4005
zow4005 collected $0.76 from pot
zow4005: doesn't show hand 
*** SUMMARY ***
Total pot $0.80 | Rake $0.04 
Board [Kc 6d Th]
Seat 2: zow4005 (big blind) collected ($0.76)
Seat 3: CashMatteo (button) folded before Flop (didn't bet)
Seat 4: Sylvester170 (small blind) folded on the Flop

Hand #1927: 

PokerStars Hand #246799697310:  Hold'em No Limit ($0.05/$0.10 CAD) - 2023/10/28 19:43:35 ET
Table 'Mavis II' 6-max Seat #4 is the button
Seat 2: zow4005 ($10.36 in chips) 
Seat 3: CashMatteo ($10 in chips) 
Seat 4: Sylvester170 ($8.30 in chips) 
roadrunner1992 will be allowed to play after the button
zow4005: posts small blind $0.05
CashMatteo: posts big blind $0.10
*** HOLE CARDS ***
Dealt to CashMatteo [Kd Ah]
Sylvester170: calls $0.10
zow4005: folds 
CashMatteo: raises $0.15 to $0.25
Sylvester170: calls $0.15
*** FLOP *** [Qs 2c 4c]
CashMatteo: bets $0.27
Hijjy91 joins the table at seat #1 
Sylvester170: calls $0.27
*** TURN *** [Qs 2c 4c] [5d]
CashMatteo: checks 
Sylvester170: bets $1.04
CashMatteo: folds 
Uncalled bet ($1.04) returned to Sylvester170
Sylvester170 collected $1.04 from pot
*** SUMMARY ***
Total pot $1.09 | Rake $0.05 
Board [Qs 2c 4c 5d]
Seat 2: zow4005 (small blind) folded before Flop
Seat 3: CashMatteo (big blind) folded on the Turn
Seat 4: Sylvester170 (button) collected ($1.04)

Hand #1928: 

PokerStars Hand #246799710953:  Hold'em No Limit ($0.05/$0.10 CAD) - 2023/10/28 19:44:32 ET
Table 'Mavis II' 6-max Seat #2 is the button
Seat 1: Hijjy91 ($6.12 in chips) 
Seat 2: zow4005 ($10.31 in chips) 
Seat 3: CashMatteo ($9.48 in chips) 
Seat 4: Sylvester170 ($8.82 in chips) 
CashMatteo: posts small blind $0.05
Sylvester170: posts big blind $0.10
roadrunner1992: sits out 
Hijjy91: posts big blind $0.10
*** HOLE CARDS ***
Dealt to CashMatteo [Ac Jh]
Hijjy91: checks 
zow4005: raises $0.30 to $0.40
CashMatteo: calls $0.35
Sylvester170: calls $0.30
Hijjy91: calls $0.30
*** FLOP *** [8s Kd As]
CashMatteo: checks 
Sylvester170: checks 
Hijjy91: checks 
zow4005: checks 
*** TURN *** [8s Kd As] [8h]
CashMatteo: bets $0.77
Sylvester170: folds 
Hijjy91: folds 
zow4005: folds 
Uncalled bet ($0.77) returned to CashMatteo
CashMatteo collected $1.53 from pot
CashMatteo: doesn't show hand 
*** SUMMARY ***
Total pot $1.60 | Rake $0.07 
Board [8s Kd As 8h]
Seat 1: Hijjy91 folded on the Turn
Seat 2: zow4005 (button) folded on the Turn
Seat 3: CashMatteo (small blind) collected ($1.53)
Seat 4: Sylvester170 (big blind) folded on the Turn

Hand #1929: 

PokerStars Hand #246799718775:  Hold'em No Limit ($0.05/$0.10 CAD) - 2023/10/28 19:45:05 ET
Table 'Mavis II' 6-max Seat #3 is the button
Seat 1: Hijjy91 ($5.72 in chips) 
Seat 2: zow4005 ($10 in chips) 
Seat 3: CashMatteo ($10.61 in chips) 
Seat 4: Sylvester170 ($8.42 in chips) 
Seat 6: roadrunner1992 ($4 in chips) 
Sylvester170: posts small blind $0.05
roadrunner1992: posts big blind $0.10
*** HOLE CARDS ***
Dealt to CashMatteo [6d 7h]
Hijjy91: folds 
zow4005: raises $0.20 to $0.30
CashMatteo: folds 
Sylvester170: raises $0.70 to $1
roadrunner1992: calls $0.90
zow4005: calls $0.70
*** FLOP *** [6h Ks 8d]
Sylvester170: checks 
roadrunner1992: checks 
zow4005: checks 
*** TURN *** [6h Ks 8d] [9s]
Sylvester170: checks 
roadrunner1992: checks 
zow4005: checks 
*** RIVER *** [6h Ks 8d 9s] [4c]
Sylvester170: bets $0.50
roadrunner1992: folds 
zow4005: calls $0.50
*** SHOW DOWN ***
Sylvester170: shows [Jd Jc] (a pair of Jacks)
zow4005: mucks hand 
Sylvester170 collected $3.82 from pot
*** SUMMARY ***
Total pot $4 | Rake $0.18 
Board [6h Ks 8d 9s 4c]
Seat 1: Hijjy91 folded before Flop (didn't bet)
Seat 2: zow4005 mucked [3h 3d]
Seat 3: CashMatteo (button) folded before Flop (didn't bet)
Seat 4: Sylvester170 (small blind) showed [Jd Jc] and won ($3.82) with a pair of Jacks
Seat 6: roadrunner1992 (big blind) folded on the River

Hand #1930: 

PokerStars Hand #246799731860:  Hold'em No Limit ($0.05/$0.10 CAD) - 2023/10/28 19:46:01 ET
Table 'Mavis II' 6-max Seat #4 is the button
Seat 1: Hijjy91 ($5.72 in chips) 
Seat 2: zow4005 ($10 in chips) 
Seat 3: CashMatteo ($10.61 in chips) 
Seat 4: Sylvester170 ($10.74 in chips) 
Seat 6: roadrunner1992 ($3 in chips) 
roadrunner1992: posts small blind $0.05
Hijjy91: posts big blind $0.10
*** HOLE CARDS ***
Dealt to CashMatteo [As 6c]
zow4005: folds 
CashMatteo: calls $0.10
Sylvester170: calls $0.10
roadrunner1992: calls $0.05
Hijjy91: checks 
*** FLOP *** [9c 3d Ac]
roadrunner1992: checks 
Hijjy91: checks 
CashMatteo: bets $0.19
Sylvester170: calls $0.19
roadrunner1992: folds 
Hijjy91: folds 
*** TURN *** [9c 3d Ac] [4d]
CashMatteo: bets $0.37
Sylvester170: raises $1.48 to $1.85
CashMatteo: folds 
Uncalled bet ($1.48) returned to Sylvester170
Sylvester170 collected $1.45 from pot
*** SUMMARY ***
Total pot $1.52 | Rake $0.07 
Board [9c 3d Ac 4d]
Seat 1: Hijjy91 (big blind) folded on the Flop
Seat 2: zow4005 folded before Flop (didn't bet)
Seat 3: CashMatteo folded on the Turn
Seat 4: Sylvester170 (button) collected ($1.45)
Seat 6: roadrunner1992 (small blind) folded on the Flop

Hand #1931: 

PokerStars Hand #246799744906:  Hold'em No Limit ($0.05/$0.10 CAD) - 2023/10/28 19:46:57 ET
Table 'Mavis II' 6-max Seat #6 is the button
Seat 1: Hijjy91 ($5.62 in chips) 
Seat 2: zow4005 ($10 in chips) 
Seat 3: CashMatteo ($9.95 in chips) 
Seat 4: Sylvester170 ($11.53 in chips) 
Seat 6: roadrunner1992 ($2.90 in chips) 
Hijjy91: posts small blind $0.05
zow4005: posts big blind $0.10
*** HOLE CARDS ***
Dealt to CashMatteo [Ts Jd]
CashMatteo: calls $0.10
Sylvester170: calls $0.10
roadrunner1992: calls $0.10
Hijjy91: calls $0.05
zow4005: checks 
*** FLOP *** [Jc 9d 3d]
Hijjy91: checks 
zow4005: checks 
CashMatteo: bets $0.24
Sylvester170: calls $0.24
roadrunner1992: calls $0.24
Hijjy91: folds 
zow4005: folds 
*** TURN *** [Jc 9d 3d] [7s]
CashMatteo: checks 
Sylvester170: bets $0.70
roadrunner1992: folds 
CashMatteo: calls $0.70
*** RIVER *** [Jc 9d 3d 7s] [Jh]
CashMatteo: checks 
Sylvester170: bets $1.25
CashMatteo: calls $1.25
*** SHOW DOWN ***
Sylvester170: shows [8s Tc] (a straight, Seven to Jack)
CashMatteo: mucks hand 
Sylvester170 collected $4.89 from pot
*** SUMMARY ***
Total pot $5.12 | Rake $0.23 
Board [Jc 9d 3d 7s Jh]
Seat 1: Hijjy91 (small blind) folded on the Flop
Seat 2: zow4005 (big blind) folded on the Flop
Seat 3: CashMatteo mucked [Ts Jd]
Seat 4: Sylvester170 showed [8s Tc] and won ($4.89) with a straight, Seven to Jack
Seat 6: roadrunner1992 (button) folded on the Turn

Hand #1932: 

PokerStars Hand #246799761973:  Hold'em No Limit ($0.05/$0.10 CAD) - 2023/10/28 19:48:10 ET
Table 'Mavis II' 6-max Seat #1 is the button
Seat 1: Hijjy91 ($5.52 in chips) 
Seat 2: zow4005 ($10 in chips) 
Seat 3: CashMatteo ($7.66 in chips) 
Seat 4: Sylvester170 ($14.13 in chips) 
Seat 6: roadrunner1992 ($2.56 in chips) 
zow4005: posts small blind $0.05
CashMatteo: posts big blind $0.10
*** HOLE CARDS ***
Dealt to CashMatteo [Ac 2c]
Sylvester170: calls $0.10
roadrunner1992: folds 
Hijjy91: raises $0.30 to $0.40
zow4005: folds 
CashMatteo: calls $0.30
Sylvester170: calls $0.30
*** FLOP *** [Qc 3d Ts]
CashMatteo: checks 
Sylvester170: checks 
Hijjy91: bets $0.70
CashMatteo: folds 
Sylvester170: folds 
Uncalled bet ($0.70) returned to Hijjy91
Hijjy91 collected $1.19 from pot
*** SUMMARY ***
Total pot $1.25 | Rake $0.06 
Board [Qc 3d Ts]
Seat 1: Hijjy91 (button) collected ($1.19)
Seat 2: zow4005 (small blind) folded before Flop
Seat 3: CashMatteo (big blind) folded on the Flop
Seat 4: Sylvester170 folded on the Flop
Seat 6: roadrunner1992 folded before Flop (didn't bet)

Hand #1933: 

PokerStars Hand #246799769884:  Hold'em No Limit ($0.05/$0.10 CAD) - 2023/10/28 19:48:44 ET
Table 'Mavis II' 6-max Seat #2 is the button
Seat 1: Hijjy91 ($6.31 in chips) 
Seat 2: zow4005 ($10 in chips) 
Seat 3: CashMatteo ($7.26 in chips) 
Seat 4: Sylvester170 ($13.73 in chips) 
Seat 6: roadrunner1992 ($2.56 in chips) 
CashMatteo: posts small blind $0.05
Sylvester170: posts big blind $0.10
*** HOLE CARDS ***
Dealt to CashMatteo [Kc Qh]
roadrunner1992: folds 
Hijjy91: raises $0.30 to $0.40
zow4005: folds 
CashMatteo: raises $0.90 to $1.30
Sylvester170: folds 
Hijjy91: calls $0.90
*** FLOP *** [7d 2c Tc]
CashMatteo: checks 
Hijjy91: checks 
*** TURN *** [7d 2c Tc] [8d]
CashMatteo: checks 
Hijjy91: checks 
*** RIVER *** [7d 2c Tc 8d] [8h]
CashMatteo: checks 
Hijjy91: checks 
*** SHOW DOWN ***
CashMatteo: shows [Kc Qh] (a pair of Eights)
Hijjy91: shows [Ah Qc] (a pair of Eights - Ace kicker)
Hijjy91 collected $2.58 from pot
*** SUMMARY ***
Total pot $2.70 | Rake $0.12 
Board [7d 2c Tc 8d 8h]
Seat 1: Hijjy91 showed [Ah Qc] and won ($2.58) with a pair of Eights
Seat 2: zow4005 (button) folded before Flop (didn't bet)
Seat 3: CashMatteo (small blind) showed [Kc Qh] and lost with a pair of Eights
Seat 4: Sylvester170 (big blind) folded before Flop
Seat 6: roadrunner1992 folded before Flop (didn't bet)

Hand #1934: 

PokerStars Hand #246799782748:  Hold'em No Limit ($0.05/$0.10 CAD) - 2023/10/28 19:49:40 ET
Table 'Mavis II' 6-max Seat #3 is the button
Seat 1: Hijjy91 ($7.59 in chips) 
Seat 2: zow4005 ($10 in chips) 
Seat 3: CashMatteo ($5.96 in chips) 
Seat 4: Sylvester170 ($13.63 in chips) 
Seat 6: roadrunner1992 ($2.56 in chips) 
Sylvester170: posts small blind $0.05
roadrunner1992: posts big blind $0.10
*** HOLE CARDS ***
Dealt to CashMatteo [8h Jc]
Hijjy91: calls $0.10
zow4005: folds 
CashMatteo: calls $0.10
Sylvester170: calls $0.05
roadrunner1992: checks 
*** FLOP *** [8d 9c 4s]
Sylvester170: checks 
roadrunner1992: checks 
Hijjy91: checks 
CashMatteo: checks 
*** TURN *** [8d 9c 4s] [3d]
Sylvester170: checks 
roadrunner1992: checks 
Hijjy91: checks 
CashMatteo: bets $0.19
Sylvester170: folds 
roadrunner1992: calls $0.19
Hijjy91: folds 
*** RIVER *** [8d 9c 4s 3d] [Qh]
roadrunner1992: checks 
CashMatteo: checks 
*** SHOW DOWN ***
roadrunner1992: shows [Kh 4c] (a pair of Fours)
CashMatteo: shows [8h Jc] (a pair of Eights)
CashMatteo collected $0.74 from pot
*** SUMMARY ***
Total pot $0.78 | Rake $0.04 
Board [8d 9c 4s 3d Qh]
Seat 1: Hijjy91 folded on the Turn
Seat 2: zow4005 folded before Flop (didn't bet)
Seat 3: CashMatteo (button) showed [8h Jc] and won ($0.74) with a pair of Eights
Seat 4: Sylvester170 (small blind) folded on the Turn
Seat 6: roadrunner1992 (big blind) showed [Kh 4c] and lost with a pair of Fours

Hand #1935: 

PokerStars Hand #246799793098:  Hold'em No Limit ($0.05/$0.10 CAD) - 2023/10/28 19:50:24 ET
Table 'Mavis II' 6-max Seat #4 is the button
Seat 1: Hijjy91 ($7.49 in chips) 
Seat 2: zow4005 ($10 in chips) 
Seat 3: CashMatteo ($6.41 in chips) 
Seat 4: Sylvester170 ($13.53 in chips) 
Seat 6: roadrunner1992 ($2.27 in chips) 
roadrunner1992: posts small blind $0.05
Hijjy91: posts big blind $0.10
*** HOLE CARDS ***
Dealt to CashMatteo [3d Js]
zow4005: folds 
CashMatteo: folds 
Sylvester170: calls $0.10
roadrunner1992: folds 
Hijjy91: checks 
*** FLOP *** [2s 9s Qh]
Hijjy91: checks 
Sylvester170: bets $0.20
Hijjy91: calls $0.20
*** TURN *** [2s 9s Qh] [Kd]
Hijjy91: checks 
Sylvester170: checks 
*** RIVER *** [2s 9s Qh Kd] [Tc]
Hijjy91: checks 
Sylvester170: checks 
*** SHOW DOWN ***
Hijjy91: shows [2h 7h] (a pair of Deuces)
Sylvester170: shows [4h 4d] (a pair of Fours)
Sylvester170 collected $0.62 from pot
*** SUMMARY ***
Total pot $0.65 | Rake $0.03 
Board [2s 9s Qh Kd Tc]
Seat 1: Hijjy91 (big blind) showed [2h 7h] and lost with a pair of Deuces
Seat 2: zow4005 folded before Flop (didn't bet)
Seat 3: CashMatteo folded before Flop (didn't bet)
Seat 4: Sylvester170 (button) showed [4h 4d] and won ($0.62) with a pair of Fours
Seat 6: roadrunner1992 (small blind) folded before Flop

Hand #1936: 

PokerStars Hand #246799802512:  Hold'em No Limit ($0.05/$0.10 CAD) - 2023/10/28 19:51:05 ET
Table 'Mavis II' 6-max Seat #6 is the button
Seat 1: Hijjy91 ($7.19 in chips) 
Seat 2: zow4005 ($10 in chips) 
Seat 3: CashMatteo ($6.41 in chips) 
Seat 4: Sylvester170 ($13.85 in chips) 
Seat 6: roadrunner1992 ($2.22 in chips) 
Hijjy91: posts small blind $0.05
zow4005: posts big blind $0.10
*** HOLE CARDS ***
Dealt to CashMatteo [6s 4h]
CashMatteo: folds 
Sylvester170: calls $0.10
roadrunner1992: calls $0.10
Hijjy91: folds 
zow4005: checks 
*** FLOP *** [9h Kh 3s]
zow4005: bets $0.20
Sylvester170: folds 
roadrunner1992: folds 
Uncalled bet ($0.20) returned to zow4005
zow4005 collected $0.33 from pot
zow4005: doesn't show hand 
*** SUMMARY ***
Total pot $0.35 | Rake $0.02 
Board [9h Kh 3s]
Seat 1: Hijjy91 (small blind) folded before Flop
Seat 2: zow4005 (big blind) collected ($0.33)
Seat 3: CashMatteo folded before Flop (didn't bet)
Seat 4: Sylvester170 folded on the Flop
Seat 6: roadrunner1992 (button) folded on the Flop

Hand #1937: 

PokerStars Hand #246799810016:  Hold'em No Limit ($0.05/$0.10 CAD) - 2023/10/28 19:51:38 ET
Table 'Mavis II' 6-max Seat #1 is the button
Seat 1: Hijjy91 ($7.14 in chips) 
Seat 2: zow4005 ($10.23 in chips) 
Seat 3: CashMatteo ($6.41 in chips) 
Seat 4: Sylvester170 ($13.75 in chips) 
Seat 6: roadrunner1992 ($2.12 in chips) 
zow4005: posts small blind $0.05
CashMatteo: posts big blind $0.10
*** HOLE CARDS ***
Dealt to CashMatteo [Jh 2h]
Sylvester170: calls $0.10
roadrunner1992: folds 
Hijjy91: folds 
zow4005: raises $0.40 to $0.50
CashMatteo: folds 
Sylvester170: calls $0.40
*** FLOP *** [As 3d Ad]
zow4005: bets $0.60
Sylvester170: folds 
Uncalled bet ($0.60) returned to zow4005
zow4005 collected $1.05 from pot
zow4005: doesn't show hand 
*** SUMMARY ***
Total pot $1.10 | Rake $0.05 
Board [As 3d Ad]
Seat 1: Hijjy91 (button) folded before Flop (didn't bet)
Seat 2: zow4005 (small blind) collected ($1.05)
Seat 3: CashMatteo (big blind) folded before Flop
Seat 4: Sylvester170 folded on the Flop
Seat 6: roadrunner1992 folded before Flop (didn't bet)

Hand #1938: 

PokerStars Hand #246799816136:  Hold'em No Limit ($0.05/$0.10 CAD) - 2023/10/28 19:52:05 ET
Table 'Mavis II' 6-max Seat #2 is the button
Seat 1: Hijjy91 ($7.14 in chips) 
Seat 2: zow4005 ($10.78 in chips) 
Seat 3: CashMatteo ($6.31 in chips) 
Seat 4: Sylvester170 ($13.25 in chips) 
Seat 6: roadrunner1992 ($2.12 in chips) 
CashMatteo: posts small blind $0.05
Sylvester170: posts big blind $0.10
*** HOLE CARDS ***
Dealt to CashMatteo [2c 3d]
roadrunner1992: calls $0.10
Hijjy91: folds 
zow4005: folds 
CashMatteo: folds 
Sylvester170: checks 
*** FLOP *** [As 9d 7c]
Sylvester170: checks 
roadrunner1992: checks 
*** TURN *** [As 9d 7c] [4d]
Sylvester170: checks 
roadrunner1992: bets $0.10
Sylvester170: raises $0.10 to $0.20
roadrunner1992: raises $0.10 to $0.30
Sylvester170: calls $0.10
*** RIVER *** [As 9d 7c 4d] [Qd]
Sylvester170: checks 
roadrunner1992: bets $1.72 and is all-in
Sylvester170: folds 
Uncalled bet ($1.72) returned to roadrunner1992
roadrunner1992 collected $0.81 from pot
*** SUMMARY ***
Total pot $0.85 | Rake $0.04 
Board [As 9d 7c 4d Qd]
Seat 1: Hijjy91 folded before Flop (didn't bet)
Seat 2: zow4005 (button) folded before Flop (didn't bet)
Seat 3: CashMatteo (small blind) folded before Flop
Seat 4: Sylvester170 (big blind) folded on the River
Seat 6: roadrunner1992 collected ($0.81)

Hand #1939: 

PokerStars Hand #246799828774:  Hold'em No Limit ($0.05/$0.10 CAD) - 2023/10/28 19:53:00 ET
Table 'Mavis II' 6-max Seat #3 is the button
Seat 1: Hijjy91 ($7.14 in chips) 
Seat 2: zow4005 ($10.78 in chips) 
Seat 3: CashMatteo ($6.26 in chips) 
Seat 4: Sylvester170 ($12.85 in chips) 
Seat 6: roadrunner1992 ($2.53 in chips) 
Sylvester170: posts small blind $0.05
roadrunner1992: posts big blind $0.10
*** HOLE CARDS ***
Dealt to CashMatteo [Kh 3s]
Hijjy91: folds 
zow4005: folds 
CashMatteo: folds 
Sylvester170: raises $0.20 to $0.30
roadrunner1992: calls $0.20
*** FLOP *** [5h 6d 7h]
Sylvester170: checks 
roadrunner1992: checks 
*** TURN *** [5h 6d 7h] [7d]
Sylvester170: bets $0.29
roadrunner1992: calls $0.29
*** RIVER *** [5h 6d 7h 7d] [Ks]
Sylvester170: bets $0.57
roadrunner1992: folds 
Uncalled bet ($0.57) returned to Sylvester170
Sylvester170 collected $1.13 from pot
Castor1 was removed from the table for failing to post
Castor1 leaves the table
*** SUMMARY ***
Total pot $1.18 | Rake $0.05 
Board [5h 6d 7h 7d Ks]
Seat 1: Hijjy91 folded before Flop (didn't bet)
Seat 2: zow4005 folded before Flop (didn't bet)
Seat 3: CashMatteo (button) folded before Flop (didn't bet)
Seat 4: Sylvester170 (small blind) collected ($1.13)
Seat 6: roadrunner1992 (big blind) folded on the River

Hand #1940: 

PokerStars Hand #246799837277:  Hold'em No Limit ($0.05/$0.10 CAD) - 2023/10/28 19:53:37 ET
Table 'Mavis II' 6-max Seat #4 is the button
Seat 1: Hijjy91 ($7.14 in chips) 
Seat 2: zow4005 ($10.78 in chips) 
Seat 3: CashMatteo ($6.26 in chips) 
Seat 4: Sylvester170 ($13.39 in chips) 
Seat 6: roadrunner1992 ($1.94 in chips) 
roadrunner1992: posts small blind $0.05
Hijjy91: posts big blind $0.10
*** HOLE CARDS ***
Dealt to CashMatteo [8s 4h]
zow4005: folds 
CashMatteo: folds 
Sylvester170: calls $0.10
roadrunner1992: calls $0.05
Hijjy91: checks 
*** FLOP *** [Kc 5c Ks]
roadrunner1992: checks 
Hijjy91: bets $0.20
Sylvester170: calls $0.20
roadrunner1992: folds 
*** TURN *** [Kc 5c Ks] [4c]
Hijjy91: checks 
Sylvester170: bets $0.67
Hijjy91: calls $0.67
*** RIVER *** [Kc 5c Ks 4c] [Ts]
Hijjy91: checks 
Sylvester170: checks 
*** SHOW DOWN ***
Hijjy91: shows [8h 8d] (two pair, Kings and Eights)
Sylvester170: mucks hand 
Hijjy91 collected $1.95 from pot
*** SUMMARY ***
Total pot $2.04 | Rake $0.09 
Board [Kc 5c Ks 4c Ts]
Seat 1: Hijjy91 (big blind) showed [8h 8d] and won ($1.95) with two pair, Kings and Eights
Seat 2: zow4005 folded before Flop (didn't bet)
Seat 3: CashMatteo folded before Flop (didn't bet)
Seat 4: Sylvester170 (button) mucked [7d 6c]
Seat 6: roadrunner1992 (small blind) folded on the Flop

Hand #1941: 

PokerStars Hand #246799845448:  Hold'em No Limit ($0.05/$0.10 CAD) - 2023/10/28 19:54:13 ET
Table 'Mavis II' 6-max Seat #6 is the button
Seat 1: Hijjy91 ($8.12 in chips) 
Seat 2: zow4005 ($10.78 in chips) 
Seat 3: CashMatteo ($6.26 in chips) 
Seat 4: Sylvester170 ($12.42 in chips) 
Seat 6: roadrunner1992 ($1.84 in chips) 
Hijjy91: posts small blind $0.05
zow4005: posts big blind $0.10
*** HOLE CARDS ***
Dealt to CashMatteo [Ac 7s]
CashMatteo: calls $0.10
zViveXz joins the table at seat #5 
Sylvester170: raises $0.20 to $0.30
roadrunner1992: folds 
Hijjy91: folds 
zow4005: calls $0.20
CashMatteo: calls $0.20
*** FLOP *** [3d 7d 9c]
zow4005: checks 
CashMatteo: checks 
Sylvester170: bets $0.46
zow4005: folds 
CashMatteo: calls $0.46
*** TURN *** [3d 7d 9c] [8c]
CashMatteo: checks 
Sylvester170: bets $1.79
CashMatteo: folds 
Uncalled bet ($1.79) returned to Sylvester170
Sylvester170 collected $1.79 from pot
*** SUMMARY ***
Total pot $1.87 | Rake $0.08 
Board [3d 7d 9c 8c]
Seat 1: Hijjy91 (small blind) folded before Flop
Seat 2: zow4005 (big blind) folded on the Flop
Seat 3: CashMatteo folded on the Turn
Seat 4: Sylvester170 collected ($1.79)
Seat 6: roadrunner1992 (button) folded before Flop (didn't bet)

Hand #1942: 

PokerStars Hand #246799855209:  Hold'em No Limit ($0.05/$0.10 CAD) - 2023/10/28 19:54:55 ET
Table 'Mavis II' 6-max Seat #1 is the button
Seat 1: Hijjy91 ($8.07 in chips) 
Seat 2: zow4005 ($10.48 in chips) 
Seat 3: CashMatteo ($5.50 in chips) 
Seat 4: Sylvester170 ($13.45 in chips) 
Seat 6: roadrunner1992 ($1.84 in chips) 
zow4005: posts small blind $0.05
CashMatteo: posts big blind $0.10
zViveXz: sits out 
*** HOLE CARDS ***
Dealt to CashMatteo [9c 7d]
Sylvester170: raises $0.20 to $0.30
roadrunner1992: folds 
Hijjy91: folds 
zow4005: folds 
CashMatteo: folds 
Uncalled bet ($0.20) returned to Sylvester170
Sylvester170 collected $0.25 from pot
*** SUMMARY ***
Total pot $0.25 | Rake $0 
Seat 1: Hijjy91 (button) folded before Flop (didn't bet)
Seat 2: zow4005 (small blind) folded before Flop
Seat 3: CashMatteo (big blind) folded before Flop
Seat 4: Sylvester170 collected ($0.25)
Seat 6: roadrunner1992 folded before Flop (didn't bet)

Hand #1943: 

PokerStars Hand #246799857919:  Hold'em No Limit ($0.05/$0.10 CAD) - 2023/10/28 19:55:07 ET
Table 'Mavis II' 6-max Seat #2 is the button
Seat 1: Hijjy91 ($8.07 in chips) 
Seat 2: zow4005 ($10.43 in chips) 
Seat 3: CashMatteo ($5.40 in chips) 
Seat 4: Sylvester170 ($13.60 in chips) 
Seat 6: roadrunner1992 ($1.84 in chips) 
CashMatteo: posts small blind $0.05
Sylvester170: posts big blind $0.10
zViveXz: sits out 
*** HOLE CARDS ***
Dealt to CashMatteo [9d 3h]
roadrunner1992: calls $0.10
Hijjy91: folds 
zow4005: folds 
CashMatteo: folds 
Sylvester170: checks 
*** FLOP *** [Kh 2s Qd]
Sylvester170: checks 
roadrunner1992: checks 
*** TURN *** [Kh 2s Qd] [5d]
Sylvester170: checks 
roadrunner1992: bets $0.10
Sylvester170: calls $0.10
*** RIVER *** [Kh 2s Qd 5d] [Kd]
Sylvester170: checks 
roadrunner1992: bets $0.30
Sylvester170: folds 
Uncalled bet ($0.30) returned to roadrunner1992
roadrunner1992 collected $0.43 from pot
*** SUMMARY ***
Total pot $0.45 | Rake $0.02 
Board [Kh 2s Qd 5d Kd]
Seat 1: Hijjy91 folded before Flop (didn't bet)
Seat 2: zow4005 (button) folded before Flop (didn't bet)
Seat 3: CashMatteo (small blind) folded before Flop
Seat 4: Sylvester170 (big blind) folded on the River
Seat 6: roadrunner1992 collected ($0.43)

Hand #1944: 

PokerStars Hand #246799864055:  Hold'em No Limit ($0.05/$0.10 CAD) - 2023/10/28 19:55:39 ET
Table 'Mavis II' 6-max Seat #3 is the button
Seat 1: Hijjy91 ($8.07 in chips) 
Seat 2: zow4005 ($10.43 in chips) 
Seat 3: CashMatteo ($5.35 in chips) 
Seat 4: Sylvester170 ($13.40 in chips) 
Seat 5: zViveXz ($10 in chips) 
Seat 6: roadrunner1992 ($2.07 in chips) 
Sylvester170: posts small blind $0.05
zViveXz: posts big blind $0.10
*** HOLE CARDS ***
Dealt to CashMatteo [4s 6c]
roadrunner1992: calls $0.10
Hijjy91: calls $0.10
zow4005: raises $0.30 to $0.40
CashMatteo: folds 
Sylvester170: calls $0.35
zViveXz: folds 
roadrunner1992: folds 
Hijjy91: calls $0.30
*** FLOP *** [9c Qd Qh]
Sylvester170: checks 
Hijjy91: checks 
zow4005: bets $0.80
Sylvester170: calls $0.80
Hijjy91: folds 
*** TURN *** [9c Qd Qh] [6s]
Sylvester170: checks 
zow4005: checks 
*** RIVER *** [9c Qd Qh 6s] [8c]
Sylvester170: bets $2.86
zow4005: raises $6.37 to $9.23 and is all-in
Sylvester170: calls $6.37
*** SHOW DOWN ***
zow4005: shows [Js Ts] (a straight, Eight to Queen)
Sylvester170: shows [Qc Jc] (three of a kind, Queens)
zow4005 collected $20.49 from pot
*** SUMMARY ***
Total pot $21.46 | Rake $0.97 
Board [9c Qd Qh 6s 8c]
Seat 1: Hijjy91 folded on the Flop
Seat 2: zow4005 showed [Js Ts] and won ($20.49) with a straight, Eight to Queen
Seat 3: CashMatteo (button) folded before Flop (didn't bet)
Seat 4: Sylvester170 (small blind) showed [Qc Jc] and lost with three of a kind, Queens
Seat 5: zViveXz (big blind) folded before Flop
Seat 6: roadrunner1992 folded before Flop

Hand #1945: 

PokerStars Hand #246799877590:  Hold'em No Limit ($0.05/$0.10 CAD) - 2023/10/28 19:56:50 ET
Table 'Mavis II' 6-max Seat #4 is the button
Seat 1: Hijjy91 ($7.67 in chips) 
Seat 2: zow4005 ($20.49 in chips) 
Seat 3: CashMatteo ($5.35 in chips) 
Seat 4: Sylvester170 ($2.97 in chips) 
Seat 5: zViveXz ($9.90 in chips) 
Seat 6: roadrunner1992 ($1.97 in chips) 
zViveXz: posts small blind $0.05
roadrunner1992: posts big blind $0.10
*** HOLE CARDS ***
Dealt to CashMatteo [Ah 7c]
Hijjy91: folds 
zow4005: raises $0.20 to $0.30
CashMatteo: calls $0.30
Sylvester170: calls $0.30
zViveXz: calls $0.25
roadrunner1992: calls $0.20
*** FLOP *** [Qd Jc 7h]
zViveXz: bets $0.72
roadrunner1992: calls $0.72
zow4005: folds 
CashMatteo: folds 
Sylvester170: folds 
*** TURN *** [Qd Jc 7h] [Kd]
zViveXz: checks 
roadrunner1992: bets $0.10
zViveXz: raises $1.51 to $1.61
roadrunner1992: calls $0.85 and is all-in
Uncalled bet ($0.66) returned to zViveXz
*** RIVER *** [Qd Jc 7h Kd] [8s]
*** SHOW DOWN ***
zViveXz: shows [Ks Tc] (a pair of Kings)
roadrunner1992: shows [9c Kc] (a pair of Kings - lower kicker)
zViveXz collected $4.62 from pot
*** SUMMARY ***
Total pot $4.84 | Rake $0.22 
Board [Qd Jc 7h Kd 8s]
Seat 1: Hijjy91 folded before Flop (didn't bet)
Seat 2: zow4005 folded on the Flop
Seat 3: CashMatteo folded on the Flop
Seat 4: Sylvester170 (button) folded on the Flop
Seat 5: zViveXz (small blind) showed [Ks Tc] and won ($4.62) with a pair of Kings
Seat 6: roadrunner1992 (big blind) showed [9c Kc] and lost with a pair of Kings

Hand #1946: 

PokerStars Hand #246799887853:  Hold'em No Limit ($0.05/$0.10 CAD) - 2023/10/28 19:57:44 ET
Table 'Mavis II' 6-max Seat #5 is the button
Seat 1: Hijjy91 ($7.67 in chips) 
Seat 2: zow4005 ($20.19 in chips) 
Seat 3: CashMatteo ($5.05 in chips) 
Seat 4: Sylvester170 ($2.67 in chips) 
Seat 5: zViveXz ($12.55 in chips) 
Hijjy91: posts small blind $0.05
zow4005: posts big blind $0.10
*** HOLE CARDS ***
Dealt to CashMatteo [Th 4c]
CashMatteo: folds 
Sylvester170: calls $0.10
zViveXz: raises $0.15 to $0.25
Hijjy91: folds 
zow4005: folds 
Sylvester170: calls $0.15
*** FLOP *** [2h 5c 3d]
Sylvester170: checks 
zViveXz: bets $0.31
Sylvester170: folds 
Uncalled bet ($0.31) returned to zViveXz
zViveXz collected $0.62 from pot
zViveXz: doesn't show hand 
*** SUMMARY ***
Total pot $0.65 | Rake $0.03 
Board [2h 5c 3d]
Seat 1: Hijjy91 (small blind) folded before Flop
Seat 2: zow4005 (big blind) folded before Flop
Seat 3: CashMatteo folded before Flop (didn't bet)
Seat 4: Sylvester170 folded on the Flop
Seat 5: zViveXz (button) collected ($0.62)

Hand #1947: 

PokerStars Hand #246799894534:  Hold'em No Limit ($0.05/$0.10 CAD) - 2023/10/28 19:58:18 ET
Table 'Mavis II' 6-max Seat #1 is the button
Seat 1: Hijjy91 ($7.62 in chips) 
Seat 2: zow4005 ($20.09 in chips) 
Seat 3: CashMatteo ($5.05 in chips) 
Seat 4: Sylvester170 ($2.42 in chips) 
Seat 5: zViveXz ($12.92 in chips) 
Seat 6: roadrunner1992 ($4 in chips) 
zow4005: posts small blind $0.05
CashMatteo: posts big blind $0.10
roadrunner1992: posts small blind $0.05
*** HOLE CARDS ***
Dealt to CashMatteo [2h Kh]
Sylvester170: calls $0.10
zViveXz: folds 
roadrunner1992: folds 
Hijjy91: raises $0.20 to $0.30
zow4005: folds 
CashMatteo: calls $0.20
Sylvester170: calls $0.20
*** FLOP *** [3d Jd 5d]
CashMatteo: checks 
Sylvester170: bets $0.48
Hijjy91: calls $0.48
CashMatteo: folds 
*** TURN *** [3d Jd 5d] [7d]
Sylvester170: checks 
Hijjy91: bets $6.84 and is all-in
Sylvester170: calls $1.64 and is all-in
Uncalled bet ($5.20) returned to Hijjy91
*** RIVER *** [3d Jd 5d 7d] [Tc]
*** SHOW DOWN ***
Sylvester170: shows [Ad 6s] (a flush, Ace high)
Hijjy91: shows [Ah Jc] (a pair of Jacks)
Sylvester170 collected $5 from pot
*** SUMMARY ***
Total pot $5.24 | Rake $0.24 
Board [3d Jd 5d 7d Tc]
Seat 1: Hijjy91 (button) showed [Ah Jc] and lost with a pair of Jacks
Seat 2: zow4005 (small blind) folded before Flop
Seat 3: CashMatteo (big blind) folded on the Flop
Seat 4: Sylvester170 showed [Ad 6s] and won ($5) with a flush, Ace high
Seat 5: zViveXz folded before Flop (didn't bet)
Seat 6: roadrunner1992 folded before Flop (didn't bet)

Hand #1948: 

PokerStars Hand #246799904096:  Hold'em No Limit ($0.05/$0.10 CAD) - 2023/10/28 19:59:07 ET
Table 'Mavis II' 6-max Seat #2 is the button
Seat 1: Hijjy91 ($5.20 in chips) 
Seat 2: zow4005 ($20.04 in chips) 
Seat 3: CashMatteo ($4.75 in chips) 
Seat 4: Sylvester170 ($5 in chips) 
Seat 5: zViveXz ($12.92 in chips) 
Seat 6: roadrunner1992 ($3.95 in chips) 
CashMatteo: posts small blind $0.05
Sylvester170: posts big blind $0.10
*** HOLE CARDS ***
Dealt to CashMatteo [2h 3d]
zViveXz: folds 
roadrunner1992: calls $0.10
Hijjy91: calls $0.10
zow4005: folds 
CashMatteo: folds 
Sylvester170: checks 
*** FLOP *** [4s 7h 6d]
Sylvester170: checks 
roadrunner1992: checks 
Hijjy91: checks 
*** TURN *** [4s 7h 6d] [Ac]
Sylvester170: checks 
roadrunner1992: checks 
Hijjy91: checks 
*** RIVER *** [4s 7h 6d Ac] [Td]
Sylvester170: checks 
roadrunner1992: bets $0.10
Hijjy91: folds 
Sylvester170: folds 
Uncalled bet ($0.10) returned to roadrunner1992
roadrunner1992 collected $0.33 from pot
roadrunner1992: doesn't show hand 
*** SUMMARY ***
Total pot $0.35 | Rake $0.02 
Board [4s 7h 6d Ac Td]
Seat 1: Hijjy91 folded on the River
Seat 2: zow4005 (button) folded before Flop (didn't bet)
Seat 3: CashMatteo (small blind) folded before Flop
Seat 4: Sylvester170 (big blind) folded on the River
Seat 5: zViveXz folded before Flop (didn't bet)
Seat 6: roadrunner1992 collected ($0.33)

Hand #1949: 

PokerStars Hand #246799910461:  Hold'em No Limit ($0.05/$0.10 CAD) - 2023/10/28 19:59:40 ET
Table 'Mavis II' 6-max Seat #3 is the button
Seat 1: Hijjy91 ($5.10 in chips) 
Seat 2: zow4005 ($20.04 in chips) 
Seat 3: CashMatteo ($4.70 in chips) 
Seat 4: Sylvester170 ($4.90 in chips) 
Seat 5: zViveXz ($12.92 in chips) 
Seat 6: roadrunner1992 ($4.18 in chips) 
Sylvester170: posts small blind $0.05
zViveXz: posts big blind $0.10
*** HOLE CARDS ***
Dealt to CashMatteo [9h Kd]
roadrunner1992: folds 
Hijjy91: calls $0.10
zow4005: folds 
CashMatteo: raises $0.15 to $0.25
Sylvester170: folds 
zViveXz: folds 
Hijjy91: calls $0.15
*** FLOP *** [6s Ts 8d]
Hijjy91: checks 
CashMatteo: bets $0.31
Hijjy91: raises $0.31 to $0.62
CashMatteo: calls $0.31
*** TURN *** [6s Ts 8d] [Qh]
Hijjy91: bets $0.90
CashMatteo: calls $0.90
*** RIVER *** [6s Ts 8d Qh] [Ah]
Hijjy91: bets $3.33 and is all-in
CashMatteo: folds 
Uncalled bet ($3.33) returned to Hijjy91
Hijjy91 collected $3.52 from pot
*** SUMMARY ***
Total pot $3.69 | Rake $0.17 
Board [6s Ts 8d Qh Ah]
Seat 1: Hijjy91 collected ($3.52)
Seat 2: zow4005 folded before Flop (didn't bet)
Seat 3: CashMatteo (button) folded on the River
Seat 4: Sylvester170 (small blind) folded before Flop
Seat 5: zViveXz (big blind) folded before Flop
Seat 6: roadrunner1992 folded before Flop (didn't bet)

Hand #1950: 

PokerStars Hand #246799924518:  Hold'em No Limit ($0.05/$0.10 CAD) - 2023/10/28 20:00:50 ET
Table 'Mavis II' 6-max Seat #4 is the button
Seat 1: Hijjy91 ($6.85 in chips) 
Seat 2: zow4005 ($20.04 in chips) 
Seat 3: CashMatteo ($2.93 in chips) 
Seat 4: Sylvester170 ($4.85 in chips) 
Seat 5: zViveXz ($12.82 in chips) 
Seat 6: roadrunner1992 ($4.18 in chips) 
zViveXz: posts small blind $0.05
roadrunner1992: posts big blind $0.10
*** HOLE CARDS ***
Dealt to CashMatteo [5c 2c]
Hijjy91: raises $0.10 to $0.20
zow4005: folds 
CashMatteo: folds 
Sylvester170: calls $0.20
zViveXz: folds 
roadrunner1992: calls $0.10
*** FLOP *** [7h Qh Ts]
roadrunner1992: checks 
Hijjy91: bets $0.30
Sylvester170: folds 
roadrunner1992: calls $0.30
*** TURN *** [7h Qh Ts] [Tc]
roadrunner1992: checks 
Hijjy91: bets $0.60
roadrunner1992: calls $0.60
*** RIVER *** [7h Qh Ts Tc] [Ks]
roadrunner1992: checks 
Hijjy91: bets $0.90
roadrunner1992: calls $0.90
*** SHOW DOWN ***
Hijjy91: shows [Jd Td] (three of a kind, Tens)
roadrunner1992: mucks hand 
Hijjy91 collected $4.06 from pot
*** SUMMARY ***
Total pot $4.25 | Rake $0.19 
Board [7h Qh Ts Tc Ks]
Seat 1: Hijjy91 showed [Jd Td] and won ($4.06) with three of a kind, Tens
Seat 2: zow4005 folded before Flop (didn't bet)
Seat 3: CashMatteo folded before Flop (didn't bet)
Seat 4: Sylvester170 (button) folded on the Flop
Seat 5: zViveXz (small blind) folded before Flop
Seat 6: roadrunner1992 (big blind) mucked [Jc Jh]

Hand #1951: 

PokerStars Hand #246799934804:  Hold'em No Limit ($0.05/$0.10 CAD) - 2023/10/28 20:01:37 ET
Table 'Mavis II' 6-max Seat #5 is the button
Seat 1: Hijjy91 ($8.91 in chips) 
Seat 2: zow4005 ($20.04 in chips) 
Seat 3: CashMatteo ($2.93 in chips) 
Seat 4: Sylvester170 ($4.65 in chips) 
Seat 5: zViveXz ($12.77 in chips) 
Seat 6: roadrunner1992 ($2.18 in chips) 
roadrunner1992: posts small blind $0.05
Hijjy91: posts big blind $0.10
*** HOLE CARDS ***
Dealt to CashMatteo [3c Qh]
zow4005: folds 
CashMatteo: folds 
Sylvester170: folds 
zViveXz: raises $0.15 to $0.25
roadrunner1992: folds 
Hijjy91: folds 
Uncalled bet ($0.15) returned to zViveXz
zViveXz collected $0.25 from pot
zViveXz: doesn't show hand 
*** SUMMARY ***
Total pot $0.25 | Rake $0 
Seat 1: Hijjy91 (big blind) folded before Flop
Seat 2: zow4005 folded before Flop (didn't bet)
Seat 3: CashMatteo folded before Flop (didn't bet)
Seat 4: Sylvester170 folded before Flop (didn't bet)
Seat 5: zViveXz (button) collected ($0.25)
Seat 6: roadrunner1992 (small blind) folded before Flop

Hand #1952: 

PokerStars Hand #246799938697:  Hold'em No Limit ($0.05/$0.10 CAD) - 2023/10/28 20:01:54 ET
Table 'Mavis II' 6-max Seat #6 is the button
Seat 1: Hijjy91 ($8.81 in chips) 
Seat 2: zow4005 ($20.04 in chips) 
Seat 3: CashMatteo ($2.93 in chips) 
Seat 4: Sylvester170 ($4.65 in chips) 
Seat 5: zViveXz ($12.92 in chips) 
Seat 6: roadrunner1992 ($2.13 in chips) 
Hijjy91: posts small blind $0.05
zow4005: posts big blind $0.10
*** HOLE CARDS ***
Dealt to CashMatteo [9h 4h]
CashMatteo: folds 
Sylvester170: folds 
zViveXz: folds 
roadrunner1992: folds 
Hijjy91: calls $0.05
zow4005: checks 
*** FLOP *** [Td Ks Ts]
Hijjy91: bets $0.10
zow4005: folds 
Uncalled bet ($0.10) returned to Hijjy91
Hijjy91 collected $0.19 from pot
*** SUMMARY ***
Total pot $0.20 | Rake $0.01 
Board [Td Ks Ts]
Seat 1: Hijjy91 (small blind) collected ($0.19)
Seat 2: zow4005 (big blind) folded on the Flop
Seat 3: CashMatteo folded before Flop (didn't bet)
Seat 4: Sylvester170 folded before Flop (didn't bet)
Seat 5: zViveXz folded before Flop (didn't bet)
Seat 6: roadrunner1992 (button) folded before Flop (didn't bet)

Hand #1953: 

PokerStars Hand #246799943574:  Hold'em No Limit ($0.05/$0.10 CAD) - 2023/10/28 20:02:15 ET
Table 'Mavis II' 6-max Seat #1 is the button
Seat 1: Hijjy91 ($8.90 in chips) 
Seat 2: zow4005 ($19.94 in chips) 
Seat 3: CashMatteo ($2.93 in chips) 
Seat 4: Sylvester170 ($4.65 in chips) 
Seat 5: zViveXz ($12.92 in chips) 
Seat 6: roadrunner1992 ($2.13 in chips) 
zow4005: posts small blind $0.05
CashMatteo: posts big blind $0.10
*** HOLE CARDS ***
Dealt to CashMatteo [7c 6s]
Sylvester170: raises $0.10 to $0.20
zViveXz: calls $0.20
roadrunner1992: calls $0.20
Hijjy91: folds 
zow4005: folds 
CashMatteo: folds 
*** FLOP *** [9c 4c 7s]
Sylvester170: checks 
zViveXz: bets $0.36
roadrunner1992: folds 
Sylvester170: calls $0.36
*** TURN *** [9c 4c 7s] [Ts]
Sylvester170: checks 
zViveXz: bets $0.70
Sylvester170: raises $1.40 to $2.10
zViveXz: folds 
Uncalled bet ($1.40) returned to Sylvester170
Sylvester170 collected $2.74 from pot
*** SUMMARY ***
Total pot $2.87 | Rake $0.13 
Board [9c 4c 7s Ts]
Seat 1: Hijjy91 (button) folded before Flop (didn't bet)
Seat 2: zow4005 (small blind) folded before Flop
Seat 3: CashMatteo (big blind) folded before Flop
Seat 4: Sylvester170 collected ($2.74)
Seat 5: zViveXz folded on the Turn
Seat 6: roadrunner1992 folded on the Flop

Hand #1954: 

PokerStars Hand #246799954220:  Hold'em No Limit ($0.05/$0.10 CAD) - 2023/10/28 20:03:02 ET
Table 'Mavis II' 6-max Seat #2 is the button
Seat 1: Hijjy91 ($8.90 in chips) 
Seat 2: zow4005 ($19.89 in chips) 
Seat 3: CashMatteo ($2.83 in chips) 
Seat 4: Sylvester170 ($6.13 in chips) 
Seat 5: zViveXz ($11.66 in chips) 
Seat 6: roadrunner1992 ($1.93 in chips) 
CashMatteo: posts small blind $0.05
Sylvester170: posts big blind $0.10
*** HOLE CARDS ***
Dealt to CashMatteo [Th Ks]
zViveXz: folds 
roadrunner1992: calls $0.10
Hijjy91: folds 
zow4005: folds 
CashMatteo: raises $0.15 to $0.25
Sylvester170: calls $0.15
roadrunner1992: calls $0.15
*** FLOP *** [9h Qh 7h]
CashMatteo: bets $0.36
Sylvester170: folds 
roadrunner1992: calls $0.36
*** TURN *** [9h Qh 7h] [3c]
CashMatteo: bets $0.70
roadrunner1992: calls $0.70
*** RIVER *** [9h Qh 7h 3c] [5s]
CashMatteo: bets $1.37
roadrunner1992: calls $0.62 and is all-in
Uncalled bet ($0.75) returned to CashMatteo
*** SHOW DOWN ***
CashMatteo: shows [Th Ks] (high card King)
roadrunner1992: shows [Kd Qc] (a pair of Queens)
roadrunner1992 collected $3.93 from pot
*** SUMMARY ***
Total pot $4.11 | Rake $0.18 
Board [9h Qh 7h 3c 5s]
Seat 1: Hijjy91 folded before Flop (didn't bet)
Seat 2: zow4005 (button) folded before Flop (didn't bet)
Seat 3: CashMatteo (small blind) showed [Th Ks] and lost with high card King
Seat 4: Sylvester170 (big blind) folded on the Flop
Seat 5: zViveXz folded before Flop (didn't bet)
Seat 6: roadrunner1992 showed [Kd Qc] and won ($3.93) with a pair of Queens

Hand #1955: 

PokerStars Hand #246799964624:  Hold'em No Limit ($0.05/$0.10 CAD) - 2023/10/28 20:03:48 ET
Table 'Mavis II' 6-max Seat #3 is the button
Seat 1: Hijjy91 ($8.90 in chips) 
Seat 2: zow4005 ($19.89 in chips) 
Seat 3: CashMatteo ($0.90 in chips) 
Seat 4: Sylvester170 ($5.88 in chips) 
Seat 5: zViveXz ($11.66 in chips) 
Seat 6: roadrunner1992 ($3.93 in chips) 
Sylvester170: posts small blind $0.05
zViveXz: posts big blind $0.10
*** HOLE CARDS ***
Dealt to CashMatteo [4c 8d]
roadrunner1992: folds 
Hijjy91: calls $0.10
zow4005: folds 
CashMatteo: folds 
CashMatteo leaves the table
Sylvester170: calls $0.05
zViveXz: checks 
*** FLOP *** [3c Ad Kc]
Sylvester170: checks 
zViveXz: bets $0.15
Hijjy91: calls $0.15
Sylvester170: raises $0.15 to $0.30
zViveXz: calls $0.15
Hijjy91: calls $0.15
*** TURN *** [3c Ad Kc] [Ts]
Sylvester170: checks 
zViveXz: bets $0.58
Hijjy91: calls $0.58
Sylvester170: calls $0.58
*** RIVER *** [3c Ad Kc Ts] [7s]
Sylvester170: checks 
zViveXz: checks 
Hijjy91: checks 
*** SHOW DOWN ***
Sylvester170: shows [8s Ah] (a pair of Aces)
zViveXz: mucks hand 
Hijjy91: shows [As 8h] (a pair of Aces)
Sylvester170 collected $1.41 from pot
Hijjy91 collected $1.40 from pot
*** SUMMARY ***
Total pot $2.94 | Rake $0.13 
Board [3c Ad Kc Ts 7s]
Seat 1: Hijjy91 showed [As 8h] and won ($1.40) with a pair of Aces
Seat 2: zow4005 folded before Flop (didn't bet)
Seat 3: CashMatteo (button) folded before Flop (didn't bet)
Seat 4: Sylvester170 (small blind) showed [8s Ah] and won ($1.41) with a pair of Aces
Seat 5: zViveXz (big blind) mucked [5c 6c]
Seat 6: roadrunner1992 folded before Flop (didn't bet)

Hand #1956: 

PokerStars Hand #246896919987:  Hold'em No Limit ($0.05/$0.10 CAD) - 2023/11/03 2:05:34 ET
Table 'Helewalda' 6-max Seat #3 is the button
Seat 1: yobrudere ($21.51 in chips) 
Seat 2: HUE JOHNSON ($5.64 in chips) 
Seat 3: Heathcliff1982 ($11.23 in chips) 
Seat 4: andrewmoneyman ($10.50 in chips) 
Seat 5: CashMatteo ($10 in chips) 
Seat 6: coverhand86 ($5.15 in chips) 
andrewmoneyman: posts small blind $0.05
CashMatteo: posts big blind $0.10
*** HOLE CARDS ***
Dealt to CashMatteo [7s 5h]
coverhand86: calls $0.10
yobrudere: folds 
HUE JOHNSON: folds 
Heathcliff1982: folds 
andrewmoneyman: folds 
CashMatteo: checks 
*** FLOP *** [4c Ks 4s]
CashMatteo: checks 
coverhand86: checks 
*** TURN *** [4c Ks 4s] [As]
CashMatteo: checks 
coverhand86: checks 
*** RIVER *** [4c Ks 4s As] [3h]
CashMatteo: checks 
coverhand86: checks 
*** SHOW DOWN ***
CashMatteo: shows [7s 5h] (a pair of Fours)
coverhand86: shows [Ts Tc] (two pair, Tens and Fours)
coverhand86 collected $0.24 from pot
*** SUMMARY ***
Total pot $0.25 | Rake $0.01 
Board [4c Ks 4s As 3h]
Seat 1: yobrudere folded before Flop (didn't bet)
Seat 2: HUE JOHNSON folded before Flop (didn't bet)
Seat 3: Heathcliff1982 (button) folded before Flop (didn't bet)
Seat 4: andrewmoneyman (small blind) folded before Flop
Seat 5: CashMatteo (big blind) showed [7s 5h] and lost with a pair of Fours
Seat 6: coverhand86 showed [Ts Tc] and won ($0.24) with two pair, Tens and Fours

Hand #1957: 

PokerStars Hand #246896924089:  Hold'em No Limit ($0.05/$0.10 CAD) - 2023/11/03 2:06:20 ET
Table 'Helewalda' 6-max Seat #4 is the button
Seat 1: yobrudere ($21.51 in chips) 
Seat 2: HUE JOHNSON ($5.64 in chips) 
Seat 3: Heathcliff1982 ($11.23 in chips) 
Seat 4: andrewmoneyman ($10.45 in chips) 
Seat 5: CashMatteo ($9.90 in chips) 
Seat 6: coverhand86 ($5.29 in chips) 
CashMatteo: posts small blind $0.05
coverhand86: posts big blind $0.10
*** HOLE CARDS ***
Dealt to CashMatteo [3c Qc]
yobrudere: raises $0.10 to $0.20
HUE JOHNSON: folds 
Heathcliff1982: calls $0.20
andrewmoneyman: folds 
CashMatteo: calls $0.15
coverhand86: calls $0.10
*** FLOP *** [Qs 9d 6d]
CashMatteo: checks 
coverhand86: checks 
yobrudere: checks 
Heathcliff1982: bets $0.30
CashMatteo: calls $0.30
coverhand86: calls $0.30
yobrudere: calls $0.30
*** TURN *** [Qs 9d 6d] [2c]
CashMatteo: checks 
coverhand86: checks 
yobrudere: checks 
Heathcliff1982: checks 
*** RIVER *** [Qs 9d 6d 2c] [4s]
CashMatteo: bets $0.66
coverhand86: folds 
yobrudere: folds 
Heathcliff1982: folds 
Uncalled bet ($0.66) returned to CashMatteo
CashMatteo collected $1.91 from pot
CashMatteo: doesn't show hand 
*** SUMMARY ***
Total pot $2 | Rake $0.09 
Board [Qs 9d 6d 2c 4s]
Seat 1: yobrudere folded on the River
Seat 2: HUE JOHNSON folded before Flop (didn't bet)
Seat 3: Heathcliff1982 folded on the River
Seat 4: andrewmoneyman (button) folded before Flop (didn't bet)
Seat 5: CashMatteo (small blind) collected ($1.91)
Seat 6: coverhand86 (big blind) folded on the River

Hand #1958: 

PokerStars Hand #246896932894:  Hold'em No Limit ($0.05/$0.10 CAD) - 2023/11/03 2:07:59 ET
Table 'Helewalda' 6-max Seat #5 is the button
Seat 1: yobrudere ($21.01 in chips) 
Seat 2: HUE JOHNSON ($5.64 in chips) 
Seat 3: Heathcliff1982 ($10.73 in chips) 
Seat 4: andrewmoneyman ($10.45 in chips) 
Seat 5: CashMatteo ($11.31 in chips) 
Seat 6: coverhand86 ($4.79 in chips) 
coverhand86: posts small blind $0.05
yobrudere: posts big blind $0.10
*** HOLE CARDS ***
Dealt to CashMatteo [As 8c]
HUE JOHNSON: folds 
Heathcliff1982: folds 
andrewmoneyman: raises $0.20 to $0.30
CashMatteo: calls $0.30
coverhand86: calls $0.25
yobrudere: folds 
*** FLOP *** [8s 9s Jd]
coverhand86: checks 
andrewmoneyman: checks 
CashMatteo: bets $0.48
coverhand86: calls $0.48
andrewmoneyman: calls $0.48
*** TURN *** [8s 9s Jd] [2h]
coverhand86: checks 
andrewmoneyman: checks 
CashMatteo: bets $1.17
coverhand86: folds 
andrewmoneyman: calls $1.17
*** RIVER *** [8s 9s Jd 2h] [Qh]
andrewmoneyman: bets $4.56
CashMatteo: folds 
Uncalled bet ($4.56) returned to andrewmoneyman
andrewmoneyman collected $4.56 from pot
andrewmoneyman: doesn't show hand 
*** SUMMARY ***
Total pot $4.78 | Rake $0.22 
Board [8s 9s Jd 2h Qh]
Seat 1: yobrudere (big blind) folded before Flop
Seat 2: HUE JOHNSON folded before Flop (didn't bet)
Seat 3: Heathcliff1982 folded before Flop (didn't bet)
Seat 4: andrewmoneyman collected ($4.56)
Seat 5: CashMatteo (button) folded on the River
Seat 6: coverhand86 (small blind) folded on the Turn

Hand #1959: 

PokerStars Hand #246896938434:  Hold'em No Limit ($0.05/$0.10 CAD) - 2023/11/03 2:09:01 ET
Table 'Helewalda' 6-max Seat #6 is the button
Seat 1: yobrudere ($20.91 in chips) 
Seat 2: HUE JOHNSON ($5.64 in chips) 
Seat 3: Heathcliff1982 ($10.73 in chips) 
Seat 4: andrewmoneyman ($13.06 in chips) 
Seat 5: CashMatteo ($9.36 in chips) 
Seat 6: coverhand86 ($4.01 in chips) 
yobrudere: posts small blind $0.05
HUE JOHNSON: posts big blind $0.10
*** HOLE CARDS ***
Dealt to CashMatteo [Kd 4d]
Heathcliff1982: folds 
andrewmoneyman: folds 
CashMatteo: calls $0.10
coverhand86: folds 
yobrudere: calls $0.05
coverhand86 leaves the table
HUE JOHNSON: raises $0.20 to $0.30
CashMatteo: calls $0.20
yobrudere: calls $0.20
*** FLOP *** [Kh 2h 3d]
yobrudere: checks 
HUE JOHNSON: bets $0.86
CashMatteo: calls $0.86
yobrudere: folds 
*** TURN *** [Kh 2h 3d] [9c]
HUE JOHNSON: checks 
CashMatteo: bets $1.45
HUE JOHNSON: folds 
Uncalled bet ($1.45) returned to CashMatteo
CashMatteo collected $2.50 from pot
CashMatteo: doesn't show hand 
*** SUMMARY ***
Total pot $2.62 | Rake $0.12 
Board [Kh 2h 3d 9c]
Seat 1: yobrudere (small blind) folded on the Flop
Seat 2: HUE JOHNSON (big blind) folded on the Turn
Seat 3: Heathcliff1982 folded before Flop (didn't bet)
Seat 4: andrewmoneyman folded before Flop (didn't bet)
Seat 5: CashMatteo collected ($2.50)
Seat 6: coverhand86 (button) folded before Flop (didn't bet)

Hand #1960: 

PokerStars Hand #246896943803:  Hold'em No Limit ($0.05/$0.10 CAD) - 2023/11/03 2:10:01 ET
Table 'Helewalda' 6-max Seat #1 is the button
Seat 1: yobrudere ($20.61 in chips) 
Seat 2: HUE JOHNSON ($4.48 in chips) 
Seat 3: Heathcliff1982 ($10.73 in chips) 
Seat 4: andrewmoneyman ($13.06 in chips) 
Seat 5: CashMatteo ($10.70 in chips) 
HUE JOHNSON: posts small blind $0.05
Heathcliff1982: posts big blind $0.10
*** HOLE CARDS ***
Dealt to CashMatteo [As Qd]
andrewmoneyman: raises $0.15 to $0.25
CashMatteo: calls $0.25
yobrudere: folds 
HUE JOHNSON: folds 
Heathcliff1982: raises $0.80 to $1.05
andrewmoneyman: folds 
CashMatteo: calls $0.80
*** FLOP *** [5d 9s 3h]
Heathcliff1982: bets $0.76
CashMatteo: calls $0.76
*** TURN *** [5d 9s 3h] [Js]
Heathcliff1982: checks 
CashMatteo: checks 
*** RIVER *** [5d 9s 3h Js] [Kc]
Heathcliff1982: bets $1.23
CashMatteo: folds 
Uncalled bet ($1.23) returned to Heathcliff1982
Heathcliff1982 collected $3.74 from pot
*** SUMMARY ***
Total pot $3.92 | Rake $0.18 
Board [5d 9s 3h Js Kc]
Seat 1: yobrudere (button) folded before Flop (didn't bet)
Seat 2: HUE JOHNSON (small blind) folded before Flop
Seat 3: Heathcliff1982 (big blind) collected ($3.74)
Seat 4: andrewmoneyman folded before Flop
Seat 5: CashMatteo folded on the River

Hand #1961: 

PokerStars Hand #246896949434:  Hold'em No Limit ($0.05/$0.10 CAD) - 2023/11/03 2:11:04 ET
Table 'Helewalda' 6-max Seat #2 is the button
Seat 1: yobrudere ($20.61 in chips) 
Seat 2: HUE JOHNSON ($4.43 in chips) 
Seat 3: Heathcliff1982 ($12.66 in chips) 
Seat 4: andrewmoneyman ($12.81 in chips) 
Seat 5: CashMatteo ($8.89 in chips) 
Heathcliff1982: posts small blind $0.05
andrewmoneyman: posts big blind $0.10
*** HOLE CARDS ***
Dealt to CashMatteo [4d Jc]
CashMatteo: folds 
yobrudere: folds 
HUE JOHNSON: folds 
Heathcliff1982: raises $0.20 to $0.30
andrewmoneyman: raises $0.95 to $1.25
Heathcliff1982: calls $0.95
*** FLOP *** [3s 4h 6h]
Heathcliff1982: checks 
andrewmoneyman: bets $0.80
Heathcliff1982: calls $0.80
*** TURN *** [3s 4h 6h] [5s]
Heathcliff1982: checks 
andrewmoneyman: checks 
*** RIVER *** [3s 4h 6h 5s] [Ah]
Heathcliff1982: checks 
andrewmoneyman: checks 
*** SHOW DOWN ***
Heathcliff1982: shows [Qc Ac] (a pair of Aces)
andrewmoneyman: mucks hand 
Heathcliff1982 collected $3.92 from pot
*** SUMMARY ***
Total pot $4.10 | Rake $0.18 
Board [3s 4h 6h 5s Ah]
Seat 1: yobrudere folded before Flop (didn't bet)
Seat 2: HUE JOHNSON (button) folded before Flop (didn't bet)
Seat 3: Heathcliff1982 (small blind) showed [Qc Ac] and won ($3.92) with a pair of Aces
Seat 4: andrewmoneyman (big blind) mucked [Tc Td]
Seat 5: CashMatteo folded before Flop (didn't bet)

Hand #1962: 

PokerStars Hand #246896954630:  Hold'em No Limit ($0.05/$0.10 CAD) - 2023/11/03 2:12:03 ET
Table 'Helewalda' 6-max Seat #3 is the button
Seat 1: yobrudere ($20.61 in chips) 
Seat 2: HUE JOHNSON ($4.43 in chips) 
Seat 3: Heathcliff1982 ($14.53 in chips) 
Seat 4: andrewmoneyman ($10.76 in chips) 
Seat 5: CashMatteo ($8.89 in chips) 
andrewmoneyman: posts small blind $0.05
CashMatteo: posts big blind $0.10
*** HOLE CARDS ***
Dealt to CashMatteo [3c Ks]
yobrudere: folds 
HUE JOHNSON: folds 
Heathcliff1982: raises $0.12 to $0.22
andrewmoneyman: calls $0.17
CashMatteo: folds 
*** FLOP *** [Ah 2d As]
andrewmoneyman: checks 
Heathcliff1982: bets $0.39
andrewmoneyman: folds 
Uncalled bet ($0.39) returned to Heathcliff1982
Heathcliff1982 collected $0.52 from pot
*** SUMMARY ***
Total pot $0.54 | Rake $0.02 
Board [Ah 2d As]
Seat 1: yobrudere folded before Flop (didn't bet)
Seat 2: HUE JOHNSON folded before Flop (didn't bet)
Seat 3: Heathcliff1982 (button) collected ($0.52)
Seat 4: andrewmoneyman (small blind) folded on the Flop
Seat 5: CashMatteo (big blind) folded before Flop

Hand #1963: 

PokerStars Hand #246896957476:  Hold'em No Limit ($0.05/$0.10 CAD) - 2023/11/03 2:12:35 ET
Table 'Helewalda' 6-max Seat #4 is the button
Seat 1: yobrudere ($20.61 in chips) 
Seat 2: HUE JOHNSON ($4.43 in chips) 
Seat 3: Heathcliff1982 ($14.83 in chips) 
Seat 4: andrewmoneyman ($10.54 in chips) 
Seat 5: CashMatteo ($8.79 in chips) 
CashMatteo: posts small blind $0.05
yobrudere: posts big blind $0.10
*** HOLE CARDS ***
Dealt to CashMatteo [Kc 8d]
HUE JOHNSON: calls $0.10
Heathcliff1982: folds 
andrewmoneyman: folds 
CashMatteo: calls $0.05
yobrudere: checks 
*** FLOP *** [7h Qd Jh]
CashMatteo: checks 
yobrudere: checks 
HUE JOHNSON: checks 
*** TURN *** [7h Qd Jh] [Ac]
CashMatteo: checks 
yobrudere: checks 
HUE JOHNSON: checks 
*** RIVER *** [7h Qd Jh Ac] [9c]
CashMatteo: checks 
yobrudere: bets $0.15
HUE JOHNSON: folds 
CashMatteo: folds 
Uncalled bet ($0.15) returned to yobrudere
yobrudere collected $0.29 from pot
yobrudere: doesn't show hand 
*** SUMMARY ***
Total pot $0.30 | Rake $0.01 
Board [7h Qd Jh Ac 9c]
Seat 1: yobrudere (big blind) collected ($0.29)
Seat 2: HUE JOHNSON folded on the River
Seat 3: Heathcliff1982 folded before Flop (didn't bet)
Seat 4: andrewmoneyman (button) folded before Flop (didn't bet)
Seat 5: CashMatteo (small blind) folded on the River

Hand #1964: 

PokerStars Hand #246896962841:  Hold'em No Limit ($0.05/$0.10 CAD) - 2023/11/03 2:13:36 ET
Table 'Helewalda' 6-max Seat #5 is the button
Seat 1: yobrudere ($20.80 in chips) 
Seat 2: HUE JOHNSON ($4.33 in chips) 
Seat 3: Heathcliff1982 ($14.83 in chips) 
Seat 4: andrewmoneyman ($10.54 in chips) 
Seat 5: CashMatteo ($8.69 in chips) 
yobrudere: posts small blind $0.05
HUE JOHNSON: posts big blind $0.10
*** HOLE CARDS ***
Dealt to CashMatteo [5c Ah]
Heathcliff1982: raises $0.12 to $0.22
andrewmoneyman: calls $0.22
CashMatteo: calls $0.22
yobrudere: folds 
HUE JOHNSON: folds 
*** FLOP *** [Js 3h 7s]
Heathcliff1982: bets $0.31
andrewmoneyman: folds 
CashMatteo: folds 
Uncalled bet ($0.31) returned to Heathcliff1982
Heathcliff1982 collected $0.77 from pot
*** SUMMARY ***
Total pot $0.81 | Rake $0.04 
Board [Js 3h 7s]
Seat 1: yobrudere (small blind) folded before Flop
Seat 2: HUE JOHNSON (big blind) folded before Flop
Seat 3: Heathcliff1982 collected ($0.77)
Seat 4: andrewmoneyman folded on the Flop
Seat 5: CashMatteo (button) folded on the Flop

Hand #1965: 

PokerStars Hand #246896965408:  Hold'em No Limit ($0.05/$0.10 CAD) - 2023/11/03 2:14:04 ET
Table 'Helewalda' 6-max Seat #1 is the button
Seat 1: yobrudere ($20.75 in chips) 
Seat 2: HUE JOHNSON ($4.23 in chips) 
Seat 3: Heathcliff1982 ($15.38 in chips) 
Seat 4: andrewmoneyman ($10.32 in chips) 
Seat 5: CashMatteo ($8.47 in chips) 
HUE JOHNSON: posts small blind $0.05
Heathcliff1982: posts big blind $0.10
*** HOLE CARDS ***
Dealt to CashMatteo [3c As]
andrewmoneyman: raises $0.20 to $0.30
CashMatteo: calls $0.30
yobrudere: folds 
HUE JOHNSON: folds 
Heathcliff1982: folds 
*** FLOP *** [4s 9d Ts]
andrewmoneyman: bets $0.36
CashMatteo: folds 
Uncalled bet ($0.36) returned to andrewmoneyman
andrewmoneyman collected $0.72 from pot
andrewmoneyman: doesn't show hand 
*** SUMMARY ***
Total pot $0.75 | Rake $0.03 
Board [4s 9d Ts]
Seat 1: yobrudere (button) folded before Flop (didn't bet)
Seat 2: HUE JOHNSON (small blind) folded before Flop
Seat 3: Heathcliff1982 (big blind) folded before Flop
Seat 4: andrewmoneyman collected ($0.72)
Seat 5: CashMatteo folded on the Flop

Hand #1966: 

PokerStars Hand #246896967912:  Hold'em No Limit ($0.05/$0.10 CAD) - 2023/11/03 2:14:33 ET
Table 'Helewalda' 6-max Seat #2 is the button
Seat 1: yobrudere ($20.75 in chips) 
Seat 2: HUE JOHNSON ($4.18 in chips) 
Seat 3: Heathcliff1982 ($15.28 in chips) 
Seat 4: andrewmoneyman ($10.74 in chips) 
Seat 5: CashMatteo ($8.17 in chips) 
Heathcliff1982: posts small blind $0.05
andrewmoneyman: posts big blind $0.10
*** HOLE CARDS ***
Dealt to CashMatteo [7s Ks]
CashMatteo: raises $0.15 to $0.25
yobrudere: folds 
HUE JOHNSON: folds 
Heathcliff1982: calls $0.20
andrewmoneyman: folds 
*** FLOP *** [2s 6d Ts]
Heathcliff1982: checks 
CashMatteo: bets $0.29
Heathcliff1982: calls $0.29
*** TURN *** [2s 6d Ts] [9s]
Heathcliff1982: checks 
CashMatteo: checks 
*** RIVER *** [2s 6d Ts 9s] [6h]
soda0101 joins the table at seat #6 
Heathcliff1982: checks 
CashMatteo: bets $1.43
Heathcliff1982: folds 
Uncalled bet ($1.43) returned to CashMatteo
CashMatteo collected $1.13 from pot
CashMatteo: doesn't show hand 
*** SUMMARY ***
Total pot $1.18 | Rake $0.05 
Board [2s 6d Ts 9s 6h]
Seat 1: yobrudere folded before Flop (didn't bet)
Seat 2: HUE JOHNSON (button) folded before Flop (didn't bet)
Seat 3: Heathcliff1982 (small blind) folded on the River
Seat 4: andrewmoneyman (big blind) folded before Flop
Seat 5: CashMatteo collected ($1.13)

Hand #1967: 

PokerStars Hand #246896971875:  Hold'em No Limit ($0.05/$0.10 CAD) - 2023/11/03 2:15:17 ET
Table 'Helewalda' 6-max Seat #3 is the button
Seat 1: yobrudere ($20.75 in chips) 
Seat 2: HUE JOHNSON ($4.18 in chips) 
Seat 3: Heathcliff1982 ($14.74 in chips) 
Seat 4: andrewmoneyman ($10.64 in chips) 
Seat 5: CashMatteo ($8.76 in chips) 
Seat 6: soda0101 ($4.30 in chips) 
andrewmoneyman: posts small blind $0.05
CashMatteo: posts big blind $0.10
soda0101: posts big blind $0.10
*** HOLE CARDS ***
Dealt to CashMatteo [Kc 5h]
soda0101: checks 
yobrudere: folds 
HUE JOHNSON: calls $0.10
Heathcliff1982: folds 
andrewmoneyman: raises $0.40 to $0.50
CashMatteo: folds 
soda0101: folds 
HUE JOHNSON: folds 
Uncalled bet ($0.40) returned to andrewmoneyman
andrewmoneyman collected $0.40 from pot
andrewmoneyman: doesn't show hand 
*** SUMMARY ***
Total pot $0.40 | Rake $0 
Seat 1: yobrudere folded before Flop (didn't bet)
Seat 2: HUE JOHNSON folded before Flop
Seat 3: Heathcliff1982 (button) folded before Flop (didn't bet)
Seat 4: andrewmoneyman (small blind) collected ($0.40)
Seat 5: CashMatteo (big blind) folded before Flop
Seat 6: soda0101 folded before Flop (didn't bet)

Hand #1968: 

PokerStars Hand #246896976369:  Hold'em No Limit ($0.05/$0.10 CAD) - 2023/11/03 2:16:08 ET
Table 'Helewalda' 6-max Seat #4 is the button
Seat 1: yobrudere ($20.75 in chips) 
Seat 2: HUE JOHNSON ($4.08 in chips) 
Seat 3: Heathcliff1982 ($14.74 in chips) 
Seat 4: andrewmoneyman ($10.94 in chips) 
Seat 5: CashMatteo ($8.66 in chips) 
Seat 6: soda0101 ($4.20 in chips) 
CashMatteo: posts small blind $0.05
soda0101: posts big blind $0.10
*** HOLE CARDS ***
Dealt to CashMatteo [7c 2c]
yobrudere: folds 
HUE JOHNSON: calls $0.10
Heathcliff1982: folds 
andrewmoneyman: raises $0.30 to $0.40
CashMatteo: folds 
soda0101: folds 
HUE JOHNSON: calls $0.30
*** FLOP *** [4d Td Kh]
HUE JOHNSON: checks 
andrewmoneyman: bets $0.30
HUE JOHNSON: calls $0.30
*** TURN *** [4d Td Kh] [4h]
HUE JOHNSON: checks 
andrewmoneyman: bets $0.75
HUE JOHNSON: calls $0.75
*** RIVER *** [4d Td Kh 4h] [Ks]
HUE JOHNSON: checks 
andrewmoneyman: bets $2.91
HUE JOHNSON: folds 
Uncalled bet ($2.91) returned to andrewmoneyman
andrewmoneyman collected $2.91 from pot
andrewmoneyman: doesn't show hand 
*** SUMMARY ***
Total pot $3.05 | Rake $0.14 
Board [4d Td Kh 4h Ks]
Seat 1: yobrudere folded before Flop (didn't bet)
Seat 2: HUE JOHNSON folded on the River
Seat 3: Heathcliff1982 folded before Flop (didn't bet)
Seat 4: andrewmoneyman (button) collected ($2.91)
Seat 5: CashMatteo (small blind) folded before Flop
Seat 6: soda0101 (big blind) folded before Flop

Hand #1969: 

PokerStars Hand #246896981111:  Hold'em No Limit ($0.05/$0.10 CAD) - 2023/11/03 2:17:01 ET
Table 'Helewalda' 6-max Seat #5 is the button
Seat 1: yobrudere ($20.75 in chips) 
Seat 2: HUE JOHNSON ($2.63 in chips) 
Seat 3: Heathcliff1982 ($14.74 in chips) 
Seat 4: andrewmoneyman ($12.40 in chips) 
Seat 5: CashMatteo ($8.61 in chips) 
Seat 6: soda0101 ($4.10 in chips) 
soda0101: posts small blind $0.05
yobrudere: posts big blind $0.10
*** HOLE CARDS ***
Dealt to CashMatteo [8s 4s]
HUE JOHNSON: calls $0.10
Heathcliff1982: folds 
andrewmoneyman: calls $0.10
CashMatteo: calls $0.10
soda0101: calls $0.05
yobrudere: checks 
*** FLOP *** [7h Td 9h]
soda0101: checks 
yobrudere: checks 
HUE JOHNSON: checks 
andrewmoneyman: checks 
CashMatteo: bets $0.24
soda0101: calls $0.24
yobrudere: calls $0.24
HUE JOHNSON: folds 
andrewmoneyman: folds 
*** TURN *** [7h Td 9h] [Kc]
soda0101: checks 
yobrudere: checks 
CashMatteo: checks 
*** RIVER *** [7h Td 9h Kc] [Ts]
soda0101: checks 
yobrudere: bets $0.59
CashMatteo: folds 
soda0101: folds 
Uncalled bet ($0.59) returned to yobrudere
yobrudere collected $1.17 from pot
yobrudere: doesn't show hand 
*** SUMMARY ***
Total pot $1.22 | Rake $0.05 
Board [7h Td 9h Kc Ts]
Seat 1: yobrudere (big blind) collected ($1.17)
Seat 2: HUE JOHNSON folded on the Flop
Seat 3: Heathcliff1982 folded before Flop (didn't bet)
Seat 4: andrewmoneyman folded on the Flop
Seat 5: CashMatteo (button) folded on the River
Seat 6: soda0101 (small blind) folded on the River

Hand #1970: 

PokerStars Hand #246896987658:  Hold'em No Limit ($0.05/$0.10 CAD) - 2023/11/03 2:18:15 ET
Table 'Helewalda' 6-max Seat #6 is the button
Seat 1: yobrudere ($21.58 in chips) 
Seat 2: HUE JOHNSON ($2.53 in chips) 
Seat 3: Heathcliff1982 ($14.74 in chips) 
Seat 4: andrewmoneyman ($12.30 in chips) 
Seat 5: CashMatteo ($8.27 in chips) 
Seat 6: soda0101 ($3.76 in chips) 
yobrudere: posts small blind $0.05
HUE JOHNSON: posts big blind $0.10
*** HOLE CARDS ***
Dealt to CashMatteo [Ah 6s]
Heathcliff1982: folds 
andrewmoneyman: raises $0.15 to $0.25
Heathcliff1982 leaves the table
CashMatteo: calls $0.25
soda0101: folds 
yobrudere: folds 
HUE JOHNSON: calls $0.15
*** FLOP *** [9s 9c 4d]
HUE JOHNSON: checks 
andrewmoneyman: bets $0.23
CashMatteo: folds 
HUE JOHNSON: folds 
Uncalled bet ($0.23) returned to andrewmoneyman
andrewmoneyman collected $0.76 from pot
andrewmoneyman: doesn't show hand 
*** SUMMARY ***
Total pot $0.80 | Rake $0.04 
Board [9s 9c 4d]
Seat 1: yobrudere (small blind) folded before Flop
Seat 2: HUE JOHNSON (big blind) folded on the Flop
Seat 3: Heathcliff1982 folded before Flop (didn't bet)
Seat 4: andrewmoneyman collected ($0.76)
Seat 5: CashMatteo folded on the Flop
Seat 6: soda0101 (button) folded before Flop (didn't bet)

Hand #1971: 

PokerStars Hand #246896991605:  Hold'em No Limit ($0.05/$0.10 CAD) - 2023/11/03 2:18:59 ET
Table 'Helewalda' 6-max Seat #1 is the button
Seat 1: yobrudere ($21.53 in chips) 
Seat 2: HUE JOHNSON ($2.28 in chips) 
Seat 4: andrewmoneyman ($12.81 in chips) 
Seat 5: CashMatteo ($8.02 in chips) 
Seat 6: soda0101 ($3.76 in chips) 
HUE JOHNSON: posts small blind $0.05
andrewmoneyman: posts big blind $0.10
*** HOLE CARDS ***
Dealt to CashMatteo [9d 3d]
CashMatteo: folds 
soda0101 has timed out
soda0101: folds 
yobrudere: raises $0.10 to $0.20
HUE JOHNSON: folds 
andrewmoneyman: folds 
Uncalled bet ($0.10) returned to yobrudere
yobrudere collected $0.25 from pot
yobrudere: doesn't show hand 
*** SUMMARY ***
Total pot $0.25 | Rake $0 
Seat 1: yobrudere (button) collected ($0.25)
Seat 2: HUE JOHNSON (small blind) folded before Flop
Seat 4: andrewmoneyman (big blind) folded before Flop
Seat 5: CashMatteo folded before Flop (didn't bet)
Seat 6: soda0101 folded before Flop (didn't bet)

Hand #1972: 

PokerStars Hand #246896993420:  Hold'em No Limit ($0.05/$0.10 CAD) - 2023/11/03 2:19:20 ET
Table 'Helewalda' 6-max Seat #2 is the button
Seat 1: yobrudere ($21.68 in chips) 
Seat 2: HUE JOHNSON ($2.23 in chips) 
Seat 4: andrewmoneyman ($12.71 in chips) 
Seat 5: CashMatteo ($8.02 in chips) 
andrewmoneyman: posts small blind $0.05
CashMatteo: posts big blind $0.10
*** HOLE CARDS ***
Dealt to CashMatteo [2d Tc]
yobrudere: raises $0.10 to $0.20
HUE JOHNSON: folds 
andrewmoneyman: folds 
CashMatteo: folds 
Uncalled bet ($0.10) returned to yobrudere
yobrudere collected $0.25 from pot
yobrudere: doesn't show hand 
*** SUMMARY ***
Total pot $0.25 | Rake $0 
Seat 1: yobrudere collected ($0.25)
Seat 2: HUE JOHNSON (button) folded before Flop (didn't bet)
Seat 4: andrewmoneyman (small blind) folded before Flop
Seat 5: CashMatteo (big blind) folded before Flop

Hand #1973: 

PokerStars Hand #246896994192:  Hold'em No Limit ($0.05/$0.10 CAD) - 2023/11/03 2:19:29 ET
Table 'Helewalda' 6-max Seat #4 is the button
Seat 1: yobrudere ($21.83 in chips) 
Seat 2: HUE JOHNSON ($2.23 in chips) 
Seat 4: andrewmoneyman ($12.66 in chips) 
Seat 5: CashMatteo ($7.92 in chips) 
CashMatteo: posts small blind $0.05
yobrudere: posts big blind $0.10
*** HOLE CARDS ***
Dealt to CashMatteo [Ts As]
HUE JOHNSON: folds 
andrewmoneyman: raises $0.15 to $0.25
CashMatteo: raises $0.60 to $0.85
yobrudere: folds 
andrewmoneyman: folds 
Uncalled bet ($0.60) returned to CashMatteo
CashMatteo collected $0.60 from pot
CashMatteo: doesn't show hand 
*** SUMMARY ***
Total pot $0.60 | Rake $0 
Seat 1: yobrudere (big blind) folded before Flop
Seat 2: HUE JOHNSON folded before Flop (didn't bet)
Seat 4: andrewmoneyman (button) folded before Flop
Seat 5: CashMatteo (small blind) collected ($0.60)

Hand #1974: 

PokerStars Hand #246896995456:  Hold'em No Limit ($0.05/$0.10 CAD) - 2023/11/03 2:19:43 ET
Table 'Helewalda' 6-max Seat #5 is the button
Seat 1: yobrudere ($21.73 in chips) 
Seat 2: HUE JOHNSON ($2.23 in chips) 
Seat 4: andrewmoneyman ($12.41 in chips) 
Seat 5: CashMatteo ($8.27 in chips) 
soda0101 will be allowed to play after the button
yobrudere: posts small blind $0.05
HUE JOHNSON: posts big blind $0.10
*** HOLE CARDS ***
Dealt to CashMatteo [8d 7c]
andrewmoneyman: folds 
CashMatteo: folds 
yobrudere: folds 
Uncalled bet ($0.05) returned to HUE JOHNSON
HUE JOHNSON collected $0.10 from pot
*** SUMMARY ***
Total pot $0.10 | Rake $0 
Seat 1: yobrudere (small blind) folded before Flop
Seat 2: HUE JOHNSON (big blind) collected ($0.10)
Seat 4: andrewmoneyman folded before Flop (didn't bet)
Seat 5: CashMatteo (button) folded before Flop (didn't bet)

Hand #1975: 

PokerStars Hand #246896996300:  Hold'em No Limit ($0.05/$0.10 CAD) - 2023/11/03 2:19:53 ET
Table 'Helewalda' 6-max Seat #1 is the button
Seat 1: yobrudere ($21.68 in chips) 
Seat 2: HUE JOHNSON ($2.28 in chips) 
Seat 4: andrewmoneyman ($12.41 in chips) 
Seat 5: CashMatteo ($8.27 in chips) 
Seat 6: soda0101 ($3.76 in chips) 
HUE JOHNSON: posts small blind $0.05
andrewmoneyman: posts big blind $0.10
soda0101: posts small & big blinds $0.15
*** HOLE CARDS ***
Dealt to CashMatteo [3h 6c]
CashMatteo: folds 
soda0101: checks 
yobrudere: calls $0.10
HUE JOHNSON: raises $0.10 to $0.20
andrewmoneyman: folds 
soda0101: calls $0.10
yobrudere: calls $0.10
*** FLOP *** [Qd Ts 9h]
HUE JOHNSON: checks 
soda0101: checks 
yobrudere: checks 
*** TURN *** [Qd Ts 9h] [8s]
HUE JOHNSON: checks 
soda0101: checks 
yobrudere: checks 
*** RIVER *** [Qd Ts 9h 8s] [8d]
HUE JOHNSON: checks 
soda0101: bets $0.36
yobrudere: folds 
HUE JOHNSON: folds 
Uncalled bet ($0.36) returned to soda0101
soda0101 collected $0.72 from pot
soda0101: doesn't show hand 
*** SUMMARY ***
Total pot $0.75 | Rake $0.03 
Board [Qd Ts 9h 8s 8d]
Seat 1: yobrudere (button) folded on the River
Seat 2: HUE JOHNSON (small blind) folded on the River
Seat 4: andrewmoneyman (big blind) folded before Flop
Seat 5: CashMatteo folded before Flop (didn't bet)
Seat 6: soda0101 collected ($0.72)

Hand #1976: 

PokerStars Hand #246897003449:  Hold'em No Limit ($0.05/$0.10 CAD) - 2023/11/03 2:21:14 ET
Table 'Helewalda' 6-max Seat #2 is the button
Seat 1: yobrudere ($21.48 in chips) 
Seat 2: HUE JOHNSON ($2.08 in chips) 
Seat 4: andrewmoneyman ($12.31 in chips) 
Seat 5: CashMatteo ($8.27 in chips) 
Seat 6: soda0101 ($4.23 in chips) 
andrewmoneyman: posts small blind $0.05
CashMatteo: posts big blind $0.10
*** HOLE CARDS ***
Dealt to CashMatteo [5h Jd]
soda0101: folds 
yobrudere: folds 
HUE JOHNSON: folds 
andrewmoneyman: folds 
Uncalled bet ($0.05) returned to CashMatteo
CashMatteo collected $0.10 from pot
CashMatteo: doesn't show hand 
*** SUMMARY ***
Total pot $0.10 | Rake $0 
Seat 1: yobrudere folded before Flop (didn't bet)
Seat 2: HUE JOHNSON (button) folded before Flop (didn't bet)
Seat 4: andrewmoneyman (small blind) folded before Flop
Seat 5: CashMatteo (big blind) collected ($0.10)
Seat 6: soda0101 folded before Flop (didn't bet)

Hand #1977: 

PokerStars Hand #246897005109:  Hold'em No Limit ($0.05/$0.10 CAD) - 2023/11/03 2:21:34 ET
Table 'Helewalda' 6-max Seat #4 is the button
Seat 1: yobrudere ($21.48 in chips) 
Seat 2: HUE JOHNSON ($2.08 in chips) 
Seat 4: andrewmoneyman ($12.26 in chips) 
Seat 5: CashMatteo ($8.32 in chips) 
Seat 6: soda0101 ($4.23 in chips) 
CashMatteo: posts small blind $0.05
soda0101: posts big blind $0.10
*** HOLE CARDS ***
Dealt to CashMatteo [Qh Ts]
yobrudere: folds 
HUE JOHNSON: calls $0.10
andrewmoneyman: raises $0.30 to $0.40
CashMatteo: calls $0.35
soda0101: folds 
HUE JOHNSON: folds 
*** FLOP *** [Js 4h Jd]
CashMatteo: checks 
andrewmoneyman: bets $0.35
CashMatteo: calls $0.35
*** TURN *** [Js 4h Jd] [3c]
CashMatteo: checks 
andrewmoneyman: checks 
*** RIVER *** [Js 4h Jd 3c] [7h]
CashMatteo: bets $1.82
andrewmoneyman: raises $6.23 to $8.05
yobrudere leaves the table
CashMatteo: folds 
Uncalled bet ($6.23) returned to andrewmoneyman
andrewmoneyman collected $5.10 from pot
andrewmoneyman: doesn't show hand 
*** SUMMARY ***
Total pot $5.34 | Rake $0.24 
Board [Js 4h Jd 3c 7h]
Seat 1: yobrudere folded before Flop (didn't bet)
Seat 2: HUE JOHNSON folded before Flop
Seat 4: andrewmoneyman (button) collected ($5.10)
Seat 5: CashMatteo (small blind) folded on the River
Seat 6: soda0101 (big blind) folded before Flop

Hand #1978: 

PokerStars Hand #246897010353:  Hold'em No Limit ($0.05/$0.10 CAD) - 2023/11/03 2:22:36 ET
Table 'Helewalda' 6-max Seat #5 is the button
Seat 2: HUE JOHNSON ($1.98 in chips) 
Seat 4: andrewmoneyman ($14.79 in chips) 
Seat 5: CashMatteo ($5.75 in chips) 
Seat 6: soda0101 ($4.13 in chips) 
soda0101: posts small blind $0.05
HUE JOHNSON: posts big blind $0.10
*** HOLE CARDS ***
Dealt to CashMatteo [Ac 8s]
andrewmoneyman: folds 
CashMatteo: raises $0.25 to $0.35
soda0101: folds 
HUE JOHNSON: folds 
Uncalled bet ($0.25) returned to CashMatteo
CashMatteo collected $0.25 from pot
CashMatteo: doesn't show hand 
*** SUMMARY ***
Total pot $0.25 | Rake $0 
Seat 2: HUE JOHNSON (big blind) folded before Flop
Seat 4: andrewmoneyman folded before Flop (didn't bet)
Seat 5: CashMatteo (button) collected ($0.25)
Seat 6: soda0101 (small blind) folded before Flop

Hand #1979: 

PokerStars Hand #246897012352:  Hold'em No Limit ($0.05/$0.10 CAD) - 2023/11/03 2:22:59 ET
Table 'Helewalda' 6-max Seat #6 is the button
Seat 2: HUE JOHNSON ($1.88 in chips) 
Seat 4: andrewmoneyman ($14.79 in chips) 
Seat 5: CashMatteo ($5.90 in chips) 
Seat 6: soda0101 ($4.08 in chips) 
HUE JOHNSON: posts small blind $0.05
andrewmoneyman: posts big blind $0.10
*** HOLE CARDS ***
Dealt to CashMatteo [5c Jd]
CashMatteo: folds 
soda0101: folds 
HUE JOHNSON: folds 
Uncalled bet ($0.05) returned to andrewmoneyman
andrewmoneyman collected $0.10 from pot
andrewmoneyman: doesn't show hand 
*** SUMMARY ***
Total pot $0.10 | Rake $0 
Seat 2: HUE JOHNSON (small blind) folded before Flop
Seat 4: andrewmoneyman (big blind) collected ($0.10)
Seat 5: CashMatteo folded before Flop (didn't bet)
Seat 6: soda0101 (button) folded before Flop (didn't bet)

Hand #1980: 

PokerStars Hand #246897013532:  Hold'em No Limit ($0.05/$0.10 CAD) - 2023/11/03 2:23:12 ET
Table 'Helewalda' 6-max Seat #2 is the button
Seat 2: HUE JOHNSON ($1.83 in chips) 
Seat 4: andrewmoneyman ($14.84 in chips) 
Seat 5: CashMatteo ($5.90 in chips) 
Seat 6: soda0101 ($4.08 in chips) 
andrewmoneyman: posts small blind $0.05
CashMatteo: posts big blind $0.10
*** HOLE CARDS ***
Dealt to CashMatteo [4s Qc]
soda0101: folds 
HUE JOHNSON: calls $0.10
andrewmoneyman: raises $0.40 to $0.50
CashMatteo: folds 
HUE JOHNSON: calls $0.40
*** FLOP *** [Ad 4h 6h]
andrewmoneyman: bets $0.10
HUE JOHNSON: calls $0.10
*** TURN *** [Ad 4h 6h] [4c]
andrewmoneyman: bets $1.24
HUE JOHNSON: folds 
Uncalled bet ($1.24) returned to andrewmoneyman
andrewmoneyman collected $1.24 from pot
andrewmoneyman: doesn't show hand 
*** SUMMARY ***
Total pot $1.30 | Rake $0.06 
Board [Ad 4h 6h 4c]
Seat 2: HUE JOHNSON (button) folded on the Turn
Seat 4: andrewmoneyman (small blind) collected ($1.24)
Seat 5: CashMatteo (big blind) folded before Flop
Seat 6: soda0101 folded before Flop (didn't bet)

Hand #1981: 

PokerStars Hand #246897016852:  Hold'em No Limit ($0.05/$0.10 CAD) - 2023/11/03 2:23:51 ET
Table 'Helewalda' 6-max Seat #4 is the button
Seat 2: HUE JOHNSON ($1.23 in chips) 
Seat 4: andrewmoneyman ($15.48 in chips) 
Seat 5: CashMatteo ($5.80 in chips) 
Seat 6: soda0101 ($4.08 in chips) 
CashMatteo: posts small blind $0.05
soda0101: posts big blind $0.10
*** HOLE CARDS ***
Dealt to CashMatteo [Td 4d]
HUE JOHNSON: folds 
andrewmoneyman: raises $0.20 to $0.30
CashMatteo: folds 
soda0101: folds 
Uncalled bet ($0.20) returned to andrewmoneyman
andrewmoneyman collected $0.25 from pot
andrewmoneyman: doesn't show hand 
*** SUMMARY ***
Total pot $0.25 | Rake $0 
Seat 2: HUE JOHNSON folded before Flop (didn't bet)
Seat 4: andrewmoneyman (button) collected ($0.25)
Seat 5: CashMatteo (small blind) folded before Flop
Seat 6: soda0101 (big blind) folded before Flop

Hand #1982: 

PokerStars Hand #246897017552:  Hold'em No Limit ($0.05/$0.10 CAD) - 2023/11/03 2:23:59 ET
Table 'Helewalda' 6-max Seat #5 is the button
Seat 2: HUE JOHNSON ($1.23 in chips) 
Seat 4: andrewmoneyman ($15.63 in chips) 
Seat 5: CashMatteo ($5.75 in chips) 
Seat 6: soda0101 ($3.98 in chips) 
soda0101: posts small blind $0.05
HUE JOHNSON: posts big blind $0.10
*** HOLE CARDS ***
Dealt to CashMatteo [6h 3s]
andrewmoneyman: folds 
CashMatteo: folds 
soda0101 has timed out
soda0101: folds 
Uncalled bet ($0.05) returned to HUE JOHNSON
HUE JOHNSON collected $0.10 from pot
*** SUMMARY ***
Total pot $0.10 | Rake $0 
Seat 2: HUE JOHNSON (big blind) collected ($0.10)
Seat 4: andrewmoneyman folded before Flop (didn't bet)
Seat 5: CashMatteo (button) folded before Flop (didn't bet)
Seat 6: soda0101 (small blind) folded before Flop

Hand #1983: 

PokerStars Hand #246897020849:  Hold'em No Limit ($0.05/$0.10 CAD) - 2023/11/03 2:24:37 ET
Table 'Helewalda' 6-max Seat #2 is the button
Seat 2: HUE JOHNSON ($1.28 in chips) 
Seat 4: andrewmoneyman ($15.63 in chips) 
Seat 5: CashMatteo ($5.75 in chips) 
andrewmoneyman: posts small blind $0.05
CashMatteo: posts big blind $0.10
*** HOLE CARDS ***
Dealt to CashMatteo [3c 6h]
HUE JOHNSON: folds 
andrewmoneyman: raises $0.20 to $0.30
CashMatteo: folds 
Uncalled bet ($0.20) returned to andrewmoneyman
andrewmoneyman collected $0.20 from pot
andrewmoneyman: doesn't show hand 
*** SUMMARY ***
Total pot $0.20 | Rake $0 
Seat 2: HUE JOHNSON (button) folded before Flop (didn't bet)
Seat 4: andrewmoneyman (small blind) collected ($0.20)
Seat 5: CashMatteo (big blind) folded before Flop

Hand #1984: 

PokerStars Hand #246897021734:  Hold'em No Limit ($0.05/$0.10 CAD) - 2023/11/03 2:24:48 ET
Table 'Helewalda' 6-max Seat #4 is the button
Seat 2: HUE JOHNSON ($1.28 in chips) 
Seat 4: andrewmoneyman ($15.73 in chips) 
Seat 5: CashMatteo ($5.65 in chips) 
Seat 6: soda0101 ($3.93 in chips) 
CashMatteo: posts small blind $0.05
soda0101: posts big blind $0.10
*** HOLE CARDS ***
Dealt to CashMatteo [7d 2h]
HUE JOHNSON: folds 
andrewmoneyman: raises $0.20 to $0.30
CashMatteo: folds 
soda0101: calls $0.20
*** FLOP *** [9c Qd Td]
soda0101: checks 
andrewmoneyman: bets $0.30
soda0101: folds 
Uncalled bet ($0.30) returned to andrewmoneyman
andrewmoneyman collected $0.62 from pot
andrewmoneyman: doesn't show hand 
*** SUMMARY ***
Total pot $0.65 | Rake $0.03 
Board [9c Qd Td]
Seat 2: HUE JOHNSON folded before Flop (didn't bet)
Seat 4: andrewmoneyman (button) collected ($0.62)
Seat 5: CashMatteo (small blind) folded before Flop
Seat 6: soda0101 (big blind) folded on the Flop

Hand #1985: 

PokerStars Hand #246897024264:  Hold'em No Limit ($0.05/$0.10 CAD) - 2023/11/03 2:25:16 ET
Table 'Helewalda' 6-max Seat #5 is the button
Seat 2: HUE JOHNSON ($1.28 in chips) 
Seat 4: andrewmoneyman ($16.05 in chips) 
Seat 5: CashMatteo ($5.60 in chips) 
Seat 6: soda0101 ($3.63 in chips) 
soda0101: posts small blind $0.05
HUE JOHNSON: posts big blind $0.10
*** HOLE CARDS ***
Dealt to CashMatteo [Jc Tc]
andrewmoneyman: folds 
CashMatteo: raises $0.15 to $0.25
soda0101: folds 
HUE JOHNSON: raises $0.15 to $0.40
CashMatteo: calls $0.15
*** FLOP *** [Qh Ah 4d]
HUE JOHNSON: bets $0.88 and is all-in
CashMatteo: calls $0.88
*** TURN *** [Qh Ah 4d] [7h]
*** RIVER *** [Qh Ah 4d 7h] [6c]
*** SHOW DOWN ***
HUE JOHNSON: shows [Kc Ac] (a pair of Aces)
CashMatteo: shows [Jc Tc] (high card Ace)
HUE JOHNSON collected $2.49 from pot
*** SUMMARY ***
Total pot $2.61 | Rake $0.12 
Board [Qh Ah 4d 7h 6c]
Seat 2: HUE JOHNSON (big blind) showed [Kc Ac] and won ($2.49) with a pair of Aces
Seat 4: andrewmoneyman folded before Flop (didn't bet)
Seat 5: CashMatteo (button) showed [Jc Tc] and lost with high card Ace
Seat 6: soda0101 (small blind) folded before Flop

Hand #1986: 

PokerStars Hand #246897027234:  Hold'em No Limit ($0.05/$0.10 CAD) - 2023/11/03 2:25:50 ET
Table 'Helewalda' 6-max Seat #6 is the button
Seat 2: HUE JOHNSON ($2.49 in chips) 
Seat 4: andrewmoneyman ($16.05 in chips) 
Seat 5: CashMatteo ($4.32 in chips) 
Seat 6: soda0101 ($3.58 in chips) 
HUE JOHNSON: posts small blind $0.05
andrewmoneyman: posts big blind $0.10
*** HOLE CARDS ***
Dealt to CashMatteo [Qh 6s]
CashMatteo: calls $0.10
soda0101: folds 
HUE JOHNSON: folds 
andrewmoneyman: raises $0.40 to $0.50
CashMatteo: folds 
Uncalled bet ($0.40) returned to andrewmoneyman
andrewmoneyman collected $0.25 from pot
andrewmoneyman: doesn't show hand 
*** SUMMARY ***
Total pot $0.25 | Rake $0 
Seat 2: HUE JOHNSON (small blind) folded before Flop
Seat 4: andrewmoneyman (big blind) collected ($0.25)
Seat 5: CashMatteo folded before Flop
Seat 6: soda0101 (button) folded before Flop (didn't bet)

Hand #1987: 

PokerStars Hand #246897028348:  Hold'em No Limit ($0.05/$0.10 CAD) - 2023/11/03 2:26:03 ET
Table 'Helewalda' 6-max Seat #2 is the button
Seat 2: HUE JOHNSON ($2.44 in chips) 
Seat 4: andrewmoneyman ($16.20 in chips) 
Seat 5: CashMatteo ($4.22 in chips) 
Seat 6: soda0101 ($3.58 in chips) 
andrewmoneyman: posts small blind $0.05
CashMatteo: posts big blind $0.10
*** HOLE CARDS ***
Dealt to CashMatteo [Qc As]
soda0101: folds 
HUE JOHNSON: folds 
andrewmoneyman: folds 
Uncalled bet ($0.05) returned to CashMatteo
CashMatteo collected $0.10 from pot
CashMatteo: doesn't show hand 
*** SUMMARY ***
Total pot $0.10 | Rake $0 
Seat 2: HUE JOHNSON (button) folded before Flop (didn't bet)
Seat 4: andrewmoneyman (small blind) folded before Flop
Seat 5: CashMatteo (big blind) collected ($0.10)
Seat 6: soda0101 folded before Flop (didn't bet)

Hand #1988: 

PokerStars Hand #246897029579:  Hold'em No Limit ($0.05/$0.10 CAD) - 2023/11/03 2:26:17 ET
Table 'Helewalda' 6-max Seat #4 is the button
Seat 2: HUE JOHNSON ($2.44 in chips) 
Seat 4: andrewmoneyman ($16.15 in chips) 
Seat 5: CashMatteo ($4.27 in chips) 
Seat 6: soda0101 ($3.58 in chips) 
CashMatteo: posts small blind $0.05
soda0101: posts big blind $0.10
*** HOLE CARDS ***
Dealt to CashMatteo [2s Ad]
HUE JOHNSON: folds 
andrewmoneyman: raises $0.20 to $0.30
CashMatteo: calls $0.25
soda0101: folds 
*** FLOP *** [6s 2d 9h]
CashMatteo: checks 
andrewmoneyman: checks 
*** TURN *** [6s 2d 9h] [3c]
CashMatteo: checks 
andrewmoneyman: checks 
*** RIVER *** [6s 2d 9h 3c] [Kd]
CashMatteo: checks 
andrewmoneyman: bets $0.40
CashMatteo: calls $0.40
*** SHOW DOWN ***
andrewmoneyman: shows [7c Ac] (high card Ace)
CashMatteo: shows [2s Ad] (a pair of Deuces)
CashMatteo collected $1.43 from pot
*** SUMMARY ***
Total pot $1.50 | Rake $0.07 
Board [6s 2d 9h 3c Kd]
Seat 2: HUE JOHNSON folded before Flop (didn't bet)
Seat 4: andrewmoneyman (button) showed [7c Ac] and lost with high card Ace
Seat 5: CashMatteo (small blind) showed [2s Ad] and won ($1.43) with a pair of Deuces
Seat 6: soda0101 (big blind) folded before Flop

Hand #1989: 

PokerStars Hand #246897032513:  Hold'em No Limit ($0.05/$0.10 CAD) - 2023/11/03 2:26:52 ET
Table 'Helewalda' 6-max Seat #5 is the button
Seat 2: HUE JOHNSON ($2.44 in chips) 
Seat 4: andrewmoneyman ($15.45 in chips) 
Seat 5: CashMatteo ($5 in chips) 
Seat 6: soda0101 ($3.48 in chips) 
soda0101: posts small blind $0.05
HUE JOHNSON: posts big blind $0.10
*** HOLE CARDS ***
Dealt to CashMatteo [2h 2d]
andrewmoneyman: raises $0.20 to $0.30
CashMatteo: calls $0.30
soda0101: folds 
HUE JOHNSON: folds 
*** FLOP *** [Jh Kc 2s]
andrewmoneyman: bets $0.25
CashMatteo: calls $0.25
*** TURN *** [Jh Kc 2s] [Td]
andrewmoneyman: checks 
CashMatteo: bets $0.99
andrewmoneyman: calls $0.99
*** RIVER *** [Jh Kc 2s Td] [Ks]
andrewmoneyman: checks 
CashMatteo: bets $2.44
andrewmoneyman: raises $2.44 to $4.88
CashMatteo: calls $1.02 and is all-in
Uncalled bet ($1.42) returned to andrewmoneyman
*** SHOW DOWN ***
andrewmoneyman: shows [Jd Kd] (a full house, Kings full of Jacks)
CashMatteo: shows [2h 2d] (a full house, Deuces full of Kings)
andrewmoneyman collected $9.69 from pot
*** SUMMARY ***
Total pot $10.15 | Rake $0.46 
Board [Jh Kc 2s Td Ks]
Seat 2: HUE JOHNSON (big blind) folded before Flop
Seat 4: andrewmoneyman showed [Jd Kd] and won ($9.69) with a full house, Kings full of Jacks
Seat 5: CashMatteo (button) showed [2h 2d] and lost with a full house, Deuces full of Kings
Seat 6: soda0101 (small blind) folded before Flop

Hand #1990: 

PokerStars Hand #246897039630:  Hold'em No Limit ($0.05/$0.10 CAD) - 2023/11/03 2:28:15 ET
Table 'Helewalda' 6-max Seat #2 is the button
Seat 2: HUE JOHNSON ($2.29 in chips) 
Seat 4: andrewmoneyman ($20.19 in chips) 
Seat 5: CashMatteo ($10 in chips) 
Seat 6: soda0101 ($3.43 in chips) 
andrewmoneyman: posts small blind $0.05
CashMatteo: posts big blind $0.10
*** HOLE CARDS ***
Dealt to CashMatteo [7c Qc]
soda0101: folds 
HUE JOHNSON: raises $0.20 to $0.30
andrewmoneyman: raises $0.60 to $0.90
CashMatteo: folds 
HUE JOHNSON: calls $0.60
*** FLOP *** [5s 5h 4h]
andrewmoneyman: bets $1.81
HUE JOHNSON: calls $1.39 and is all-in
Uncalled bet ($0.42) returned to andrewmoneyman
*** TURN *** [5s 5h 4h] [8d]
*** RIVER *** [5s 5h 4h 8d] [Kc]
*** SHOW DOWN ***
andrewmoneyman: shows [8h 8s] (a full house, Eights full of Fives)
HUE JOHNSON: shows [Td Ah] (a pair of Fives)
andrewmoneyman collected $4.47 from pot
*** SUMMARY ***
Total pot $4.68 | Rake $0.21 
Board [5s 5h 4h 8d Kc]
Seat 2: HUE JOHNSON (button) showed [Td Ah] and lost with a pair of Fives
Seat 4: andrewmoneyman (small blind) showed [8h 8s] and won ($4.47) with a full house, Eights full of Fives
Seat 5: CashMatteo (big blind) folded before Flop
Seat 6: soda0101 folded before Flop (didn't bet)

Hand #1991: 

PokerStars Hand #246897043028:  Hold'em No Limit ($0.05/$0.10 CAD) - 2023/11/03 2:28:54 ET
Table 'Helewalda' 6-max Seat #4 is the button
Seat 4: andrewmoneyman ($22.37 in chips) 
Seat 5: CashMatteo ($9.90 in chips) 
Seat 6: soda0101 ($3.43 in chips) 
CashMatteo: posts small blind $0.05
soda0101: posts big blind $0.10
*** HOLE CARDS ***
Dealt to CashMatteo [5c 3s]
andrewmoneyman: raises $0.15 to $0.25
CashMatteo: folds 
HUE JOHNSON leaves the table
soda0101: folds 
Uncalled bet ($0.15) returned to andrewmoneyman
andrewmoneyman collected $0.25 from pot
andrewmoneyman: doesn't show hand 
*** SUMMARY ***
Total pot $0.25 | Rake $0 
Seat 4: andrewmoneyman (button) collected ($0.25)
Seat 5: CashMatteo (small blind) folded before Flop
Seat 6: soda0101 (big blind) folded before Flop

Hand #1992: 

PokerStars Hand #246897044007:  Hold'em No Limit ($0.05/$0.10 CAD) - 2023/11/03 2:29:05 ET
Table 'Helewalda' 6-max Seat #5 is the button
Seat 4: andrewmoneyman ($22.52 in chips) 
Seat 5: CashMatteo ($9.85 in chips) 
Seat 6: soda0101 ($3.33 in chips) 
soda0101: posts small blind $0.05
andrewmoneyman: posts big blind $0.10
*** HOLE CARDS ***
Dealt to CashMatteo [6h Ts]
CashMatteo: folds 
soda0101: calls $0.05
andrewmoneyman: raises $0.30 to $0.40
soda0101: raises $2.93 to $3.33 and is all-in
andrewmoneyman: calls $2.93
*** FLOP *** [Qd Ac Jh]
*** TURN *** [Qd Ac Jh] [4s]
*** RIVER *** [Qd Ac Jh 4s] [7d]
*** SHOW DOWN ***
soda0101: shows [Th Tc] (a pair of Tens)
andrewmoneyman: shows [As 8h] (a pair of Aces)
andrewmoneyman collected $6.36 from pot
*** SUMMARY ***
Total pot $6.66 | Rake $0.30 
Board [Qd Ac Jh 4s 7d]
Seat 4: andrewmoneyman (big blind) showed [As 8h] and won ($6.36) with a pair of Aces
Seat 5: CashMatteo (button) folded before Flop (didn't bet)
Seat 6: soda0101 (small blind) showed [Th Tc] and lost with a pair of Tens

Hand #1993: 

PokerStars Hand #246897046382:  Hold'em No Limit ($0.05/$0.10 CAD) - 2023/11/03 2:29:34 ET
Table 'Helewalda' 6-max Seat #4 is the button
Seat 4: andrewmoneyman ($25.55 in chips) 
Seat 5: CashMatteo ($9.85 in chips) 
andrewmoneyman: posts small blind $0.05
CashMatteo: posts big blind $0.10
*** HOLE CARDS ***
Dealt to CashMatteo [Ts 3d]
andrewmoneyman: folds 
Uncalled bet ($0.05) returned to CashMatteo
CashMatteo collected $0.10 from pot
CashMatteo: doesn't show hand 
*** SUMMARY ***
Total pot $0.10 | Rake $0 
Seat 4: andrewmoneyman (button) (small blind) folded before Flop
Seat 5: CashMatteo (big blind) collected ($0.10)

Hand #1994: 

PokerStars Hand #246897046905:  Hold'em No Limit ($0.05/$0.10 CAD) - 2023/11/03 2:29:40 ET
Table 'Helewalda' 6-max Seat #5 is the button
Seat 4: andrewmoneyman ($25.50 in chips) 
Seat 5: CashMatteo ($9.90 in chips) 
CashMatteo: posts small blind $0.05
soda0101 leaves the table
andrewmoneyman: posts big blind $0.10
*** HOLE CARDS ***
Dealt to CashMatteo [4c 8s]
CashMatteo: folds 
Uncalled bet ($0.05) returned to andrewmoneyman
andrewmoneyman collected $0.10 from pot
andrewmoneyman: doesn't show hand 
*** SUMMARY ***
Total pot $0.10 | Rake $0 
Seat 4: andrewmoneyman (big blind) collected ($0.10)
Seat 5: CashMatteo (button) (small blind) folded before Flop

Hand #1995: 

PokerStars Hand #246897047452:  Hold'em No Limit ($0.05/$0.10 CAD) - 2023/11/03 2:29:46 ET
Table 'Helewalda' 6-max Seat #4 is the button
Seat 4: andrewmoneyman ($25.55 in chips) 
Seat 5: CashMatteo ($9.85 in chips) 
andrewmoneyman: posts small blind $0.05
CashMatteo: posts big blind $0.10
*** HOLE CARDS ***
Dealt to CashMatteo [8s 2c]
andrewmoneyman: folds 
Uncalled bet ($0.05) returned to CashMatteo
CashMatteo collected $0.10 from pot
CashMatteo: doesn't show hand 
*** SUMMARY ***
Total pot $0.10 | Rake $0 
Seat 4: andrewmoneyman (button) (small blind) folded before Flop
Seat 5: CashMatteo (big blind) collected ($0.10)

Hand #1996: 

PokerStars Hand #246897047981:  Hold'em No Limit ($0.05/$0.10 CAD) - 2023/11/03 2:29:53 ET
Table 'Helewalda' 6-max Seat #5 is the button
Seat 4: andrewmoneyman ($25.50 in chips) 
Seat 5: CashMatteo ($9.90 in chips) 
CashMatteo: posts small blind $0.05
andrewmoneyman: posts big blind $0.10
*** HOLE CARDS ***
Dealt to CashMatteo [4h 3s]
CashMatteo: folds 
Uncalled bet ($0.05) returned to andrewmoneyman
andrewmoneyman collected $0.10 from pot
andrewmoneyman: doesn't show hand 
*** SUMMARY ***
Total pot $0.10 | Rake $0 
Seat 4: andrewmoneyman (big blind) collected ($0.10)
Seat 5: CashMatteo (button) (small blind) folded before Flop

Hand #1997: 

PokerStars Hand #246897048515:  Hold'em No Limit ($0.05/$0.10 CAD) - 2023/11/03 2:29:59 ET
Table 'Helewalda' 6-max Seat #4 is the button
Seat 4: andrewmoneyman ($25.55 in chips) 
Seat 5: CashMatteo ($9.85 in chips) 
andrewmoneyman: posts small blind $0.05
CashMatteo: posts big blind $0.10
*** HOLE CARDS ***
Dealt to CashMatteo [4h 8d]
andrewmoneyman: raises $0.15 to $0.25
CashMatteo: calls $0.15
*** FLOP *** [Qd Js Kd]
CashMatteo: checks 
andrewmoneyman: bets $0.25
CashMatteo: folds 
Uncalled bet ($0.25) returned to andrewmoneyman
andrewmoneyman collected $0.48 from pot
andrewmoneyman: doesn't show hand 
*** SUMMARY ***
Total pot $0.50 | Rake $0.02 
Board [Qd Js Kd]
Seat 4: andrewmoneyman (button) (small blind) collected ($0.48)
Seat 5: CashMatteo (big blind) folded on the Flop

Hand #1998: 

PokerStars Hand #246897049924:  Hold'em No Limit ($0.05/$0.10 CAD) - 2023/11/03 2:30:14 ET
Table 'Helewalda' 6-max Seat #5 is the button
Seat 4: andrewmoneyman ($25.78 in chips) 
Seat 5: CashMatteo ($9.60 in chips) 
CashMatteo: posts small blind $0.05
andrewmoneyman: posts big blind $0.10
*** HOLE CARDS ***
Dealt to CashMatteo [3s Ac]
CashMatteo: calls $0.05
andrewmoneyman: checks 
*** FLOP *** [Jc 9c Ks]
andrewmoneyman: checks 
CashMatteo: bets $0.19
andrewmoneyman: folds 
Uncalled bet ($0.19) returned to CashMatteo
CashMatteo collected $0.19 from pot
CashMatteo: doesn't show hand 
*** SUMMARY ***
Total pot $0.20 | Rake $0.01 
Board [Jc 9c Ks]
Seat 4: andrewmoneyman (big blind) folded on the Flop
Seat 5: CashMatteo (button) (small blind) collected ($0.19)

Hand #1999: 

PokerStars Hand #246897051181:  Hold'em No Limit ($0.05/$0.10 CAD) - 2023/11/03 2:30:29 ET
Table 'Helewalda' 6-max Seat #4 is the button
Seat 4: andrewmoneyman ($25.68 in chips) 
Seat 5: CashMatteo ($9.69 in chips) 
andrewmoneyman: posts small blind $0.05
CashMatteo: posts big blind $0.10
*** HOLE CARDS ***
Dealt to CashMatteo [Qh 8c]
andrewmoneyman: raises $0.20 to $0.30
CashMatteo: calls $0.20
*** FLOP *** [6s 7h Tc]
CashMatteo: checks 
andrewmoneyman: bets $0.30
CashMatteo: calls $0.30
*** TURN *** [6s 7h Tc] [Ah]
CashMatteo: checks 
andrewmoneyman: bets $0.70
CashMatteo: folds 
Uncalled bet ($0.70) returned to andrewmoneyman
andrewmoneyman collected $1.15 from pot
andrewmoneyman: doesn't show hand 
*** SUMMARY ***
Total pot $1.20 | Rake $0.05 
Board [6s 7h Tc Ah]
Seat 4: andrewmoneyman (button) (small blind) collected ($1.15)
Seat 5: CashMatteo (big blind) folded on the Turn

Hand #2000: 

PokerStars Hand #246897054579:  Hold'em No Limit ($0.05/$0.10 CAD) - 2023/11/03 2:31:08 ET
Table 'Helewalda' 6-max Seat #5 is the button
Seat 4: andrewmoneyman ($26.23 in chips) 
Seat 5: CashMatteo ($9.09 in chips) 
CashMatteo: posts small blind $0.05
andrewmoneyman: posts big blind $0.10
*** HOLE CARDS ***
Dealt to CashMatteo [2d 7c]
CashMatteo: raises $0.15 to $0.25
andrewmoneyman: calls $0.15
*** FLOP *** [Qd 8d 9h]
andrewmoneyman: checks 
CashMatteo: bets $0.24
andrewmoneyman: folds 
Uncalled bet ($0.24) returned to CashMatteo
CashMatteo collected $0.48 from pot
CashMatteo: doesn't show hand 
*** SUMMARY ***
Total pot $0.50 | Rake $0.02 
Board [Qd 8d 9h]
Seat 4: andrewmoneyman (big blind) folded on the Flop
Seat 5: CashMatteo (button) (small blind) collected ($0.48)

Hand #2001: 

PokerStars Hand #246897055864:  Hold'em No Limit ($0.05/$0.10 CAD) - 2023/11/03 2:31:22 ET
Table 'Helewalda' 6-max Seat #4 is the button
Seat 4: andrewmoneyman ($25.98 in chips) 
Seat 5: CashMatteo ($9.32 in chips) 
andrewmoneyman: posts small blind $0.05
CashMatteo: posts big blind $0.10
*** HOLE CARDS ***
Dealt to CashMatteo [5h 9d]
andrewmoneyman: calls $0.05
CashMatteo: checks 
*** FLOP *** [3c Qs Jd]
CashMatteo: checks 
andrewmoneyman: bets $0.15
CashMatteo: folds 
Uncalled bet ($0.15) returned to andrewmoneyman
andrewmoneyman collected $0.19 from pot
andrewmoneyman: doesn't show hand 
*** SUMMARY ***
Total pot $0.20 | Rake $0.01 
Board [3c Qs Jd]
Seat 4: andrewmoneyman (button) (small blind) collected ($0.19)
Seat 5: CashMatteo (big blind) folded on the Flop

Hand #2002: 

PokerStars Hand #246897057047:  Hold'em No Limit ($0.05/$0.10 CAD) - 2023/11/03 2:31:36 ET
Table 'Helewalda' 6-max Seat #5 is the button
Seat 4: andrewmoneyman ($26.07 in chips) 
Seat 5: CashMatteo ($9.22 in chips) 
CashMatteo: posts small blind $0.05
andrewmoneyman: posts big blind $0.10
*** HOLE CARDS ***
Dealt to CashMatteo [7h 4c]
CashMatteo: folds 
Uncalled bet ($0.05) returned to andrewmoneyman
andrewmoneyman collected $0.10 from pot
andrewmoneyman: doesn't show hand 
*** SUMMARY ***
Total pot $0.10 | Rake $0 
Seat 4: andrewmoneyman (big blind) collected ($0.10)
Seat 5: CashMatteo (button) (small blind) folded before Flop

Hand #2003: 

PokerStars Hand #246897057612:  Hold'em No Limit ($0.05/$0.10 CAD) - 2023/11/03 2:31:42 ET
Table 'Helewalda' 6-max Seat #4 is the button
Seat 4: andrewmoneyman ($26.12 in chips) 
Seat 5: CashMatteo ($9.17 in chips) 
andrewmoneyman: posts small blind $0.05
CashMatteo: posts big blind $0.10
*** HOLE CARDS ***
Dealt to CashMatteo [5s 9s]
andrewmoneyman: raises $0.15 to $0.25
CashMatteo: calls $0.15
*** FLOP *** [2d 7d Td]
CashMatteo: bets $0.24
andrewmoneyman: raises $0.81 to $1.05
CashMatteo: folds 
Uncalled bet ($0.81) returned to andrewmoneyman
andrewmoneyman collected $0.94 from pot
andrewmoneyman: doesn't show hand 
*** SUMMARY ***
Total pot $0.98 | Rake $0.04 
Board [2d 7d Td]
Seat 4: andrewmoneyman (button) (small blind) collected ($0.94)
Seat 5: CashMatteo (big blind) folded on the Flop

Hand #2004: 

PokerStars Hand #246897059978:  Hold'em No Limit ($0.05/$0.10 CAD) - 2023/11/03 2:32:09 ET
Table 'Helewalda' 6-max Seat #5 is the button
Seat 4: andrewmoneyman ($26.57 in chips) 
Seat 5: CashMatteo ($8.68 in chips) 
CashMatteo: posts small blind $0.05
andrewmoneyman: posts big blind $0.10
*** HOLE CARDS ***
Dealt to CashMatteo [Kc Th]
CashMatteo: raises $0.15 to $0.25
andrewmoneyman: folds 
Uncalled bet ($0.15) returned to CashMatteo
CashMatteo collected $0.20 from pot
CashMatteo: doesn't show hand 
*** SUMMARY ***
Total pot $0.20 | Rake $0 
Seat 4: andrewmoneyman (big blind) folded before Flop
Seat 5: CashMatteo (button) (small blind) collected ($0.20)

Hand #2005: 

PokerStars Hand #246897060719:  Hold'em No Limit ($0.05/$0.10 CAD) - 2023/11/03 2:32:17 ET
Table 'Helewalda' 6-max Seat #4 is the button
Seat 4: andrewmoneyman ($26.47 in chips) 
Seat 5: CashMatteo ($8.78 in chips) 
andrewmoneyman: posts small blind $0.05
CashMatteo: posts big blind $0.10
*** HOLE CARDS ***
Dealt to CashMatteo [7d Qd]
andrewmoneyman: calls $0.05
CashMatteo: checks 
*** FLOP *** [7c Kc Kh]
CashMatteo: bets $0.10
andrewmoneyman: folds 
Uncalled bet ($0.10) returned to CashMatteo
CashMatteo collected $0.19 from pot
CashMatteo: doesn't show hand 
*** SUMMARY ***
Total pot $0.20 | Rake $0.01 
Board [7c Kc Kh]
Seat 4: andrewmoneyman (button) (small blind) folded on the Flop
Seat 5: CashMatteo (big blind) collected ($0.19)

Hand #2006: 

PokerStars Hand #246897061878:  Hold'em No Limit ($0.05/$0.10 CAD) - 2023/11/03 2:32:31 ET
Table 'Helewalda' 6-max Seat #5 is the button
Seat 4: andrewmoneyman ($26.37 in chips) 
Seat 5: CashMatteo ($8.87 in chips) 
CashMatteo: posts small blind $0.05
andrewmoneyman: posts big blind $0.10
*** HOLE CARDS ***
Dealt to CashMatteo [4h 2s]
CashMatteo: folds 
Uncalled bet ($0.05) returned to andrewmoneyman
andrewmoneyman collected $0.10 from pot
andrewmoneyman: doesn't show hand 
*** SUMMARY ***
Total pot $0.10 | Rake $0 
Seat 4: andrewmoneyman (big blind) collected ($0.10)
Seat 5: CashMatteo (button) (small blind) folded before Flop

Hand #2007: 

PokerStars Hand #246897062394:  Hold'em No Limit ($0.05/$0.10 CAD) - 2023/11/03 2:32:37 ET
Table 'Helewalda' 6-max Seat #4 is the button
Seat 4: andrewmoneyman ($26.42 in chips) 
Seat 5: CashMatteo ($8.82 in chips) 
andrewmoneyman: posts small blind $0.05
CashMatteo: posts big blind $0.10
*** HOLE CARDS ***
Dealt to CashMatteo [Jd Ac]
andrewmoneyman: raises $0.20 to $0.30
CashMatteo: raises $0.60 to $0.90
andrewmoneyman: calls $0.60
*** FLOP *** [7s 3s 6s]
CashMatteo: bets $0.86
andrewmoneyman: raises $1.49 to $2.35
CashMatteo: folds 
Uncalled bet ($1.49) returned to andrewmoneyman
andrewmoneyman collected $3.36 from pot
andrewmoneyman: doesn't show hand 
*** SUMMARY ***
Total pot $3.52 | Rake $0.16 
Board [7s 3s 6s]
Seat 4: andrewmoneyman (button) (small blind) collected ($3.36)
Seat 5: CashMatteo (big blind) folded on the Flop

Hand #2008: 

PokerStars Hand #246897066981:  Hold'em No Limit ($0.05/$0.10 CAD) - 2023/11/03 2:33:28 ET
Table 'Helewalda' 6-max Seat #5 is the button
Seat 4: andrewmoneyman ($28.02 in chips) 
Seat 5: CashMatteo ($7.06 in chips) 
CashMatteo: posts small blind $0.05
andrewmoneyman: posts big blind $0.10
*** HOLE CARDS ***
Dealt to CashMatteo [3d 5d]
CashMatteo: calls $0.05
andrewmoneyman: checks 
*** FLOP *** [Ks Jh 6d]
andrewmoneyman: checks 
CashMatteo: bets $0.10
andrewmoneyman: folds 
Uncalled bet ($0.10) returned to CashMatteo
CashMatteo collected $0.19 from pot
CashMatteo: doesn't show hand 
*** SUMMARY ***
Total pot $0.20 | Rake $0.01 
Board [Ks Jh 6d]
Seat 4: andrewmoneyman (big blind) folded on the Flop
Seat 5: CashMatteo (button) (small blind) collected ($0.19)

Hand #2009: 

PokerStars Hand #246897068200:  Hold'em No Limit ($0.05/$0.10 CAD) - 2023/11/03 2:33:42 ET
Table 'Helewalda' 6-max Seat #4 is the button
Seat 4: andrewmoneyman ($27.92 in chips) 
Seat 5: CashMatteo ($7.15 in chips) 
andrewmoneyman: posts small blind $0.05
CashMatteo: posts big blind $0.10
*** HOLE CARDS ***
Dealt to CashMatteo [5h 5d]
andrewmoneyman: raises $0.20 to $0.30
CashMatteo: raises $6.85 to $7.15 and is all-in
andrewmoneyman: folds 
Uncalled bet ($6.85) returned to CashMatteo
CashMatteo collected $0.60 from pot
CashMatteo: doesn't show hand 
*** SUMMARY ***
Total pot $0.60 | Rake $0 
Seat 4: andrewmoneyman (button) (small blind) folded before Flop
Seat 5: CashMatteo (big blind) collected ($0.60)

Hand #2010: 

PokerStars Hand #246897069269:  Hold'em No Limit ($0.05/$0.10 CAD) - 2023/11/03 2:33:54 ET
Table 'Helewalda' 6-max Seat #5 is the button
Seat 4: andrewmoneyman ($27.62 in chips) 
Seat 5: CashMatteo ($7.45 in chips) 
CashMatteo: posts small blind $0.05
andrewmoneyman: posts big blind $0.10
*** HOLE CARDS ***
Dealt to CashMatteo [4d As]
CashMatteo: raises $0.15 to $0.25
andrewmoneyman: calls $0.15
*** FLOP *** [Kd 8d Kh]
andrewmoneyman: checks 
CashMatteo: bets $0.24
andrewmoneyman: calls $0.24
*** TURN *** [Kd 8d Kh] [4c]
andrewmoneyman: checks 
CashMatteo: bets $0.57
andrewmoneyman: folds 
Uncalled bet ($0.57) returned to CashMatteo
CashMatteo collected $0.94 from pot
CashMatteo: doesn't show hand 
*** SUMMARY ***
Total pot $0.98 | Rake $0.04 
Board [Kd 8d Kh 4c]
Seat 4: andrewmoneyman (big blind) folded on the Turn
Seat 5: CashMatteo (button) (small blind) collected ($0.94)

Hand #2011: 

PokerStars Hand #246897071573:  Hold'em No Limit ($0.05/$0.10 CAD) - 2023/11/03 2:34:20 ET
Table 'Helewalda' 6-max Seat #4 is the button
Seat 4: andrewmoneyman ($27.13 in chips) 
Seat 5: CashMatteo ($7.90 in chips) 
andrewmoneyman: posts small blind $0.05
CashMatteo: posts big blind $0.10
*** HOLE CARDS ***
Dealt to CashMatteo [6s 4d]
andrewmoneyman: raises $0.20 to $0.30
CashMatteo: folds 
Uncalled bet ($0.20) returned to andrewmoneyman
andrewmoneyman collected $0.20 from pot
andrewmoneyman: doesn't show hand 
*** SUMMARY ***
Total pot $0.20 | Rake $0 
Seat 4: andrewmoneyman (button) (small blind) collected ($0.20)
Seat 5: CashMatteo (big blind) folded before Flop

Hand #2012: 

PokerStars Hand #246897072421:  Hold'em No Limit ($0.05/$0.10 CAD) - 2023/11/03 2:34:30 ET
Table 'Helewalda' 6-max Seat #5 is the button
Seat 4: andrewmoneyman ($27.23 in chips) 
Seat 5: CashMatteo ($7.80 in chips) 
CashMatteo: posts small blind $0.05
andrewmoneyman: posts big blind $0.10
*** HOLE CARDS ***
Dealt to CashMatteo [9d 8c]
CashMatteo: raises $0.15 to $0.25
andrewmoneyman: raises $0.70 to $0.95
CashMatteo: folds 
Uncalled bet ($0.70) returned to andrewmoneyman
andrewmoneyman collected $0.50 from pot
andrewmoneyman: doesn't show hand 
*** SUMMARY ***
Total pot $0.50 | Rake $0 
Seat 4: andrewmoneyman (big blind) collected ($0.50)
Seat 5: CashMatteo (button) (small blind) folded before Flop

Hand #2013: 

PokerStars Hand #246897073439:  Hold'em No Limit ($0.05/$0.10 CAD) - 2023/11/03 2:34:41 ET
Table 'Helewalda' 6-max Seat #4 is the button
Seat 4: andrewmoneyman ($27.48 in chips) 
Seat 5: CashMatteo ($7.55 in chips) 
andrewmoneyman: posts small blind $0.05
CashMatteo: posts big blind $0.10
*** HOLE CARDS ***
Dealt to CashMatteo [5d 6s]
andrewmoneyman: folds 
Uncalled bet ($0.05) returned to CashMatteo
CashMatteo collected $0.10 from pot
CashMatteo: doesn't show hand 
*** SUMMARY ***
Total pot $0.10 | Rake $0 
Seat 4: andrewmoneyman (button) (small blind) folded before Flop
Seat 5: CashMatteo (big blind) collected ($0.10)

Hand #2014: 

PokerStars Hand #246897074031:  Hold'em No Limit ($0.05/$0.10 CAD) - 2023/11/03 2:34:48 ET
Table 'Helewalda' 6-max Seat #5 is the button
Seat 4: andrewmoneyman ($27.43 in chips) 
Seat 5: CashMatteo ($7.60 in chips) 
CashMatteo: posts small blind $0.05
andrewmoneyman: posts big blind $0.10
*** HOLE CARDS ***
Dealt to CashMatteo [Js As]
CashMatteo: raises $0.15 to $0.25
andrewmoneyman: folds 
Uncalled bet ($0.15) returned to CashMatteo
CashMatteo collected $0.20 from pot
CashMatteo: doesn't show hand 
*** SUMMARY ***
Total pot $0.20 | Rake $0 
Seat 4: andrewmoneyman (big blind) folded before Flop
Seat 5: CashMatteo (button) (small blind) collected ($0.20)

Hand #2015: 

PokerStars Hand #246897074718:  Hold'em No Limit ($0.05/$0.10 CAD) - 2023/11/03 2:34:56 ET
Table 'Helewalda' 6-max Seat #4 is the button
Seat 4: andrewmoneyman ($27.33 in chips) 
Seat 5: CashMatteo ($7.70 in chips) 
andrewmoneyman: posts small blind $0.05
CashMatteo: posts big blind $0.10
*** HOLE CARDS ***
Dealt to CashMatteo [Kh Ks]
andrewmoneyman: raises $0.20 to $0.30
CashMatteo: calls $0.20
*** FLOP *** [Jh 3c 7h]
CashMatteo: checks 
andrewmoneyman: bets $0.20
CashMatteo: calls $0.20
*** TURN *** [Jh 3c 7h] [2d]
CashMatteo: bets $0.48
andrewmoneyman: calls $0.48
*** RIVER *** [Jh 3c 7h 2d] [5d]
CashMatteo: bets $2.17
andrewmoneyman: folds 
Uncalled bet ($2.17) returned to CashMatteo
CashMatteo collected $1.87 from pot
CashMatteo: doesn't show hand 
*** SUMMARY ***
Total pot $1.96 | Rake $0.09 
Board [Jh 3c 7h 2d 5d]
Seat 4: andrewmoneyman (button) (small blind) folded on the River
Seat 5: CashMatteo (big blind) collected ($1.87)

Hand #2016: 

PokerStars Hand #246897078997:  Hold'em No Limit ($0.05/$0.10 CAD) - 2023/11/03 2:35:45 ET
Table 'Helewalda' 6-max Seat #5 is the button
Seat 4: andrewmoneyman ($26.35 in chips) 
Seat 5: CashMatteo ($8.59 in chips) 
CashMatteo: posts small blind $0.05
andrewmoneyman: posts big blind $0.10
*** HOLE CARDS ***
Dealt to CashMatteo [Qh 6h]
CashMatteo: raises $0.15 to $0.25
andrewmoneyman: folds 
Uncalled bet ($0.15) returned to CashMatteo
CashMatteo collected $0.20 from pot
CashMatteo: doesn't show hand 
*** SUMMARY ***
Total pot $0.20 | Rake $0 
Seat 4: andrewmoneyman (big blind) folded before Flop
Seat 5: CashMatteo (button) (small blind) collected ($0.20)

Hand #2017: 

PokerStars Hand #246897079717:  Hold'em No Limit ($0.05/$0.10 CAD) - 2023/11/03 2:35:53 ET
Table 'Helewalda' 6-max Seat #4 is the button
Seat 4: andrewmoneyman ($26.25 in chips) 
Seat 5: CashMatteo ($8.69 in chips) 
andrewmoneyman: posts small blind $0.05
CashMatteo: posts big blind $0.10
*** HOLE CARDS ***
Dealt to CashMatteo [6h 4c]
andrewmoneyman: raises $0.20 to $0.30
CashMatteo: folds 
Uncalled bet ($0.20) returned to andrewmoneyman
andrewmoneyman collected $0.20 from pot
andrewmoneyman: doesn't show hand 
*** SUMMARY ***
Total pot $0.20 | Rake $0 
Seat 4: andrewmoneyman (button) (small blind) collected ($0.20)
Seat 5: CashMatteo (big blind) folded before Flop

Hand #2018: 

PokerStars Hand #246897080497:  Hold'em No Limit ($0.05/$0.10 CAD) - 2023/11/03 2:36:02 ET
Table 'Helewalda' 6-max Seat #5 is the button
Seat 4: andrewmoneyman ($26.35 in chips) 
Seat 5: CashMatteo ($8.59 in chips) 
CashMatteo: posts small blind $0.05
andrewmoneyman: posts big blind $0.10
*** HOLE CARDS ***
Dealt to CashMatteo [7c Td]
CashMatteo: calls $0.05
andrewmoneyman: raises $0.35 to $0.45
CashMatteo: folds 
Uncalled bet ($0.35) returned to andrewmoneyman
andrewmoneyman collected $0.20 from pot
andrewmoneyman: doesn't show hand 
*** SUMMARY ***
Total pot $0.20 | Rake $0 
Seat 4: andrewmoneyman (big blind) collected ($0.20)
Seat 5: CashMatteo (button) (small blind) folded before Flop

Hand #2019: 

PokerStars Hand #246897081501:  Hold'em No Limit ($0.05/$0.10 CAD) - 2023/11/03 2:36:14 ET
Table 'Helewalda' 6-max Seat #4 is the button
Seat 4: andrewmoneyman ($26.45 in chips) 
Seat 5: CashMatteo ($8.49 in chips) 
andrewmoneyman: posts small blind $0.05
CashMatteo: posts big blind $0.10
*** HOLE CARDS ***
Dealt to CashMatteo [9s 3d]
andrewmoneyman: folds 
Uncalled bet ($0.05) returned to CashMatteo
CashMatteo collected $0.10 from pot
CashMatteo: doesn't show hand 
*** SUMMARY ***
Total pot $0.10 | Rake $0 
Seat 4: andrewmoneyman (button) (small blind) folded before Flop
Seat 5: CashMatteo (big blind) collected ($0.10)

Hand #2020: 

PokerStars Hand #246897082118:  Hold'em No Limit ($0.05/$0.10 CAD) - 2023/11/03 2:36:21 ET
Table 'Helewalda' 6-max Seat #5 is the button
Seat 4: andrewmoneyman ($26.40 in chips) 
Seat 5: CashMatteo ($8.54 in chips) 
CashMatteo: posts small blind $0.05
andrewmoneyman: posts big blind $0.10
*** HOLE CARDS ***
Dealt to CashMatteo [Qh Js]
CashMatteo: raises $0.15 to $0.25
andrewmoneyman: calls $0.15
*** FLOP *** [Ac Qs 7d]
andrewmoneyman: checks 
CashMatteo: checks 
*** TURN *** [Ac Qs 7d] [3c]
andrewmoneyman: checks 
CashMatteo: bets $0.24
andrewmoneyman: calls $0.24
*** RIVER *** [Ac Qs 7d 3c] [8d]
andrewmoneyman: checks 
CashMatteo: bets $0.47
andrewmoneyman: folds 
Uncalled bet ($0.47) returned to CashMatteo
CashMatteo collected $0.94 from pot
CashMatteo: doesn't show hand 
*** SUMMARY ***
Total pot $0.98 | Rake $0.04 
Board [Ac Qs 7d 3c 8d]
Seat 4: andrewmoneyman (big blind) folded on the River
Seat 5: CashMatteo (button) (small blind) collected ($0.94)

Hand #2021: 

PokerStars Hand #246897084659:  Hold'em No Limit ($0.05/$0.10 CAD) - 2023/11/03 2:36:51 ET
Table 'Helewalda' 6-max Seat #4 is the button
Seat 4: andrewmoneyman ($25.91 in chips) 
Seat 5: CashMatteo ($8.99 in chips) 
andrewmoneyman: posts small blind $0.05
CashMatteo: posts big blind $0.10
*** HOLE CARDS ***
Dealt to CashMatteo [5s 3h]
andrewmoneyman: raises $0.15 to $0.25
CashMatteo: folds 
Uncalled bet ($0.15) returned to andrewmoneyman
andrewmoneyman collected $0.20 from pot
andrewmoneyman: doesn't show hand 
*** SUMMARY ***
Total pot $0.20 | Rake $0 
Seat 4: andrewmoneyman (button) (small blind) collected ($0.20)
Seat 5: CashMatteo (big blind) folded before Flop

Hand #2022: 

PokerStars Hand #246897085604:  Hold'em No Limit ($0.05/$0.10 CAD) - 2023/11/03 2:37:01 ET
Table 'Helewalda' 6-max Seat #5 is the button
Seat 4: andrewmoneyman ($26.01 in chips) 
Seat 5: CashMatteo ($8.89 in chips) 
CashMatteo: posts small blind $0.05
andrewmoneyman: posts big blind $0.10
*** HOLE CARDS ***
Dealt to CashMatteo [Qc 3d]
CashMatteo: folds 
Uncalled bet ($0.05) returned to andrewmoneyman
andrewmoneyman collected $0.10 from pot
andrewmoneyman: doesn't show hand 
*** SUMMARY ***
Total pot $0.10 | Rake $0 
Seat 4: andrewmoneyman (big blind) collected ($0.10)
Seat 5: CashMatteo (button) (small blind) folded before Flop

Hand #2023: 

PokerStars Hand #246897086148:  Hold'em No Limit ($0.05/$0.10 CAD) - 2023/11/03 2:37:07 ET
Table 'Helewalda' 6-max Seat #4 is the button
Seat 4: andrewmoneyman ($26.06 in chips) 
Seat 5: CashMatteo ($8.84 in chips) 
andrewmoneyman: posts small blind $0.05
CashMatteo: posts big blind $0.10
*** HOLE CARDS ***
Dealt to CashMatteo [5h 9c]
andrewmoneyman: raises $0.15 to $0.25
CashMatteo: calls $0.15
*** FLOP *** [Ks Ah 7c]
CashMatteo: checks 
andrewmoneyman: bets $0.20
CashMatteo: folds 
Uncalled bet ($0.20) returned to andrewmoneyman
andrewmoneyman collected $0.48 from pot
andrewmoneyman: doesn't show hand 
*** SUMMARY ***
Total pot $0.50 | Rake $0.02 
Board [Ks Ah 7c]
Seat 4: andrewmoneyman (button) (small blind) collected ($0.48)
Seat 5: CashMatteo (big blind) folded on the Flop

Hand #2024: 

PokerStars Hand #246897087464:  Hold'em No Limit ($0.05/$0.10 CAD) - 2023/11/03 2:37:22 ET
Table 'Helewalda' 6-max Seat #5 is the button
Seat 4: andrewmoneyman ($26.29 in chips) 
Seat 5: CashMatteo ($8.59 in chips) 
CashMatteo: posts small blind $0.05
andrewmoneyman: posts big blind $0.10
*** HOLE CARDS ***
Dealt to CashMatteo [3d 6c]
CashMatteo: calls $0.05
andrewmoneyman: raises $0.30 to $0.40
CashMatteo: calls $0.30
*** FLOP *** [3s 2d Td]
andrewmoneyman: bets $0.25
CashMatteo: raises $0.63 to $0.88
andrewmoneyman: calls $0.63
*** TURN *** [3s 2d Td] [Kh]
andrewmoneyman: checks 
CashMatteo: bets $1.22
andrewmoneyman: calls $1.22
*** RIVER *** [3s 2d Td Kh] [Jh]
andrewmoneyman: bets $2.10
CashMatteo: folds 
Uncalled bet ($2.10) returned to andrewmoneyman
andrewmoneyman collected $4.78 from pot
andrewmoneyman: doesn't show hand 
*** SUMMARY ***
Total pot $5 | Rake $0.22 
Board [3s 2d Td Kh Jh]
Seat 4: andrewmoneyman (big blind) collected ($4.78)
Seat 5: CashMatteo (button) (small blind) folded on the River

Hand #2025: 

PokerStars Hand #246897091935:  Hold'em No Limit ($0.05/$0.10 CAD) - 2023/11/03 2:38:14 ET
Table 'Helewalda' 6-max Seat #4 is the button
Seat 4: andrewmoneyman ($28.57 in chips) 
Seat 5: CashMatteo ($6.09 in chips) 
andrewmoneyman: posts small blind $0.05
CashMatteo: posts big blind $0.10
*** HOLE CARDS ***
Dealt to CashMatteo [6d 4d]
andrewmoneyman: folds 
Uncalled bet ($0.05) returned to CashMatteo
CashMatteo collected $0.10 from pot
CashMatteo: doesn't show hand 
*** SUMMARY ***
Total pot $0.10 | Rake $0 
Seat 4: andrewmoneyman (button) (small blind) folded before Flop
Seat 5: CashMatteo (big blind) collected ($0.10)

Hand #2026: 

PokerStars Hand #246897092530:  Hold'em No Limit ($0.05/$0.10 CAD) - 2023/11/03 2:38:20 ET
Table 'Helewalda' 6-max Seat #5 is the button
Seat 4: andrewmoneyman ($28.52 in chips) 
Seat 5: CashMatteo ($6.14 in chips) 
CashMatteo: posts small blind $0.05
andrewmoneyman: posts big blind $0.10
*** HOLE CARDS ***
Dealt to CashMatteo [4c Jd]
CashMatteo: calls $0.05
andrewmoneyman: checks 
*** FLOP *** [5d Ad 7s]
andrewmoneyman: checks 
CashMatteo: checks 
*** TURN *** [5d Ad 7s] [9s]
andrewmoneyman: bets $0.20
CashMatteo: folds 
Uncalled bet ($0.20) returned to andrewmoneyman
andrewmoneyman collected $0.19 from pot
andrewmoneyman: doesn't show hand 
*** SUMMARY ***
Total pot $0.20 | Rake $0.01 
Board [5d Ad 7s 9s]
Seat 4: andrewmoneyman (big blind) collected ($0.19)
Seat 5: CashMatteo (button) (small blind) folded on the Turn

Hand #2027: 

PokerStars Hand #246897094213:  Hold'em No Limit ($0.05/$0.10 CAD) - 2023/11/03 2:38:40 ET
Table 'Helewalda' 6-max Seat #4 is the button
Seat 4: andrewmoneyman ($28.61 in chips) 
Seat 5: CashMatteo ($6.04 in chips) 
andrewmoneyman: posts small blind $0.05
CashMatteo: posts big blind $0.10
*** HOLE CARDS ***
Dealt to CashMatteo [8d 3c]
andrewmoneyman: folds 
Uncalled bet ($0.05) returned to CashMatteo
CashMatteo collected $0.10 from pot
CashMatteo: doesn't show hand 
*** SUMMARY ***
Total pot $0.10 | Rake $0 
Seat 4: andrewmoneyman (button) (small blind) folded before Flop
Seat 5: CashMatteo (big blind) collected ($0.10)

Hand #2028: 

PokerStars Hand #246897094815:  Hold'em No Limit ($0.05/$0.10 CAD) - 2023/11/03 2:38:46 ET
Table 'Helewalda' 6-max Seat #5 is the button
Seat 4: andrewmoneyman ($28.56 in chips) 
Seat 5: CashMatteo ($6.09 in chips) 
CashMatteo: posts small blind $0.05
andrewmoneyman: posts big blind $0.10
*** HOLE CARDS ***
Dealt to CashMatteo [5c Ah]
CashMatteo: calls $0.05
andrewmoneyman: raises $0.30 to $0.40
CashMatteo: raises $0.80 to $1.20
andrewmoneyman: calls $0.80
*** FLOP *** [4s 5s 2d]
andrewmoneyman: checks 
CashMatteo: bets $1.15
andrewmoneyman: raises $4.59 to $5.74
CashMatteo: calls $3.74 and is all-in
Uncalled bet ($0.85) returned to andrewmoneyman
*** TURN *** [4s 5s 2d] [Qh]
*** RIVER *** [4s 5s 2d Qh] [7s]
*** SHOW DOWN ***
andrewmoneyman: shows [5d Ac] (a pair of Fives)
CashMatteo: shows [5c Ah] (a pair of Fives)
andrewmoneyman collected $5.82 from pot
CashMatteo collected $5.81 from pot
*** SUMMARY ***
Total pot $12.18 | Rake $0.55 
Board [4s 5s 2d Qh 7s]
Seat 4: andrewmoneyman (big blind) showed [5d Ac] and won ($5.82) with a pair of Fives
Seat 5: CashMatteo (button) (small blind) showed [5c Ah] and won ($5.81) with a pair of Fives

Hand #2029: 

PokerStars Hand #246897097379:  Hold'em No Limit ($0.05/$0.10 CAD) - 2023/11/03 2:39:16 ET
Table 'Helewalda' 6-max Seat #4 is the button
Seat 4: andrewmoneyman ($28.29 in chips) 
Seat 5: CashMatteo ($5.81 in chips) 
andrewmoneyman: posts small blind $0.05
CashMatteo: posts big blind $0.10
*** HOLE CARDS ***
Dealt to CashMatteo [Ts Kh]
andrewmoneyman: folds 
Uncalled bet ($0.05) returned to CashMatteo
CashMatteo collected $0.10 from pot
CashMatteo: doesn't show hand 
*** SUMMARY ***
Total pot $0.10 | Rake $0 
Seat 4: andrewmoneyman (button) (small blind) folded before Flop
Seat 5: CashMatteo (big blind) collected ($0.10)

Hand #2030: 

PokerStars Hand #246897097949:  Hold'em No Limit ($0.05/$0.10 CAD) - 2023/11/03 2:39:22 ET
Table 'Helewalda' 6-max Seat #5 is the button
Seat 4: andrewmoneyman ($28.24 in chips) 
Seat 5: CashMatteo ($5.86 in chips) 
CashMatteo: posts small blind $0.05
andrewmoneyman: posts big blind $0.10
*** HOLE CARDS ***
Dealt to CashMatteo [Qc 6c]
CashMatteo: calls $0.05
andrewmoneyman: checks 
*** FLOP *** [Qd 7c Kh]
andrewmoneyman: checks 
CashMatteo: bets $0.10
andrewmoneyman: calls $0.10
*** TURN *** [Qd 7c Kh] [7d]
andrewmoneyman: checks 
CashMatteo: checks 
*** RIVER *** [Qd 7c Kh 7d] [Jd]
andrewmoneyman: bets $0.25
CashMatteo: calls $0.25
*** SHOW DOWN ***
andrewmoneyman: shows [3s Kc] (two pair, Kings and Sevens)
CashMatteo: mucks hand 
andrewmoneyman collected $0.86 from pot
*** SUMMARY ***
Total pot $0.90 | Rake $0.04 
Board [Qd 7c Kh 7d Jd]
Seat 4: andrewmoneyman (big blind) showed [3s Kc] and won ($0.86) with two pair, Kings and Sevens
Seat 5: CashMatteo (button) (small blind) mucked [Qc 6c]

Hand #2031: 

PokerStars Hand #246897100013:  Hold'em No Limit ($0.05/$0.10 CAD) - 2023/11/03 2:39:46 ET
Table 'Helewalda' 6-max Seat #4 is the button
Seat 4: andrewmoneyman ($28.65 in chips) 
Seat 5: CashMatteo ($5.41 in chips) 
andrewmoneyman: posts small blind $0.05
CashMatteo: posts big blind $0.10
*** HOLE CARDS ***
Dealt to CashMatteo [Qh 3c]
andrewmoneyman: raises $0.15 to $0.25
CashMatteo: folds 
Uncalled bet ($0.15) returned to andrewmoneyman
andrewmoneyman collected $0.20 from pot
andrewmoneyman: doesn't show hand 
*** SUMMARY ***
Total pot $0.20 | Rake $0 
Seat 4: andrewmoneyman (button) (small blind) collected ($0.20)
Seat 5: CashMatteo (big blind) folded before Flop

Hand #2032: 

PokerStars Hand #246897100672:  Hold'em No Limit ($0.05/$0.10 CAD) - 2023/11/03 2:39:53 ET
Table 'Helewalda' 6-max Seat #5 is the button
Seat 4: andrewmoneyman ($28.75 in chips) 
Seat 5: CashMatteo ($5.31 in chips) 
CashMatteo: posts small blind $0.05
andrewmoneyman: posts big blind $0.10
*** HOLE CARDS ***
Dealt to CashMatteo [Tc 5s]
CashMatteo: folds 
Uncalled bet ($0.05) returned to andrewmoneyman
andrewmoneyman collected $0.10 from pot
andrewmoneyman: doesn't show hand 
*** SUMMARY ***
Total pot $0.10 | Rake $0 
Seat 4: andrewmoneyman (big blind) collected ($0.10)
Seat 5: CashMatteo (button) (small blind) folded before Flop

Hand #2033: 

PokerStars Hand #246897101175:  Hold'em No Limit ($0.05/$0.10 CAD) - 2023/11/03 2:39:59 ET
Table 'Helewalda' 6-max Seat #4 is the button
Seat 4: andrewmoneyman ($28.80 in chips) 
Seat 5: CashMatteo ($5.26 in chips) 
andrewmoneyman: posts small blind $0.05
CashMatteo: posts big blind $0.10
*** HOLE CARDS ***
Dealt to CashMatteo [Qc 8d]
andrewmoneyman: folds 
Uncalled bet ($0.05) returned to CashMatteo
CashMatteo collected $0.10 from pot
CashMatteo: doesn't show hand 
*** SUMMARY ***
Total pot $0.10 | Rake $0 
Seat 4: andrewmoneyman (button) (small blind) folded before Flop
Seat 5: CashMatteo (big blind) collected ($0.10)

Hand #2034: 

PokerStars Hand #246897101745:  Hold'em No Limit ($0.05/$0.10 CAD) - 2023/11/03 2:40:06 ET
Table 'Helewalda' 6-max Seat #5 is the button
Seat 4: andrewmoneyman ($28.75 in chips) 
Seat 5: CashMatteo ($5.31 in chips) 
CashMatteo: posts small blind $0.05
andrewmoneyman: posts big blind $0.10
*** HOLE CARDS ***
Dealt to CashMatteo [3c Ac]
CashMatteo: raises $0.15 to $0.25
andrewmoneyman: calls $0.15
*** FLOP *** [5d Ah 3d]
andrewmoneyman: checks 
CashMatteo: checks 
*** TURN *** [5d Ah 3d] [4c]
andrewmoneyman: bets $0.36
CashMatteo: calls $0.36
*** RIVER *** [5d Ah 3d 4c] [7s]
andrewmoneyman: bets $1.35
CashMatteo: calls $1.35
*** SHOW DOWN ***
andrewmoneyman: shows [Qh 6h] (a straight, Three to Seven)
CashMatteo: mucks hand 
andrewmoneyman collected $3.74 from pot
*** SUMMARY ***
Total pot $3.92 | Rake $0.18 
Board [5d Ah 3d 4c 7s]
Seat 4: andrewmoneyman (big blind) showed [Qh 6h] and won ($3.74) with a straight, Three to Seven
Seat 5: CashMatteo (button) (small blind) mucked [3c Ac]

Hand #2035: 

PokerStars Hand #246897104793:  Hold'em No Limit ($0.05/$0.10 CAD) - 2023/11/03 2:40:41 ET
Table 'Helewalda' 6-max Seat #4 is the button
Seat 4: andrewmoneyman ($30.53 in chips) 
Seat 5: CashMatteo ($3.35 in chips) 
andrewmoneyman: posts small blind $0.05
CashMatteo: posts big blind $0.10
*** HOLE CARDS ***
Dealt to CashMatteo [Jc 6s]
andrewmoneyman: raises $0.15 to $0.25
CashMatteo: calls $0.15
*** FLOP *** [2s 4d Qd]
CashMatteo: checks 
andrewmoneyman: bets $0.20
CashMatteo: folds 
Uncalled bet ($0.20) returned to andrewmoneyman
andrewmoneyman collected $0.48 from pot
andrewmoneyman: doesn't show hand 
*** SUMMARY ***
Total pot $0.50 | Rake $0.02 
Board [2s 4d Qd]
Seat 4: andrewmoneyman (button) (small blind) collected ($0.48)
Seat 5: CashMatteo (big blind) folded on the Flop

Hand #2036: 

PokerStars Hand #246897106509:  Hold'em No Limit ($0.05/$0.10 CAD) - 2023/11/03 2:41:00 ET
Table 'Helewalda' 6-max Seat #5 is the button
Seat 4: andrewmoneyman ($30.76 in chips) 
Seat 5: CashMatteo ($3.10 in chips) 
CashMatteo: posts small blind $0.05
andrewmoneyman: posts big blind $0.10
*** HOLE CARDS ***
Dealt to CashMatteo [Td Kh]
CashMatteo: raises $0.20 to $0.30
andrewmoneyman: calls $0.20
*** FLOP *** [Js Ah 5c]
andrewmoneyman: checks 
CashMatteo: bets $0.29
andrewmoneyman: calls $0.29
*** TURN *** [Js Ah 5c] [2h]
andrewmoneyman: checks 
CashMatteo: checks 
*** RIVER *** [Js Ah 5c 2h] [4h]
andrewmoneyman: bets $0.85
CashMatteo: folds 
Uncalled bet ($0.85) returned to andrewmoneyman
andrewmoneyman collected $1.13 from pot
andrewmoneyman: doesn't show hand 
*** SUMMARY ***
Total pot $1.18 | Rake $0.05 
Board [Js Ah 5c 2h 4h]
Seat 4: andrewmoneyman (big blind) collected ($1.13)
Seat 5: CashMatteo (button) (small blind) folded on the River

Hand #2037: 

PokerStars Hand #246897108655:  Hold'em No Limit ($0.05/$0.10 CAD) - 2023/11/03 2:41:25 ET
Table 'Helewalda' 6-max Seat #4 is the button
Seat 4: andrewmoneyman ($31.30 in chips) 
Seat 5: CashMatteo ($2.51 in chips) 
andrewmoneyman: posts small blind $0.05
CashMatteo: posts big blind $0.10
*** HOLE CARDS ***
Dealt to CashMatteo [Ks 3h]
andrewmoneyman: folds 
Uncalled bet ($0.05) returned to CashMatteo
CashMatteo collected $0.10 from pot
CashMatteo: doesn't show hand 
*** SUMMARY ***
Total pot $0.10 | Rake $0 
Seat 4: andrewmoneyman (button) (small blind) folded before Flop
Seat 5: CashMatteo (big blind) collected ($0.10)

Hand #2038: 

PokerStars Hand #246897109223:  Hold'em No Limit ($0.05/$0.10 CAD) - 2023/11/03 2:41:32 ET
Table 'Helewalda' 6-max Seat #5 is the button
Seat 4: andrewmoneyman ($31.25 in chips) 
Seat 5: CashMatteo ($2.56 in chips) 
CashMatteo: posts small blind $0.05
andrewmoneyman: posts big blind $0.10
*** HOLE CARDS ***
Dealt to CashMatteo [5c Qh]
CashMatteo: calls $0.05
andrewmoneyman: raises $0.30 to $0.40
CashMatteo: folds 
Uncalled bet ($0.30) returned to andrewmoneyman
andrewmoneyman collected $0.20 from pot
andrewmoneyman: doesn't show hand 
*** SUMMARY ***
Total pot $0.20 | Rake $0 
Seat 4: andrewmoneyman (big blind) collected ($0.20)
Seat 5: CashMatteo (button) (small blind) folded before Flop

Hand #2039: 

PokerStars Hand #246897110094:  Hold'em No Limit ($0.05/$0.10 CAD) - 2023/11/03 2:41:42 ET
Table 'Helewalda' 6-max Seat #4 is the button
Seat 4: andrewmoneyman ($31.35 in chips) 
Seat 5: CashMatteo ($2.46 in chips) 
andrewmoneyman: posts small blind $0.05
CashMatteo: posts big blind $0.10
*** HOLE CARDS ***
Dealt to CashMatteo [Ts 5c]
andrewmoneyman: folds 
Uncalled bet ($0.05) returned to CashMatteo
CashMatteo collected $0.10 from pot
CashMatteo: doesn't show hand 
*** SUMMARY ***
Total pot $0.10 | Rake $0 
Seat 4: andrewmoneyman (button) (small blind) folded before Flop
Seat 5: CashMatteo (big blind) collected ($0.10)

Hand #2040: 

PokerStars Hand #246897110766:  Hold'em No Limit ($0.05/$0.10 CAD) - 2023/11/03 2:41:50 ET
Table 'Helewalda' 6-max Seat #5 is the button
Seat 4: andrewmoneyman ($31.30 in chips) 
Seat 5: CashMatteo ($2.51 in chips) 
CashMatteo: posts small blind $0.05
andrewmoneyman: posts big blind $0.10
*** HOLE CARDS ***
Dealt to CashMatteo [As 5d]
CashMatteo: raises $2.41 to $2.51 and is all-in
andrewmoneyman: folds 
Uncalled bet ($2.41) returned to CashMatteo
CashMatteo collected $0.20 from pot
CashMatteo: doesn't show hand 
*** SUMMARY ***
Total pot $0.20 | Rake $0 
Seat 4: andrewmoneyman (big blind) folded before Flop
Seat 5: CashMatteo (button) (small blind) collected ($0.20)

Hand #2041: 

PokerStars Hand #246897111587:  Hold'em No Limit ($0.05/$0.10 CAD) - 2023/11/03 2:41:59 ET
Table 'Helewalda' 6-max Seat #4 is the button
Seat 4: andrewmoneyman ($31.20 in chips) 
Seat 5: CashMatteo ($2.61 in chips) 
andrewmoneyman: posts small blind $0.05
CashMatteo: posts big blind $0.10
*** HOLE CARDS ***
Dealt to CashMatteo [Kd Kh]
andrewmoneyman: raises $0.15 to $0.25
CashMatteo: raises $2.36 to $2.61 and is all-in
andrewmoneyman: calls $2.36
*** FLOP *** [9s 3c Th]
*** TURN *** [9s 3c Th] [7d]
*** RIVER *** [9s 3c Th 7d] [Td]
*** SHOW DOWN ***
CashMatteo: shows [Kd Kh] (two pair, Kings and Tens)
andrewmoneyman: shows [2c Ac] (a pair of Tens)
CashMatteo collected $4.99 from pot
*** SUMMARY ***
Total pot $5.22 | Rake $0.23 
Board [9s 3c Th 7d Td]
Seat 4: andrewmoneyman (button) (small blind) showed [2c Ac] and lost with a pair of Tens
Seat 5: CashMatteo (big blind) showed [Kd Kh] and won ($4.99) with two pair, Kings and Tens

Hand #2042: 

PokerStars Hand #246897113097:  Hold'em No Limit ($0.05/$0.10 CAD) - 2023/11/03 2:42:16 ET
Table 'Helewalda' 6-max Seat #5 is the button
Seat 4: andrewmoneyman ($28.59 in chips) 
Seat 5: CashMatteo ($4.99 in chips) 
CashMatteo: posts small blind $0.05
andrewmoneyman: posts big blind $0.10
*** HOLE CARDS ***
Dealt to CashMatteo [2c 5d]
CashMatteo: folds 
Uncalled bet ($0.05) returned to andrewmoneyman
andrewmoneyman collected $0.10 from pot
andrewmoneyman: doesn't show hand 
*** SUMMARY ***
Total pot $0.10 | Rake $0 
Seat 4: andrewmoneyman (big blind) collected ($0.10)
Seat 5: CashMatteo (button) (small blind) folded before Flop

Hand #2043: 

PokerStars Hand #246897113676:  Hold'em No Limit ($0.05/$0.10 CAD) - 2023/11/03 2:42:23 ET
Table 'Helewalda' 6-max Seat #4 is the button
Seat 4: andrewmoneyman ($28.64 in chips) 
Seat 5: CashMatteo ($4.94 in chips) 
andrewmoneyman: posts small blind $0.05
CashMatteo: posts big blind $0.10
*** HOLE CARDS ***
Dealt to CashMatteo [3s 6c]
andrewmoneyman: raises $0.15 to $0.25
CashMatteo: folds 
Uncalled bet ($0.15) returned to andrewmoneyman
andrewmoneyman collected $0.20 from pot
andrewmoneyman: doesn't show hand 
*** SUMMARY ***
Total pot $0.20 | Rake $0 
Seat 4: andrewmoneyman (button) (small blind) collected ($0.20)
Seat 5: CashMatteo (big blind) folded before Flop

Hand #2044: 

PokerStars Hand #246897114339:  Hold'em No Limit ($0.05/$0.10 CAD) - 2023/11/03 2:42:30 ET
Table 'Helewalda' 6-max Seat #5 is the button
Seat 4: andrewmoneyman ($28.74 in chips) 
Seat 5: CashMatteo ($4.84 in chips) 
CashMatteo: posts small blind $0.05
andrewmoneyman: posts big blind $0.10
*** HOLE CARDS ***
Dealt to CashMatteo [7s Td]
CashMatteo: folds 
Uncalled bet ($0.05) returned to andrewmoneyman
andrewmoneyman collected $0.10 from pot
andrewmoneyman: doesn't show hand 
*** SUMMARY ***
Total pot $0.10 | Rake $0 
Seat 4: andrewmoneyman (big blind) collected ($0.10)
Seat 5: CashMatteo (button) (small blind) folded before Flop

Hand #2045: 

PokerStars Hand #246897114902:  Hold'em No Limit ($0.05/$0.10 CAD) - 2023/11/03 2:42:36 ET
Table 'Helewalda' 6-max Seat #4 is the button
Seat 4: andrewmoneyman ($28.79 in chips) 
Seat 5: CashMatteo ($4.79 in chips) 
andrewmoneyman: posts small blind $0.05
CashMatteo: posts big blind $0.10
*** HOLE CARDS ***
Dealt to CashMatteo [2c 9h]
andrewmoneyman: folds 
Uncalled bet ($0.05) returned to CashMatteo
CashMatteo collected $0.10 from pot
CashMatteo: doesn't show hand 
*** SUMMARY ***
Total pot $0.10 | Rake $0 
Seat 4: andrewmoneyman (button) (small blind) folded before Flop
Seat 5: CashMatteo (big blind) collected ($0.10)

Hand #2046: 

PokerStars Hand #246897115452:  Hold'em No Limit ($0.05/$0.10 CAD) - 2023/11/03 2:42:43 ET
Table 'Helewalda' 6-max Seat #5 is the button
Seat 4: andrewmoneyman ($28.74 in chips) 
Seat 5: CashMatteo ($4.84 in chips) 
CashMatteo: posts small blind $0.05
andrewmoneyman: posts big blind $0.10
*** HOLE CARDS ***
Dealt to CashMatteo [8c 7s]
CashMatteo: raises $0.15 to $0.25
andrewmoneyman: raises $0.60 to $0.85
CashMatteo: folds 
Uncalled bet ($0.60) returned to andrewmoneyman
andrewmoneyman collected $0.50 from pot
andrewmoneyman: doesn't show hand 
*** SUMMARY ***
Total pot $0.50 | Rake $0 
Seat 4: andrewmoneyman (big blind) collected ($0.50)
Seat 5: CashMatteo (button) (small blind) folded before Flop

Hand #2047: 

PokerStars Hand #246897116596:  Hold'em No Limit ($0.05/$0.10 CAD) - 2023/11/03 2:42:56 ET
Table 'Helewalda' 6-max Seat #4 is the button
Seat 4: andrewmoneyman ($28.99 in chips) 
Seat 5: CashMatteo ($4.59 in chips) 
andrewmoneyman: posts small blind $0.05
CashMatteo: posts big blind $0.10
*** HOLE CARDS ***
Dealt to CashMatteo [Qs 5c]
andrewmoneyman: folds 
Uncalled bet ($0.05) returned to CashMatteo
CashMatteo collected $0.10 from pot
CashMatteo: doesn't show hand 
*** SUMMARY ***
Total pot $0.10 | Rake $0 
Seat 4: andrewmoneyman (button) (small blind) folded before Flop
Seat 5: CashMatteo (big blind) collected ($0.10)

Hand #2048: 

PokerStars Hand #246897117161:  Hold'em No Limit ($0.05/$0.10 CAD) - 2023/11/03 2:43:02 ET
Table 'Helewalda' 6-max Seat #5 is the button
Seat 4: andrewmoneyman ($28.94 in chips) 
Seat 5: CashMatteo ($4.64 in chips) 
CashMatteo: posts small blind $0.05
andrewmoneyman: posts big blind $0.10
*** HOLE CARDS ***
Dealt to CashMatteo [Qd 9s]
CashMatteo: calls $0.05
andrewmoneyman: checks 
*** FLOP *** [6s 4s 2s]
andrewmoneyman: bets $0.20
CashMatteo: calls $0.20
*** TURN *** [6s 4s 2s] [5d]
andrewmoneyman: bets $0.20
CashMatteo: calls $0.20
*** RIVER *** [6s 4s 2s 5d] [6c]
andrewmoneyman: bets $0.80
CashMatteo: folds 
Uncalled bet ($0.80) returned to andrewmoneyman
andrewmoneyman collected $0.96 from pot
andrewmoneyman: doesn't show hand 
*** SUMMARY ***
Total pot $1 | Rake $0.04 
Board [6s 4s 2s 5d 6c]
Seat 4: andrewmoneyman (big blind) collected ($0.96)
Seat 5: CashMatteo (button) (small blind) folded on the River

Hand #2049: 

PokerStars Hand #246897119838:  Hold'em No Limit ($0.05/$0.10 CAD) - 2023/11/03 2:43:33 ET
Table 'Helewalda' 6-max Seat #4 is the button
Seat 4: andrewmoneyman ($29.40 in chips) 
Seat 5: CashMatteo ($4.14 in chips) 
andrewmoneyman: posts small blind $0.05
CashMatteo: posts big blind $0.10
*** HOLE CARDS ***
Dealt to CashMatteo [2c 7d]
andrewmoneyman: raises $0.20 to $0.30
CashMatteo: folds 
Uncalled bet ($0.20) returned to andrewmoneyman
andrewmoneyman collected $0.20 from pot
andrewmoneyman: doesn't show hand 
*** SUMMARY ***
Total pot $0.20 | Rake $0 
Seat 4: andrewmoneyman (button) (small blind) collected ($0.20)
Seat 5: CashMatteo (big blind) folded before Flop

Hand #2050: 

PokerStars Hand #246897120584:  Hold'em No Limit ($0.05/$0.10 CAD) - 2023/11/03 2:43:42 ET
Table 'Helewalda' 6-max Seat #5 is the button
Seat 4: andrewmoneyman ($29.50 in chips) 
Seat 5: CashMatteo ($4.04 in chips) 
CashMatteo: posts small blind $0.05
andrewmoneyman: posts big blind $0.10
*** HOLE CARDS ***
Dealt to CashMatteo [4c 9s]
CashMatteo: folds 
Uncalled bet ($0.05) returned to andrewmoneyman
andrewmoneyman collected $0.10 from pot
andrewmoneyman: doesn't show hand 
*** SUMMARY ***
Total pot $0.10 | Rake $0 
Seat 4: andrewmoneyman (big blind) collected ($0.10)
Seat 5: CashMatteo (button) (small blind) folded before Flop

Hand #2051: 

PokerStars Hand #246897121119:  Hold'em No Limit ($0.05/$0.10 CAD) - 2023/11/03 2:43:48 ET
Table 'Helewalda' 6-max Seat #4 is the button
Seat 4: andrewmoneyman ($29.55 in chips) 
Seat 5: CashMatteo ($3.99 in chips) 
andrewmoneyman: posts small blind $0.05
CashMatteo: posts big blind $0.10
*** HOLE CARDS ***
Dealt to CashMatteo [2h 6s]
andrewmoneyman: raises $0.15 to $0.25
CashMatteo: calls $0.15
*** FLOP *** [7c 6h Ks]
CashMatteo: checks 
andrewmoneyman: bets $0.24
CashMatteo: calls $0.24
*** TURN *** [7c 6h Ks] [Qs]
CashMatteo: checks 
andrewmoneyman: bets $0.47
CashMatteo: folds 
Uncalled bet ($0.47) returned to andrewmoneyman
andrewmoneyman collected $0.94 from pot
andrewmoneyman: doesn't show hand 
*** SUMMARY ***
Total pot $0.98 | Rake $0.04 
Board [7c 6h Ks Qs]
Seat 4: andrewmoneyman (button) (small blind) collected ($0.94)
Seat 5: CashMatteo (big blind) folded on the Turn

Hand #2052: 

PokerStars Hand #246897124116:  Hold'em No Limit ($0.05/$0.10 CAD) - 2023/11/03 2:44:22 ET
Table 'Helewalda' 6-max Seat #5 is the button
Seat 4: andrewmoneyman ($30 in chips) 
Seat 5: CashMatteo ($3.50 in chips) 
CashMatteo: posts small blind $0.05
andrewmoneyman: posts big blind $0.10
*** HOLE CARDS ***
Dealt to CashMatteo [2s 8s]
CashMatteo: folds 
Uncalled bet ($0.05) returned to andrewmoneyman
andrewmoneyman collected $0.10 from pot
andrewmoneyman: doesn't show hand 
*** SUMMARY ***
Total pot $0.10 | Rake $0 
Seat 4: andrewmoneyman (big blind) collected ($0.10)
Seat 5: CashMatteo (button) (small blind) folded before Flop

Hand #2053: 

PokerStars Hand #246897124814:  Hold'em No Limit ($0.05/$0.10 CAD) - 2023/11/03 2:44:29 ET
Table 'Helewalda' 6-max Seat #4 is the button
Seat 4: andrewmoneyman ($30.05 in chips) 
Seat 5: CashMatteo ($3.45 in chips) 
andrewmoneyman: posts small blind $0.05
CashMatteo: posts big blind $0.10
*** HOLE CARDS ***
Dealt to CashMatteo [6h 8c]
andrewmoneyman: raises $0.15 to $0.25
CashMatteo: folds 
Uncalled bet ($0.15) returned to andrewmoneyman
andrewmoneyman collected $0.20 from pot
andrewmoneyman: doesn't show hand 
*** SUMMARY ***
Total pot $0.20 | Rake $0 
Seat 4: andrewmoneyman (button) (small blind) collected ($0.20)
Seat 5: CashMatteo (big blind) folded before Flop

Hand #2054: 

PokerStars Hand #246897125604:  Hold'em No Limit ($0.05/$0.10 CAD) - 2023/11/03 2:44:38 ET
Table 'Helewalda' 6-max Seat #5 is the button
Seat 4: andrewmoneyman ($30.15 in chips) 
Seat 5: CashMatteo ($3.35 in chips) 
CashMatteo: posts small blind $0.05
andrewmoneyman: posts big blind $0.10
*** HOLE CARDS ***
Dealt to CashMatteo [3c 2d]
CashMatteo: folds 
Uncalled bet ($0.05) returned to andrewmoneyman
andrewmoneyman collected $0.10 from pot
andrewmoneyman: doesn't show hand 
*** SUMMARY ***
Total pot $0.10 | Rake $0 
Seat 4: andrewmoneyman (big blind) collected ($0.10)
Seat 5: CashMatteo (button) (small blind) folded before Flop

Hand #2055: 

PokerStars Hand #246897126182:  Hold'em No Limit ($0.05/$0.10 CAD) - 2023/11/03 2:44:45 ET
Table 'Helewalda' 6-max Seat #4 is the button
Seat 4: andrewmoneyman ($30.20 in chips) 
Seat 5: CashMatteo ($3.30 in chips) 
andrewmoneyman: posts small blind $0.05
CashMatteo: posts big blind $0.10
*** HOLE CARDS ***
Dealt to CashMatteo [4d Ad]
andrewmoneyman: raises $0.15 to $0.25
CashMatteo: raises $0.50 to $0.75
andrewmoneyman: calls $0.50
*** FLOP *** [Jd 5h 4c]
CashMatteo: bets $0.72
andrewmoneyman: folds 
Uncalled bet ($0.72) returned to CashMatteo
CashMatteo collected $1.43 from pot
CashMatteo: doesn't show hand 
*** SUMMARY ***
Total pot $1.50 | Rake $0.07 
Board [Jd 5h 4c]
Seat 4: andrewmoneyman (button) (small blind) folded on the Flop
Seat 5: CashMatteo (big blind) collected ($1.43)

Hand #2056: 

PokerStars Hand #246897127609:  Hold'em No Limit ($0.05/$0.10 CAD) - 2023/11/03 2:45:01 ET
Table 'Helewalda' 6-max Seat #5 is the button
Seat 4: andrewmoneyman ($29.45 in chips) 
Seat 5: CashMatteo ($3.98 in chips) 
CashMatteo: posts small blind $0.05
andrewmoneyman: posts big blind $0.10
*** HOLE CARDS ***
Dealt to CashMatteo [6h 9h]
CashMatteo: raises $3.88 to $3.98 and is all-in
andrewmoneyman: folds 
Uncalled bet ($3.88) returned to CashMatteo
CashMatteo collected $0.20 from pot
CashMatteo: doesn't show hand 
*** SUMMARY ***
Total pot $0.20 | Rake $0 
Seat 4: andrewmoneyman (big blind) folded before Flop
Seat 5: CashMatteo (button) (small blind) collected ($0.20)

Hand #2057: 

PokerStars Hand #246897128353:  Hold'em No Limit ($0.05/$0.10 CAD) - 2023/11/03 2:45:09 ET
Table 'Helewalda' 6-max Seat #4 is the button
Seat 4: andrewmoneyman ($29.35 in chips) 
Seat 5: CashMatteo ($4.08 in chips) 
andrewmoneyman: posts small blind $0.05
CashMatteo: posts big blind $0.10
*** HOLE CARDS ***
Dealt to CashMatteo [8s Th]
andrewmoneyman: calls $0.05
CashMatteo: checks 
*** FLOP *** [8d Ah Tc]
CashMatteo: checks 
andrewmoneyman: bets $0.10
CashMatteo: calls $0.10
*** TURN *** [8d Ah Tc] [Kh]
CashMatteo: checks 
andrewmoneyman: bets $0.15
CashMatteo: calls $0.15
*** RIVER *** [8d Ah Tc Kh] [3s]
CashMatteo: checks 
andrewmoneyman: checks 
*** SHOW DOWN ***
CashMatteo: shows [8s Th] (two pair, Tens and Eights)
andrewmoneyman: mucks hand 
CashMatteo collected $0.67 from pot
*** SUMMARY ***
Total pot $0.70 | Rake $0.03 
Board [8d Ah Tc Kh 3s]
Seat 4: andrewmoneyman (button) (small blind) mucked [5h 8h]
Seat 5: CashMatteo (big blind) showed [8s Th] and won ($0.67) with two pair, Tens and Eights

Hand #2058: 

PokerStars Hand #246897130173:  Hold'em No Limit ($0.05/$0.10 CAD) - 2023/11/03 2:45:29 ET
Table 'Helewalda' 6-max Seat #5 is the button
Seat 4: andrewmoneyman ($29 in chips) 
Seat 5: CashMatteo ($4.40 in chips) 
CashMatteo: posts small blind $0.05
andrewmoneyman: posts big blind $0.10
*** HOLE CARDS ***
Dealt to CashMatteo [Th 4d]
CashMatteo: folds 
Uncalled bet ($0.05) returned to andrewmoneyman
andrewmoneyman collected $0.10 from pot
andrewmoneyman: doesn't show hand 
*** SUMMARY ***
Total pot $0.10 | Rake $0 
Seat 4: andrewmoneyman (big blind) collected ($0.10)
Seat 5: CashMatteo (button) (small blind) folded before Flop

Hand #2059: 

PokerStars Hand #246897130791:  Hold'em No Limit ($0.05/$0.10 CAD) - 2023/11/03 2:45:36 ET
Table 'Helewalda' 6-max Seat #4 is the button
Seat 4: andrewmoneyman ($29.05 in chips) 
Seat 5: CashMatteo ($4.35 in chips) 
andrewmoneyman: posts small blind $0.05
CashMatteo: posts big blind $0.10
*** HOLE CARDS ***
Dealt to CashMatteo [4c 9c]
andrewmoneyman: folds 
Uncalled bet ($0.05) returned to CashMatteo
CashMatteo collected $0.10 from pot
CashMatteo: doesn't show hand 
*** SUMMARY ***
Total pot $0.10 | Rake $0 
Seat 4: andrewmoneyman (button) (small blind) folded before Flop
Seat 5: CashMatteo (big blind) collected ($0.10)

Hand #2060: 

PokerStars Hand #246897131396:  Hold'em No Limit ($0.05/$0.10 CAD) - 2023/11/03 2:45:43 ET
Table 'Helewalda' 6-max Seat #5 is the button
Seat 4: andrewmoneyman ($29 in chips) 
Seat 5: CashMatteo ($4.40 in chips) 
CashMatteo: posts small blind $0.05
andrewmoneyman: posts big blind $0.10
*** HOLE CARDS ***
Dealt to CashMatteo [2d 9d]
CashMatteo: calls $0.05
andrewmoneyman: raises $0.30 to $0.40
CashMatteo: calls $0.30
*** FLOP *** [4h As 6d]
andrewmoneyman: bets $0.25
CashMatteo: calls $0.25
*** TURN *** [4h As 6d] [7d]
andrewmoneyman: bets $0.93
CashMatteo: calls $0.93
*** RIVER *** [4h As 6d 7d] [Td]
andrewmoneyman: bets $3.02
CashMatteo: calls $2.82 and is all-in
Uncalled bet ($0.20) returned to andrewmoneyman
*** SHOW DOWN ***
andrewmoneyman: shows [Ah Ts] (two pair, Aces and Tens)
CashMatteo: shows [2d 9d] (a flush, Ten high)
CashMatteo collected $8.40 from pot
*** SUMMARY ***
Total pot $8.80 | Rake $0.40 
Board [4h As 6d 7d Td]
Seat 4: andrewmoneyman (big blind) showed [Ah Ts] and lost with two pair, Aces and Tens
Seat 5: CashMatteo (button) (small blind) showed [2d 9d] and won ($8.40) with a flush, Ten high

Hand #2061: 

PokerStars Hand #246897133609:  Hold'em No Limit ($0.05/$0.10 CAD) - 2023/11/03 2:46:07 ET
Table 'Helewalda' 6-max Seat #4 is the button
Seat 4: andrewmoneyman ($24.60 in chips) 
Seat 5: CashMatteo ($8.40 in chips) 
andrewmoneyman: posts small blind $0.05
CashMatteo: posts big blind $0.10
*** HOLE CARDS ***
Dealt to CashMatteo [3h 4d]
andrewmoneyman: folds 
Uncalled bet ($0.05) returned to CashMatteo
CashMatteo collected $0.10 from pot
CashMatteo: doesn't show hand 
*** SUMMARY ***
Total pot $0.10 | Rake $0 
Seat 4: andrewmoneyman (button) (small blind) folded before Flop
Seat 5: CashMatteo (big blind) collected ($0.10)

Hand #2062: 

PokerStars Hand #246897134210:  Hold'em No Limit ($0.05/$0.10 CAD) - 2023/11/03 2:46:13 ET
Table 'Helewalda' 6-max Seat #5 is the button
Seat 4: andrewmoneyman ($24.55 in chips) 
Seat 5: CashMatteo ($8.45 in chips) 
CashMatteo: posts small blind $0.05
andrewmoneyman: posts big blind $0.10
*** HOLE CARDS ***
Dealt to CashMatteo [Ah Qc]
CashMatteo: calls $0.05
andrewmoneyman: checks 
*** FLOP *** [6h 9h 5h]
andrewmoneyman: checks 
CashMatteo: checks 
*** TURN *** [6h 9h 5h] [3h]
andrewmoneyman: checks 
CashMatteo: checks 
*** RIVER *** [6h 9h 5h 3h] [3s]
andrewmoneyman: bets $0.20
CashMatteo: raises $0.59 to $0.79
andrewmoneyman: folds 
Uncalled bet ($0.59) returned to CashMatteo
CashMatteo collected $0.57 from pot
CashMatteo: doesn't show hand 
*** SUMMARY ***
Total pot $0.60 | Rake $0.03 
Board [6h 9h 5h 3h 3s]
Seat 4: andrewmoneyman (big blind) folded on the River
Seat 5: CashMatteo (button) (small blind) collected ($0.57)

Hand #2063: 

PokerStars Hand #246897136244:  Hold'em No Limit ($0.05/$0.10 CAD) - 2023/11/03 2:46:36 ET
Table 'Helewalda' 6-max Seat #4 is the button
Seat 4: andrewmoneyman ($24.25 in chips) 
Seat 5: CashMatteo ($8.72 in chips) 
andrewmoneyman: posts small blind $0.05
CashMatteo: posts big blind $0.10
*** HOLE CARDS ***
Dealt to CashMatteo [Jd 3c]
andrewmoneyman: folds 
Uncalled bet ($0.05) returned to CashMatteo
CashMatteo collected $0.10 from pot
CashMatteo: doesn't show hand 
*** SUMMARY ***
Total pot $0.10 | Rake $0 
Seat 4: andrewmoneyman (button) (small blind) folded before Flop
Seat 5: CashMatteo (big blind) collected ($0.10)

Hand #2064: 

PokerStars Hand #246897136818:  Hold'em No Limit ($0.05/$0.10 CAD) - 2023/11/03 2:46:42 ET
Table 'Helewalda' 6-max Seat #5 is the button
Seat 4: andrewmoneyman ($24.20 in chips) 
Seat 5: CashMatteo ($8.77 in chips) 
CashMatteo: posts small blind $0.05
andrewmoneyman: posts big blind $0.10
*** HOLE CARDS ***
Dealt to CashMatteo [Kd 6h]
CashMatteo: raises $0.20 to $0.30
andrewmoneyman: folds 
Uncalled bet ($0.20) returned to CashMatteo
CashMatteo collected $0.20 from pot
CashMatteo: doesn't show hand 
*** SUMMARY ***
Total pot $0.20 | Rake $0 
Seat 4: andrewmoneyman (big blind) folded before Flop
Seat 5: CashMatteo (button) (small blind) collected ($0.20)

Hand #2065: 

PokerStars Hand #246897137692:  Hold'em No Limit ($0.05/$0.10 CAD) - 2023/11/03 2:46:52 ET
Table 'Helewalda' 6-max Seat #4 is the button
Seat 4: andrewmoneyman ($24.10 in chips) 
Seat 5: CashMatteo ($8.87 in chips) 
andrewmoneyman: posts small blind $0.05
CashMatteo: posts big blind $0.10
*** HOLE CARDS ***
Dealt to CashMatteo [7h 5c]
andrewmoneyman: raises $0.20 to $0.30
CashMatteo: folds 
Uncalled bet ($0.20) returned to andrewmoneyman
andrewmoneyman collected $0.20 from pot
andrewmoneyman: doesn't show hand 
*** SUMMARY ***
Total pot $0.20 | Rake $0 
Seat 4: andrewmoneyman (button) (small blind) collected ($0.20)
Seat 5: CashMatteo (big blind) folded before Flop

Hand #2066: 

PokerStars Hand #246897138594:  Hold'em No Limit ($0.05/$0.10 CAD) - 2023/11/03 2:47:01 ET
Table 'Helewalda' 6-max Seat #5 is the button
Seat 4: andrewmoneyman ($24.20 in chips) 
Seat 5: CashMatteo ($8.77 in chips) 
CashMatteo: posts small blind $0.05
andrewmoneyman: posts big blind $0.10
*** HOLE CARDS ***
Dealt to CashMatteo [7h 8d]
CashMatteo: folds 
Uncalled bet ($0.05) returned to andrewmoneyman
andrewmoneyman collected $0.10 from pot
andrewmoneyman: doesn't show hand 
*** SUMMARY ***
Total pot $0.10 | Rake $0 
Seat 4: andrewmoneyman (big blind) collected ($0.10)
Seat 5: CashMatteo (button) (small blind) folded before Flop

Hand #2067: 

PokerStars Hand #246897139399:  Hold'em No Limit ($0.05/$0.10 CAD) - 2023/11/03 2:47:10 ET
Table 'Helewalda' 6-max Seat #4 is the button
Seat 4: andrewmoneyman ($24.25 in chips) 
Seat 5: CashMatteo ($8.72 in chips) 
andrewmoneyman: posts small blind $0.05
CashMatteo: posts big blind $0.10
*** HOLE CARDS ***
Dealt to CashMatteo [4h 8d]
andrewmoneyman: calls $0.05
CashMatteo: checks 
*** FLOP *** [Tc Td Kc]
CashMatteo: checks 
andrewmoneyman: bets $0.20
CashMatteo: raises $0.30 to $0.50
andrewmoneyman: calls $0.30
*** TURN *** [Tc Td Kc] [8h]
CashMatteo: bets $0.58
andrewmoneyman: calls $0.58
*** RIVER *** [Tc Td Kc 8h] [7s]
CashMatteo: checks 
andrewmoneyman: checks 
*** SHOW DOWN ***
CashMatteo: shows [4h 8d] (two pair, Tens and Eights)
andrewmoneyman: shows [Kh 7h] (two pair, Kings and Tens)
andrewmoneyman collected $2.25 from pot
*** SUMMARY ***
Total pot $2.36 | Rake $0.11 
Board [Tc Td Kc 8h 7s]
Seat 4: andrewmoneyman (button) (small blind) showed [Kh 7h] and won ($2.25) with two pair, Kings and Tens
Seat 5: CashMatteo (big blind) showed [4h 8d] and lost with two pair, Tens and Eights

Hand #2068: 

PokerStars Hand #246897142730:  Hold'em No Limit ($0.05/$0.10 CAD) - 2023/11/03 2:47:48 ET
Table 'Helewalda' 6-max Seat #5 is the button
Seat 4: andrewmoneyman ($25.32 in chips) 
Seat 5: CashMatteo ($7.54 in chips) 
CashMatteo: posts small blind $0.05
andrewmoneyman: posts big blind $0.10
*** HOLE CARDS ***
Dealt to CashMatteo [Ad 4h]
CashMatteo: calls $0.05
andrewmoneyman: checks 
*** FLOP *** [Qd 3h 2d]
andrewmoneyman: checks 
CashMatteo: bets $0.10
andrewmoneyman: raises $0.20 to $0.30
CashMatteo: raises $0.40 to $0.70
andrewmoneyman: calls $0.40
*** TURN *** [Qd 3h 2d] [Js]
andrewmoneyman: checks 
CashMatteo: checks 
*** RIVER *** [Qd 3h 2d Js] [6s]
andrewmoneyman: checks 
CashMatteo: checks 
*** SHOW DOWN ***
andrewmoneyman: shows [3s 5d] (a pair of Threes)
CashMatteo: mucks hand 
andrewmoneyman collected $1.53 from pot
*** SUMMARY ***
Total pot $1.60 | Rake $0.07 
Board [Qd 3h 2d Js 6s]
Seat 4: andrewmoneyman (big blind) showed [3s 5d] and won ($1.53) with a pair of Threes
Seat 5: CashMatteo (button) (small blind) mucked [Ad 4h]

Hand #2069: 

PokerStars Hand #246897145679:  Hold'em No Limit ($0.05/$0.10 CAD) - 2023/11/03 2:48:20 ET
Table 'Helewalda' 6-max Seat #4 is the button
Seat 4: andrewmoneyman ($26.05 in chips) 
Seat 5: CashMatteo ($6.74 in chips) 
andrewmoneyman: posts small blind $0.05
CashMatteo: posts big blind $0.10
*** HOLE CARDS ***
Dealt to CashMatteo [4c Ac]
andrewmoneyman: calls $0.05
CashMatteo: raises $0.15 to $0.25
andrewmoneyman: calls $0.15
*** FLOP *** [2c 4s Qs]
CashMatteo: checks 
andrewmoneyman: bets $0.30
CashMatteo: calls $0.30
*** TURN *** [2c 4s Qs] [6s]
CashMatteo: checks 
andrewmoneyman: checks 
*** RIVER *** [2c 4s Qs 6s] [Ks]
CashMatteo: checks 
andrewmoneyman: checks 
*** SHOW DOWN ***
CashMatteo: shows [4c Ac] (a pair of Fours)
andrewmoneyman: shows [Qh 9c] (a pair of Queens)
andrewmoneyman collected $1.05 from pot
*** SUMMARY ***
Total pot $1.10 | Rake $0.05 
Board [2c 4s Qs 6s Ks]
Seat 4: andrewmoneyman (button) (small blind) showed [Qh 9c] and won ($1.05) with a pair of Queens
Seat 5: CashMatteo (big blind) showed [4c Ac] and lost with a pair of Fours

Hand #2070: 

PokerStars Hand #246897148119:  Hold'em No Limit ($0.05/$0.10 CAD) - 2023/11/03 2:48:47 ET
Table 'Helewalda' 6-max Seat #5 is the button
Seat 4: andrewmoneyman ($26.55 in chips) 
Seat 5: CashMatteo ($6.19 in chips) 
CashMatteo: posts small blind $0.05
andrewmoneyman: posts big blind $0.10
*** HOLE CARDS ***
Dealt to CashMatteo [4c 6c]
CashMatteo: folds 
Uncalled bet ($0.05) returned to andrewmoneyman
andrewmoneyman collected $0.10 from pot
andrewmoneyman: doesn't show hand 
*** SUMMARY ***
Total pot $0.10 | Rake $0 
Seat 4: andrewmoneyman (big blind) collected ($0.10)
Seat 5: CashMatteo (button) (small blind) folded before Flop

Hand #2071: 

PokerStars Hand #246897148662:  Hold'em No Limit ($0.05/$0.10 CAD) - 2023/11/03 2:48:53 ET
Table 'Helewalda' 6-max Seat #4 is the button
Seat 4: andrewmoneyman ($26.60 in chips) 
Seat 5: CashMatteo ($6.14 in chips) 
andrewmoneyman: posts small blind $0.05
CashMatteo: posts big blind $0.10
*** HOLE CARDS ***
Dealt to CashMatteo [Ad Kh]
andrewmoneyman: raises $0.15 to $0.25
CashMatteo: raises $0.50 to $0.75
andrewmoneyman: folds 
Uncalled bet ($0.50) returned to CashMatteo
CashMatteo collected $0.50 from pot
CashMatteo: doesn't show hand 
*** SUMMARY ***
Total pot $0.50 | Rake $0 
Seat 4: andrewmoneyman (button) (small blind) folded before Flop
Seat 5: CashMatteo (big blind) collected ($0.50)

Hand #2072: 

PokerStars Hand #246897149616:  Hold'em No Limit ($0.05/$0.10 CAD) - 2023/11/03 2:49:04 ET
Table 'Helewalda' 6-max Seat #5 is the button
Seat 4: andrewmoneyman ($26.35 in chips) 
Seat 5: CashMatteo ($6.39 in chips) 
CashMatteo: posts small blind $0.05
andrewmoneyman: posts big blind $0.10
*** HOLE CARDS ***
Dealt to CashMatteo [6h 5h]
CashMatteo: calls $0.05
andrewmoneyman: raises $0.30 to $0.40
CashMatteo: calls $0.30
*** FLOP *** [4s 8d 9h]
andrewmoneyman: bets $0.38
CashMatteo: calls $0.38
*** TURN *** [4s 8d 9h] [7s]
andrewmoneyman: bets $1.49
CashMatteo: calls $1.49
*** RIVER *** [4s 8d 9h 7s] [2c]
andrewmoneyman: bets $4.34
CashMatteo: calls $4.12 and is all-in
Uncalled bet ($0.22) returned to andrewmoneyman
*** SHOW DOWN ***
andrewmoneyman: shows [Kd Td] (high card King)
CashMatteo: shows [6h 5h] (a straight, Five to Nine)
CashMatteo collected $12.20 from pot
*** SUMMARY ***
Total pot $12.78 | Rake $0.58 
Board [4s 8d 9h 7s 2c]
Seat 4: andrewmoneyman (big blind) showed [Kd Td] and lost with high card King
Seat 5: CashMatteo (button) (small blind) showed [6h 5h] and won ($12.20) with a straight, Five to Nine

Hand #2073: 

PokerStars Hand #246897153104:  Hold'em No Limit ($0.05/$0.10 CAD) - 2023/11/03 2:49:43 ET
Table 'Helewalda' 6-max Seat #4 is the button
Seat 4: andrewmoneyman ($19.96 in chips) 
Seat 5: CashMatteo ($12.20 in chips) 
andrewmoneyman: posts small blind $0.05
CashMatteo: posts big blind $0.10
*** HOLE CARDS ***
Dealt to CashMatteo [Qh 6c]
andrewmoneyman: folds 
Uncalled bet ($0.05) returned to CashMatteo
CashMatteo collected $0.10 from pot
CashMatteo: doesn't show hand 
*** SUMMARY ***
Total pot $0.10 | Rake $0 
Seat 4: andrewmoneyman (button) (small blind) folded before Flop
Seat 5: CashMatteo (big blind) collected ($0.10)

Hand #2074: 

PokerStars Hand #246897153666:  Hold'em No Limit ($0.05/$0.10 CAD) - 2023/11/03 2:49:50 ET
Table 'Helewalda' 6-max Seat #5 is the button
Seat 4: andrewmoneyman ($19.91 in chips) 
Seat 5: CashMatteo ($12.25 in chips) 
CashMatteo: posts small blind $0.05
andrewmoneyman: posts big blind $0.10
*** HOLE CARDS ***
Dealt to CashMatteo [7h 4h]
CashMatteo: calls $0.05
andrewmoneyman: raises $0.30 to $0.40
CashMatteo: folds 
Uncalled bet ($0.30) returned to andrewmoneyman
andrewmoneyman collected $0.20 from pot
andrewmoneyman: doesn't show hand 
*** SUMMARY ***
Total pot $0.20 | Rake $0 
Seat 4: andrewmoneyman (big blind) collected ($0.20)
Seat 5: CashMatteo (button) (small blind) folded before Flop

Hand #2075: 

PokerStars Hand #246897154865:  Hold'em No Limit ($0.05/$0.10 CAD) - 2023/11/03 2:50:03 ET
Table 'Helewalda' 6-max Seat #4 is the button
Seat 4: andrewmoneyman ($20.01 in chips) 
Seat 5: CashMatteo ($12.15 in chips) 
andrewmoneyman: posts small blind $0.05
CashMatteo: posts big blind $0.10
*** HOLE CARDS ***
Dealt to CashMatteo [3s 2s]
andrewmoneyman: raises $0.20 to $0.30
CashMatteo: calls $0.20
*** FLOP *** [Ah 7h 8d]
CashMatteo: checks 
andrewmoneyman: bets $0.43
CashMatteo: folds 
Uncalled bet ($0.43) returned to andrewmoneyman
andrewmoneyman collected $0.57 from pot
andrewmoneyman: doesn't show hand 
*** SUMMARY ***
Total pot $0.60 | Rake $0.03 
Board [Ah 7h 8d]
Seat 4: andrewmoneyman (button) (small blind) collected ($0.57)
Seat 5: CashMatteo (big blind) folded on the Flop

Hand #2076: 

PokerStars Hand #246897156262:  Hold'em No Limit ($0.05/$0.10 CAD) - 2023/11/03 2:50:19 ET
Table 'Helewalda' 6-max Seat #5 is the button
Seat 4: andrewmoneyman ($20.28 in chips) 
Seat 5: CashMatteo ($11.85 in chips) 
CashMatteo: posts small blind $0.05
andrewmoneyman: posts big blind $0.10
*** HOLE CARDS ***
Dealt to CashMatteo [5h 6h]
CashMatteo: calls $0.05
andrewmoneyman: raises $0.30 to $0.40
CashMatteo: calls $0.30
*** FLOP *** [5c 4d 5d]
andrewmoneyman: bets $0.57
CashMatteo: calls $0.57
*** TURN *** [5c 4d 5d] [Qd]
andrewmoneyman: bets $1.39
CashMatteo: calls $1.39
*** RIVER *** [5c 4d 5d Qd] [Qh]
andrewmoneyman: bets $17.92 and is all-in
CashMatteo: calls $9.49 and is all-in
Uncalled bet ($8.43) returned to andrewmoneyman
*** SHOW DOWN ***
andrewmoneyman: shows [9s 9d] (two pair, Queens and Nines)
CashMatteo: shows [5h 6h] (a full house, Fives full of Queens)
CashMatteo collected $23.10 from pot
*** SUMMARY ***
Total pot $23.70 | Rake $0.60 
Board [5c 4d 5d Qd Qh]
Seat 4: andrewmoneyman (big blind) showed [9s 9d] and lost with two pair, Queens and Nines
Seat 5: CashMatteo (button) (small blind) showed [5h 6h] and won ($23.10) with a full house, Fives full of Queens

Hand #2077: 

PokerStars Hand #246897159962:  Hold'em No Limit ($0.05/$0.10 CAD) - 2023/11/03 2:51:00 ET
Table 'Helewalda' 6-max Seat #4 is the button
Seat 4: andrewmoneyman ($8.43 in chips) 
Seat 5: CashMatteo ($23.10 in chips) 
andrewmoneyman: posts small blind $0.05
CashMatteo: posts big blind $0.10
*** HOLE CARDS ***
Dealt to CashMatteo [Qc Qd]
andrewmoneyman: raises $0.20 to $0.30
CashMatteo: raises $22.80 to $23.10 and is all-in
andrewmoneyman: calls $8.13 and is all-in
Uncalled bet ($14.67) returned to CashMatteo
CashMatteo said, "gay"
*** FLOP *** [Ah 4s 6c]
*** TURN *** [Ah 4s 6c] [Kh]
*** RIVER *** [Ah 4s 6c Kh] [5s]
*** SHOW DOWN ***
CashMatteo: shows [Qc Qd] (a pair of Queens)
andrewmoneyman: shows [8s As] (a pair of Aces)
andrewmoneyman collected $16.26 from pot
*** SUMMARY ***
Total pot $16.86 | Rake $0.60 
Board [Ah 4s 6c Kh 5s]
Seat 4: andrewmoneyman (button) (small blind) showed [8s As] and won ($16.26) with a pair of Aces
Seat 5: CashMatteo (big blind) showed [Qc Qd] and lost with a pair of Queens

Hand #2078: 

PokerStars Hand #246897161692:  Hold'em No Limit ($0.05/$0.10 CAD) - 2023/11/03 2:51:20 ET
Table 'Helewalda' 6-max Seat #5 is the button
Seat 4: andrewmoneyman ($16.26 in chips) 
Seat 5: CashMatteo ($14.67 in chips) 
CashMatteo: posts small blind $0.05
andrewmoneyman: posts big blind $0.10
*** HOLE CARDS ***
Dealt to CashMatteo [Ts 8s]
CashMatteo said, "still gay"
CashMatteo: calls $0.05
andrewmoneyman: checks 
*** FLOP *** [2h Ks Tc]
andrewmoneyman: checks 
CashMatteo: checks 
*** TURN *** [2h Ks Tc] [4c]
andrewmoneyman: checks 
CashMatteo: bets $0.10
andrewmoneyman: calls $0.10
*** RIVER *** [2h Ks Tc 4c] [4h]
andrewmoneyman: checks 
CashMatteo: bets $0.19
andrewmoneyman: raises $0.56 to $0.75
CashMatteo: calls $0.56
*** SHOW DOWN ***
andrewmoneyman: shows [3c 4s] (three of a kind, Fours)
CashMatteo: mucks hand 
andrewmoneyman collected $1.81 from pot
*** SUMMARY ***
Total pot $1.90 | Rake $0.09 
Board [2h Ks Tc 4c 4h]
Seat 4: andrewmoneyman (big blind) showed [3c 4s] and won ($1.81) with three of a kind, Fours
Seat 5: CashMatteo (button) (small blind) mucked [Ts 8s]

Hand #2079: 

PokerStars Hand #246897164407:  Hold'em No Limit ($0.05/$0.10 CAD) - 2023/11/03 2:51:50 ET
Table 'Helewalda' 6-max Seat #4 is the button
Seat 4: andrewmoneyman ($17.12 in chips) 
Seat 5: CashMatteo ($13.72 in chips) 
andrewmoneyman: posts small blind $0.05
CashMatteo: posts big blind $0.10
*** HOLE CARDS ***
Dealt to CashMatteo [5c Js]
andrewmoneyman: folds 
Uncalled bet ($0.05) returned to CashMatteo
CashMatteo collected $0.10 from pot
CashMatteo: doesn't show hand 
*** SUMMARY ***
Total pot $0.10 | Rake $0 
Seat 4: andrewmoneyman (button) (small blind) folded before Flop
Seat 5: CashMatteo (big blind) collected ($0.10)

Hand #2080: 

PokerStars Hand #246897165068:  Hold'em No Limit ($0.05/$0.10 CAD) - 2023/11/03 2:51:57 ET
Table 'Helewalda' 6-max Seat #5 is the button
Seat 4: andrewmoneyman ($17.07 in chips) 
Seat 5: CashMatteo ($13.77 in chips) 
CashMatteo: posts small blind $0.05
andrewmoneyman: posts big blind $0.10
*** HOLE CARDS ***
Dealt to CashMatteo [2c Ts]
CashMatteo: folds 
Uncalled bet ($0.05) returned to andrewmoneyman
andrewmoneyman collected $0.10 from pot
andrewmoneyman: doesn't show hand 
*** SUMMARY ***
Total pot $0.10 | Rake $0 
Seat 4: andrewmoneyman (big blind) collected ($0.10)
Seat 5: CashMatteo (button) (small blind) folded before Flop

Hand #2081: 

PokerStars Hand #246897165582:  Hold'em No Limit ($0.05/$0.10 CAD) - 2023/11/03 2:52:03 ET
Table 'Helewalda' 6-max Seat #4 is the button
Seat 4: andrewmoneyman ($17.12 in chips) 
Seat 5: CashMatteo ($13.72 in chips) 
andrewmoneyman: posts small blind $0.05
CashMatteo: posts big blind $0.10
*** HOLE CARDS ***
Dealt to CashMatteo [Jh 4s]
andrewmoneyman: folds 
Uncalled bet ($0.05) returned to CashMatteo
CashMatteo collected $0.10 from pot
CashMatteo: doesn't show hand 
*** SUMMARY ***
Total pot $0.10 | Rake $0 
Seat 4: andrewmoneyman (button) (small blind) folded before Flop
Seat 5: CashMatteo (big blind) collected ($0.10)

Hand #2082: 

PokerStars Hand #246897166125:  Hold'em No Limit ($0.05/$0.10 CAD) - 2023/11/03 2:52:10 ET
Table 'Helewalda' 6-max Seat #5 is the button
Seat 4: andrewmoneyman ($17.07 in chips) 
Seat 5: CashMatteo ($13.77 in chips) 
CashMatteo: posts small blind $0.05
andrewmoneyman: posts big blind $0.10
*** HOLE CARDS ***
Dealt to CashMatteo [Qh 5c]
CashMatteo: calls $0.05
andrewmoneyman: raises $0.20 to $0.30
CashMatteo: calls $0.20
*** FLOP *** [7h 8d 6s]
andrewmoneyman: checks 
CashMatteo: bets $0.29
andrewmoneyman: calls $0.29
*** TURN *** [7h 8d 6s] [8s]
andrewmoneyman: checks 
CashMatteo: checks 
*** RIVER *** [7h 8d 6s 8s] [2c]
andrewmoneyman: checks 
CashMatteo: checks 
*** SHOW DOWN ***
andrewmoneyman: shows [5s 5h] (two pair, Eights and Fives)
CashMatteo: mucks hand 
andrewmoneyman collected $1.13 from pot
*** SUMMARY ***
Total pot $1.18 | Rake $0.05 
Board [7h 8d 6s 8s 2c]
Seat 4: andrewmoneyman (big blind) showed [5s 5h] and won ($1.13) with two pair, Eights and Fives
Seat 5: CashMatteo (button) (small blind) mucked [Qh 5c]

Hand #2083: 

PokerStars Hand #246897168344:  Hold'em No Limit ($0.05/$0.10 CAD) - 2023/11/03 2:52:35 ET
Table 'Helewalda' 6-max Seat #4 is the button
Seat 4: andrewmoneyman ($17.61 in chips) 
Seat 5: CashMatteo ($13.18 in chips) 
andrewmoneyman: posts small blind $0.05
CashMatteo: posts big blind $0.10
*** HOLE CARDS ***
Dealt to CashMatteo [9s 7h]
andrewmoneyman: folds 
Uncalled bet ($0.05) returned to CashMatteo
CashMatteo collected $0.10 from pot
CashMatteo: doesn't show hand 
*** SUMMARY ***
Total pot $0.10 | Rake $0 
Seat 4: andrewmoneyman (button) (small blind) folded before Flop
Seat 5: CashMatteo (big blind) collected ($0.10)

Hand #2084: 

PokerStars Hand #246897168908:  Hold'em No Limit ($0.05/$0.10 CAD) - 2023/11/03 2:52:41 ET
Table 'Helewalda' 6-max Seat #5 is the button
Seat 4: andrewmoneyman ($17.56 in chips) 
Seat 5: CashMatteo ($13.23 in chips) 
CashMatteo: posts small blind $0.05
andrewmoneyman: posts big blind $0.10
*** HOLE CARDS ***
Dealt to CashMatteo [5s Td]
CashMatteo: folds 
Uncalled bet ($0.05) returned to andrewmoneyman
andrewmoneyman collected $0.10 from pot
andrewmoneyman: doesn't show hand 
*** SUMMARY ***
Total pot $0.10 | Rake $0 
Seat 4: andrewmoneyman (big blind) collected ($0.10)
Seat 5: CashMatteo (button) (small blind) folded before Flop

Hand #2085: 

PokerStars Hand #246897169488:  Hold'em No Limit ($0.05/$0.10 CAD) - 2023/11/03 2:52:48 ET
Table 'Helewalda' 6-max Seat #4 is the button
Seat 4: andrewmoneyman ($17.61 in chips) 
Seat 5: CashMatteo ($13.18 in chips) 
andrewmoneyman: posts small blind $0.05
CashMatteo: posts big blind $0.10
*** HOLE CARDS ***
Dealt to CashMatteo [Qs 4d]
andrewmoneyman: raises $0.20 to $0.30
CashMatteo: calls $0.20
*** FLOP *** [Th As 2s]
CashMatteo: checks 
andrewmoneyman: bets $0.25
CashMatteo: folds 
Uncalled bet ($0.25) returned to andrewmoneyman
andrewmoneyman collected $0.57 from pot
andrewmoneyman: doesn't show hand 
*** SUMMARY ***
Total pot $0.60 | Rake $0.03 
Board [Th As 2s]
Seat 4: andrewmoneyman (button) (small blind) collected ($0.57)
Seat 5: CashMatteo (big blind) folded on the Flop

Hand #2086: 

PokerStars Hand #246897171450:  Hold'em No Limit ($0.05/$0.10 CAD) - 2023/11/03 2:53:10 ET
Table 'Helewalda' 6-max Seat #5 is the button
Seat 4: andrewmoneyman ($17.88 in chips) 
Seat 5: CashMatteo ($12.88 in chips) 
CashMatteo: posts small blind $0.05
andrewmoneyman: posts big blind $0.10
*** HOLE CARDS ***
Dealt to CashMatteo [4c 2h]
CashMatteo: folds 
Uncalled bet ($0.05) returned to andrewmoneyman
andrewmoneyman collected $0.10 from pot
andrewmoneyman: doesn't show hand 
*** SUMMARY ***
Total pot $0.10 | Rake $0 
Seat 4: andrewmoneyman (big blind) collected ($0.10)
Seat 5: CashMatteo (button) (small blind) folded before Flop

Hand #2087: 

PokerStars Hand #246897171944:  Hold'em No Limit ($0.05/$0.10 CAD) - 2023/11/03 2:53:16 ET
Table 'Helewalda' 6-max Seat #4 is the button
Seat 4: andrewmoneyman ($17.93 in chips) 
Seat 5: CashMatteo ($12.83 in chips) 
andrewmoneyman: posts small blind $0.05
CashMatteo: posts big blind $0.10
*** HOLE CARDS ***
Dealt to CashMatteo [Ks 9s]
andrewmoneyman: calls $0.05
CashMatteo: raises $0.15 to $0.25
andrewmoneyman: calls $0.15
*** FLOP *** [As 5c 7h]
CashMatteo: bets $0.24
andrewmoneyman: calls $0.24
*** TURN *** [As 5c 7h] [Ac]
CashMatteo: bets $0.47
andrewmoneyman: folds 
Uncalled bet ($0.47) returned to CashMatteo
CashMatteo collected $0.94 from pot
CashMatteo: doesn't show hand 
*** SUMMARY ***
Total pot $0.98 | Rake $0.04 
Board [As 5c 7h Ac]
Seat 4: andrewmoneyman (button) (small blind) folded on the Turn
Seat 5: CashMatteo (big blind) collected ($0.94)

Hand #2088: 

PokerStars Hand #246897173746:  Hold'em No Limit ($0.05/$0.10 CAD) - 2023/11/03 2:53:36 ET
Table 'Helewalda' 6-max Seat #5 is the button
Seat 4: andrewmoneyman ($17.44 in chips) 
Seat 5: CashMatteo ($13.28 in chips) 
CashMatteo: posts small blind $0.05
andrewmoneyman: posts big blind $0.10
*** HOLE CARDS ***
Dealt to CashMatteo [As 3d]
CashMatteo: calls $0.05
andrewmoneyman: checks 
*** FLOP *** [4c 3h 9s]
andrewmoneyman: checks 
CashMatteo: checks 
*** TURN *** [4c 3h 9s] [4h]
andrewmoneyman: checks 
CashMatteo: bets $0.10
andrewmoneyman: calls $0.10
*** RIVER *** [4c 3h 9s 4h] [7s]
andrewmoneyman: checks 
CashMatteo: checks 
*** SHOW DOWN ***
andrewmoneyman: shows [Qd 7c] (two pair, Sevens and Fours)
CashMatteo: mucks hand 
andrewmoneyman collected $0.38 from pot
*** SUMMARY ***
Total pot $0.40 | Rake $0.02 
Board [4c 3h 9s 4h 7s]
Seat 4: andrewmoneyman (big blind) showed [Qd 7c] and won ($0.38) with two pair, Sevens and Fours
Seat 5: CashMatteo (button) (small blind) mucked [As 3d]

Hand #2089: 

PokerStars Hand #246897175529:  Hold'em No Limit ($0.05/$0.10 CAD) - 2023/11/03 2:53:56 ET
Table 'Helewalda' 6-max Seat #4 is the button
Seat 4: andrewmoneyman ($17.62 in chips) 
Seat 5: CashMatteo ($13.08 in chips) 
andrewmoneyman: posts small blind $0.05
CashMatteo: posts big blind $0.10
*** HOLE CARDS ***
Dealt to CashMatteo [5s Qh]
andrewmoneyman: raises $0.15 to $0.25
CashMatteo: folds 
Uncalled bet ($0.15) returned to andrewmoneyman
andrewmoneyman collected $0.20 from pot
andrewmoneyman: doesn't show hand 
*** SUMMARY ***
Total pot $0.20 | Rake $0 
Seat 4: andrewmoneyman (button) (small blind) collected ($0.20)
Seat 5: CashMatteo (big blind) folded before Flop

Hand #2090: 

PokerStars Hand #246897176255:  Hold'em No Limit ($0.05/$0.10 CAD) - 2023/11/03 2:54:04 ET
Table 'Helewalda' 6-max Seat #5 is the button
Seat 4: andrewmoneyman ($17.72 in chips) 
Seat 5: CashMatteo ($12.98 in chips) 
CashMatteo: posts small blind $0.05
andrewmoneyman: posts big blind $0.10
*** HOLE CARDS ***
Dealt to CashMatteo [Tc Ts]
CashMatteo: raises $0.15 to $0.25
andrewmoneyman: folds 
Uncalled bet ($0.15) returned to CashMatteo
CashMatteo collected $0.20 from pot
CashMatteo: doesn't show hand 
*** SUMMARY ***
Total pot $0.20 | Rake $0 
Seat 4: andrewmoneyman (big blind) folded before Flop
Seat 5: CashMatteo (button) (small blind) collected ($0.20)

Hand #2091: 

PokerStars Hand #246897177071:  Hold'em No Limit ($0.05/$0.10 CAD) - 2023/11/03 2:54:13 ET
Table 'Helewalda' 6-max Seat #4 is the button
Seat 4: andrewmoneyman ($17.62 in chips) 
Seat 5: CashMatteo ($13.08 in chips) 
andrewmoneyman: posts small blind $0.05
CashMatteo: posts big blind $0.10
*** HOLE CARDS ***
Dealt to CashMatteo [3d 5c]
andrewmoneyman: raises $0.15 to $0.25
CashMatteo: folds 
Uncalled bet ($0.15) returned to andrewmoneyman
andrewmoneyman collected $0.20 from pot
andrewmoneyman: doesn't show hand 
*** SUMMARY ***
Total pot $0.20 | Rake $0 
Seat 4: andrewmoneyman (button) (small blind) collected ($0.20)
Seat 5: CashMatteo (big blind) folded before Flop

Hand #2092: 

PokerStars Hand #246897177690:  Hold'em No Limit ($0.05/$0.10 CAD) - 2023/11/03 2:54:20 ET
Table 'Helewalda' 6-max Seat #5 is the button
Seat 4: andrewmoneyman ($17.72 in chips) 
Seat 5: CashMatteo ($12.98 in chips) 
CashMatteo: posts small blind $0.05
andrewmoneyman: posts big blind $0.10
*** HOLE CARDS ***
Dealt to CashMatteo [6h 4c]
CashMatteo: folds 
Uncalled bet ($0.05) returned to andrewmoneyman
andrewmoneyman collected $0.10 from pot
andrewmoneyman: doesn't show hand 
*** SUMMARY ***
Total pot $0.10 | Rake $0 
Seat 4: andrewmoneyman (big blind) collected ($0.10)
Seat 5: CashMatteo (button) (small blind) folded before Flop

Hand #2093: 

PokerStars Hand #246897178212:  Hold'em No Limit ($0.05/$0.10 CAD) - 2023/11/03 2:54:26 ET
Table 'Helewalda' 6-max Seat #4 is the button
Seat 4: andrewmoneyman ($17.77 in chips) 
Seat 5: CashMatteo ($12.93 in chips) 
andrewmoneyman: posts small blind $0.05
CashMatteo: posts big blind $0.10
*** HOLE CARDS ***
Dealt to CashMatteo [Ac 2c]
andrewmoneyman: folds 
Uncalled bet ($0.05) returned to CashMatteo
CashMatteo collected $0.10 from pot
CashMatteo: doesn't show hand 
*** SUMMARY ***
Total pot $0.10 | Rake $0 
Seat 4: andrewmoneyman (button) (small blind) folded before Flop
Seat 5: CashMatteo (big blind) collected ($0.10)

Hand #2094: 

PokerStars Hand #246897178792:  Hold'em No Limit ($0.05/$0.10 CAD) - 2023/11/03 2:54:32 ET
Table 'Helewalda' 6-max Seat #5 is the button
Seat 4: andrewmoneyman ($17.72 in chips) 
Seat 5: CashMatteo ($12.98 in chips) 
CashMatteo: posts small blind $0.05
andrewmoneyman: posts big blind $0.10
*** HOLE CARDS ***
Dealt to CashMatteo [9d Th]
CashMatteo: raises $0.15 to $0.25
andrewmoneyman: calls $0.15
*** FLOP *** [Jc 7c 3s]
andrewmoneyman: checks 
CashMatteo: bets $0.24
andrewmoneyman: raises $0.48 to $0.72
CashMatteo: calls $0.48
*** TURN *** [Jc 7c 3s] [2d]
andrewmoneyman: bets $1.25
CashMatteo: folds 
Uncalled bet ($1.25) returned to andrewmoneyman
andrewmoneyman collected $1.85 from pot
andrewmoneyman: doesn't show hand 
*** SUMMARY ***
Total pot $1.94 | Rake $0.09 
Board [Jc 7c 3s 2d]
Seat 4: andrewmoneyman (big blind) collected ($1.85)
Seat 5: CashMatteo (button) (small blind) folded on the Turn

Hand #2095: 

PokerStars Hand #246897182179:  Hold'em No Limit ($0.05/$0.10 CAD) - 2023/11/03 2:55:12 ET
Table 'Helewalda' 6-max Seat #4 is the button
Seat 4: andrewmoneyman ($18.60 in chips) 
Seat 5: CashMatteo ($12.01 in chips) 
andrewmoneyman: posts small blind $0.05
CashMatteo: posts big blind $0.10
*** HOLE CARDS ***
Dealt to CashMatteo [4d 2s]
andrewmoneyman: folds 
Uncalled bet ($0.05) returned to CashMatteo
CashMatteo collected $0.10 from pot
CashMatteo: doesn't show hand 
*** SUMMARY ***
Total pot $0.10 | Rake $0 
Seat 4: andrewmoneyman (button) (small blind) folded before Flop
Seat 5: CashMatteo (big blind) collected ($0.10)

Hand #2096: 

PokerStars Hand #246897182691:  Hold'em No Limit ($0.05/$0.10 CAD) - 2023/11/03 2:55:18 ET
Table 'Helewalda' 6-max Seat #5 is the button
Seat 4: andrewmoneyman ($18.55 in chips) 
Seat 5: CashMatteo ($12.06 in chips) 
CashMatteo: posts small blind $0.05
andrewmoneyman: posts big blind $0.10
*** HOLE CARDS ***
Dealt to CashMatteo [7d 5d]
CashMatteo: calls $0.05
andrewmoneyman: checks 
*** FLOP *** [Ad Ks Jc]
andrewmoneyman: checks 
CashMatteo: checks 
*** TURN *** [Ad Ks Jc] [4d]
andrewmoneyman: checks 
CashMatteo: bets $0.19
andrewmoneyman: folds 
Uncalled bet ($0.19) returned to CashMatteo
CashMatteo collected $0.19 from pot
CashMatteo: doesn't show hand 
*** SUMMARY ***
Total pot $0.20 | Rake $0.01 
Board [Ad Ks Jc 4d]
Seat 4: andrewmoneyman (big blind) folded on the Turn
Seat 5: CashMatteo (button) (small blind) collected ($0.19)

Hand #2097: 

PokerStars Hand #246897183953:  Hold'em No Limit ($0.05/$0.10 CAD) - 2023/11/03 2:55:35 ET
Table 'Helewalda' 6-max Seat #4 is the button
Seat 4: andrewmoneyman ($18.45 in chips) 
Seat 5: CashMatteo ($12.15 in chips) 
andrewmoneyman: posts small blind $0.05
CashMatteo: posts big blind $0.10
*** HOLE CARDS ***
Dealt to CashMatteo [Js Kc]
andrewmoneyman: raises $0.20 to $0.30
CashMatteo: raises $0.60 to $0.90
andrewmoneyman: calls $0.60
*** FLOP *** [7h Ac 3h]
CashMatteo: checks 
andrewmoneyman: checks 
*** TURN *** [7h Ac 3h] [4s]
CashMatteo: bets $0.86
andrewmoneyman: folds 
Uncalled bet ($0.86) returned to CashMatteo
CashMatteo collected $1.72 from pot
CashMatteo: doesn't show hand 
*** SUMMARY ***
Total pot $1.80 | Rake $0.08 
Board [7h Ac 3h 4s]
Seat 4: andrewmoneyman (button) (small blind) folded on the Turn
Seat 5: CashMatteo (big blind) collected ($1.72)

Hand #2098: 

PokerStars Hand #246897185426:  Hold'em No Limit ($0.05/$0.10 CAD) - 2023/11/03 2:55:54 ET
Table 'Helewalda' 6-max Seat #5 is the button
Seat 4: andrewmoneyman ($17.55 in chips) 
Seat 5: CashMatteo ($12.97 in chips) 
CashMatteo: posts small blind $0.05
andrewmoneyman: posts big blind $0.10
*** HOLE CARDS ***
Dealt to CashMatteo [7h 3d]
CashMatteo: folds 
Uncalled bet ($0.05) returned to andrewmoneyman
andrewmoneyman collected $0.10 from pot
andrewmoneyman: doesn't show hand 
*** SUMMARY ***
Total pot $0.10 | Rake $0 
Seat 4: andrewmoneyman (big blind) collected ($0.10)
Seat 5: CashMatteo (button) (small blind) folded before Flop

Hand #2099: 

PokerStars Hand #246897185883:  Hold'em No Limit ($0.05/$0.10 CAD) - 2023/11/03 2:56:00 ET
Table 'Helewalda' 6-max Seat #4 is the button
Seat 4: andrewmoneyman ($17.60 in chips) 
Seat 5: CashMatteo ($12.92 in chips) 
andrewmoneyman: posts small blind $0.05
CashMatteo: posts big blind $0.10
*** HOLE CARDS ***
Dealt to CashMatteo [3d Qd]
andrewmoneyman: calls $0.05
CashMatteo: raises $0.15 to $0.25
andrewmoneyman: calls $0.15
*** FLOP *** [4d Td 6h]
CashMatteo: bets $0.24
andrewmoneyman: raises $0.72 to $0.96
CashMatteo: raises $11.71 to $12.67 and is all-in
andrewmoneyman: calls $11.71
*** TURN *** [4d Td 6h] [9s]
*** RIVER *** [4d Td 6h 9s] [3h]
*** SHOW DOWN ***
CashMatteo: shows [3d Qd] (a pair of Threes)
andrewmoneyman: shows [Ts Jc] (a pair of Tens)
andrewmoneyman collected $25.24 from pot
*** SUMMARY ***
Total pot $25.84 | Rake $0.60 
Board [4d Td 6h 9s 3h]
Seat 4: andrewmoneyman (button) (small blind) showed [Ts Jc] and won ($25.24) with a pair of Tens
Seat 5: CashMatteo (big blind) showed [3d Qd] and lost with a pair of Threes

Hand #2100: 

PokerStars Hand #250519127765:  Hold'em No Limit ($0.01/$0.02 CAD) - 2024/05/15 17:12:25 ET
Table 'Gedania IV' 6-max Seat #3 is the button
Seat 1: theepan895 ($0.84 in chips) 
Seat 2: lunderk ($2.57 in chips) 
Seat 3: paul853 ($1.36 in chips) 
Seat 4: Howardhof ($1.89 in chips) 
Seat 5: CashMatteo ($2 in chips) 
Howardhof: posts small blind $0.01
CashMatteo: posts big blind $0.02
*** HOLE CARDS ***
Dealt to CashMatteo [9s Kd]
whichspell joins the table at seat #6 
theepan895: raises $0.02 to $0.04
lunderk: folds 
paul853: folds 
Howardhof: folds 
CashMatteo: raises $0.09 to $0.13
theepan895: calls $0.09
*** FLOP *** [8c 4d 5c]
CashMatteo: checks 
theepan895: bets $0.29
CashMatteo: folds 
Uncalled bet ($0.29) returned to theepan895
theepan895 collected $0.26 from pot
*** SUMMARY ***
Total pot $0.27 | Rake $0.01 
Board [8c 4d 5c]
Seat 1: theepan895 collected ($0.26)
Seat 2: lunderk folded before Flop (didn't bet)
Seat 3: paul853 (button) folded before Flop (didn't bet)
Seat 4: Howardhof (small blind) folded before Flop
Seat 5: CashMatteo (big blind) folded on the Flop

Hand #2101: 

PokerStars Hand #250519138620:  Hold'em No Limit ($0.01/$0.02 CAD) - 2024/05/15 17:12:56 ET
Table 'Gedania IV' 6-max Seat #4 is the button
Seat 1: theepan895 ($0.97 in chips) 
Seat 2: lunderk ($2.57 in chips) 
Seat 3: paul853 ($1.36 in chips) 
Seat 4: Howardhof ($1.88 in chips) 
Seat 5: CashMatteo ($1.87 in chips) 
Seat 6: whichspell ($2 in chips) 
CashMatteo: posts small blind $0.01
whichspell: posts big blind $0.02
*** HOLE CARDS ***
Dealt to CashMatteo [3s Td]
theepan895: raises $0.02 to $0.04
lunderk: folds 
paul853: folds 
Howardhof: folds 
CashMatteo: folds 
whichspell: calls $0.02
*** FLOP *** [Ts Ks Tc]
whichspell: bets $0.05
theepan895: folds 
Uncalled bet ($0.05) returned to whichspell
whichspell collected $0.09 from pot
whichspell: doesn't show hand 
*** SUMMARY ***
Total pot $0.09 | Rake $0 
Board [Ts Ks Tc]
Seat 1: theepan895 folded on the Flop
Seat 2: lunderk folded before Flop (didn't bet)
Seat 3: paul853 folded before Flop (didn't bet)
Seat 4: Howardhof (button) folded before Flop (didn't bet)
Seat 5: CashMatteo (small blind) folded before Flop
Seat 6: whichspell (big blind) collected ($0.09)

Hand #2102: 

PokerStars Hand #250519145519:  Hold'em No Limit ($0.01/$0.02 CAD) - 2024/05/15 17:13:15 ET
Table 'Gedania IV' 6-max Seat #5 is the button
Seat 1: theepan895 ($0.93 in chips) 
Seat 2: lunderk ($2.57 in chips) 
Seat 3: paul853 ($1.36 in chips) 
Seat 4: Howardhof ($1.88 in chips) 
Seat 5: CashMatteo ($1.86 in chips) 
Seat 6: whichspell ($2.05 in chips) 
whichspell: posts small blind $0.01
theepan895: posts big blind $0.02
*** HOLE CARDS ***
Dealt to CashMatteo [2d 8d]
lunderk: folds 
paul853: folds 
Howardhof: calls $0.02
CashMatteo: folds 
whichspell: calls $0.01
theepan895: checks 
*** FLOP *** [4s Ts Kh]
whichspell: checks 
theepan895: bets $0.04
Howardhof: calls $0.04
whichspell: folds 
*** TURN *** [4s Ts Kh] [4h]
theepan895: bets $0.09
Howardhof: calls $0.09
*** RIVER *** [4s Ts Kh 4h] [9h]
theepan895: checks 
Howardhof: checks 
*** SHOW DOWN ***
theepan895: shows [Th Qs] (two pair, Tens and Fours)
Howardhof: mucks hand 
theepan895 collected $0.31 from pot
*** SUMMARY ***
Total pot $0.32 | Rake $0.01 
Board [4s Ts Kh 4h 9h]
Seat 1: theepan895 (big blind) showed [Th Qs] and won ($0.31) with two pair, Tens and Fours
Seat 2: lunderk folded before Flop (didn't bet)
Seat 3: paul853 folded before Flop (didn't bet)
Seat 4: Howardhof mucked [Ad Qd]
Seat 5: CashMatteo (button) folded before Flop (didn't bet)
Seat 6: whichspell (small blind) folded on the Flop

Hand #2103: 

PokerStars Hand #250519157542:  Hold'em No Limit ($0.01/$0.02 CAD) - 2024/05/15 17:13:49 ET
Table 'Gedania IV' 6-max Seat #6 is the button
Seat 1: theepan895 ($1.09 in chips) 
Seat 2: lunderk ($2.57 in chips) 
Seat 3: paul853 ($1.36 in chips) 
Seat 4: Howardhof ($1.73 in chips) 
Seat 5: CashMatteo ($1.86 in chips) 
Seat 6: whichspell ($2.03 in chips) 
theepan895: posts small blind $0.01
lunderk: posts big blind $0.02
*** HOLE CARDS ***
Dealt to CashMatteo [2h Js]
paul853: calls $0.02
Howardhof: folds 
CashMatteo: folds 
whichspell: raises $0.09 to $0.11
theepan895: folds 
lunderk: folds 
paul853: calls $0.09
*** FLOP *** [Tc 7s Ah]
paul853: checks 
whichspell: bets $0.12
paul853: calls $0.12
*** TURN *** [Tc 7s Ah] [9h]
paul853: checks 
whichspell: bets $0.30
paul853: raises $0.83 to $1.13 and is all-in
whichspell: calls $0.83
*** RIVER *** [Tc 7s Ah 9h] [Ks]
*** SHOW DOWN ***
paul853: shows [3c Ac] (a pair of Aces)
whichspell: shows [Th Ad] (two pair, Aces and Tens)
whichspell collected $2.65 from pot
*** SUMMARY ***
Total pot $2.75 | Rake $0.10 
Board [Tc 7s Ah 9h Ks]
Seat 1: theepan895 (small blind) folded before Flop
Seat 2: lunderk (big blind) folded before Flop
Seat 3: paul853 showed [3c Ac] and lost with a pair of Aces
Seat 4: Howardhof folded before Flop (didn't bet)
Seat 5: CashMatteo folded before Flop (didn't bet)
Seat 6: whichspell (button) showed [Th Ad] and won ($2.65) with two pair, Aces and Tens

Hand #2104: 

PokerStars Hand #250519171524:  Hold'em No Limit ($0.01/$0.02 CAD) - 2024/05/15 17:14:28 ET
Table 'Gedania IV' 6-max Seat #1 is the button
Seat 1: theepan895 ($1.08 in chips) 
Seat 2: lunderk ($2.55 in chips) 
Seat 4: Howardhof ($1.73 in chips) 
Seat 5: CashMatteo ($1.86 in chips) 
Seat 6: whichspell ($3.32 in chips) 
lunderk: posts small blind $0.01
Howardhof: posts big blind $0.02
*** HOLE CARDS ***
Dealt to CashMatteo [3d Jh]
CashMatteo: folds 
whichspell: folds 
theepan895: calls $0.02
lunderk: folds 
Howardhof: checks 
*** FLOP *** [8c Ah Jc]
Howardhof: checks 
theepan895: bets $0.03
Howardhof: calls $0.03
*** TURN *** [8c Ah Jc] [3s]
Howardhof: checks 
theepan895: bets $0.14
Howardhof: folds 
Uncalled bet ($0.14) returned to theepan895
theepan895 collected $0.11 from pot
*** SUMMARY ***
Total pot $0.11 | Rake $0 
Board [8c Ah Jc 3s]
Seat 1: theepan895 (button) collected ($0.11)
Seat 2: lunderk (small blind) folded before Flop
Seat 4: Howardhof (big blind) folded on the Turn
Seat 5: CashMatteo folded before Flop (didn't bet)
Seat 6: whichspell folded before Flop (didn't bet)

Hand #2105: 

PokerStars Hand #250519184750:  Hold'em No Limit ($0.01/$0.02 CAD) - 2024/05/15 17:15:06 ET
Table 'Gedania IV' 6-max Seat #2 is the button
Seat 1: theepan895 ($1.14 in chips) 
Seat 2: lunderk ($2.54 in chips) 
Seat 4: Howardhof ($1.68 in chips) 
Seat 5: CashMatteo ($1.86 in chips) 
Seat 6: whichspell ($3.32 in chips) 
paul853 will be allowed to play after the button
Howardhof: posts small blind $0.01
CashMatteo: posts big blind $0.02
*** HOLE CARDS ***
Dealt to CashMatteo [3s 5s]
whichspell: raises $0.09 to $0.11
theepan895: folds 
lunderk: folds 
Howardhof: folds 
CashMatteo: calls $0.09
*** FLOP *** [2s 8s 4d]
CashMatteo: bets $0.22
whichspell: calls $0.22
*** TURN *** [2s 8s 4d] [4s]
CashMatteo: bets $0.37
whichspell: raises $1.39 to $1.76
CashMatteo: calls $1.16 and is all-in
Uncalled bet ($0.23) returned to whichspell
*** RIVER *** [2s 8s 4d 4s] [Kd]
*** SHOW DOWN ***
CashMatteo: shows [3s 5s] (a flush, Eight high)
whichspell: shows [9h Ah] (a pair of Fours)
CashMatteo collected $3.60 from pot
*** SUMMARY ***
Total pot $3.73 | Rake $0.13 
Board [2s 8s 4d 4s Kd]
Seat 1: theepan895 folded before Flop (didn't bet)
Seat 2: lunderk (button) folded before Flop (didn't bet)
Seat 4: Howardhof (small blind) folded before Flop
Seat 5: CashMatteo (big blind) showed [3s 5s] and won ($3.60) with a flush, Eight high
Seat 6: whichspell showed [9h Ah] and lost with a pair of Fours

Hand #2106: 

PokerStars Hand #250519200113:  Hold'em No Limit ($0.01/$0.02 CAD) - 2024/05/15 17:15:49 ET
Table 'Gedania IV' 6-max Seat #4 is the button
Seat 1: theepan895 ($1.14 in chips) 
Seat 2: lunderk ($2.54 in chips) 
Seat 3: paul853 ($2 in chips) 
Seat 4: Howardhof ($1.67 in chips) 
Seat 5: CashMatteo ($3.60 in chips) 
Seat 6: whichspell ($1.46 in chips) 
CashMatteo: posts small blind $0.01
whichspell: posts big blind $0.02
paul853: posts small & big blinds $0.03
*** HOLE CARDS ***
Dealt to CashMatteo [Qc Qd]
theepan895: raises $0.04 to $0.06
lunderk: folds 
paul853: calls $0.04
Howardhof: folds 
CashMatteo: raises $0.15 to $0.21
whichspell: folds 
theepan895: folds 
theepan895 is disconnected 
paul853: folds 
Uncalled bet ($0.15) returned to CashMatteo
CashMatteo collected $0.21 from pot
CashMatteo: doesn't show hand 
*** SUMMARY ***
Total pot $0.21 | Rake $0 
Seat 1: theepan895 folded before Flop
Seat 2: lunderk folded before Flop (didn't bet)
Seat 3: paul853 folded before Flop
Seat 4: Howardhof (button) folded before Flop (didn't bet)
Seat 5: CashMatteo (small blind) collected ($0.21)
Seat 6: whichspell (big blind) folded before Flop

Hand #2107: 

PokerStars Hand #250519209495:  Hold'em No Limit ($0.01/$0.02 CAD) - 2024/05/15 17:16:15 ET
Table 'Gedania IV' 6-max Seat #5 is the button
Seat 2: lunderk ($2.54 in chips) 
Seat 3: paul853 ($1.93 in chips) 
Seat 4: Howardhof ($1.67 in chips) 
Seat 5: CashMatteo ($3.75 in chips) 
Seat 6: whichspell ($1.44 in chips) 
whichspell: posts small blind $0.01
lunderk: posts big blind $0.02
*** HOLE CARDS ***
Dealt to CashMatteo [Td 6d]
paul853: calls $0.02
Howardhof: calls $0.02
CashMatteo: calls $0.02
whichspell: raises $0.04 to $0.06
lunderk: calls $0.04
paul853: calls $0.04
Howardhof: calls $0.04
CashMatteo: folds 
*** FLOP *** [5c 3h 9c]
whichspell: checks 
lunderk: checks 
paul853: bets $1.87 and is all-in
Howardhof: folds 
whichspell: folds 
lunderk: folds 
Uncalled bet ($1.87) returned to paul853
paul853 collected $0.25 from pot
*** SUMMARY ***
Total pot $0.26 | Rake $0.01 
Board [5c 3h 9c]
Seat 2: lunderk (big blind) folded on the Flop
Seat 3: paul853 collected ($0.25)
Seat 4: Howardhof folded on the Flop
Seat 5: CashMatteo (button) folded before Flop
Seat 6: whichspell (small blind) folded on the Flop

Hand #2108: 

PokerStars Hand #250519231586:  Hold'em No Limit ($0.01/$0.02 CAD) - 2024/05/15 17:17:18 ET
Table 'Gedania IV' 6-max Seat #6 is the button
Seat 2: lunderk ($2.48 in chips) 
Seat 3: paul853 ($2.12 in chips) 
Seat 4: Howardhof ($1.61 in chips) 
Seat 5: CashMatteo ($3.73 in chips) 
Seat 6: whichspell ($1.38 in chips) 
lunderk: posts small blind $0.01
paul853: posts big blind $0.02
*** HOLE CARDS ***
Dealt to CashMatteo [7h Th]
Howardhof: calls $0.02
CashMatteo: calls $0.02
whichspell: folds 
lunderk: folds 
paul853: checks 
*** FLOP *** [Ac 7c 8s]
paul853: checks 
Howardhof: checks 
CashMatteo: bets $0.02
paul853: folds 
Howardhof: folds 
Uncalled bet ($0.02) returned to CashMatteo
CashMatteo collected $0.07 from pot
CashMatteo: doesn't show hand 
*** SUMMARY ***
Total pot $0.07 | Rake $0 
Board [Ac 7c 8s]
Seat 2: lunderk (small blind) folded before Flop
Seat 3: paul853 (big blind) folded on the Flop
Seat 4: Howardhof folded on the Flop
Seat 5: CashMatteo collected ($0.07)
Seat 6: whichspell (button) folded before Flop (didn't bet)

Hand #2109: 

PokerStars Hand #250519240280:  Hold'em No Limit ($0.01/$0.02 CAD) - 2024/05/15 17:17:42 ET
Table 'Gedania IV' 6-max Seat #2 is the button
Seat 2: lunderk ($2.47 in chips) 
Seat 3: paul853 ($2.10 in chips) 
Seat 4: Howardhof ($1.59 in chips) 
Seat 5: CashMatteo ($3.78 in chips) 
Seat 6: whichspell ($1.38 in chips) 
paul853: posts small blind $0.01
Howardhof: posts big blind $0.02
*** HOLE CARDS ***
Dealt to CashMatteo [9s 7d]
CashMatteo: folds 
whichspell: calls $0.02
lunderk: folds 
paul853: calls $0.01
Howardhof: checks 
*** FLOP *** [4c Qh Ad]
paul853: checks 
Howardhof: checks 
whichspell: checks 
*** TURN *** [4c Qh Ad] [Kh]
paul853: checks 
Howardhof: checks 
whichspell: checks 
*** RIVER *** [4c Qh Ad Kh] [9d]
paul853: checks 
Howardhof: checks 
whichspell: bets $0.06
paul853: folds 
Howardhof: folds 
Uncalled bet ($0.06) returned to whichspell
whichspell collected $0.06 from pot
whichspell: doesn't show hand 
*** SUMMARY ***
Total pot $0.06 | Rake $0 
Board [4c Qh Ad Kh 9d]
Seat 2: lunderk (button) folded before Flop (didn't bet)
Seat 3: paul853 (small blind) folded on the River
Seat 4: Howardhof (big blind) folded on the River
Seat 5: CashMatteo folded before Flop (didn't bet)
Seat 6: whichspell collected ($0.06)

Hand #2110: 

PokerStars Hand #250519253692:  Hold'em No Limit ($0.01/$0.02 CAD) - 2024/05/15 17:18:19 ET
Table 'Thuban III' 6-max Seat #3 is the button
Seat 1: rubey2steps ($1.06 in chips) 
Seat 2: hotdog1948 ($2.74 in chips) 
Seat 3: grandmasteel ($1.18 in chips) 
Seat 4: LoboR1 ($3.56 in chips) 
Seat 5: CashMatteo ($1.60 in chips) 
Seat 6: Kennyg519 ($0.85 in chips) 
LoboR1: posts small blind $0.01
CashMatteo: posts big blind $0.02
*** HOLE CARDS ***
Dealt to CashMatteo [7d Ts]
Kennyg519: folds 
rubey2steps: folds 
hotdog1948: raises $0.02 to $0.04
grandmasteel: folds 
LoboR1: folds 
CashMatteo: folds 
Uncalled bet ($0.02) returned to hotdog1948
hotdog1948 collected $0.05 from pot
*** SUMMARY ***
Total pot $0.05 | Rake $0 
Seat 1: rubey2steps folded before Flop (didn't bet)
Seat 2: hotdog1948 collected ($0.05)
Seat 3: grandmasteel (button) folded before Flop (didn't bet)
Seat 4: LoboR1 (small blind) folded before Flop
Seat 5: CashMatteo (big blind) folded before Flop
Seat 6: Kennyg519 folded before Flop (didn't bet)

Hand #2111: 

PokerStars Hand #250519254783:  Hold'em No Limit ($0.01/$0.02 CAD) - 2024/05/15 17:18:22 ET
Table 'Gedania IV' 6-max Seat #3 is the button
Seat 2: lunderk ($2.47 in chips) 
Seat 3: paul853 ($2.08 in chips) 
Seat 4: Howardhof ($1.57 in chips) 
Seat 5: CashMatteo ($3.78 in chips) 
Seat 6: whichspell ($1.42 in chips) 
Howardhof: posts small blind $0.01
CashMatteo: posts big blind $0.02
*** HOLE CARDS ***
Dealt to CashMatteo [4d Td]
whichspell: folds 
lunderk: folds 
paul853: folds 
Howardhof: calls $0.01
CashMatteo: checks 
*** FLOP *** [8c Qs 7h]
Howardhof: bets $0.02
CashMatteo: calls $0.02
*** TURN *** [8c Qs 7h] [9d]
Howardhof: checks 
CashMatteo: bets $0.08
Howardhof: folds 
Uncalled bet ($0.08) returned to CashMatteo
CashMatteo collected $0.08 from pot
CashMatteo: doesn't show hand 
*** SUMMARY ***
Total pot $0.08 | Rake $0 
Board [8c Qs 7h 9d]
Seat 2: lunderk folded before Flop (didn't bet)
Seat 3: paul853 (button) folded before Flop (didn't bet)
Seat 4: Howardhof (small blind) folded on the Turn
Seat 5: CashMatteo (big blind) collected ($0.08)
Seat 6: whichspell folded before Flop (didn't bet)

Hand #2112: 

PokerStars Hand #250519258361:  Hold'em No Limit ($0.01/$0.02 CAD) - 2024/05/15 17:18:33 ET
Table 'Thuban III' 6-max Seat #4 is the button
Seat 1: rubey2steps ($1.06 in chips) 
Seat 2: hotdog1948 ($2.77 in chips) 
Seat 3: grandmasteel ($1.18 in chips) 
Seat 4: LoboR1 ($3.55 in chips) 
Seat 5: CashMatteo ($1.58 in chips) 
Seat 6: Kennyg519 ($0.85 in chips) 
CashMatteo: posts small blind $0.01
Kennyg519: posts big blind $0.02
*** HOLE CARDS ***
Dealt to CashMatteo [6s 3h]
rubey2steps: calls $0.02
hotdog1948: calls $0.02
grandmasteel: calls $0.02
LoboR1: folds 
CashMatteo: folds 
Kennyg519: checks 
*** FLOP *** [Kh Qs 2c]
Kennyg519: checks 
rubey2steps: checks 
hotdog1948: checks 
grandmasteel: checks 
*** TURN *** [Kh Qs 2c] [9h]
Kennyg519: checks 
rubey2steps: checks 
hotdog1948: checks 
grandmasteel: bets $1.16 and is all-in
Kennyg519: calls $0.83 and is all-in
rubey2steps: folds 
hotdog1948: folds 
Uncalled bet ($0.33) returned to grandmasteel
*** RIVER *** [Kh Qs 2c 9h] [7c]
*** SHOW DOWN ***
Kennyg519: shows [9s Ac] (a pair of Nines)
grandmasteel: shows [Js Tc] (a straight, Nine to King)
grandmasteel collected $1.69 from pot
*** SUMMARY ***
Total pot $1.75 | Rake $0.06 
Board [Kh Qs 2c 9h 7c]
Seat 1: rubey2steps folded on the Turn
Seat 2: hotdog1948 folded on the Turn
Seat 3: grandmasteel showed [Js Tc] and won ($1.69) with a straight, Nine to King
Seat 4: LoboR1 (button) folded before Flop (didn't bet)
Seat 5: CashMatteo (small blind) folded before Flop
Seat 6: Kennyg519 (big blind) showed [9s Ac] and lost with a pair of Nines

Hand #2113: 

PokerStars Hand #250519270715:  Hold'em No Limit ($0.01/$0.02 CAD) - 2024/05/15 17:19:07 ET
Table 'Gedania IV' 6-max Seat #4 is the button
Seat 2: lunderk ($2.47 in chips) 
Seat 3: paul853 ($2.08 in chips) 
Seat 4: Howardhof ($1.53 in chips) 
Seat 5: CashMatteo ($3.82 in chips) 
Seat 6: whichspell ($1.42 in chips) 
CashMatteo: posts small blind $0.01
whichspell: posts big blind $0.02
*** HOLE CARDS ***
Dealt to CashMatteo [9h Ah]
lunderk: raises $0.04 to $0.06
paul853: calls $0.06
Howardhof: calls $0.06
CashMatteo: raises $0.26 to $0.32
whichspell: folds 
lunderk: raises $0.78 to $1.10
paul853: folds 
Howardhof: folds 
CashMatteo: calls $0.78
*** FLOP *** [Js 6d 2h]
CashMatteo: checks 
lunderk: bets $1.37 and is all-in
CashMatteo: calls $1.37
*** TURN *** [Js 6d 2h] [9s]
*** RIVER *** [Js 6d 2h 9s] [Qd]
*** SHOW DOWN ***
CashMatteo: shows [9h Ah] (a pair of Nines)
lunderk: shows [Ad Kh] (high card Ace)
CashMatteo collected $4.90 from pot
*** SUMMARY ***
Total pot $5.08 | Rake $0.18 
Board [Js 6d 2h 9s Qd]
Seat 2: lunderk showed [Ad Kh] and lost with high card Ace
Seat 3: paul853 folded before Flop
Seat 4: Howardhof (button) folded before Flop
Seat 5: CashMatteo (small blind) showed [9h Ah] and won ($4.90) with a pair of Nines
Seat 6: whichspell (big blind) folded before Flop

Hand #2114: 

PokerStars Hand #250519278847:  Hold'em No Limit ($0.01/$0.02 CAD) - 2024/05/15 17:19:30 ET
Table 'Thuban III' 6-max Seat #5 is the button
Seat 1: rubey2steps ($1.04 in chips) 
Seat 2: hotdog1948 ($2.75 in chips) 
Seat 3: grandmasteel ($2.02 in chips) 
Seat 4: LoboR1 ($3.55 in chips) 
Seat 5: CashMatteo ($1.57 in chips) 
rubey2steps: posts small blind $0.01
hotdog1948: posts big blind $0.02
*** HOLE CARDS ***
Dealt to CashMatteo [9d 5d]
grandmasteel: calls $0.02
Kennyg519 leaves the table
ahophing joins the table at seat #6 
LoboR1: folds 
CashMatteo: calls $0.02
rubey2steps: calls $0.01
hotdog1948: checks 
*** FLOP *** [Qc 6s 6h]
rubey2steps: checks 
hotdog1948: checks 
grandmasteel: bets $0.04
CashMatteo: folds 
rubey2steps: folds 
hotdog1948: calls $0.04
*** TURN *** [Qc 6s 6h] [7h]
hotdog1948: checks 
grandmasteel: bets $0.10
hotdog1948: calls $0.10
*** RIVER *** [Qc 6s 6h 7h] [Ac]
hotdog1948: checks 
grandmasteel: checks 
*** SHOW DOWN ***
hotdog1948: shows [Qs 6c] (a full house, Sixes full of Queens)
grandmasteel: mucks hand 
hotdog1948 collected $0.35 from pot
*** SUMMARY ***
Total pot $0.36 | Rake $0.01 
Board [Qc 6s 6h 7h Ac]
Seat 1: rubey2steps (small blind) folded on the Flop
Seat 2: hotdog1948 (big blind) showed [Qs 6c] and won ($0.35) with a full house, Sixes full of Queens
Seat 3: grandmasteel mucked [8h Qd]
Seat 4: LoboR1 folded before Flop (didn't bet)
Seat 5: CashMatteo (button) folded on the Flop

Hand #2115: 

PokerStars Hand #250519287420:  Hold'em No Limit ($0.01/$0.02 CAD) - 2024/05/15 17:19:55 ET
Table 'Gedania IV' 6-max Seat #5 is the button
Seat 2: lunderk ($2 in chips) 
Seat 3: paul853 ($2.02 in chips) 
Seat 4: Howardhof ($1.47 in chips) 
Seat 5: CashMatteo ($6.25 in chips) 
Seat 6: whichspell ($1.40 in chips) 
whichspell: posts small blind $0.01
lunderk: posts big blind $0.02
*** HOLE CARDS ***
Dealt to CashMatteo [Kh Tc]
paul853: folds 
Howardhof: folds 
CashMatteo: calls $0.02
whichspell: raises $0.10 to $0.12
lunderk: folds 
CashMatteo: calls $0.10
*** FLOP *** [5c 7h 3c]
whichspell: checks 
CashMatteo: bets $0.09
whichspell: calls $0.09
*** TURN *** [5c 7h 3c] [Ah]
whichspell: bets $0.42
CashMatteo: folds 
Uncalled bet ($0.42) returned to whichspell
whichspell collected $0.42 from pot
whichspell: doesn't show hand 
*** SUMMARY ***
Total pot $0.44 | Rake $0.02 
Board [5c 7h 3c Ah]
Seat 2: lunderk (big blind) folded before Flop
Seat 3: paul853 folded before Flop (didn't bet)
Seat 4: Howardhof folded before Flop (didn't bet)
Seat 5: CashMatteo (button) folded on the Turn
Seat 6: whichspell (small blind) collected ($0.42)

Hand #2116: 

PokerStars Hand #250519301081:  Hold'em No Limit ($0.01/$0.02 CAD) - 2024/05/15 17:20:33 ET
Table 'Gedania IV' 6-max Seat #6 is the button
Seat 2: lunderk ($2 in chips) 
Seat 3: paul853 ($2.02 in chips) 
Seat 4: Howardhof ($1.47 in chips) 
Seat 5: CashMatteo ($6.04 in chips) 
Seat 6: whichspell ($1.61 in chips) 
lunderk: posts small blind $0.01
paul853: posts big blind $0.02
*** HOLE CARDS ***
Dealt to CashMatteo [9d Qh]
Howardhof: folds 
CashMatteo: raises $0.03 to $0.05
whichspell: calls $0.05
lunderk: folds 
paul853: folds 
*** FLOP *** [7d 8h 2c]
CashMatteo: checks 
whichspell: checks 
*** TURN *** [7d 8h 2c] [5c]
CashMatteo: checks 
whichspell: checks 
*** RIVER *** [7d 8h 2c 5c] [3h]
CashMatteo: checks 
whichspell: bets $0.07
CashMatteo: calls $0.07
*** SHOW DOWN ***
whichspell: shows [4h 4s] (a pair of Fours)
CashMatteo: mucks hand 
whichspell collected $0.26 from pot
*** SUMMARY ***
Total pot $0.27 | Rake $0.01 
Board [7d 8h 2c 5c 3h]
Seat 2: lunderk (small blind) folded before Flop
Seat 3: paul853 (big blind) folded before Flop
Seat 4: Howardhof folded before Flop (didn't bet)
Seat 5: CashMatteo mucked [9d Qh]
Seat 6: whichspell (button) showed [4h 4s] and won ($0.26) with a pair of Fours

Hand #2117: 

PokerStars Hand #250519307641:  Hold'em No Limit ($0.01/$0.02 CAD) - 2024/05/15 17:20:52 ET
Table 'Thuban III' 6-max Seat #1 is the button
Seat 1: rubey2steps ($1.02 in chips) 
Seat 2: hotdog1948 ($2.94 in chips) 
Seat 3: grandmasteel ($1.86 in chips) 
Seat 4: LoboR1 ($3.55 in chips) 
Seat 5: CashMatteo ($1.55 in chips) 
hotdog1948: posts small blind $0.01
grandmasteel: posts big blind $0.02
*** HOLE CARDS ***
Dealt to CashMatteo [2c 6d]
LoboR1: folds 
CashMatteo: folds 
rubey2steps: calls $0.02
hotdog1948: calls $0.01
grandmasteel: checks 
*** FLOP *** [Ac 6c Jh]
hotdog1948: checks 
grandmasteel: checks 
rubey2steps: bets $0.04
hotdog1948: folds 
grandmasteel: folds 
Uncalled bet ($0.04) returned to rubey2steps
rubey2steps collected $0.06 from pot
*** SUMMARY ***
Total pot $0.06 | Rake $0 
Board [Ac 6c Jh]
Seat 1: rubey2steps (button) collected ($0.06)
Seat 2: hotdog1948 (small blind) folded on the Flop
Seat 3: grandmasteel (big blind) folded on the Flop
Seat 4: LoboR1 folded before Flop (didn't bet)
Seat 5: CashMatteo folded before Flop (didn't bet)

Hand #2118: 

PokerStars Hand #250519312491:  Hold'em No Limit ($0.01/$0.02 CAD) - 2024/05/15 17:21:05 ET
Table 'Gedania IV' 6-max Seat #2 is the button
Seat 2: lunderk ($2 in chips) 
Seat 3: paul853 ($2 in chips) 
Seat 4: Howardhof ($1.47 in chips) 
Seat 5: CashMatteo ($5.92 in chips) 
Seat 6: whichspell ($1.75 in chips) 
paul853: posts small blind $0.01
Howardhof: posts big blind $0.02
*** HOLE CARDS ***
Dealt to CashMatteo [Td Ts]
CashMatteo: raises $0.03 to $0.05
whichspell: folds 
lunderk: raises $0.11 to $0.16
paul853: folds 
Howardhof: folds 
CashMatteo: raises $0.35 to $0.51
lunderk: raises $1.49 to $2 and is all-in
CashMatteo: calls $1.49
*** FLOP *** [5c Js 5d]
*** TURN *** [5c Js 5d] [8h]
*** RIVER *** [5c Js 5d 8h] [4c]
*** SHOW DOWN ***
CashMatteo: shows [Td Ts] (two pair, Tens and Fives)
lunderk: shows [Kh Ac] (a pair of Fives)
CashMatteo collected $3.89 from pot
*** SUMMARY ***
Total pot $4.03 | Rake $0.14 
Board [5c Js 5d 8h 4c]
Seat 2: lunderk (button) showed [Kh Ac] and lost with a pair of Fives
Seat 3: paul853 (small blind) folded before Flop
Seat 4: Howardhof (big blind) folded before Flop
Seat 5: CashMatteo showed [Td Ts] and won ($3.89) with two pair, Tens and Fives
Seat 6: whichspell folded before Flop (didn't bet)

Hand #2119: 

PokerStars Hand #250519318927:  Hold'em No Limit ($0.01/$0.02 CAD) - 2024/05/15 17:21:24 ET
Table 'Thuban III' 6-max Seat #2 is the button
Seat 1: rubey2steps ($1.06 in chips) 
Seat 2: hotdog1948 ($2.92 in chips) 
Seat 3: grandmasteel ($1.84 in chips) 
Seat 4: LoboR1 ($3.55 in chips) 
Seat 5: CashMatteo ($1.55 in chips) 
grandmasteel: posts small blind $0.01
LoboR1: posts big blind $0.02
ahophing: sits out 
*** HOLE CARDS ***
Dealt to CashMatteo [9d 9h]
CashMatteo: raises $0.03 to $0.05
rubey2steps: calls $0.05
hotdog1948: calls $0.05
grandmasteel: folds 
LoboR1: raises $3.50 to $3.55 and is all-in
CashMatteo: calls $1.50 and is all-in
rubey2steps: folds 
hotdog1948: folds 
Uncalled bet ($2) returned to LoboR1
*** FLOP *** [3s 9s 5c]
*** TURN *** [3s 9s 5c] [Kc]
*** RIVER *** [3s 9s 5c Kc] [3h]
*** SHOW DOWN ***
LoboR1: shows [Ad Ah] (two pair, Aces and Threes)
CashMatteo: shows [9d 9h] (a full house, Nines full of Threes)
CashMatteo collected $3.10 from pot
*** SUMMARY ***
Total pot $3.21 | Rake $0.11 
Board [3s 9s 5c Kc 3h]
Seat 1: rubey2steps folded before Flop
Seat 2: hotdog1948 (button) folded before Flop
Seat 3: grandmasteel (small blind) folded before Flop
Seat 4: LoboR1 (big blind) showed [Ad Ah] and lost with two pair, Aces and Threes
Seat 5: CashMatteo showed [9d 9h] and won ($3.10) with a full house, Nines full of Threes

Hand #2120: 

PokerStars Hand #250519324584:  Hold'em No Limit ($0.01/$0.02 CAD) - 2024/05/15 17:21:40 ET
Table 'Gedania IV' 6-max Seat #3 is the button
Seat 3: paul853 ($1.99 in chips) 
Seat 4: Howardhof ($1.45 in chips) 
Seat 5: CashMatteo ($7.81 in chips) 
Seat 6: whichspell ($1.75 in chips) 
Howardhof: posts small blind $0.01
CashMatteo: posts big blind $0.02
*** HOLE CARDS ***
Dealt to CashMatteo [9c 8c]
whichspell: folds 
paul853: folds 
Howardhof: calls $0.01
lunderk leaves the table
CashMatteo: checks 
*** FLOP *** [Qd 8h 6h]
ahophing joins the table at seat #2 
Howardhof: checks 
CashMatteo: bets $0.02
Howardhof: calls $0.02
*** TURN *** [Qd 8h 6h] [8s]
Howardhof: checks 
CashMatteo: bets $0.08
Howardhof: folds 
Uncalled bet ($0.08) returned to CashMatteo
CashMatteo collected $0.08 from pot
CashMatteo: doesn't show hand 
*** SUMMARY ***
Total pot $0.08 | Rake $0 
Board [Qd 8h 6h 8s]
Seat 3: paul853 (button) folded before Flop (didn't bet)
Seat 4: Howardhof (small blind) folded on the Turn
Seat 5: CashMatteo (big blind) collected ($0.08)
Seat 6: whichspell folded before Flop (didn't bet)

Hand #2121: 

PokerStars Hand #250519336638:  Hold'em No Limit ($0.01/$0.02 CAD) - 2024/05/15 17:22:14 ET
Table 'Gedania IV' 6-max Seat #4 is the button
Seat 3: paul853 ($1.99 in chips) 
Seat 4: Howardhof ($1.41 in chips) 
Seat 5: CashMatteo ($7.85 in chips) 
Seat 6: whichspell ($1.75 in chips) 
CashMatteo: posts small blind $0.01
whichspell: posts big blind $0.02
ahophing: sits out 
*** HOLE CARDS ***
Dealt to CashMatteo [2d 6d]
paul853: calls $0.02
Howardhof: folds 
CashMatteo: folds 
whichspell: checks 
*** FLOP *** [4h Kd 2s]
whichspell: checks 
paul853: bets $0.05
whichspell: folds 
Uncalled bet ($0.05) returned to paul853
paul853 collected $0.05 from pot
*** SUMMARY ***
Total pot $0.05 | Rake $0 
Board [4h Kd 2s]
Seat 3: paul853 collected ($0.05)
Seat 4: Howardhof (button) folded before Flop (didn't bet)
Seat 5: CashMatteo (small blind) folded before Flop
Seat 6: whichspell (big blind) folded on the Flop

Hand #2122: 

PokerStars Hand #250519337449:  Hold'em No Limit ($0.01/$0.02 CAD) - 2024/05/15 17:22:17 ET
Table 'Thuban III' 6-max Seat #4 is the button
Seat 1: rubey2steps ($1.01 in chips) 
Seat 2: hotdog1948 ($2.87 in chips) 
Seat 4: LoboR1 ($2 in chips) 
Seat 5: CashMatteo ($3.10 in chips) 
Seat 6: ahophing ($4.09 in chips) 
CashMatteo: posts small blind $0.01
ahophing: posts big blind $0.02
*** HOLE CARDS ***
Dealt to CashMatteo [Kc 4h]
rubey2steps: folds 
ahophing said, "i see your luck hasn't changed"
hotdog1948: raises $0.04 to $0.06
LoboR1: folds 
CashMatteo: folds 
ahophing: folds 
Uncalled bet ($0.04) returned to hotdog1948
hotdog1948 collected $0.05 from pot
LoboR1 said, "brutal lol"
*** SUMMARY ***
Total pot $0.05 | Rake $0 
Seat 1: rubey2steps folded before Flop (didn't bet)
Seat 2: hotdog1948 collected ($0.05)
Seat 4: LoboR1 (button) folded before Flop (didn't bet)
Seat 5: CashMatteo (small blind) folded before Flop
Seat 6: ahophing (big blind) folded before Flop

Hand #2123: 

PokerStars Hand #250519344569:  Hold'em No Limit ($0.01/$0.02 CAD) - 2024/05/15 17:22:37 ET
Table 'Thuban III' 6-max Seat #5 is the button
Seat 1: rubey2steps ($1.01 in chips) 
Seat 2: hotdog1948 ($2.90 in chips) 
Seat 4: LoboR1 ($2 in chips) 
Seat 5: CashMatteo ($3.09 in chips) 
Seat 6: ahophing ($4.07 in chips) 
ahophing: posts small blind $0.01
rubey2steps: posts big blind $0.02
*** HOLE CARDS ***
Dealt to CashMatteo [8h 6s]
hotdog1948: raises $0.02 to $0.04
LoboR1: folds 
CashMatteo: folds 
ahophing: calls $0.03
rubey2steps: calls $0.02
*** FLOP *** [6d 4c Jd]
ahophing: checks 
hotdog1948 said, "Stupid freat h"
LoboR1 said, "card dead and running bad when i get good starting hands"
rubey2steps: checks 
hotdog1948: checks 
*** TURN *** [6d 4c Jd] [As]
ahophing: bets $0.04
rubey2steps: folds 
hotdog1948: calls $0.04
*** RIVER *** [6d 4c Jd As] [3s]
ahophing said, "pokerstars, where the worst hand always wins"
ahophing: bets $0.06
hotdog1948: folds 
Uncalled bet ($0.06) returned to ahophing
ahophing collected $0.19 from pot
*** SUMMARY ***
Total pot $0.20 | Rake $0.01 
Board [6d 4c Jd As 3s]
Seat 1: rubey2steps (big blind) folded on the Turn
Seat 2: hotdog1948 folded on the River
Seat 4: LoboR1 folded before Flop (didn't bet)
Seat 5: CashMatteo (button) folded before Flop (didn't bet)
Seat 6: ahophing (small blind) collected ($0.19)

Hand #2124: 

PokerStars Hand #250519344949:  Hold'em No Limit ($0.01/$0.02 CAD) - 2024/05/15 17:22:38 ET
Table 'Gedania IV' 6-max Seat #5 is the button
Seat 2: ahophing ($2 in chips) 
Seat 3: paul853 ($2.02 in chips) 
Seat 4: Howardhof ($1.41 in chips) 
Seat 5: CashMatteo ($7.84 in chips) 
Seat 6: whichspell ($1.73 in chips) 
whichspell: posts small blind $0.01
ahophing: posts big blind $0.02
*** HOLE CARDS ***
Dealt to CashMatteo [Kc Ts]
paul853: calls $0.02
Howardhof: folds 
CashMatteo: raises $0.03 to $0.05
whichspell: folds 
ahophing: folds 
paul853: calls $0.03
*** FLOP *** [9h Jd 4s]
paul853: checks 
CashMatteo: bets $0.07
paul853: calls $0.07
*** TURN *** [9h Jd 4s] [Qs]
paul853: checks 
CashMatteo: bets $0.14
paul853: folds 
Uncalled bet ($0.14) returned to CashMatteo
CashMatteo collected $0.26 from pot
CashMatteo: doesn't show hand 
*** SUMMARY ***
Total pot $0.27 | Rake $0.01 
Board [9h Jd 4s Qs]
Seat 2: ahophing (big blind) folded before Flop
Seat 3: paul853 folded on the Turn
Seat 4: Howardhof folded before Flop (didn't bet)
Seat 5: CashMatteo (button) collected ($0.26)
Seat 6: whichspell (small blind) folded before Flop

Hand #2125: 

PokerStars Hand #250519357078:  Hold'em No Limit ($0.01/$0.02 CAD) - 2024/05/15 17:23:12 ET
Table 'Gedania IV' 6-max Seat #6 is the button
Seat 2: ahophing ($2 in chips) 
Seat 3: paul853 ($1.90 in chips) 
Seat 4: Howardhof ($1.41 in chips) 
Seat 5: CashMatteo ($7.98 in chips) 
Seat 6: whichspell ($1.72 in chips) 
ahophing: posts small blind $0.01
paul853: posts big blind $0.02
*** HOLE CARDS ***
Dealt to CashMatteo [9h Qh]
Howardhof: folds 
CashMatteo: raises $0.03 to $0.05
whichspell: folds 
ahophing: folds 
paul853: calls $0.03
*** FLOP *** [3d 5d 2h]
paul853: checks 
CashMatteo: checks 
*** TURN *** [3d 5d 2h] [Jd]
paul853: bets $0.11
CashMatteo: folds 
Uncalled bet ($0.11) returned to paul853
paul853 collected $0.11 from pot
*** SUMMARY ***
Total pot $0.11 | Rake $0 
Board [3d 5d 2h Jd]
Seat 2: ahophing (small blind) folded before Flop
Seat 3: paul853 (big blind) collected ($0.11)
Seat 4: Howardhof folded before Flop (didn't bet)
Seat 5: CashMatteo folded on the Turn
Seat 6: whichspell (button) folded before Flop (didn't bet)

Hand #2126: 

PokerStars Hand #250519359858:  Hold'em No Limit ($0.01/$0.02 CAD) - 2024/05/15 17:23:20 ET
Table 'Thuban III' 6-max Seat #6 is the button
Seat 1: rubey2steps ($0.97 in chips) 
Seat 2: hotdog1948 ($2.82 in chips) 
Seat 4: LoboR1 ($2 in chips) 
Seat 5: CashMatteo ($3.09 in chips) 
Seat 6: ahophing ($4.18 in chips) 
rubey2steps: posts small blind $0.01
hotdog1948: posts big blind $0.02
*** HOLE CARDS ***
Dealt to CashMatteo [Ac 4s]
LoboR1: folds 
CashMatteo: calls $0.02
ahophing: calls $0.02
rubey2steps: calls $0.01
hotdog1948: checks 
*** FLOP *** [Td Js 9c]
rubey2steps: bets $0.02
hotdog1948: calls $0.02
CashMatteo: calls $0.02
ahophing: folds 
*** TURN *** [Td Js 9c] [6h]
rubey2steps: checks 
hotdog1948: bets $0.02
CashMatteo: calls $0.02
hotdog1948 said, "Assssss"
rubey2steps: calls $0.02
*** RIVER *** [Td Js 9c 6h] [Kc]
rubey2steps: checks 
hotdog1948: checks 
CashMatteo: checks 
*** SHOW DOWN ***
rubey2steps: shows [7d 9d] (a pair of Nines)
hotdog1948: shows [4h Jd] (a pair of Jacks)
CashMatteo: mucks hand 
hotdog1948 collected $0.19 from pot
*** SUMMARY ***
Total pot $0.20 | Rake $0.01 
Board [Td Js 9c 6h Kc]
Seat 1: rubey2steps (small blind) showed [7d 9d] and lost with a pair of Nines
Seat 2: hotdog1948 (big blind) showed [4h Jd] and won ($0.19) with a pair of Jacks
Seat 4: LoboR1 folded before Flop (didn't bet)
Seat 5: CashMatteo mucked [Ac 4s]
Seat 6: ahophing (button) folded on the Flop

Hand #2127: 

PokerStars Hand #250519369675:  Hold'em No Limit ($0.01/$0.02 CAD) - 2024/05/15 17:23:48 ET
Table 'Gedania IV' 6-max Seat #2 is the button
Seat 2: ahophing ($2 in chips) 
Seat 3: paul853 ($1.96 in chips) 
Seat 4: Howardhof ($1.41 in chips) 
Seat 5: CashMatteo ($7.93 in chips) 
Seat 6: whichspell ($1.72 in chips) 
paul853: posts small blind $0.01
Howardhof: posts big blind $0.02
*** HOLE CARDS ***
Dealt to CashMatteo [Jh 2c]
CashMatteo: folds 
whichspell: calls $0.02
ahophing: folds 
paul853: calls $0.01
Howardhof: checks 
*** FLOP *** [2h 7d 4d]
paul853: checks 
Howardhof: checks 
whichspell: checks 
*** TURN *** [2h 7d 4d] [Kd]
paul853: checks 
Howardhof: checks 
whichspell: bets $0.06
paul853: folds 
Howardhof: folds 
Uncalled bet ($0.06) returned to whichspell
whichspell collected $0.06 from pot
whichspell: doesn't show hand 
*** SUMMARY ***
Total pot $0.06 | Rake $0 
Board [2h 7d 4d Kd]
Seat 2: ahophing (button) folded before Flop (didn't bet)
Seat 3: paul853 (small blind) folded on the Turn
Seat 4: Howardhof (big blind) folded on the Turn
Seat 5: CashMatteo folded before Flop (didn't bet)
Seat 6: whichspell collected ($0.06)

Hand #2128: 

PokerStars Hand #250519378762:  Hold'em No Limit ($0.01/$0.02 CAD) - 2024/05/15 17:24:13 ET
Table 'Gedania IV' 6-max Seat #3 is the button
Seat 2: ahophing ($2 in chips) 
Seat 3: paul853 ($1.94 in chips) 
Seat 4: Howardhof ($1.39 in chips) 
Seat 5: CashMatteo ($7.93 in chips) 
Seat 6: whichspell ($1.76 in chips) 
Howardhof: posts small blind $0.01
CashMatteo: posts big blind $0.02
*** HOLE CARDS ***
Dealt to CashMatteo [Qs Ac]
whichspell: folds 
ahophing: folds 
paul853: raises $0.05 to $0.07
Howardhof: calls $0.06
CashMatteo: raises $0.19 to $0.26
paul853: raises $1.68 to $1.94 and is all-in
Howardhof: calls $1.32 and is all-in
CashMatteo: calls $1.68
*** FLOP *** [Qh Td 3c]
*** TURN *** [Qh Td 3c] [7h]
*** RIVER *** [Qh Td 3c 7h] [2d]
*** SHOW DOWN ***
CashMatteo: shows [Qs Ac] (a pair of Queens)
paul853: shows [8d 8c] (a pair of Eights)
CashMatteo collected $1.07 from side pot
Howardhof: shows [Ks Kc] (a pair of Kings)
Howardhof collected $4.02 from main pot
*** SUMMARY ***
Total pot $5.27 Main pot $4.02. Side pot $1.07. | Rake $0.18 
Board [Qh Td 3c 7h 2d]
Seat 2: ahophing folded before Flop (didn't bet)
Seat 3: paul853 (button) showed [8d 8c] and lost with a pair of Eights
Seat 4: Howardhof (small blind) showed [Ks Kc] and won ($4.02) with a pair of Kings
Seat 5: CashMatteo (big blind) showed [Qs Ac] and won ($1.07) with a pair of Queens
Seat 6: whichspell folded before Flop (didn't bet)

Hand #2129: 

PokerStars Hand #250519385238:  Hold'em No Limit ($0.01/$0.02 CAD) - 2024/05/15 17:24:32 ET
Table 'Thuban III' 6-max Seat #1 is the button
Seat 1: rubey2steps ($0.91 in chips) 
Seat 2: hotdog1948 ($2.95 in chips) 
Seat 4: LoboR1 ($2 in chips) 
Seat 5: CashMatteo ($3.03 in chips) 
Seat 6: ahophing ($4.16 in chips) 
hotdog1948: posts small blind $0.01
LoboR1: posts big blind $0.02
*** HOLE CARDS ***
Dealt to CashMatteo [8s 7s]
CashMatteo: calls $0.02
ahophing: folds 
rubey2steps: folds 
hotdog1948: raises $0.06 to $0.08
LoboR1: folds 
CashMatteo: calls $0.06
*** FLOP *** [Kh Ac Ad]
hotdog1948: bets $0.17
CashMatteo: folds 
Uncalled bet ($0.17) returned to hotdog1948
hotdog1948 collected $0.17 from pot
*** SUMMARY ***
Total pot $0.18 | Rake $0.01 
Board [Kh Ac Ad]
Seat 1: rubey2steps (button) folded before Flop (didn't bet)
Seat 2: hotdog1948 (small blind) collected ($0.17)
Seat 4: LoboR1 (big blind) folded before Flop
Seat 5: CashMatteo folded on the Flop
Seat 6: ahophing folded before Flop (didn't bet)

Hand #2130: 

PokerStars Hand #250519389631:  Hold'em No Limit ($0.01/$0.02 CAD) - 2024/05/15 17:24:45 ET
Table 'Gedania IV' 6-max Seat #4 is the button
Seat 2: ahophing ($2 in chips) 
Seat 4: Howardhof ($4.02 in chips) 
Seat 5: CashMatteo ($7.06 in chips) 
Seat 6: whichspell ($1.76 in chips) 
CashMatteo: posts small blind $0.01
whichspell: posts big blind $0.02
*** HOLE CARDS ***
Dealt to CashMatteo [Jh Th]
ahophing: calls $0.02
Howardhof: calls $0.02
paul853 leaves the table
CashMatteo: calls $0.01
whichspell: raises $0.08 to $0.10
ahophing: folds 
Howardhof: calls $0.08
CashMatteo: calls $0.08
*** FLOP *** [7h 8s 8c]
CashMatteo: checks 
whichspell: checks 
Howardhof: checks 
*** TURN *** [7h 8s 8c] [5d]
CashMatteo: checks 
whichspell: checks 
Howardhof: checks 
*** RIVER *** [7h 8s 8c 5d] [6d]
CashMatteo: bets $0.16
whichspell: raises $0.16 to $0.32
Howardhof: folds 
CashMatteo: folds 
Uncalled bet ($0.16) returned to whichspell
whichspell collected $0.62 from pot
whichspell: doesn't show hand 
*** SUMMARY ***
Total pot $0.64 | Rake $0.02 
Board [7h 8s 8c 5d 6d]
Seat 2: ahophing folded before Flop
Seat 4: Howardhof (button) folded on the River
Seat 5: CashMatteo (small blind) folded on the River
Seat 6: whichspell (big blind) collected ($0.62)

Hand #2131: 

PokerStars Hand #250519403851:  Hold'em No Limit ($0.01/$0.02 CAD) - 2024/05/15 17:25:26 ET
Table 'Thuban III' 6-max Seat #2 is the button
Seat 1: rubey2steps ($0.91 in chips) 
Seat 2: hotdog1948 ($3.04 in chips) 
Seat 4: LoboR1 ($2 in chips) 
Seat 5: CashMatteo ($2.95 in chips) 
Seat 6: ahophing ($4.16 in chips) 
LoboR1: posts small blind $0.01
CashMatteo: posts big blind $0.02
*** HOLE CARDS ***
Dealt to CashMatteo [Ks Th]
ahophing: folds 
rubey2steps: folds 
hotdog1948: raises $0.05 to $0.07
LoboR1: folds 
CashMatteo: calls $0.05
*** FLOP *** [2c Tc 4c]
CashMatteo: checks 
hotdog1948: bets $0.14
CashMatteo: calls $0.14
*** TURN *** [2c Tc 4c] [Qc]
CashMatteo: checks 
hotdog1948: checks 
*** RIVER *** [2c Tc 4c Qc] [9h]
CashMatteo: bets $0.21
hotdog1948: folds 
Uncalled bet ($0.21) returned to CashMatteo
CashMatteo collected $0.41 from pot
CashMatteo: doesn't show hand 
*** SUMMARY ***
Total pot $0.43 | Rake $0.02 
Board [2c Tc 4c Qc 9h]
Seat 1: rubey2steps folded before Flop (didn't bet)
Seat 2: hotdog1948 (button) folded on the River
Seat 4: LoboR1 (small blind) folded before Flop
Seat 5: CashMatteo (big blind) collected ($0.41)
Seat 6: ahophing folded before Flop (didn't bet)

Hand #2132: 

PokerStars Hand #250519411033:  Hold'em No Limit ($0.01/$0.02 CAD) - 2024/05/15 17:25:47 ET
Table 'Gedania IV' 6-max Seat #5 is the button
Seat 2: ahophing ($2 in chips) 
Seat 4: Howardhof ($3.92 in chips) 
Seat 5: CashMatteo ($6.80 in chips) 
Seat 6: whichspell ($2.12 in chips) 
whichspell: posts small blind $0.01
ahophing: posts big blind $0.02
*** HOLE CARDS ***
Dealt to CashMatteo [3s 8d]
Howardhof: calls $0.02
CashMatteo: folds 
whichspell: raises $0.08 to $0.10
ahophing: folds 
Howardhof: raises $0.08 to $0.18
whichspell: calls $0.08
*** FLOP *** [6d 5c Jh]
whichspell: checks 
theepan895 was removed from the table for failing to post
theepan895 leaves the table
Howardhof: bets $0.19
whichspell: calls $0.19
*** TURN *** [6d 5c Jh] [9d]
whichspell: checks 
Indie993 joins the table at seat #1 
Howardhof: bets $0.37
Allinkoo joins the table at seat #3 
whichspell: calls $0.37
*** RIVER *** [6d 5c Jh 9d] [2c]
whichspell: checks 
Howardhof: checks 
*** SHOW DOWN ***
whichspell: shows [Ac 7d] (high card Ace)
Howardhof: shows [As Ks] (high card Ace - King kicker)
Howardhof collected $1.45 from pot
*** SUMMARY ***
Total pot $1.50 | Rake $0.05 
Board [6d 5c Jh 9d 2c]
Seat 2: ahophing (big blind) folded before Flop
Seat 4: Howardhof showed [As Ks] and won ($1.45) with high card Ace
Seat 5: CashMatteo (button) folded before Flop (didn't bet)
Seat 6: whichspell (small blind) showed [Ac 7d] and lost with high card Ace

Hand #2133: 

PokerStars Hand #250519418023:  Hold'em No Limit ($0.01/$0.02 CAD) - 2024/05/15 17:26:07 ET
Table 'Thuban III' 6-max Seat #4 is the button
Seat 1: rubey2steps ($0.91 in chips) 
Seat 2: hotdog1948 ($2.83 in chips) 
Seat 4: LoboR1 ($2 in chips) 
Seat 5: CashMatteo ($3.15 in chips) 
Seat 6: ahophing ($4.16 in chips) 
CashMatteo: posts small blind $0.01
ahophing: posts big blind $0.02
*** HOLE CARDS ***
Dealt to CashMatteo [2c 5d]
rubey2steps: calls $0.02
hotdog1948: folds 
LoboR1: folds 
CashMatteo: folds 
ahophing: checks 
*** FLOP *** [Qh Jc Th]
ahophing: checks 
rubey2steps: checks 
*** TURN *** [Qh Jc Th] [Jd]
ahophing: checks 
rubey2steps: checks 
*** RIVER *** [Qh Jc Th Jd] [Kh]
ahophing: checks 
rubey2steps: checks 
*** SHOW DOWN ***
ahophing: shows [7d 3s] (a pair of Jacks)
rubey2steps: shows [Kd 8h] (two pair, Kings and Jacks)
rubey2steps collected $0.05 from pot
*** SUMMARY ***
Total pot $0.05 | Rake $0 
Board [Qh Jc Th Jd Kh]
Seat 1: rubey2steps showed [Kd 8h] and won ($0.05) with two pair, Kings and Jacks
Seat 2: hotdog1948 folded before Flop (didn't bet)
Seat 4: LoboR1 (button) folded before Flop (didn't bet)
Seat 5: CashMatteo (small blind) folded before Flop
Seat 6: ahophing (big blind) showed [7d 3s] and lost with a pair of Jacks

Hand #2134: 

PokerStars Hand #250519427635:  Hold'em No Limit ($0.01/$0.02 CAD) - 2024/05/15 17:26:35 ET
Table 'Thuban III' 6-max Seat #5 is the button
Seat 1: rubey2steps ($0.94 in chips) 
Seat 2: hotdog1948 ($2.83 in chips) 
Seat 4: LoboR1 ($2 in chips) 
Seat 5: CashMatteo ($3.14 in chips) 
Seat 6: ahophing ($4.14 in chips) 
ahophing: posts small blind $0.01
rubey2steps: posts big blind $0.02
grandmasteel: sits out 
*** HOLE CARDS ***
Dealt to CashMatteo [2s Ts]
hotdog1948: raises $0.02 to $0.04
LoboR1: calls $0.04
CashMatteo: calls $0.04
ahophing: calls $0.03
rubey2steps: calls $0.02
*** FLOP *** [Qc 6h 6c]
ahophing: checks 
rubey2steps: bets $0.02
hotdog1948: calls $0.02
LoboR1: folds 
CashMatteo: calls $0.02
ahophing: calls $0.02
*** TURN *** [Qc 6h 6c] [8h]
ahophing: checks 
rubey2steps: checks 
hotdog1948: bets $0.02
CashMatteo: calls $0.02
ahophing: calls $0.02
rubey2steps: calls $0.02
*** RIVER *** [Qc 6h 6c 8h] [Js]
ahophing: bets $0.12
rubey2steps: folds 
hotdog1948: folds 
CashMatteo: folds 
Uncalled bet ($0.12) returned to ahophing
ahophing collected $0.35 from pot
ahophing: doesn't show hand 
*** SUMMARY ***
Total pot $0.36 | Rake $0.01 
Board [Qc 6h 6c 8h Js]
Seat 1: rubey2steps (big blind) folded on the River
Seat 2: hotdog1948 folded on the River
Seat 4: LoboR1 folded on the Flop
Seat 5: CashMatteo (button) folded on the River
Seat 6: ahophing (small blind) collected ($0.35)

Hand #2135: 

PokerStars Hand #250519432590:  Hold'em No Limit ($0.01/$0.02 CAD) - 2024/05/15 17:26:49 ET
Table 'Gedania IV' 6-max Seat #2 is the button
Seat 1: Indie993 ($0.80 in chips) 
Seat 2: ahophing ($2 in chips) 
Seat 4: Howardhof ($4.63 in chips) 
Seat 5: CashMatteo ($6.80 in chips) 
Allinkoo will be allowed to play after the button
Howardhof: posts small blind $0.01
CashMatteo: posts big blind $0.02
Indie993: posts big blind $0.02
*** HOLE CARDS ***
Dealt to CashMatteo [Qd 4c]
whichspell leaves the table
Indie993: checks 
ahophing: folds 
Howardhof: calls $0.01
CashMatteo: checks 
*** FLOP *** [4s Th Qs]
Howardhof: checks 
CashMatteo: checks 
Indie993: bets $0.06
Howardhof: calls $0.06
CashMatteo: calls $0.06
*** TURN *** [4s Th Qs] [Kd]
Howardhof: checks 
CashMatteo: bets $0.14
Indie993: calls $0.14
Howardhof: calls $0.14
*** RIVER *** [4s Th Qs Kd] [2c]
Howardhof: checks 
CashMatteo: bets $0.60
Indie993: calls $0.58 and is all-in
Howardhof: raises $3.81 to $4.41 and is all-in
CashMatteo: calls $3.81
*** SHOW DOWN ***
Howardhof: shows [Js Ac] (a straight, Ten to Ace)
CashMatteo: shows [Qd 4c] (two pair, Queens and Fours)
Howardhof collected $7.44 from side pot
Indie993: shows [Kh Qh] (two pair, Kings and Queens)
Howardhof collected $2.32 from main pot
*** SUMMARY ***
Total pot $10.06 Main pot $2.32. Side pot $7.44. | Rake $0.30 
Board [4s Th Qs Kd 2c]
Seat 1: Indie993 showed [Kh Qh] and lost with two pair, Kings and Queens
Seat 2: ahophing (button) folded before Flop (didn't bet)
Seat 4: Howardhof (small blind) showed [Js Ac] and won ($9.76) with a straight, Ten to Ace
Seat 5: CashMatteo (big blind) showed [Qd 4c] and lost with two pair, Queens and Fours

Hand #2136: 

PokerStars Hand #250519452778:  Hold'em No Limit ($0.01/$0.02 CAD) - 2024/05/15 17:27:46 ET
Table 'Thuban III' 6-max Seat #6 is the button
Seat 1: rubey2steps ($0.86 in chips) 
Seat 2: hotdog1948 ($2.75 in chips) 
Seat 4: LoboR1 ($2 in chips) 
Seat 5: CashMatteo ($3.06 in chips) 
Seat 6: ahophing ($4.41 in chips) 
rubey2steps: posts small blind $0.01
hotdog1948: posts big blind $0.02
grandmasteel: sits out 
*** HOLE CARDS ***
Dealt to CashMatteo [3c Ah]
LoboR1: folds 
CashMatteo: calls $0.02
ahophing: calls $0.02
rubey2steps: folds 
hotdog1948: checks 
*** FLOP *** [5h 9s 3d]
hotdog1948: bets $0.02
CashMatteo: calls $0.02
ahophing: folds 
*** TURN *** [5h 9s 3d] [Qd]
hotdog1948: bets $0.11
CashMatteo: calls $0.11
*** RIVER *** [5h 9s 3d Qd] [8d]
hotdog1948: bets $0.74
CashMatteo: folds 
Uncalled bet ($0.74) returned to hotdog1948
hotdog1948 collected $0.32 from pot
*** SUMMARY ***
Total pot $0.33 | Rake $0.01 
Board [5h 9s 3d Qd 8d]
Seat 1: rubey2steps (small blind) folded before Flop
Seat 2: hotdog1948 (big blind) collected ($0.32)
Seat 4: LoboR1 folded before Flop (didn't bet)
Seat 5: CashMatteo folded on the River
Seat 6: ahophing (button) folded on the Flop

Hand #2137: 

PokerStars Hand #250519456005:  Hold'em No Limit ($0.01/$0.02 CAD) - 2024/05/15 17:27:55 ET
Table 'Gedania IV' 6-max Seat #4 is the button
Seat 2: ahophing ($2 in chips) 
Seat 3: Allinkoo ($1.60 in chips) 
Seat 4: Howardhof ($9.76 in chips) 
Seat 5: CashMatteo ($2.17 in chips) 
CashMatteo: posts small blind $0.01
ahophing: posts big blind $0.02
Allinkoo: posts big blind $0.02
*** HOLE CARDS ***
Dealt to CashMatteo [7s 7d]
Allinkoo: checks 
Howardhof: folds 
paul853 joins the table at seat #6 
CashMatteo: raises $0.03 to $0.05
ahophing: folds 
Allinkoo: calls $0.03
*** FLOP *** [3s 6d 2h]
CashMatteo: bets $0.06
Allinkoo: calls $0.06
*** TURN *** [3s 6d 2h] [4d]
CashMatteo: bets $0.18
Allinkoo: folds 
Uncalled bet ($0.18) returned to CashMatteo
CashMatteo collected $0.23 from pot
CashMatteo: doesn't show hand 
*** SUMMARY ***
Total pot $0.24 | Rake $0.01 
Board [3s 6d 2h 4d]
Seat 2: ahophing (big blind) folded before Flop
Seat 3: Allinkoo folded on the Turn
Seat 4: Howardhof (button) folded before Flop (didn't bet)
Seat 5: CashMatteo (small blind) collected ($0.23)

Hand #2138: 

PokerStars Hand #250519469593:  Hold'em No Limit ($0.01/$0.02 CAD) - 2024/05/15 17:28:34 ET
Table 'Gedania IV' 6-max Seat #5 is the button
Seat 2: ahophing ($2 in chips) 
Seat 3: Allinkoo ($1.49 in chips) 
Seat 4: Howardhof ($9.76 in chips) 
Seat 5: CashMatteo ($2.29 in chips) 
paul853 will be allowed to play after the button
Indie993 will be allowed to play after the button
ahophing: posts small blind $0.01
Allinkoo: posts big blind $0.02
*** HOLE CARDS ***
Dealt to CashMatteo [4s 6d]
Howardhof: calls $0.02
CashMatteo: folds 
ahophing: calls $0.01
Allinkoo: checks 
*** FLOP *** [8c 9h Ts]
ahophing: checks 
Allinkoo: bets $0.06
Howardhof: folds 
ahophing: folds 
Uncalled bet ($0.06) returned to Allinkoo
Allinkoo collected $0.06 from pot
*** SUMMARY ***
Total pot $0.06 | Rake $0 
Board [8c 9h Ts]
Seat 2: ahophing (small blind) folded on the Flop
Seat 3: Allinkoo (big blind) collected ($0.06)
Seat 4: Howardhof folded on the Flop
Seat 5: CashMatteo (button) folded before Flop (didn't bet)

Hand #2139: 

PokerStars Hand #250519470898:  Hold'em No Limit ($0.01/$0.02 CAD) - 2024/05/15 17:28:37 ET
Table 'Thuban III' 6-max Seat #1 is the button
Seat 1: rubey2steps ($0.85 in chips) 
Seat 2: hotdog1948 ($2.92 in chips) 
Seat 3: grandmasteel ($1.83 in chips) 
Seat 4: LoboR1 ($2 in chips) 
Seat 5: CashMatteo ($2.91 in chips) 
Seat 6: ahophing ($4.39 in chips) 
hotdog1948: posts small blind $0.01
grandmasteel: posts big blind $0.02
*** HOLE CARDS ***
Dealt to CashMatteo [9s 3d]
LoboR1: folds 
CashMatteo: folds 
ahophing: folds 
rubey2steps: folds 
hotdog1948: raises $0.02 to $0.04
grandmasteel: folds 
Uncalled bet ($0.02) returned to hotdog1948
hotdog1948 collected $0.04 from pot
*** SUMMARY ***
Total pot $0.04 | Rake $0 
Seat 1: rubey2steps (button) folded before Flop (didn't bet)
Seat 2: hotdog1948 (small blind) collected ($0.04)
Seat 3: grandmasteel (big blind) folded before Flop
Seat 4: LoboR1 folded before Flop (didn't bet)
Seat 5: CashMatteo folded before Flop (didn't bet)
Seat 6: ahophing folded before Flop (didn't bet)

Hand #2140: 

PokerStars Hand #250519474958:  Hold'em No Limit ($0.01/$0.02 CAD) - 2024/05/15 17:28:49 ET
Table 'Thuban III' 6-max Seat #2 is the button
Seat 1: rubey2steps ($0.85 in chips) 
Seat 2: hotdog1948 ($2.94 in chips) 
Seat 3: grandmasteel ($1.81 in chips) 
Seat 4: LoboR1 ($2 in chips) 
Seat 5: CashMatteo ($2.91 in chips) 
Seat 6: ahophing ($4.39 in chips) 
grandmasteel: posts small blind $0.01
LoboR1: posts big blind $0.02
*** HOLE CARDS ***
Dealt to CashMatteo [Qd 4h]
CashMatteo: calls $0.02
ahophing: folds 
rubey2steps: calls $0.02
hotdog1948: raises $0.09 to $0.11
grandmasteel: calls $0.10
LoboR1: folds 
CashMatteo: folds 
rubey2steps: folds 
*** FLOP *** [5d 3h 6d]
grandmasteel: checks 
hotdog1948: bets $0.27
grandmasteel: folds [Ad Tc]
Uncalled bet ($0.27) returned to hotdog1948
hotdog1948 collected $0.27 from pot
*** SUMMARY ***
Total pot $0.28 | Rake $0.01 
Board [5d 3h 6d]
Seat 1: rubey2steps folded before Flop
Seat 2: hotdog1948 (button) collected ($0.27)
Seat 3: grandmasteel (small blind) folded on the Flop
Seat 4: LoboR1 (big blind) folded before Flop
Seat 5: CashMatteo folded before Flop
Seat 6: ahophing folded before Flop (didn't bet)

Hand #2141: 

PokerStars Hand #250519477260:  Hold'em No Limit ($0.01/$0.02 CAD) - 2024/05/15 17:28:55 ET
Table 'Gedania IV' 6-max Seat #2 is the button
Seat 1: Indie993 ($0.80 in chips) 
Seat 2: ahophing ($2 in chips) 
Seat 3: Allinkoo ($1.53 in chips) 
Seat 4: Howardhof ($9.74 in chips) 
Seat 5: CashMatteo ($2.29 in chips) 
Seat 6: paul853 ($1.60 in chips) 
Allinkoo: posts small blind $0.01
Howardhof: posts big blind $0.02
paul853: posts big blind $0.02
Indie993: posts small & big blinds $0.03
*** HOLE CARDS ***
Dealt to CashMatteo [4d 2s]
CashMatteo: folds 
paul853: checks 
Indie993: checks 
ahophing: folds 
Allinkoo: calls $0.01
Howardhof: checks 
*** FLOP *** [Tc 5c Ks]
Allinkoo: bets $0.06
Howardhof: folds 
paul853: folds 
Indie993: calls $0.06
*** TURN *** [Tc 5c Ks] [Kd]
Allinkoo: checks 
Indie993: checks 
*** RIVER *** [Tc 5c Ks Kd] [4s]
Allinkoo: bets $0.10
Indie993: calls $0.10
*** SHOW DOWN ***
Allinkoo: shows [Ts 2h] (two pair, Kings and Tens)
Indie993: shows [Th Qs] (two pair, Kings and Tens - Queen kicker)
Indie993 collected $0.40 from pot
*** SUMMARY ***
Total pot $0.41 | Rake $0.01 
Board [Tc 5c Ks Kd 4s]
Seat 1: Indie993 showed [Th Qs] and won ($0.40) with two pair, Kings and Tens
Seat 2: ahophing (button) folded before Flop (didn't bet)
Seat 3: Allinkoo (small blind) showed [Ts 2h] and lost with two pair, Kings and Tens
Seat 4: Howardhof (big blind) folded on the Flop
Seat 5: CashMatteo folded before Flop (didn't bet)
Seat 6: paul853 folded on the Flop (didn't bet)

Hand #2142: 

PokerStars Hand #250519486616:  Hold'em No Limit ($0.01/$0.02 CAD) - 2024/05/15 17:29:22 ET
Table 'Thuban III' 6-max Seat #3 is the button
Seat 1: rubey2steps ($0.83 in chips) 
Seat 2: hotdog1948 ($3.10 in chips) 
Seat 3: grandmasteel ($1.70 in chips) 
Seat 4: LoboR1 ($2 in chips) 
Seat 5: CashMatteo ($2.89 in chips) 
Seat 6: ahophing ($4.39 in chips) 
LoboR1: posts small blind $0.01
CashMatteo: posts big blind $0.02
*** HOLE CARDS ***
Dealt to CashMatteo [As 3s]
ahophing: folds 
rubey2steps: folds 
hotdog1948: folds 
grandmasteel: folds 
LoboR1: folds 
Uncalled bet ($0.01) returned to CashMatteo
CashMatteo collected $0.02 from pot
CashMatteo: doesn't show hand 
*** SUMMARY ***
Total pot $0.02 | Rake $0 
Seat 1: rubey2steps folded before Flop (didn't bet)
Seat 2: hotdog1948 folded before Flop (didn't bet)
Seat 3: grandmasteel (button) folded before Flop (didn't bet)
Seat 4: LoboR1 (small blind) folded before Flop
Seat 5: CashMatteo (big blind) collected ($0.02)
Seat 6: ahophing folded before Flop (didn't bet)

Hand #2143: 

PokerStars Hand #250519487677:  Hold'em No Limit ($0.01/$0.02 CAD) - 2024/05/15 17:29:25 ET
Table 'Gedania IV' 6-max Seat #3 is the button
Seat 1: Indie993 ($1.01 in chips) 
Seat 2: ahophing ($2 in chips) 
Seat 3: Allinkoo ($1.35 in chips) 
Seat 4: Howardhof ($9.72 in chips) 
Seat 5: CashMatteo ($2.29 in chips) 
Seat 6: paul853 ($1.58 in chips) 
Howardhof: posts small blind $0.01
CashMatteo: posts big blind $0.02
*** HOLE CARDS ***
Dealt to CashMatteo [Jd 2s]
paul853: calls $0.02
Indie993: folds 
ahophing: folds 
Allinkoo: folds 
Howardhof: folds 
CashMatteo: checks 
*** FLOP *** [3h Kd 9h]
CashMatteo: checks 
paul853: checks 
*** TURN *** [3h Kd 9h] [9s]
CashMatteo: checks 
paul853: checks 
*** RIVER *** [3h Kd 9h 9s] [2c]
CashMatteo: bets $0.03
paul853: folds 
Uncalled bet ($0.03) returned to CashMatteo
CashMatteo collected $0.05 from pot
CashMatteo: doesn't show hand 
*** SUMMARY ***
Total pot $0.05 | Rake $0 
Board [3h Kd 9h 9s 2c]
Seat 1: Indie993 folded before Flop (didn't bet)
Seat 2: ahophing folded before Flop (didn't bet)
Seat 3: Allinkoo (button) folded before Flop (didn't bet)
Seat 4: Howardhof (small blind) folded before Flop
Seat 5: CashMatteo (big blind) collected ($0.05)
Seat 6: paul853 folded on the River

Hand #2144: 

PokerStars Hand #250519492386:  Hold'em No Limit ($0.01/$0.02 CAD) - 2024/05/15 17:29:39 ET
Table 'Thuban III' 6-max Seat #4 is the button
Seat 1: rubey2steps ($0.83 in chips) 
Seat 2: hotdog1948 ($3.10 in chips) 
Seat 3: grandmasteel ($1.70 in chips) 
Seat 4: LoboR1 ($2 in chips) 
Seat 5: CashMatteo ($2.90 in chips) 
CashMatteo: posts small blind $0.01
rubey2steps: posts big blind $0.02
*** HOLE CARDS ***
Dealt to CashMatteo [Qs 2c]
hotdog1948: folds 
grandmasteel: calls $0.02
LoboR1: folds 
CashMatteo: calls $0.01
rubey2steps: checks 
*** FLOP *** [Jh 9s 4d]
CashMatteo: checks 
rubey2steps: checks 
grandmasteel: bets $0.22
CashMatteo: folds 
rubey2steps: folds 
Uncalled bet ($0.22) returned to grandmasteel
grandmasteel collected $0.06 from pot
grandmasteel: doesn't show hand 
*** SUMMARY ***
Total pot $0.06 | Rake $0 
Board [Jh 9s 4d]
Seat 1: rubey2steps (big blind) folded on the Flop
Seat 2: hotdog1948 folded before Flop (didn't bet)
Seat 3: grandmasteel collected ($0.06)
Seat 4: LoboR1 (button) folded before Flop (didn't bet)
Seat 5: CashMatteo (small blind) folded on the Flop

Hand #2145: 

PokerStars Hand #250519497053:  Hold'em No Limit ($0.01/$0.02 CAD) - 2024/05/15 17:29:52 ET
Table 'Gedania IV' 6-max Seat #4 is the button
Seat 1: Indie993 ($1.01 in chips) 
Seat 2: ahophing ($2 in chips) 
Seat 3: Allinkoo ($1.35 in chips) 
Seat 4: Howardhof ($9.71 in chips) 
Seat 5: CashMatteo ($2.32 in chips) 
Seat 6: paul853 ($1.56 in chips) 
CashMatteo: posts small blind $0.01
paul853: posts big blind $0.02
*** HOLE CARDS ***
Dealt to CashMatteo [6s 2h]
Indie993: folds 
ahophing: folds 
Allinkoo: calls $0.02
Howardhof: calls $0.02
CashMatteo: folds 
paul853: checks 
*** FLOP *** [9s 6c Ah]
paul853: checks 
Allinkoo: checks 
Howardhof: checks 
*** TURN *** [9s 6c Ah] [Ad]
paul853: checks 
Allinkoo: checks 
Howardhof: checks 
*** RIVER *** [9s 6c Ah Ad] [3h]
paul853: checks 
Allinkoo: bets $0.06
Howardhof: folds 
paul853: folds 
Uncalled bet ($0.06) returned to Allinkoo
Allinkoo collected $0.07 from pot
*** SUMMARY ***
Total pot $0.07 | Rake $0 
Board [9s 6c Ah Ad 3h]
Seat 1: Indie993 folded before Flop (didn't bet)
Seat 2: ahophing folded before Flop (didn't bet)
Seat 3: Allinkoo collected ($0.07)
Seat 4: Howardhof (button) folded on the River
Seat 5: CashMatteo (small blind) folded before Flop
Seat 6: paul853 (big blind) folded on the River

Hand #2146: 

PokerStars Hand #250519509531:  Hold'em No Limit ($0.01/$0.02 CAD) - 2024/05/15 17:30:29 ET
Table 'Gedania IV' 6-max Seat #5 is the button
Seat 1: Indie993 ($1.01 in chips) 
Seat 2: ahophing ($2 in chips) 
Seat 3: Allinkoo ($1.40 in chips) 
Seat 4: Howardhof ($9.69 in chips) 
Seat 5: CashMatteo ($2.31 in chips) 
Seat 6: paul853 ($1.54 in chips) 
paul853: posts small blind $0.01
Indie993: posts big blind $0.02
*** HOLE CARDS ***
Dealt to CashMatteo [2s Ks]
ahophing: folds 
Allinkoo: folds 
Howardhof: folds 
CashMatteo: raises $0.03 to $0.05
paul853: calls $0.04
Indie993: calls $0.03
*** FLOP *** [Td Qd 2d]
paul853: checks 
Indie993: checks 
CashMatteo: bets $0.14
paul853: folds 
Indie993: folds 
Uncalled bet ($0.14) returned to CashMatteo
CashMatteo collected $0.14 from pot
CashMatteo: doesn't show hand 
*** SUMMARY ***
Total pot $0.15 | Rake $0.01 
Board [Td Qd 2d]
Seat 1: Indie993 (big blind) folded on the Flop
Seat 2: ahophing folded before Flop (didn't bet)
Seat 3: Allinkoo folded before Flop (didn't bet)
Seat 4: Howardhof folded before Flop (didn't bet)
Seat 5: CashMatteo (button) collected ($0.14)
Seat 6: paul853 (small blind) folded on the Flop

Hand #2147: 

PokerStars Hand #250519513253:  Hold'em No Limit ($0.01/$0.02 CAD) - 2024/05/15 17:30:39 ET
Table 'Thuban III' 6-max Seat #5 is the button
Seat 1: rubey2steps ($0.81 in chips) 
Seat 2: hotdog1948 ($3.10 in chips) 
Seat 3: grandmasteel ($1.74 in chips) 
Seat 4: LoboR1 ($2 in chips) 
Seat 5: CashMatteo ($2.88 in chips) 
rubey2steps: posts small blind $0.01
hotdog1948: posts big blind $0.02
*** HOLE CARDS ***
Dealt to CashMatteo [Js Qc]
grandmasteel: calls $0.02
LoboR1: folds 
CashMatteo: raises $0.03 to $0.05
rubey2steps: calls $0.04
hotdog1948: raises $0.17 to $0.22
grandmasteel: folds 
CashMatteo: calls $0.17
rubey2steps: calls $0.17
*** FLOP *** [9h 7d 3d]
rubey2steps: checks 
hotdog1948: bets $2.88 and is all-in
CashMatteo: folds 
rubey2steps: folds 
Uncalled bet ($2.88) returned to hotdog1948
hotdog1948 collected $0.66 from pot
*** SUMMARY ***
Total pot $0.68 | Rake $0.02 
Board [9h 7d 3d]
Seat 1: rubey2steps (small blind) folded on the Flop
Seat 2: hotdog1948 (big blind) collected ($0.66)
Seat 3: grandmasteel folded before Flop
Seat 4: LoboR1 folded before Flop (didn't bet)
Seat 5: CashMatteo (button) folded on the Flop

Hand #2148: 

PokerStars Hand #250519520235:  Hold'em No Limit ($0.01/$0.02 CAD) - 2024/05/15 17:30:59 ET
Table 'Gedania IV' 6-max Seat #6 is the button
Seat 1: Indie993 ($0.96 in chips) 
Seat 3: Allinkoo ($1.40 in chips) 
Seat 4: Howardhof ($9.69 in chips) 
Seat 5: CashMatteo ($2.40 in chips) 
Seat 6: paul853 ($1.49 in chips) 
Indie993: posts small blind $0.01
Allinkoo: posts big blind $0.02
*** HOLE CARDS ***
Dealt to CashMatteo [Kd 6c]
Howardhof: calls $0.02
CashMatteo: calls $0.02
paul853: calls $0.02
Indie993: calls $0.01
Allinkoo: raises $0.04 to $0.06
Howardhof: calls $0.04
CashMatteo: folds 
paul853: calls $0.04
Indie993: calls $0.04
*** FLOP *** [9s Jc 2c]
Indie993: checks 
Allinkoo: checks 
Howardhof: bets $0.25
paul853: calls $0.25
Indie993: calls $0.25
Allinkoo: folds 
*** TURN *** [9s Jc 2c] [Qc]
Indie993: checks 
Howardhof: bets $0.49
paul853: raises $0.69 to $1.18 and is all-in
Indie993: folds 
Howardhof: calls $0.69
*** RIVER *** [9s Jc 2c Qc] [Jd]
*** SHOW DOWN ***
Howardhof: shows [Jh Kc] (three of a kind, Jacks)
paul853: shows [4c 7c] (a flush, Queen high)
paul853 collected $3.25 from pot
*** SUMMARY ***
Total pot $3.37 | Rake $0.12 
Board [9s Jc 2c Qc Jd]
Seat 1: Indie993 (small blind) folded on the Turn
Seat 3: Allinkoo (big blind) folded on the Flop
Seat 4: Howardhof showed [Jh Kc] and lost with three of a kind, Jacks
Seat 5: CashMatteo folded before Flop
Seat 6: paul853 (button) showed [4c 7c] and won ($3.25) with a flush, Queen high

Hand #2149: 

PokerStars Hand #250519531981:  Hold'em No Limit ($0.01/$0.02 CAD) - 2024/05/15 17:31:33 ET
Table 'Thuban III' 6-max Seat #1 is the button
Seat 1: rubey2steps ($0.59 in chips) 
Seat 2: hotdog1948 ($3.54 in chips) 
Seat 3: grandmasteel ($1.72 in chips) 
Seat 4: LoboR1 ($2 in chips) 
Seat 5: CashMatteo ($2.66 in chips) 
hotdog1948: posts small blind $0.01
grandmasteel: posts big blind $0.02
*** HOLE CARDS ***
Dealt to CashMatteo [Jd Qd]
LoboR1: folds 
CashMatteo: raises $0.05 to $0.07
rubey2steps: raises $0.52 to $0.59 and is all-in
hotdog1948: calls $0.58
grandmasteel: folds 
CashMatteo: calls $0.52
*** FLOP *** [2s 4d Kc]
hotdog1948: bets $2.95 and is all-in
CashMatteo: folds 
Uncalled bet ($2.95) returned to hotdog1948
*** TURN *** [2s 4d Kc] [Kh]
*** RIVER *** [2s 4d Kc Kh] [Qc]
*** SHOW DOWN ***
hotdog1948: shows [Ks Th] (three of a kind, Kings)
rubey2steps: shows [9d 9c] (two pair, Kings and Nines)
hotdog1948 collected $1.73 from pot
*** SUMMARY ***
Total pot $1.79 | Rake $0.06 
Board [2s 4d Kc Kh Qc]
Seat 1: rubey2steps (button) showed [9d 9c] and lost with two pair, Kings and Nines
Seat 2: hotdog1948 (small blind) showed [Ks Th] and won ($1.73) with three of a kind, Kings
Seat 3: grandmasteel (big blind) folded before Flop
Seat 4: LoboR1 folded before Flop (didn't bet)
Seat 5: CashMatteo folded on the Flop

Hand #2150: 

PokerStars Hand #250519537535:  Hold'em No Limit ($0.01/$0.02 CAD) - 2024/05/15 17:31:49 ET
Table 'Gedania IV' 6-max Seat #1 is the button
Seat 1: Indie993 ($0.65 in chips) 
Seat 3: Allinkoo ($1.34 in chips) 
Seat 4: Howardhof ($8.20 in chips) 
Seat 5: CashMatteo ($2.38 in chips) 
Seat 6: paul853 ($3.25 in chips) 
Allinkoo: posts small blind $0.01
Howardhof: posts big blind $0.02
*** HOLE CARDS ***
Dealt to CashMatteo [8d 6h]
CashMatteo: folds 
paul853: calls $0.02
Indie993: folds 
Allinkoo: calls $0.01
Howardhof: checks 
*** FLOP *** [Ts 7h 3s]
Allinkoo: bets $0.04
Howardhof: folds 
paul853: calls $0.04
*** TURN *** [Ts 7h 3s] [8c]
Allinkoo: bets $0.08
paul853: calls $0.08
*** RIVER *** [Ts 7h 3s 8c] [8h]
Allinkoo: checks 
paul853: checks 
*** SHOW DOWN ***
Allinkoo: shows [6s 2s] (a pair of Eights)
paul853: shows [Qs 9s] (a pair of Eights - Queen kicker)
paul853 collected $0.29 from pot
*** SUMMARY ***
Total pot $0.30 | Rake $0.01 
Board [Ts 7h 3s 8c 8h]
Seat 1: Indie993 (button) folded before Flop (didn't bet)
Seat 3: Allinkoo (small blind) showed [6s 2s] and lost with a pair of Eights
Seat 4: Howardhof (big blind) folded on the Flop
Seat 5: CashMatteo folded before Flop (didn't bet)
Seat 6: paul853 showed [Qs 9s] and won ($0.29) with a pair of Eights

Hand #2151: 

PokerStars Hand #250519547700:  Hold'em No Limit ($0.01/$0.02 CAD) - 2024/05/15 17:32:19 ET
Table 'Gedania IV' 6-max Seat #3 is the button
Seat 1: Indie993 ($0.65 in chips) 
Seat 3: Allinkoo ($1.20 in chips) 
Seat 4: Howardhof ($8.18 in chips) 
Seat 5: CashMatteo ($2.38 in chips) 
Seat 6: paul853 ($3.40 in chips) 
Howardhof: posts small blind $0.01
CashMatteo: posts big blind $0.02
*** HOLE CARDS ***
Dealt to CashMatteo [6s 5c]
paul853: calls $0.02
Indie993: calls $0.02
Allinkoo: calls $0.02
Howardhof: calls $0.01
CashMatteo: raises $0.02 to $0.04
paul853: calls $0.02
Indie993: calls $0.02
Allinkoo: calls $0.02
Howardhof: calls $0.02
*** FLOP *** [8h Ah 4d]
Howardhof: checks 
CashMatteo: checks 
paul853: checks 
Indie993: checks 
Allinkoo: bets $0.08
Howardhof: folds 
CashMatteo: calls $0.08
paul853: calls $0.08
Indie993: folds 
*** TURN *** [8h Ah 4d] [7h]
CashMatteo: checks 
paul853: bets $0.42
Allinkoo: raises $0.66 to $1.08 and is all-in
ahophing leaves the table
CashMatteo: calls $1.08
paul853: raises $2.20 to $3.28 and is all-in
CashMatteo: calls $1.18 and is all-in
Uncalled bet ($1.02) returned to paul853
*** RIVER *** [8h Ah 4d 7h] [Ks]
*** SHOW DOWN ***
CashMatteo: shows [6s 5c] (a straight, Four to Eight)
paul853: shows [5h 9h] (a flush, Ace high)
paul853 collected $2.28 from side pot
Allinkoo: shows [Jh 3h] (a flush, Ace high - Jack higher)
Allinkoo collected $3.55 from main pot
*** SUMMARY ***
Total pot $6.04 Main pot $3.55. Side pot $2.28. | Rake $0.21 
Board [8h Ah 4d 7h Ks]
Seat 1: Indie993 folded on the Flop
Seat 3: Allinkoo (button) showed [Jh 3h] and won ($3.55) with a flush, Ace high
Seat 4: Howardhof (small blind) folded on the Flop
Seat 5: CashMatteo (big blind) showed [6s 5c] and lost with a straight, Four to Eight
Seat 6: paul853 showed [5h 9h] and won ($2.28) with a flush, Ace high

Hand #2152: 

PokerStars Hand #250519552336:  Hold'em No Limit ($0.01/$0.02 CAD) - 2024/05/15 17:32:32 ET
Table 'Thuban III' 6-max Seat #2 is the button
Seat 2: hotdog1948 ($4.68 in chips) 
Seat 3: grandmasteel ($1.70 in chips) 
Seat 4: LoboR1 ($2 in chips) 
Seat 5: CashMatteo ($2.07 in chips) 
grandmasteel: posts small blind $0.01
LoboR1: posts big blind $0.02
*** HOLE CARDS ***
Dealt to CashMatteo [9h Jh]
CashMatteo: raises $0.03 to $0.05
hotdog1948: folds 
grandmasteel: folds 
LoboR1: folds 
Uncalled bet ($0.03) returned to CashMatteo
CashMatteo collected $0.05 from pot
CashMatteo: doesn't show hand 
*** SUMMARY ***
Total pot $0.05 | Rake $0 
Seat 2: hotdog1948 (button) folded before Flop (didn't bet)
Seat 3: grandmasteel (small blind) folded before Flop
Seat 4: LoboR1 (big blind) folded before Flop
Seat 5: CashMatteo collected ($0.05)

Hand #2153: 

PokerStars Hand #250519556821:  Hold'em No Limit ($0.01/$0.02 CAD) - 2024/05/15 17:32:46 ET
Table 'Thuban III' 6-max Seat #3 is the button
Seat 2: hotdog1948 ($4.68 in chips) 
Seat 3: grandmasteel ($1.69 in chips) 
Seat 4: LoboR1 ($2 in chips) 
Seat 5: CashMatteo ($2.10 in chips) 
LoboR1: posts small blind $0.01
CashMatteo: posts big blind $0.02
*** HOLE CARDS ***
Dealt to CashMatteo [5s 8h]
rubey2steps leaves the table
hotdog1948: calls $0.02
grandmasteel: calls $0.02
LoboR1: calls $0.01
CashMatteo: checks 
*** FLOP *** [9s 5h Th]
Indie993 joins the table at seat #1 
LoboR1: checks 
CashMatteo: checks 
hotdog1948: checks 
grandmasteel: checks 
*** TURN *** [9s 5h Th] [Ts]
LoboR1: checks 
CashMatteo: bets $0.08
hotdog1948: folds 
ahophing leaves the table
grandmasteel: folds 
LoboR1: folds 
Uncalled bet ($0.08) returned to CashMatteo
CashMatteo collected $0.08 from pot
CashMatteo: doesn't show hand 
*** SUMMARY ***
Total pot $0.08 | Rake $0 
Board [9s 5h Th Ts]
Seat 2: hotdog1948 folded on the Turn
Seat 3: grandmasteel (button) folded on the Turn
Seat 4: LoboR1 (small blind) folded on the Turn
Seat 5: CashMatteo (big blind) collected ($0.08)

Hand #2154: 

PokerStars Hand #250519573114:  Hold'em No Limit ($0.01/$0.02 CAD) - 2024/05/15 17:33:33 ET
Table 'Thuban III' 6-max Seat #4 is the button
Seat 1: Indie993 ($0.80 in chips) 
Seat 2: hotdog1948 ($4.66 in chips) 
Seat 3: grandmasteel ($1.67 in chips) 
Seat 4: LoboR1 ($2 in chips) 
Seat 5: CashMatteo ($2.16 in chips) 
CashMatteo: posts small blind $0.01
Indie993: posts big blind $0.02
*** HOLE CARDS ***
Dealt to CashMatteo [Ts Qs]
hotdog1948: raises $0.02 to $0.04
grandmasteel: calls $0.04
LoboR1: folds 
CashMatteo: raises $0.02 to $0.06
Indie993: calls $0.04
hotdog1948: calls $0.02
grandmasteel: calls $0.02
*** FLOP *** [3h Js Qc]
CashMatteo: bets $0.23
Indie993: folds 
hotdog1948: folds 
grandmasteel: folds 
Uncalled bet ($0.23) returned to CashMatteo
CashMatteo collected $0.23 from pot
CashMatteo: doesn't show hand 
*** SUMMARY ***
Total pot $0.24 | Rake $0.01 
Board [3h Js Qc]
Seat 1: Indie993 (big blind) folded on the Flop
Seat 2: hotdog1948 folded on the Flop
Seat 3: grandmasteel folded on the Flop
Seat 4: LoboR1 (button) folded before Flop (didn't bet)
Seat 5: CashMatteo (small blind) collected ($0.23)

Hand #2155: 

PokerStars Hand #250519586888:  Hold'em No Limit ($0.01/$0.02 CAD) - 2024/05/15 17:34:13 ET
Table 'Gedania IV' 6-max Seat #6 is the button
Seat 1: Indie993 ($0.61 in chips) 
Seat 3: Allinkoo ($3.55 in chips) 
Seat 4: Howardhof ($8.14 in chips) 
Seat 5: CashMatteo ($1.50 in chips) 
Seat 6: paul853 ($3.30 in chips) 
Indie993: posts small blind $0.01
Allinkoo: posts big blind $0.02
CashMatteo: posts small blind $0.01
*** HOLE CARDS ***
Dealt to CashMatteo [7c 5c]
Howardhof: folds 
CashMatteo: calls $0.02
paul853: folds 
Indie993: folds 
Allinkoo: checks 
*** FLOP *** [4c Jd 6d]
Allinkoo: checks 
CashMatteo: bets $0.06
Allinkoo: folds 
Uncalled bet ($0.06) returned to CashMatteo
CashMatteo collected $0.06 from pot
CashMatteo: doesn't show hand 
*** SUMMARY ***
Total pot $0.06 | Rake $0 
Board [4c Jd 6d]
Seat 1: Indie993 (small blind) folded before Flop
Seat 3: Allinkoo (big blind) folded on the Flop
Seat 4: Howardhof folded before Flop (didn't bet)
Seat 5: CashMatteo collected ($0.06)
Seat 6: paul853 (button) folded before Flop (didn't bet)

Hand #2156: 

PokerStars Hand #250519587158:  Hold'em No Limit ($0.01/$0.02 CAD) - 2024/05/15 17:34:14 ET
Table 'Thuban III' 6-max Seat #5 is the button
Seat 1: Indie993 ($0.74 in chips) 
Seat 2: hotdog1948 ($4.60 in chips) 
Seat 3: grandmasteel ($1.61 in chips) 
Seat 4: LoboR1 ($2 in chips) 
Seat 5: CashMatteo ($2.33 in chips) 
Indie993: posts small blind $0.01
hotdog1948: posts big blind $0.02
*** HOLE CARDS ***
Dealt to CashMatteo [3c Td]
grandmasteel: folds 
LoboR1: calls $0.02
CashMatteo: folds 
Indie993: folds 
hotdog1948: checks 
*** FLOP *** [Jc 6c Ks]
hotdog1948: checks 
LoboR1: checks 
*** TURN *** [Jc 6c Ks] [7c]
hotdog1948: checks 
LoboR1: checks 
*** RIVER *** [Jc 6c Ks 7c] [9c]
hotdog1948: bets $0.02
LoboR1: folds 
Uncalled bet ($0.02) returned to hotdog1948
hotdog1948 collected $0.05 from pot
*** SUMMARY ***
Total pot $0.05 | Rake $0 
Board [Jc 6c Ks 7c 9c]
Seat 1: Indie993 (small blind) folded before Flop
Seat 2: hotdog1948 (big blind) collected ($0.05)
Seat 3: grandmasteel folded before Flop (didn't bet)
Seat 4: LoboR1 folded on the River
Seat 5: CashMatteo (button) folded before Flop (didn't bet)

Hand #2157: 

PokerStars Hand #250519592498:  Hold'em No Limit ($0.01/$0.02 CAD) - 2024/05/15 17:34:30 ET
Table 'Gedania IV' 6-max Seat #1 is the button
Seat 1: Indie993 ($0.60 in chips) 
Seat 3: Allinkoo ($3.53 in chips) 
Seat 4: Howardhof ($8.14 in chips) 
Seat 5: CashMatteo ($1.53 in chips) 
Seat 6: paul853 ($3.30 in chips) 
Allinkoo: posts small blind $0.01
Howardhof: posts big blind $0.02
*** HOLE CARDS ***
Dealt to CashMatteo [5c 5h]
CashMatteo: raises $0.03 to $0.05
paul853: calls $0.05
Indie993: calls $0.05
Allinkoo: calls $0.04
Howardhof: calls $0.03
*** FLOP *** [4d Td 3d]
Allinkoo: checks 
Howardhof: checks 
CashMatteo: bets $0.12
paul853: calls $0.12
Indie993: folds 
Indie993 leaves the table
Allinkoo: calls $0.12
Howardhof: folds 
*** TURN *** [4d Td 3d] [Qs]
Allinkoo: bets $0.22
CashMatteo: calls $0.22
paul853: calls $0.22
*** RIVER *** [4d Td 3d Qs] [Qd]
Allinkoo: checks 
CashMatteo: checks 
paul853: checks 
*** SHOW DOWN ***
Allinkoo: shows [2d Kd] (a flush, King high)
CashMatteo: mucks hand 
paul853: mucks hand 
Allinkoo collected $1.23 from pot
*** SUMMARY ***
Total pot $1.27 | Rake $0.04 
Board [4d Td 3d Qs Qd]
Seat 1: Indie993 (button) folded on the Flop
Seat 3: Allinkoo (small blind) showed [2d Kd] and won ($1.23) with a flush, King high
Seat 4: Howardhof (big blind) folded on the Flop
Seat 5: CashMatteo mucked [5c 5h]
Seat 6: paul853 mucked [Ts 9s]

Hand #2158: 

PokerStars Hand #250519595815:  Hold'em No Limit ($0.01/$0.02 CAD) - 2024/05/15 17:34:39 ET
Table 'Thuban III' 6-max Seat #1 is the button
Seat 1: Indie993 ($0.73 in chips) 
Seat 2: hotdog1948 ($4.63 in chips) 
Seat 3: grandmasteel ($1.61 in chips) 
Seat 4: LoboR1 ($2 in chips) 
Seat 5: CashMatteo ($2.33 in chips) 
hotdog1948: posts small blind $0.01
grandmasteel: posts big blind $0.02
*** HOLE CARDS ***
Dealt to CashMatteo [Ts Jc]
LoboR1: folds 
CashMatteo: raises $0.03 to $0.05
Indie993: calls $0.05
hotdog1948: calls $0.04
grandmasteel: folds 
*** FLOP *** [4d 6s 5c]
hotdog1948: bets $0.02
CashMatteo: calls $0.02
Indie993: calls $0.02
*** TURN *** [4d 6s 5c] [Td]
hotdog1948: bets $0.22
CashMatteo: calls $0.22
Indie993: calls $0.22
*** RIVER *** [4d 6s 5c Td] [7s]
hotdog1948: bets $0.86
CashMatteo: calls $0.86
Indie993: folds 
*** SHOW DOWN ***
hotdog1948: shows [7h Th] (two pair, Tens and Sevens)
CashMatteo: mucks hand 
hotdog1948 collected $2.52 from pot
*** SUMMARY ***
Total pot $2.61 | Rake $0.09 
Board [4d 6s 5c Td 7s]
Seat 1: Indie993 (button) folded on the River
Seat 2: hotdog1948 (small blind) showed [7h Th] and won ($2.52) with two pair, Tens and Sevens
Seat 3: grandmasteel (big blind) folded before Flop
Seat 4: LoboR1 folded before Flop (didn't bet)
Seat 5: CashMatteo mucked [Ts Jc]

Hand #2159: 

PokerStars Hand #250519609065:  Hold'em No Limit ($0.01/$0.02 CAD) - 2024/05/15 17:35:18 ET
Table 'Gedania IV' 6-max Seat #3 is the button
Seat 3: Allinkoo ($4.37 in chips) 
Seat 4: Howardhof ($8.09 in chips) 
Seat 5: CashMatteo ($1.14 in chips) 
Seat 6: paul853 ($2.91 in chips) 
Howardhof: posts small blind $0.01
CashMatteo: posts big blind $0.02
*** HOLE CARDS ***
Dealt to CashMatteo [Js 8d]
paul853: folds 
Allinkoo: calls $0.02
Howardhof: folds 
CashMatteo: raises $0.02 to $0.04
Allinkoo: calls $0.02
*** FLOP *** [Ks Th 9s]
CashMatteo: bets $0.05
Allinkoo: folds 
Uncalled bet ($0.05) returned to CashMatteo
CashMatteo collected $0.09 from pot
CashMatteo: doesn't show hand 
*** SUMMARY ***
Total pot $0.09 | Rake $0 
Board [Ks Th 9s]
Seat 3: Allinkoo (button) folded on the Flop
Seat 4: Howardhof (small blind) folded before Flop
Seat 5: CashMatteo (big blind) collected ($0.09)
Seat 6: paul853 folded before Flop (didn't bet)

Hand #2160: 

PokerStars Hand #250519611511:  Hold'em No Limit ($0.01/$0.02 CAD) - 2024/05/15 17:35:25 ET
Table 'Thuban III' 6-max Seat #2 is the button
Seat 1: Indie993 ($0.44 in chips) 
Seat 2: hotdog1948 ($6 in chips) 
Seat 3: grandmasteel ($1.59 in chips) 
Seat 4: LoboR1 ($2 in chips) 
Seat 5: CashMatteo ($1.18 in chips) 
grandmasteel: posts small blind $0.01
LoboR1: posts big blind $0.02
*** HOLE CARDS ***
Dealt to CashMatteo [Qc 9c]
CashMatteo: raises $0.03 to $0.05
Indie993: folds 
hotdog1948: calls $0.05
grandmasteel: folds 
LoboR1: calls $0.03
*** FLOP *** [Qd 9s Jh]
LoboR1: checks 
CashMatteo: bets $0.08
hotdog1948: folds 
LoboR1: calls $0.08
*** TURN *** [Qd 9s Jh] [6s]
LoboR1: checks 
-Hold'Em-253 joins the table at seat #6 
CashMatteo: checks 
*** RIVER *** [Qd 9s Jh 6s] [3h]
LoboR1: checks 
CashMatteo: bets $0.31
LoboR1: folds 
Uncalled bet ($0.31) returned to CashMatteo
CashMatteo collected $0.31 from pot
CashMatteo: doesn't show hand 
*** SUMMARY ***
Total pot $0.32 | Rake $0.01 
Board [Qd 9s Jh 6s 3h]
Seat 1: Indie993 folded before Flop (didn't bet)
Seat 2: hotdog1948 (button) folded on the Flop
Seat 3: grandmasteel (small blind) folded before Flop
Seat 4: LoboR1 (big blind) folded on the River
Seat 5: CashMatteo collected ($0.31)

Hand #2161: 

PokerStars Hand #250519618182:  Hold'em No Limit ($0.01/$0.02 CAD) - 2024/05/15 17:35:45 ET
Table 'Gedania IV' 6-max Seat #4 is the button
Seat 3: Allinkoo ($4.33 in chips) 
Seat 4: Howardhof ($8.08 in chips) 
Seat 5: CashMatteo ($1.19 in chips) 
Seat 6: paul853 ($2.91 in chips) 
CashMatteo: posts small blind $0.01
paul853: posts big blind $0.02
*** HOLE CARDS ***
Dealt to CashMatteo [Qc Ts]
Allinkoo: calls $0.02
Howardhof: folds 
CashMatteo: raises $0.03 to $0.05
paul853: calls $0.03
Allinkoo: calls $0.03
*** FLOP *** [7c 9s 6c]
CashMatteo: checks 
paul853: bets $0.14
Allinkoo: folds 
Allinkoo leaves the table
CashMatteo: folds 
Uncalled bet ($0.14) returned to paul853
paul853 collected $0.14 from pot
*** SUMMARY ***
Total pot $0.15 | Rake $0.01 
Board [7c 9s 6c]
Seat 3: Allinkoo folded on the Flop
Seat 4: Howardhof (button) folded before Flop (didn't bet)
Seat 5: CashMatteo (small blind) folded on the Flop
Seat 6: paul853 (big blind) collected ($0.14)

Hand #2162: 

PokerStars Hand #250519627963:  Hold'em No Limit ($0.01/$0.02 CAD) - 2024/05/15 17:36:14 ET
Table 'Gedania IV' 6-max Seat #5 is the button
Seat 4: Howardhof ($8.08 in chips) 
Seat 5: CashMatteo ($1.14 in chips) 
Seat 6: paul853 ($3 in chips) 
paul853: posts small blind $0.01
Howardhof: posts big blind $0.02
*** HOLE CARDS ***
Dealt to CashMatteo [3h Qd]
CashMatteo: folds 
paul853: calls $0.01
Howardhof: checks 
*** FLOP *** [Ac 7s 4c]
paul853: checks 
Howardhof: checks 
*** TURN *** [Ac 7s 4c] [8h]
paul853: checks 
Howardhof: bets $0.02
paul853: calls $0.02
*** RIVER *** [Ac 7s 4c 8h] [Kh]
paul853: checks 
Howardhof: bets $0.08
paul853: folds 
Uncalled bet ($0.08) returned to Howardhof
Howardhof collected $0.08 from pot
*** SUMMARY ***
Total pot $0.08 | Rake $0 
Board [Ac 7s 4c 8h Kh]
Seat 4: Howardhof (big blind) collected ($0.08)
Seat 5: CashMatteo (button) folded before Flop (didn't bet)
Seat 6: paul853 (small blind) folded on the River

Hand #2163: 

PokerStars Hand #250519631247:  Hold'em No Limit ($0.01/$0.02 CAD) - 2024/05/15 17:36:23 ET
Table 'Thuban III' 6-max Seat #3 is the button
Seat 1: Indie993 ($0.44 in chips) 
Seat 2: hotdog1948 ($5.95 in chips) 
Seat 3: grandmasteel ($1.58 in chips) 
Seat 4: LoboR1 ($2 in chips) 
Seat 5: CashMatteo ($1.36 in chips) 
LoboR1: posts small blind $0.01
CashMatteo: posts big blind $0.02
-Hold'Em-253: sits out 
*** HOLE CARDS ***
Dealt to CashMatteo [3d 2c]
Indie993: calls $0.02
hotdog1948: raises $0.02 to $0.04
grandmasteel: calls $0.04
LoboR1: folds 
CashMatteo: folds 
Indie993: calls $0.02
*** FLOP *** [6d Jc As]
Indie993: checks 
hotdog1948: bets $0.02
grandmasteel: folds 
Indie993: folds 
Uncalled bet ($0.02) returned to hotdog1948
hotdog1948 collected $0.14 from pot
*** SUMMARY ***
Total pot $0.15 | Rake $0.01 
Board [6d Jc As]
Seat 1: Indie993 folded on the Flop
Seat 2: hotdog1948 collected ($0.14)
Seat 3: grandmasteel (button) folded on the Flop
Seat 4: LoboR1 (small blind) folded before Flop
Seat 5: CashMatteo (big blind) folded before Flop

Hand #2164: 

PokerStars Hand #250519638358:  Hold'em No Limit ($0.01/$0.02 CAD) - 2024/05/15 17:36:44 ET
Table 'Gedania IV' 6-max Seat #6 is the button
Seat 4: Howardhof ($8.12 in chips) 
Seat 5: CashMatteo ($1.14 in chips) 
Seat 6: paul853 ($2.96 in chips) 
Howardhof: posts small blind $0.01
CashMatteo: posts big blind $0.02
*** HOLE CARDS ***
Dealt to CashMatteo [7d Ad]
paul853: calls $0.02
Howardhof: raises $0.02 to $0.04
CashMatteo: raises $0.02 to $0.06
paul853: calls $0.04
Howardhof: calls $0.02
*** FLOP *** [3c 8d 5h]
Howardhof: checks 
CashMatteo: bets $0.09
paul853: folds 
Howardhof: calls $0.09
*** TURN *** [3c 8d 5h] [4h]
Howardhof: checks 
CashMatteo: checks 
*** RIVER *** [3c 8d 5h 4h] [7c]
Howardhof: checks 
CashMatteo: bets $0.18
Howardhof: folds 
Uncalled bet ($0.18) returned to CashMatteo
Pikdee joins the table at seat #1 
CashMatteo collected $0.35 from pot
CashMatteo: doesn't show hand 
*** SUMMARY ***
Total pot $0.36 | Rake $0.01 
Board [3c 8d 5h 4h 7c]
Seat 4: Howardhof (small blind) folded on the River
Seat 5: CashMatteo (big blind) collected ($0.35)
Seat 6: paul853 (button) folded on the Flop

Hand #2165: 

PokerStars Hand #250519644283:  Hold'em No Limit ($0.01/$0.02 CAD) - 2024/05/15 17:37:02 ET
Table 'Thuban III' 6-max Seat #4 is the button
Seat 1: Indie993 ($0.40 in chips) 
Seat 2: hotdog1948 ($6.05 in chips) 
Seat 3: grandmasteel ($1.54 in chips) 
Seat 4: LoboR1 ($2 in chips) 
Seat 5: CashMatteo ($1.34 in chips) 
Seat 6: -Hold'Em-253 ($2 in chips) 
CashMatteo: posts small blind $0.01
-Hold'Em-253: posts big blind $0.02
*** HOLE CARDS ***
Dealt to CashMatteo [Td 8d]
Indie993: calls $0.02
hotdog1948: raises $0.07 to $0.09
grandmasteel: folds 
LoboR1: folds 
CashMatteo: calls $0.08
-Hold'Em-253: folds 
Indie993: calls $0.07
*** FLOP *** [Js 8c 3s]
CashMatteo: bets $0.14
Indie993: calls $0.14
hotdog1948: calls $0.14
*** TURN *** [Js 8c 3s] [8s]
CashMatteo: bets $0.35
Indie993: folds 
hotdog1948: calls $0.35
*** RIVER *** [Js 8c 3s 8s] [Ts]
CashMatteo: bets $0.76 and is all-in
hotdog1948: calls $0.76
*** SHOW DOWN ***
CashMatteo: shows [Td 8d] (a full house, Eights full of Tens)
hotdog1948: shows [9s 9d] (a flush, Jack high)
CashMatteo collected $2.83 from pot
*** SUMMARY ***
Total pot $2.93 | Rake $0.10 
Board [Js 8c 3s 8s Ts]
Seat 1: Indie993 folded on the Turn
Seat 2: hotdog1948 showed [9s 9d] and lost with a flush, Jack high
Seat 3: grandmasteel folded before Flop (didn't bet)
Seat 4: LoboR1 (button) folded before Flop (didn't bet)
Seat 5: CashMatteo (small blind) showed [Td 8d] and won ($2.83) with a full house, Eights full of Tens
Seat 6: -Hold'Em-253 (big blind) folded before Flop

Hand #2166: 

PokerStars Hand #250519654178:  Hold'em No Limit ($0.01/$0.02 CAD) - 2024/05/15 17:37:31 ET
Table 'Gedania IV' 6-max Seat #4 is the button
Seat 4: Howardhof ($7.97 in chips) 
Seat 5: CashMatteo ($1.34 in chips) 
Seat 6: paul853 ($2.90 in chips) 
CashMatteo: posts small blind $0.01
paul853: posts big blind $0.02
Pikdee: sits out 
*** HOLE CARDS ***
Dealt to CashMatteo [9h 4s]
Howardhof: folds 
Howardhof leaves the table
CashMatteo: folds 
Uncalled bet ($0.01) returned to paul853
paul853 collected $0.02 from pot
*** SUMMARY ***
Total pot $0.02 | Rake $0 
Seat 4: Howardhof (button) folded before Flop (didn't bet)
Seat 5: CashMatteo (small blind) folded before Flop
Seat 6: paul853 (big blind) collected ($0.02)

Hand #2167: 

PokerStars Hand #250519656335:  Hold'em No Limit ($0.01/$0.02 CAD) - 2024/05/15 17:37:38 ET
Table 'Gedania IV' 6-max Seat #5 is the button
Seat 1: Pikdee ($2 in chips) 
Seat 5: CashMatteo ($1.33 in chips) 
Seat 6: paul853 ($2.91 in chips) 
paul853: posts small blind $0.01
Pikdee: posts big blind $0.02
*** HOLE CARDS ***
Dealt to CashMatteo [5s Tc]
CashMatteo: folds 
paul853: raises $0.04 to $0.06
alimathers joins the table at seat #2 
Pikdee: folds 
Uncalled bet ($0.04) returned to paul853
paul853 collected $0.04 from pot
*** SUMMARY ***
Total pot $0.04 | Rake $0 
Seat 1: Pikdee (big blind) folded before Flop
Seat 5: CashMatteo (button) folded before Flop (didn't bet)
Seat 6: paul853 (small blind) collected ($0.04)

Hand #2168: 

PokerStars Hand #250519660936:  Hold'em No Limit ($0.01/$0.02 CAD) - 2024/05/15 17:37:51 ET
Table 'Thuban III' 6-max Seat #5 is the button
Seat 1: Indie993 ($0.17 in chips) 
Seat 2: hotdog1948 ($4.71 in chips) 
Seat 3: grandmasteel ($1.54 in chips) 
Seat 4: LoboR1 ($2 in chips) 
Seat 5: CashMatteo ($2.83 in chips) 
Seat 6: -Hold'Em-253 ($2 in chips) 
-Hold'Em-253: posts small blind $0.01
Indie993: posts big blind $0.02
*** HOLE CARDS ***
Dealt to CashMatteo [3s 6s]
hotdog1948: raises $0.02 to $0.04
grandmasteel: folds 
LoboR1: folds 
CashMatteo: calls $0.04
-Hold'Em-253: folds 
Indie993: calls $0.02
*** FLOP *** [Ah 5h Qc]
Indie993: checks 
hotdog1948: bets $0.02
CashMatteo: folds 
Indie993: folds 
Uncalled bet ($0.02) returned to hotdog1948
hotdog1948 collected $0.13 from pot
*** SUMMARY ***
Total pot $0.13 | Rake $0 
Board [Ah 5h Qc]
Seat 1: Indie993 (big blind) folded on the Flop
Seat 2: hotdog1948 collected ($0.13)
Seat 3: grandmasteel folded before Flop (didn't bet)
Seat 4: LoboR1 folded before Flop (didn't bet)
Seat 5: CashMatteo (button) folded on the Flop
Seat 6: -Hold'Em-253 (small blind) folded before Flop

Hand #2169: 

PokerStars Hand #250519661539:  Hold'em No Limit ($0.01/$0.02 CAD) - 2024/05/15 17:37:53 ET
Table 'Gedania IV' 6-max Seat #6 is the button
Seat 1: Pikdee ($1.98 in chips) 
Seat 2: alimathers ($1.60 in chips) 
Seat 5: CashMatteo ($1.33 in chips) 
Seat 6: paul853 ($2.93 in chips) 
Pikdee: posts small blind $0.01
alimathers: posts big blind $0.02
*** HOLE CARDS ***
Dealt to CashMatteo [Qd 2c]
CashMatteo: folds 
paul853: calls $0.02
Pikdee: folds 
alimathers: checks 
*** FLOP *** [Qh Js Kd]
alimathers: checks 
paul853: checks 
*** TURN *** [Qh Js Kd] [7c]
alimathers: checks 
paul853: checks 
*** RIVER *** [Qh Js Kd 7c] [Ts]
alimathers: checks 
paul853: bets $0.05
alimathers: folds 
Uncalled bet ($0.05) returned to paul853
paul853 collected $0.05 from pot
*** SUMMARY ***
Total pot $0.05 | Rake $0 
Board [Qh Js Kd 7c Ts]
Seat 1: Pikdee (small blind) folded before Flop
Seat 2: alimathers (big blind) folded on the River
Seat 5: CashMatteo folded before Flop (didn't bet)
Seat 6: paul853 (button) collected ($0.05)

Hand #2170: 

PokerStars Hand #250519668804:  Hold'em No Limit ($0.01/$0.02 CAD) - 2024/05/15 17:38:15 ET
Table 'Gedania IV' 6-max Seat #1 is the button
Seat 1: Pikdee ($1.97 in chips) 
Seat 2: alimathers ($1.58 in chips) 
Seat 5: CashMatteo ($1.33 in chips) 
Seat 6: paul853 ($2.96 in chips) 
alimathers: posts small blind $0.01
CashMatteo: posts big blind $0.02
*** HOLE CARDS ***
Dealt to CashMatteo [6s 3h]
paul853: calls $0.02
Pikdee: folds 
alimathers: calls $0.01
CashMatteo: checks 
*** FLOP *** [Qh 5s 7c]
alimathers: checks 
CashMatteo: checks 
paul853: bets $0.06
alimathers: folds 
CashMatteo: folds 
Uncalled bet ($0.06) returned to paul853
paul853 collected $0.06 from pot
*** SUMMARY ***
Total pot $0.06 | Rake $0 
Board [Qh 5s 7c]
Seat 1: Pikdee (button) folded before Flop (didn't bet)
Seat 2: alimathers (small blind) folded on the Flop
Seat 5: CashMatteo (big blind) folded on the Flop
Seat 6: paul853 collected ($0.06)

Hand #2171: 

PokerStars Hand #250519671375:  Hold'em No Limit ($0.01/$0.02 CAD) - 2024/05/15 17:38:22 ET
Table 'Thuban III' 6-max Seat #1 is the button
Seat 1: Indie993 ($0.13 in chips) 
Seat 2: hotdog1948 ($4.80 in chips) 
Seat 3: grandmasteel ($1.54 in chips) 
Seat 4: LoboR1 ($2 in chips) 
Seat 5: CashMatteo ($2.79 in chips) 
hotdog1948: posts small blind $0.01
grandmasteel: posts big blind $0.02
*** HOLE CARDS ***
Dealt to CashMatteo [Jc Kc]
LoboR1: raises $0.03 to $0.05
CashMatteo: calls $0.05
Indie993: folds 
Indie993 leaves the table
hotdog1948: folds 
grandmasteel: folds 
*** FLOP *** [Jd 4h Qd]
Pikdee joins the table at seat #1 
LoboR1: bets $0.04
CashMatteo: calls $0.04
*** TURN *** [Jd 4h Qd] [Ks]
LoboR1: bets $0.07
CashMatteo: raises $0.19 to $0.26
LoboR1: folds 
Uncalled bet ($0.19) returned to CashMatteo
CashMatteo collected $0.34 from pot
CashMatteo: doesn't show hand 
*** SUMMARY ***
Total pot $0.35 | Rake $0.01 
Board [Jd 4h Qd Ks]
Seat 1: Indie993 (button) folded before Flop (didn't bet)
Seat 2: hotdog1948 (small blind) folded before Flop
Seat 3: grandmasteel (big blind) folded before Flop
Seat 4: LoboR1 folded on the Turn
Seat 5: CashMatteo collected ($0.34)

Hand #2172: 

PokerStars Hand #250519677488:  Hold'em No Limit ($0.01/$0.02 CAD) - 2024/05/15 17:38:40 ET
Table 'Gedania IV' 6-max Seat #2 is the button
Seat 1: Pikdee ($1.97 in chips) 
Seat 2: alimathers ($1.56 in chips) 
Seat 5: CashMatteo ($1.31 in chips) 
Seat 6: paul853 ($3 in chips) 
CashMatteo: posts small blind $0.01
paul853: posts big blind $0.02
*** HOLE CARDS ***
Dealt to CashMatteo [Tc Ks]
Pikdee: folds 
alimathers: folds 
CashMatteo: raises $0.03 to $0.05
paul853: calls $0.03
*** FLOP *** [3h 7c 5h]
CashMatteo: checks 
paul853: bets $0.02
CashMatteo: calls $0.02
*** TURN *** [3h 7c 5h] [Kd]
CashMatteo: checks 
paul853: bets $0.14
CashMatteo: raises $0.23 to $0.37
paul853: calls $0.23
*** RIVER *** [3h 7c 5h Kd] [Js]
CashMatteo: bets $0.42
paul853: raises $0.42 to $0.84
CashMatteo: calls $0.42
*** SHOW DOWN ***
paul853: shows [Jh Kh] (two pair, Kings and Jacks)
CashMatteo: mucks hand 
paul853 collected $2.47 from pot
*** SUMMARY ***
Total pot $2.56 | Rake $0.09 
Board [3h 7c 5h Kd Js]
Seat 1: Pikdee folded before Flop (didn't bet)
Seat 2: alimathers (button) folded before Flop (didn't bet)
Seat 5: CashMatteo (small blind) mucked [Tc Ks]
Seat 6: paul853 (big blind) showed [Jh Kh] and won ($2.47) with two pair, Kings and Jacks

Hand #2173: 

PokerStars Hand #250519685510:  Hold'em No Limit ($0.01/$0.02 CAD) - 2024/05/15 17:39:04 ET
Table 'Thuban III' 6-max Seat #2 is the button
Seat 2: hotdog1948 ($4.79 in chips) 
Seat 3: grandmasteel ($1.52 in chips) 
Seat 4: LoboR1 ($2 in chips) 
Seat 5: CashMatteo ($2.97 in chips) 
Seat 6: -Hold'Em-253 ($2 in chips) 
grandmasteel: posts small blind $0.01
LoboR1: posts big blind $0.02
Pikdee: sits out 
*** HOLE CARDS ***
Dealt to CashMatteo [5h Qs]
CashMatteo: calls $0.02
LoboR1 said, "unfkngreal"
-Hold'Em-253: folds 
hotdog1948: calls $0.02
grandmasteel: folds 
LoboR1: checks 
*** FLOP *** [9c Ts Qh]
LoboR1: checks 
CashMatteo: bets $0.04
hotdog1948: calls $0.04
LoboR1: folds 
*** TURN *** [9c Ts Qh] [7s]
CashMatteo: bets $0.07
hotdog1948: calls $0.07
*** RIVER *** [9c Ts Qh 7s] [6s]
CashMatteo: checks 
hotdog1948: bets $0.50
CashMatteo: calls $0.50
*** SHOW DOWN ***
hotdog1948: shows [3h 8h] (a straight, Six to Ten)
CashMatteo: mucks hand 
hotdog1948 collected $1.24 from pot
*** SUMMARY ***
Total pot $1.29 | Rake $0.05 
Board [9c Ts Qh 7s 6s]
Seat 2: hotdog1948 (button) showed [3h 8h] and won ($1.24) with a straight, Six to Ten
Seat 3: grandmasteel (small blind) folded before Flop
Seat 4: LoboR1 (big blind) folded on the Flop
Seat 5: CashMatteo mucked [5h Qs]
Seat 6: -Hold'Em-253 folded before Flop (didn't bet)

Hand #2174: 

PokerStars Hand #250519692189:  Hold'em No Limit ($0.01/$0.02 CAD) - 2024/05/15 17:39:23 ET
Table 'Gedania IV' 6-max Seat #5 is the button
Seat 1: Pikdee ($1.97 in chips) 
Seat 2: alimathers ($1.56 in chips) 
Seat 5: CashMatteo ($0.03 in chips) 
Seat 6: paul853 ($4.19 in chips) 
paul853: posts small blind $0.01
Pikdee: posts big blind $0.02
*** HOLE CARDS ***
Dealt to CashMatteo [8c Qc]
alimathers: folds 
CashMatteo: raises $0.01 to $0.03 and is all-in
paul853: calls $0.02
Pikdee: calls $0.01
*** FLOP *** [Js Ah Jd]
paul853: checks 
Pikdee: checks 
*** TURN *** [Js Ah Jd] [9c]
paul853: checks 
Pikdee: checks 
*** RIVER *** [Js Ah Jd 9c] [6h]
paul853: checks 
Pikdee: checks 
*** SHOW DOWN ***
paul853: shows [Tc Kc] (a pair of Jacks)
Pikdee: shows [Td Kd] (a pair of Jacks)
CashMatteo: mucks hand 
paul853 collected $0.05 from pot
Pikdee collected $0.04 from pot
*** SUMMARY ***
Total pot $0.09 | Rake $0 
Board [Js Ah Jd 9c 6h]
Seat 1: Pikdee (big blind) showed [Td Kd] and won ($0.04) with a pair of Jacks
Seat 2: alimathers folded before Flop (didn't bet)
Seat 5: CashMatteo (button) mucked [8c Qc]
Seat 6: paul853 (small blind) showed [Tc Kc] and won ($0.05) with a pair of Jacks

Hand #2175: 

PokerStars Hand #250519704751:  Hold'em No Limit ($0.01/$0.02 CAD) - 2024/05/15 17:40:01 ET
Table 'Thuban III' 6-max Seat #3 is the button
Seat 2: hotdog1948 ($5.40 in chips) 
Seat 3: grandmasteel ($1.51 in chips) 
Seat 4: LoboR1 ($2 in chips) 
Seat 5: CashMatteo ($2.34 in chips) 
Seat 6: -Hold'Em-253 ($2 in chips) 
LoboR1: posts small blind $0.01
CashMatteo: posts big blind $0.02
Pikdee: sits out 
*** HOLE CARDS ***
Dealt to CashMatteo [Tc Ks]
-Hold'Em-253: folds 
hotdog1948: calls $0.02
grandmasteel: folds 
LoboR1: raises $0.03 to $0.05
CashMatteo: raises $0.03 to $0.08
hotdog1948: calls $0.06
LoboR1: calls $0.03
*** FLOP *** [Ac 3c Kd]
LoboR1: checks 
CashMatteo: bets $0.14
hotdog1948: folds 
LoboR1: folds 
Uncalled bet ($0.14) returned to CashMatteo
CashMatteo collected $0.23 from pot
LoboR1 leaves the table
CashMatteo: doesn't show hand 
*** SUMMARY ***
Total pot $0.24 | Rake $0.01 
Board [Ac 3c Kd]
Seat 2: hotdog1948 folded on the Flop
Seat 3: grandmasteel (button) folded before Flop (didn't bet)
Seat 4: LoboR1 (small blind) folded on the Flop
Seat 5: CashMatteo (big blind) collected ($0.23)
Seat 6: -Hold'Em-253 folded before Flop (didn't bet)

Hand #2176: 

PokerStars Hand #250519715557:  Hold'em No Limit ($0.01/$0.02 CAD) - 2024/05/15 17:40:33 ET
Table 'Thuban III' 6-max Seat #5 is the button
Seat 1: Pikdee ($2 in chips) 
Seat 2: hotdog1948 ($5.32 in chips) 
Seat 3: grandmasteel ($1.51 in chips) 
Seat 5: CashMatteo ($2.49 in chips) 
Seat 6: -Hold'Em-253 ($2 in chips) 
-Hold'Em-253: posts small blind $0.01
Pikdee: posts big blind $0.02
*** HOLE CARDS ***
Dealt to CashMatteo [Js 6c]
hotdog1948: calls $0.02
grandmasteel: folds 
CashMatteo: calls $0.02
muskyfanatic joins the table at seat #4 
-Hold'Em-253: folds 
Pikdee: checks 
*** FLOP *** [Ah Kc 2h]
Pikdee: checks 
hotdog1948: bets $0.02
CashMatteo: calls $0.02
Pikdee: folds 
*** TURN *** [Ah Kc 2h] [Ad]
hotdog1948: bets $0.02
CashMatteo: calls $0.02
*** RIVER *** [Ah Kc 2h Ad] [Jh]
hotdog1948: bets $2.62
CashMatteo: folds 
Uncalled bet ($2.62) returned to hotdog1948
hotdog1948 collected $0.14 from pot
*** SUMMARY ***
Total pot $0.15 | Rake $0.01 
Board [Ah Kc 2h Ad Jh]
Seat 1: Pikdee (big blind) folded on the Flop
Seat 2: hotdog1948 collected ($0.14)
Seat 3: grandmasteel folded before Flop (didn't bet)
Seat 5: CashMatteo (button) folded on the River
Seat 6: -Hold'Em-253 (small blind) folded before Flop

Hand #2177: 

PokerStars Hand #250519736518:  Hold'em No Limit ($0.01/$0.02 CAD) - 2024/05/15 17:41:36 ET
Table 'Thuban III' 6-max Seat #6 is the button
Seat 1: Pikdee ($1.98 in chips) 
Seat 2: hotdog1948 ($5.40 in chips) 
Seat 3: grandmasteel ($1.51 in chips) 
Seat 4: muskyfanatic ($2 in chips) 
Seat 5: CashMatteo ($2.43 in chips) 
Seat 6: -Hold'Em-253 ($2 in chips) 
Pikdee: posts small blind $0.01
hotdog1948: posts big blind $0.02
muskyfanatic: posts big blind $0.02
*** HOLE CARDS ***
Dealt to CashMatteo [5h As]
grandmasteel: calls $0.02
muskyfanatic: checks 
CashMatteo: raises $0.03 to $0.05
-Hold'Em-253: folds 
Pikdee: folds 
hotdog1948: calls $0.03
grandmasteel: calls $0.03
muskyfanatic: calls $0.03
*** FLOP *** [3d Qs 7s]
hotdog1948: bets $0.02
grandmasteel: folds 
muskyfanatic: folds 
CashMatteo: calls $0.02
*** TURN *** [3d Qs 7s] [3c]
hotdog1948: bets $0.02
grandmasteel leaves the table
CashMatteo: calls $0.02
*** RIVER *** [3d Qs 7s 3c] [9c]
hotdog1948: bets $0.02
CashMatteo: calls $0.02
*** SHOW DOWN ***
hotdog1948: shows [4s Ac] (a pair of Threes)
CashMatteo: shows [5h As] (a pair of Threes)
hotdog1948 collected $0.16 from pot
CashMatteo collected $0.16 from pot
*** SUMMARY ***
Total pot $0.33 | Rake $0.01 
Board [3d Qs 7s 3c 9c]
Seat 1: Pikdee (small blind) folded before Flop
Seat 2: hotdog1948 (big blind) showed [4s Ac] and won ($0.16) with a pair of Threes
Seat 3: grandmasteel folded on the Flop
Seat 4: muskyfanatic folded on the Flop
Seat 5: CashMatteo showed [5h As] and won ($0.16) with a pair of Threes
Seat 6: -Hold'Em-253 (button) folded before Flop (didn't bet)

Hand #2178: 

PokerStars Hand #250519750015:  Hold'em No Limit ($0.01/$0.02 CAD) - 2024/05/15 17:42:18 ET
Table 'Thuban III' 6-max Seat #1 is the button
Seat 1: Pikdee ($1.97 in chips) 
Seat 2: hotdog1948 ($5.45 in chips) 
Seat 4: muskyfanatic ($1.95 in chips) 
Seat 5: CashMatteo ($2.48 in chips) 
Seat 6: -Hold'Em-253 ($2 in chips) 
hotdog1948: posts small blind $0.01
muskyfanatic: posts big blind $0.02
*** HOLE CARDS ***
Dealt to CashMatteo [6c 9s]
monkeyman1224 joins the table at seat #3 
CashMatteo: raises $0.03 to $0.05
-Hold'Em-253: folds 
Pikdee: folds 
hotdog1948: folds 
muskyfanatic: folds 
Uncalled bet ($0.03) returned to CashMatteo
CashMatteo collected $0.05 from pot
CashMatteo: doesn't show hand 
*** SUMMARY ***
Total pot $0.05 | Rake $0 
Seat 1: Pikdee (button) folded before Flop (didn't bet)
Seat 2: hotdog1948 (small blind) folded before Flop
Seat 4: muskyfanatic (big blind) folded before Flop
Seat 5: CashMatteo collected ($0.05)
Seat 6: -Hold'Em-253 folded before Flop (didn't bet)

Hand #2179: 

PokerStars Hand #250519758891:  Hold'em No Limit ($0.01/$0.02 CAD) - 2024/05/15 17:42:45 ET
Table 'Thuban III' 6-max Seat #2 is the button
Seat 1: Pikdee ($1.97 in chips) 
Seat 2: hotdog1948 ($5.44 in chips) 
Seat 4: muskyfanatic ($1.93 in chips) 
Seat 5: CashMatteo ($2.51 in chips) 
Seat 6: -Hold'Em-253 ($2 in chips) 
monkeyman1224 will be allowed to play after the button
muskyfanatic: posts small blind $0.01
CashMatteo: posts big blind $0.02
*** HOLE CARDS ***
Dealt to CashMatteo [6c Qc]
-Hold'Em-253: folds 
Pikdee: folds 
hotdog1948: raises $0.02 to $0.04
muskyfanatic: folds 
CashMatteo: calls $0.02
*** FLOP *** [Ts 2s 5s]
CashMatteo: checks 
hotdog1948: bets $0.02
CashMatteo: folds 
Uncalled bet ($0.02) returned to hotdog1948
hotdog1948 collected $0.09 from pot
*** SUMMARY ***
Total pot $0.09 | Rake $0 
Board [Ts 2s 5s]
Seat 1: Pikdee folded before Flop (didn't bet)
Seat 2: hotdog1948 (button) collected ($0.09)
Seat 4: muskyfanatic (small blind) folded before Flop
Seat 5: CashMatteo (big blind) folded on the Flop
Seat 6: -Hold'Em-253 folded before Flop (didn't bet)

Hand #2180: 

PokerStars Hand #250519769215:  Hold'em No Limit ($0.01/$0.02 CAD) - 2024/05/15 17:43:16 ET
Table 'Thuban III' 6-max Seat #4 is the button
Seat 1: Pikdee ($1.97 in chips) 
Seat 2: hotdog1948 ($5.49 in chips) 
Seat 3: monkeyman1224 ($1.60 in chips) 
Seat 4: muskyfanatic ($1.92 in chips) 
Seat 5: CashMatteo ($2.47 in chips) 
Seat 6: -Hold'Em-253 ($2 in chips) 
CashMatteo: posts small blind $0.01
-Hold'Em-253: posts big blind $0.02
monkeyman1224: posts big blind $0.02
*** HOLE CARDS ***
Dealt to CashMatteo [4h Th]
Pikdee: folds 
hotdog1948: calls $0.02
monkeyman1224: raises $0.06 to $0.08
muskyfanatic: folds 
CashMatteo: folds 
-Hold'Em-253: folds 
hotdog1948: folds 
Uncalled bet ($0.06) returned to monkeyman1224
monkeyman1224 collected $0.07 from pot
monkeyman1224: doesn't show hand 
*** SUMMARY ***
Total pot $0.07 | Rake $0 
Seat 1: Pikdee folded before Flop (didn't bet)
Seat 2: hotdog1948 folded before Flop
Seat 3: monkeyman1224 collected ($0.07)
Seat 4: muskyfanatic (button) folded before Flop (didn't bet)
Seat 5: CashMatteo (small blind) folded before Flop
Seat 6: -Hold'Em-253 (big blind) folded before Flop

Hand #2181: 

PokerStars Hand #250519774442:  Hold'em No Limit ($0.01/$0.02 CAD) - 2024/05/15 17:43:32 ET
Table 'Thuban III' 6-max Seat #5 is the button
Seat 1: Pikdee ($1.97 in chips) 
Seat 2: hotdog1948 ($5.47 in chips) 
Seat 3: monkeyman1224 ($1.65 in chips) 
Seat 4: muskyfanatic ($1.92 in chips) 
Seat 5: CashMatteo ($2.46 in chips) 
Seat 6: -Hold'Em-253 ($2 in chips) 
-Hold'Em-253: posts small blind $0.01
Pikdee: posts big blind $0.02
*** HOLE CARDS ***
Dealt to CashMatteo [Ts 2s]
hotdog1948: raises $0.02 to $0.04
monkeyman1224: calls $0.04
muskyfanatic: calls $0.04
CashMatteo: folds 
-Hold'Em-253: folds 
Pikdee: folds 
*** FLOP *** [Kh 8s Jd]
hotdog1948: bets $0.02
monkeyman1224: calls $0.02
muskyfanatic: calls $0.02
*** TURN *** [Kh 8s Jd] [Jh]
hotdog1948: bets $0.02
monkeyman1224: folds 
muskyfanatic: calls $0.02
*** RIVER *** [Kh 8s Jd Jh] [4d]
hotdog1948: bets $0.02
muskyfanatic: raises $0.14 to $0.16
hotdog1948: folds 
Uncalled bet ($0.14) returned to muskyfanatic
muskyfanatic collected $0.28 from pot
muskyfanatic: doesn't show hand 
*** SUMMARY ***
Total pot $0.29 | Rake $0.01 
Board [Kh 8s Jd Jh 4d]
Seat 1: Pikdee (big blind) folded before Flop
Seat 2: hotdog1948 folded on the River
Seat 3: monkeyman1224 folded on the Turn
Seat 4: muskyfanatic collected ($0.28)
Seat 5: CashMatteo (button) folded before Flop (didn't bet)
Seat 6: -Hold'Em-253 (small blind) folded before Flop

Hand #2182: 

PokerStars Hand #250519792994:  Hold'em No Limit ($0.01/$0.02 CAD) - 2024/05/15 17:44:29 ET
Table 'Thuban III' 6-max Seat #6 is the button
Seat 1: Pikdee ($1.95 in chips) 
Seat 2: hotdog1948 ($5.37 in chips) 
Seat 3: monkeyman1224 ($1.59 in chips) 
Seat 4: muskyfanatic ($2.10 in chips) 
Seat 5: CashMatteo ($2.46 in chips) 
Seat 6: -Hold'Em-253 ($2 in chips) 
Pikdee: posts small blind $0.01
hotdog1948: posts big blind $0.02
*** HOLE CARDS ***
Dealt to CashMatteo [Kc As]
monkeyman1224: folds 
muskyfanatic: folds 
CashMatteo: raises $0.03 to $0.05
-Hold'Em-253: folds 
Pikdee: folds 
hotdog1948: calls $0.03
*** FLOP *** [7d 6d Kh]
hotdog1948: bets $0.02
CashMatteo: raises $0.13 to $0.15
hotdog1948: calls $0.13
*** TURN *** [7d 6d Kh] [Ad]
hotdog1948: bets $0.02
CashMatteo: raises $0.22 to $0.24
hotdog1948: raises $0.22 to $0.46
CashMatteo: calls $0.22
*** RIVER *** [7d 6d Kh Ad] [5s]
hotdog1948: bets $1.28
CashMatteo: calls $1.28
*** SHOW DOWN ***
hotdog1948: shows [6s Kd] (two pair, Kings and Sixes)
CashMatteo: shows [Kc As] (two pair, Aces and Kings)
CashMatteo collected $3.75 from pot
*** SUMMARY ***
Total pot $3.89 | Rake $0.14 
Board [7d 6d Kh Ad 5s]
Seat 1: Pikdee (small blind) folded before Flop
Seat 2: hotdog1948 (big blind) showed [6s Kd] and lost with two pair, Kings and Sixes
Seat 3: monkeyman1224 folded before Flop (didn't bet)
Seat 4: muskyfanatic folded before Flop (didn't bet)
Seat 5: CashMatteo showed [Kc As] and won ($3.75) with two pair, Aces and Kings
Seat 6: -Hold'Em-253 (button) folded before Flop (didn't bet)

Hand #2183: 

PokerStars Hand #250519809511:  Hold'em No Limit ($0.01/$0.02 CAD) - 2024/05/15 17:45:19 ET
Table 'Thuban III' 6-max Seat #1 is the button
Seat 1: Pikdee ($1.94 in chips) 
Seat 2: hotdog1948 ($3.43 in chips) 
Seat 3: monkeyman1224 ($1.59 in chips) 
Seat 4: muskyfanatic ($2.10 in chips) 
Seat 5: CashMatteo ($4.27 in chips) 
Seat 6: -Hold'Em-253 ($2 in chips) 
hotdog1948: posts small blind $0.01
monkeyman1224: posts big blind $0.02
*** HOLE CARDS ***
Dealt to CashMatteo [4s 6h]
muskyfanatic: folds 
CashMatteo: folds 
-Hold'Em-253: raises $0.04 to $0.06
Pikdee: folds 
hotdog1948: raises $0.14 to $0.20
monkeyman1224: folds 
-Hold'Em-253: folds 
Uncalled bet ($0.14) returned to hotdog1948
hotdog1948 collected $0.14 from pot
*** SUMMARY ***
Total pot $0.14 | Rake $0 
Seat 1: Pikdee (button) folded before Flop (didn't bet)
Seat 2: hotdog1948 (small blind) collected ($0.14)
Seat 3: monkeyman1224 (big blind) folded before Flop
Seat 4: muskyfanatic folded before Flop (didn't bet)
Seat 5: CashMatteo folded before Flop (didn't bet)
Seat 6: -Hold'Em-253 folded before Flop

Hand #2184: 

PokerStars Hand #250519818453:  Hold'em No Limit ($0.01/$0.02 CAD) - 2024/05/15 17:45:47 ET
Table 'Thuban III' 6-max Seat #2 is the button
Seat 1: Pikdee ($1.94 in chips) 
Seat 2: hotdog1948 ($3.51 in chips) 
Seat 3: monkeyman1224 ($1.57 in chips) 
Seat 4: muskyfanatic ($2.10 in chips) 
Seat 5: CashMatteo ($4.27 in chips) 
Seat 6: -Hold'Em-253 ($2 in chips) 
monkeyman1224: posts small blind $0.01
muskyfanatic: posts big blind $0.02
*** HOLE CARDS ***
Dealt to CashMatteo [4c Ts]
CashMatteo: folds 
-Hold'Em-253: folds 
Pikdee: folds 
hotdog1948: raises $0.05 to $0.07
monkeyman1224: folds 
muskyfanatic: folds 
Uncalled bet ($0.05) returned to hotdog1948
hotdog1948 collected $0.05 from pot
*** SUMMARY ***
Total pot $0.05 | Rake $0 
Seat 1: Pikdee folded before Flop (didn't bet)
Seat 2: hotdog1948 (button) collected ($0.05)
Seat 3: monkeyman1224 (small blind) folded before Flop
Seat 4: muskyfanatic (big blind) folded before Flop
Seat 5: CashMatteo folded before Flop (didn't bet)
Seat 6: -Hold'Em-253 folded before Flop (didn't bet)

Hand #2185: 

PokerStars Hand #250519825319:  Hold'em No Limit ($0.01/$0.02 CAD) - 2024/05/15 17:46:08 ET
Table 'Thuban III' 6-max Seat #3 is the button
Seat 1: Pikdee ($1.94 in chips) 
Seat 2: hotdog1948 ($3.54 in chips) 
Seat 3: monkeyman1224 ($1.56 in chips) 
Seat 4: muskyfanatic ($2.08 in chips) 
Seat 5: CashMatteo ($4.27 in chips) 
Seat 6: -Hold'Em-253 ($2 in chips) 
muskyfanatic: posts small blind $0.01
CashMatteo: posts big blind $0.02
*** HOLE CARDS ***
Dealt to CashMatteo [9c Kc]
-Hold'Em-253: folds 
Pikdee: folds 
hotdog1948: raises $0.05 to $0.07
monkeyman1224: folds 
muskyfanatic: calls $0.06
CashMatteo: calls $0.05
*** FLOP *** [Ad Kd Jc]
muskyfanatic: checks 
CashMatteo: checks 
hotdog1948: bets $0.20
muskyfanatic: calls $0.20
CashMatteo: calls $0.20
*** TURN *** [Ad Kd Jc] [8h]
muskyfanatic: checks 
CashMatteo: checks 
hotdog1948: bets $1.90
muskyfanatic: calls $1.81 and is all-in
CashMatteo: folds 
Uncalled bet ($0.09) returned to hotdog1948
*** RIVER *** [Ad Kd Jc 8h] [9h]
*** SHOW DOWN ***
muskyfanatic: shows [Ac 8d] (two pair, Aces and Eights)
hotdog1948: shows [Jd Js] (three of a kind, Jacks)
hotdog1948 collected $4.27 from pot
*** SUMMARY ***
Total pot $4.43 | Rake $0.16 
Board [Ad Kd Jc 8h 9h]
Seat 1: Pikdee folded before Flop (didn't bet)
Seat 2: hotdog1948 showed [Jd Js] and won ($4.27) with three of a kind, Jacks
Seat 3: monkeyman1224 (button) folded before Flop (didn't bet)
Seat 4: muskyfanatic (small blind) showed [Ac 8d] and lost with two pair, Aces and Eights
Seat 5: CashMatteo (big blind) folded on the Turn
Seat 6: -Hold'Em-253 folded before Flop (didn't bet)

Hand #2186: 

PokerStars Hand #250519843656:  Hold'em No Limit ($0.01/$0.02 CAD) - 2024/05/15 17:47:04 ET
Table 'Thuban III' 6-max Seat #5 is the button
Seat 1: Pikdee ($1.94 in chips) 
Seat 2: hotdog1948 ($5.73 in chips) 
Seat 3: monkeyman1224 ($1.56 in chips) 
Seat 5: CashMatteo ($4 in chips) 
Seat 6: -Hold'Em-253 ($2 in chips) 
-Hold'Em-253: posts small blind $0.01
Pikdee: posts big blind $0.02
*** HOLE CARDS ***
Dealt to CashMatteo [Ts 8d]
hotdog1948: calls $0.02
muskyfanatic leaves the table
monkeyman1224: calls $0.02
CashMatteo: folds 
-Hold'Em-253: folds 
Pikdee: checks 
*** FLOP *** [6d 3d 8h]
Pikdee: bets $0.05
hotdog1948: calls $0.05
monkeyman1224: calls $0.05
*** TURN *** [6d 3d 8h] [6s]
Pikdee: bets $0.11
hotdog1948: calls $0.11
monkeyman1224: calls $0.11
*** RIVER *** [6d 3d 8h 6s] [2s]
Pikdee: checks 
hotdog1948: checks 
monkeyman1224: checks 
*** SHOW DOWN ***
Pikdee: shows [Kd 5d] (a pair of Sixes)
hotdog1948: mucks hand 
monkeyman1224: shows [5h 5c] (two pair, Sixes and Fives)
monkeyman1224 collected $0.53 from pot
*** SUMMARY ***
Total pot $0.55 | Rake $0.02 
Board [6d 3d 8h 6s 2s]
Seat 1: Pikdee (big blind) showed [Kd 5d] and lost with a pair of Sixes
Seat 2: hotdog1948 mucked [Tc 9d]
Seat 3: monkeyman1224 showed [5h 5c] and won ($0.53) with two pair, Sixes and Fives
Seat 5: CashMatteo (button) folded before Flop (didn't bet)
Seat 6: -Hold'Em-253 (small blind) folded before Flop

Hand #2187: 

PokerStars Hand #250519858094:  Hold'em No Limit ($0.01/$0.02 CAD) - 2024/05/15 17:47:49 ET
Table 'Thuban III' 6-max Seat #6 is the button
Seat 1: Pikdee ($1.76 in chips) 
Seat 2: hotdog1948 ($5.55 in chips) 
Seat 3: monkeyman1224 ($1.91 in chips) 
Seat 5: CashMatteo ($4 in chips) 
Seat 6: -Hold'Em-253 ($2 in chips) 
Pikdee: posts small blind $0.01
hotdog1948: posts big blind $0.02
*** HOLE CARDS ***
Dealt to CashMatteo [2d 2s]
monkeyman1224: folds 
CashMatteo: calls $0.02
-Hold'Em-253: raises $0.10 to $0.12
Pikdee: folds 
hotdog1948: folds 
CashMatteo: calls $0.10
*** FLOP *** [9s Qd 7s]
CashMatteo: checks 
-Hold'Em-253: bets $0.19
CashMatteo: folds 
Uncalled bet ($0.19) returned to -Hold'Em-253
-Hold'Em-253 collected $0.26 from pot
-Hold'Em-253: doesn't show hand 
*** SUMMARY ***
Total pot $0.27 | Rake $0.01 
Board [9s Qd 7s]
Seat 1: Pikdee (small blind) folded before Flop
Seat 2: hotdog1948 (big blind) folded before Flop
Seat 3: monkeyman1224 folded before Flop (didn't bet)
Seat 5: CashMatteo folded on the Flop
Seat 6: -Hold'Em-253 (button) collected ($0.26)

Hand #2188: 

PokerStars Hand #250519868286:  Hold'em No Limit ($0.01/$0.02 CAD) - 2024/05/15 17:48:21 ET
Table 'Thuban III' 6-max Seat #1 is the button
Seat 1: Pikdee ($1.75 in chips) 
Seat 2: hotdog1948 ($5.53 in chips) 
Seat 3: monkeyman1224 ($1.91 in chips) 
Seat 5: CashMatteo ($3.88 in chips) 
Seat 6: -Hold'Em-253 ($2.14 in chips) 
hotdog1948: posts small blind $0.01
monkeyman1224: posts big blind $0.02
*** HOLE CARDS ***
Dealt to CashMatteo [5s 4d]
CashMatteo: folds 
-Hold'Em-253: folds 
Pikdee: folds 
hotdog1948: calls $0.01
monkeyman1224: checks 
*** FLOP *** [7c 9c Jd]
hotdog1948: bets $0.02
monkeyman1224: raises $0.02 to $0.04
hotdog1948: calls $0.02
*** TURN *** [7c 9c Jd] [6d]
hotdog1948: bets $0.02
monkeyman1224: raises $0.08 to $0.10
hotdog1948: calls $0.08
*** RIVER *** [7c 9c Jd 6d] [9s]
hotdog1948: bets $0.02
monkeyman1224: raises $0.30 to $0.32
hotdog1948: folds 
Uncalled bet ($0.30) returned to monkeyman1224
monkeyman1224 collected $0.35 from pot
monkeyman1224: doesn't show hand 
*** SUMMARY ***
Total pot $0.36 | Rake $0.01 
Board [7c 9c Jd 6d 9s]
Seat 1: Pikdee (button) folded before Flop (didn't bet)
Seat 2: hotdog1948 (small blind) folded on the River
Seat 3: monkeyman1224 (big blind) collected ($0.35)
Seat 5: CashMatteo folded before Flop (didn't bet)
Seat 6: -Hold'Em-253 folded before Flop (didn't bet)

Hand #2189: 

PokerStars Hand #250519884770:  Hold'em No Limit ($0.01/$0.02 CAD) - 2024/05/15 17:49:11 ET
Table 'Thuban III' 6-max Seat #2 is the button
Seat 1: Pikdee ($1.75 in chips) 
Seat 2: hotdog1948 ($5.35 in chips) 
Seat 3: monkeyman1224 ($2.08 in chips) 
Seat 5: CashMatteo ($3.88 in chips) 
Seat 6: -Hold'Em-253 ($2.14 in chips) 
monkeyman1224: posts small blind $0.01
CashMatteo: posts big blind $0.02
*** HOLE CARDS ***
Dealt to CashMatteo [3d 2s]
-Hold'Em-253: raises $0.04 to $0.06
Pikdee: folds 
hotdog1948: calls $0.06
monkeyman1224: folds 
CashMatteo: folds 
*** FLOP *** [9d Jd Th]
-Hold'Em-253: checks 
hotdog1948: checks 
*** TURN *** [9d Jd Th] [As]
-Hold'Em-253: bets $0.11
hotdog1948: folds 
Uncalled bet ($0.11) returned to -Hold'Em-253
-Hold'Em-253 collected $0.14 from pot
-Hold'Em-253: doesn't show hand 
*** SUMMARY ***
Total pot $0.15 | Rake $0.01 
Board [9d Jd Th As]
Seat 1: Pikdee folded before Flop (didn't bet)
Seat 2: hotdog1948 (button) folded on the Turn
Seat 3: monkeyman1224 (small blind) folded before Flop
Seat 5: CashMatteo (big blind) folded before Flop
Seat 6: -Hold'Em-253 collected ($0.14)

Hand #2190: 

PokerStars Hand #250519896922:  Hold'em No Limit ($0.01/$0.02 CAD) - 2024/05/15 17:49:49 ET
Table 'Thuban III' 6-max Seat #3 is the button
Seat 1: Pikdee ($1.75 in chips) 
Seat 2: hotdog1948 ($5.29 in chips) 
Seat 3: monkeyman1224 ($2.07 in chips) 
Seat 5: CashMatteo ($3.86 in chips) 
Seat 6: -Hold'Em-253 ($2.22 in chips) 
CashMatteo: posts small blind $0.01
-Hold'Em-253: posts big blind $0.02
*** HOLE CARDS ***
Dealt to CashMatteo [9d Kh]
Pikdee: raises $0.03 to $0.05
hotdog1948: raises $0.03 to $0.08
crazykid62 joins the table at seat #4 
monkeyman1224: calls $0.08
CashMatteo: calls $0.07
-Hold'Em-253: folds 
Pikdee: calls $0.03
*** FLOP *** [2h Th Ks]
CashMatteo: checks 
Pikdee: bets $0.17
hotdog1948: calls $0.17
monkeyman1224: calls $0.17
CashMatteo: raises $0.53 to $0.70
Pikdee: folds 
hotdog1948: calls $0.53
monkeyman1224: calls $0.53
*** TURN *** [2h Th Ks] [3h]
CashMatteo: checks 
hotdog1948: bets $2.52
monkeyman1224: calls $1.29 and is all-in
CashMatteo: calls $2.52
*** RIVER *** [2h Th Ks 3h] [9c]
CashMatteo: bets $0.56 and is all-in
hotdog1948: calls $0.56
*** SHOW DOWN ***
CashMatteo: shows [9d Kh] (two pair, Kings and Nines)
hotdog1948: shows [Qd Qh] (a pair of Queens)
CashMatteo collected $3.51 from side pot
monkeyman1224: shows [Ah 9h] (a flush, Ace high)
monkeyman1224 collected $6.25 from main pot
*** SUMMARY ***
Total pot $10.06 Main pot $6.25. Side pot $3.51. | Rake $0.30 
Board [2h Th Ks 3h 9c]
Seat 1: Pikdee folded on the Flop
Seat 2: hotdog1948 showed [Qd Qh] and lost with a pair of Queens
Seat 3: monkeyman1224 (button) showed [Ah 9h] and won ($6.25) with a flush, Ace high
Seat 5: CashMatteo (small blind) showed [9d Kh] and won ($3.51) with two pair, Kings and Nines
Seat 6: -Hold'Em-253 (big blind) folded before Flop

Hand #2191: 

PokerStars Hand #250519922022:  Hold'em No Limit ($0.01/$0.02 CAD) - 2024/05/15 17:51:08 ET
Table 'Thuban III' 6-max Seat #5 is the button
Seat 1: Pikdee ($1.50 in chips) 
Seat 2: hotdog1948 ($1.43 in chips) 
Seat 3: monkeyman1224 ($6.25 in chips) 
Seat 5: CashMatteo ($3.51 in chips) 
Seat 6: -Hold'Em-253 ($2.20 in chips) 
-Hold'Em-253: posts small blind $0.01
Pikdee: posts big blind $0.02
crazykid62: sits out 
*** HOLE CARDS ***
Dealt to CashMatteo [6c 9s]
hotdog1948: raises $0.02 to $0.04
monkeyman1224: folds 
CashMatteo: calls $0.04
-Hold'Em-253: folds 
Pikdee: folds 
*** FLOP *** [3c As 4c]
hotdog1948: bets $0.02
CashMatteo: calls $0.02
*** TURN *** [3c As 4c] [3h]
hotdog1948: bets $0.02
CashMatteo: raises $0.18 to $0.20
hotdog1948: folds 
Uncalled bet ($0.18) returned to CashMatteo
crazykid62 leaves the table
CashMatteo collected $0.18 from pot
CashMatteo: doesn't show hand 
*** SUMMARY ***
Total pot $0.19 | Rake $0.01 
Board [3c As 4c 3h]
Seat 1: Pikdee (big blind) folded before Flop
Seat 2: hotdog1948 folded on the Turn
Seat 3: monkeyman1224 folded before Flop (didn't bet)
Seat 5: CashMatteo (button) collected ($0.18)
Seat 6: -Hold'Em-253 (small blind) folded before Flop

Hand #2192: 

PokerStars Hand #250519931139:  Hold'em No Limit ($0.01/$0.02 CAD) - 2024/05/15 17:51:37 ET
Table 'Thuban III' 6-max Seat #6 is the button
Seat 1: Pikdee ($1.48 in chips) 
Seat 2: hotdog1948 ($1.35 in chips) 
Seat 3: monkeyman1224 ($6.25 in chips) 
Seat 5: CashMatteo ($3.61 in chips) 
Seat 6: -Hold'Em-253 ($2.19 in chips) 
Pikdee: posts small blind $0.01
hotdog1948: posts big blind $0.02
*** HOLE CARDS ***
Dealt to CashMatteo [8d Qh]
monkeyman1224: folds 
CashMatteo: raises $0.03 to $0.05
-Hold'Em-253: folds 
Pikdee: folds 
hotdog1948: calls $0.03
*** FLOP *** [Ah Qc 9d]
hotdog1948: checks 
CashMatteo: bets $0.06
hotdog1948: folds 
Uncalled bet ($0.06) returned to CashMatteo
CashMatteo collected $0.11 from pot
CashMatteo: doesn't show hand 
*** SUMMARY ***
Total pot $0.11 | Rake $0 
Board [Ah Qc 9d]
Seat 1: Pikdee (small blind) folded before Flop
Seat 2: hotdog1948 (big blind) folded on the Flop
Seat 3: monkeyman1224 folded before Flop (didn't bet)
Seat 5: CashMatteo collected ($0.11)
Seat 6: -Hold'Em-253 (button) folded before Flop (didn't bet)

Hand #2193: 

PokerStars Hand #250519937792:  Hold'em No Limit ($0.01/$0.02 CAD) - 2024/05/15 17:51:58 ET
Table 'Thuban III' 6-max Seat #1 is the button
Seat 1: Pikdee ($1.47 in chips) 
Seat 2: hotdog1948 ($1.30 in chips) 
Seat 3: monkeyman1224 ($6.25 in chips) 
Seat 5: CashMatteo ($3.67 in chips) 
Seat 6: -Hold'Em-253 ($2.19 in chips) 
hotdog1948: posts small blind $0.01
monkeyman1224: posts big blind $0.02
*** HOLE CARDS ***
Dealt to CashMatteo [6h 3s]
CashMatteo: folds 
-Hold'Em-253: raises $0.04 to $0.06
Pikdee: folds 
hotdog1948: raises $1.24 to $1.30 and is all-in
monkeyman1224: folds 
flubberlux joins the table at seat #4 
-Hold'Em-253: folds 
Uncalled bet ($1.24) returned to hotdog1948
hotdog1948 collected $0.14 from pot
*** SUMMARY ***
Total pot $0.14 | Rake $0 
Seat 1: Pikdee (button) folded before Flop (didn't bet)
Seat 2: hotdog1948 (small blind) collected ($0.14)
Seat 3: monkeyman1224 (big blind) folded before Flop
Seat 5: CashMatteo folded before Flop (didn't bet)
Seat 6: -Hold'Em-253 folded before Flop

Hand #2194: 

PokerStars Hand #250519955400:  Hold'em No Limit ($0.01/$0.02 CAD) - 2024/05/15 17:52:55 ET
Table 'Thuban III' 6-max Seat #2 is the button
Seat 1: Pikdee ($1.47 in chips) 
Seat 2: hotdog1948 ($1.38 in chips) 
Seat 3: monkeyman1224 ($6.23 in chips) 
Seat 4: flubberlux ($0.80 in chips) 
Seat 5: CashMatteo ($3.67 in chips) 
Seat 6: -Hold'Em-253 ($2.13 in chips) 
monkeyman1224: posts small blind $0.01
flubberlux: posts big blind $0.02
*** HOLE CARDS ***
Dealt to CashMatteo [6d Qh]
CashMatteo: raises $0.03 to $0.05
-Hold'Em-253: folds 
Pikdee: folds 
hotdog1948: raises $0.13 to $0.18
monkeyman1224: folds 
flubberlux: folds 
CashMatteo: calls $0.13
*** FLOP *** [2h 4h 3h]
CashMatteo: checks 
hotdog1948: bets $0.19
CashMatteo: calls $0.19
*** TURN *** [2h 4h 3h] [Th]
CashMatteo: checks 
hotdog1948: bets $1.01 and is all-in
CashMatteo: calls $1.01
*** RIVER *** [2h 4h 3h Th] [Qd]
*** SHOW DOWN ***
CashMatteo: shows [6d Qh] (a flush, Queen high)
hotdog1948: shows [9c 9s] (a pair of Nines)
CashMatteo collected $2.69 from pot
*** SUMMARY ***
Total pot $2.79 | Rake $0.10 
Board [2h 4h 3h Th Qd]
Seat 1: Pikdee folded before Flop (didn't bet)
Seat 2: hotdog1948 (button) showed [9c 9s] and lost with a pair of Nines
Seat 3: monkeyman1224 (small blind) folded before Flop
Seat 4: flubberlux (big blind) folded before Flop
Seat 5: CashMatteo showed [6d Qh] and won ($2.69) with a flush, Queen high
Seat 6: -Hold'Em-253 folded before Flop (didn't bet)

Hand #2195: 

PokerStars Hand #250519971495:  Hold'em No Limit ($0.01/$0.02 CAD) - 2024/05/15 17:53:47 ET
Table 'Thuban III' 6-max Seat #3 is the button
Seat 1: Pikdee ($1.47 in chips) 
Seat 3: monkeyman1224 ($6.22 in chips) 
Seat 4: flubberlux ($0.78 in chips) 
Seat 5: CashMatteo ($4.98 in chips) 
Seat 6: -Hold'Em-253 ($2.13 in chips) 
flubberlux: posts small blind $0.01
CashMatteo: posts big blind $0.02
*** HOLE CARDS ***
Dealt to CashMatteo [6h 8s]
-Hold'Em-253: folds 
Pikdee: folds 
monkeyman1224: folds 
flubberlux: calls $0.01
CashMatteo: folds 
CashMatteo leaves the table
flubberlux collected $0.04 from pot
flubberlux: doesn't show hand 
*** SUMMARY ***
Total pot $0.04 | Rake $0 
Seat 1: Pikdee folded before Flop (didn't bet)
Seat 3: monkeyman1224 (button) folded before Flop (didn't bet)
Seat 4: flubberlux (small blind) collected ($0.04)
Seat 5: CashMatteo (big blind) folded before Flop
Seat 6: -Hold'Em-253 folded before Flop (didn't bet)

Hand #2196: 

PokerStars Hand #250519986878:  Hold'em No Limit ($0.05/$0.10 CAD) - 2024/05/15 17:54:37 ET
Table 'Astronomia III' 6-max Seat #5 is the button
Seat 1: DSilver ($10 in chips) 
Seat 2: sTYLz_23 ($24.53 in chips) 
Seat 3: AA Mac ($15.78 in chips) 
Seat 4: CashMatteo ($8 in chips) 
Seat 5: krrum ($18.19 in chips) 
Seat 6: SomeGoodKush ($18.22 in chips) 
SomeGoodKush: posts small blind $0.05
DSilver: posts big blind $0.10
CashMatteo: posts big blind $0.10
*** HOLE CARDS ***
Dealt to CashMatteo [9c Qd]
sTYLz_23 has timed out
sTYLz_23: folds 
AA Mac: folds 
CashMatteo: raises $0.15 to $0.25
krrum: folds 
SomeGoodKush: folds 
DSilver: folds 
Uncalled bet ($0.15) returned to CashMatteo
CashMatteo collected $0.25 from pot
CashMatteo: doesn't show hand 
*** SUMMARY ***
Total pot $0.25 | Rake $0 
Seat 1: DSilver (big blind) folded before Flop
Seat 2: sTYLz_23 folded before Flop (didn't bet)
Seat 3: AA Mac folded before Flop (didn't bet)
Seat 4: CashMatteo collected ($0.25)
Seat 5: krrum (button) folded before Flop (didn't bet)
Seat 6: SomeGoodKush (small blind) folded before Flop

Hand #2197: 

PokerStars Hand #250519994878:  Hold'em No Limit ($0.05/$0.10 CAD) - 2024/05/15 17:55:03 ET
Table 'Astronomia III' 6-max Seat #6 is the button
Seat 1: DSilver ($10 in chips) 
Seat 2: sTYLz_23 ($24.53 in chips) 
Seat 3: AA Mac ($15.78 in chips) 
Seat 4: CashMatteo ($8.15 in chips) 
Seat 5: krrum ($18.19 in chips) 
Seat 6: SomeGoodKush ($18.17 in chips) 
DSilver: posts small blind $0.05
sTYLz_23: posts big blind $0.10
*** HOLE CARDS ***
Dealt to CashMatteo [Kh Kc]
AA Mac: folds 
CashMatteo: raises $0.15 to $0.25
krrum: folds 
SomeGoodKush: folds 
DSilver: folds 
sTYLz_23: folds 
Uncalled bet ($0.15) returned to CashMatteo
CashMatteo collected $0.25 from pot
CashMatteo: doesn't show hand 
*** SUMMARY ***
Total pot $0.25 | Rake $0 
Seat 1: DSilver (small blind) folded before Flop
Seat 2: sTYLz_23 (big blind) folded before Flop
Seat 3: AA Mac folded before Flop (didn't bet)
Seat 4: CashMatteo collected ($0.25)
Seat 5: krrum folded before Flop (didn't bet)
Seat 6: SomeGoodKush (button) folded before Flop (didn't bet)

Hand #2198: 

PokerStars Hand #250519999207:  Hold'em No Limit ($0.05/$0.10 CAD) - 2024/05/15 17:55:18 ET
Table 'Astronomia III' 6-max Seat #1 is the button
Seat 1: DSilver ($10 in chips) 
Seat 2: sTYLz_23 ($24.43 in chips) 
Seat 3: AA Mac ($15.78 in chips) 
Seat 4: CashMatteo ($8.30 in chips) 
Seat 5: krrum ($18.19 in chips) 
Seat 6: SomeGoodKush ($18.17 in chips) 
sTYLz_23: posts small blind $0.05
AA Mac: posts big blind $0.10
*** HOLE CARDS ***
Dealt to CashMatteo [9h 9s]
CashMatteo: raises $0.15 to $0.25
krrum: raises $0.50 to $0.75
SomeGoodKush: folds 
DSilver: folds 
sTYLz_23: folds 
AA Mac: folds 
CashMatteo: calls $0.50
*** FLOP *** [4h Qc Ks]
CashMatteo: checks 
krrum: bets $0.82
CashMatteo: calls $0.82
*** TURN *** [4h Qc Ks] [Ac]
CashMatteo: checks 
krrum: bets $2.10
CashMatteo: folds 
Uncalled bet ($2.10) returned to krrum
krrum collected $3.14 from pot
*** SUMMARY ***
Total pot $3.29 | Rake $0.15 
Board [4h Qc Ks Ac]
Seat 1: DSilver (button) folded before Flop (didn't bet)
Seat 2: sTYLz_23 (small blind) folded before Flop
Seat 3: AA Mac (big blind) folded before Flop
Seat 4: CashMatteo folded on the Turn
Seat 5: krrum collected ($3.14)
Seat 6: SomeGoodKush folded before Flop (didn't bet)

Hand #2199: 

PokerStars Hand #250520010264:  Hold'em No Limit ($0.05/$0.10 CAD) - 2024/05/15 17:56:10 ET
Table 'Astronomia III' 6-max Seat #2 is the button
Seat 1: DSilver ($10 in chips) 
Seat 2: sTYLz_23 ($24.38 in chips) 
Seat 3: AA Mac ($15.68 in chips) 
Seat 4: CashMatteo ($6.73 in chips) 
Seat 5: krrum ($19.76 in chips) 
Seat 6: SomeGoodKush ($18.17 in chips) 
AA Mac: posts small blind $0.05
CashMatteo: posts big blind $0.10
*** HOLE CARDS ***
Dealt to CashMatteo [2h 6h]
krrum: folds 
SomeGoodKush: folds 
DSilver: folds 
sTYLz_23: folds 
AA Mac: raises $0.10 to $0.20
CashMatteo: calls $0.10
*** FLOP *** [8c Kd 5d]
AA Mac: bets $0.21
CashMatteo: calls $0.21
*** TURN *** [8c Kd 5d] [5s]
AA Mac: bets $0.42
CashMatteo: folds 
Uncalled bet ($0.42) returned to AA Mac
AA Mac collected $0.78 from pot
AA Mac: doesn't show hand 
*** SUMMARY ***
Total pot $0.82 | Rake $0.04 
Board [8c Kd 5d 5s]
Seat 1: DSilver folded before Flop (didn't bet)
Seat 2: sTYLz_23 (button) folded before Flop (didn't bet)
Seat 3: AA Mac (small blind) collected ($0.78)
Seat 4: CashMatteo (big blind) folded on the Turn
Seat 5: krrum folded before Flop (didn't bet)
Seat 6: SomeGoodKush folded before Flop (didn't bet)

Hand #2200: 

PokerStars Hand #250520017522:  Hold'em No Limit ($0.05/$0.10 CAD) - 2024/05/15 17:56:43 ET
Table 'Astronomia III' 6-max Seat #3 is the button
Seat 1: DSilver ($10 in chips) 
Seat 2: sTYLz_23 ($24.38 in chips) 
Seat 3: AA Mac ($16.05 in chips) 
Seat 4: CashMatteo ($6.32 in chips) 
Seat 5: krrum ($19.76 in chips) 
Seat 6: SomeGoodKush ($18.17 in chips) 
CashMatteo: posts small blind $0.05
krrum: posts big blind $0.10
*** HOLE CARDS ***
Dealt to CashMatteo [Jh 7s]
SomeGoodKush: folds 
DSilver: folds 
sTYLz_23: folds 
AA Mac: folds 
CashMatteo: folds 
Uncalled bet ($0.05) returned to krrum
krrum collected $0.10 from pot
*** SUMMARY ***
Total pot $0.10 | Rake $0 
Seat 1: DSilver folded before Flop (didn't bet)
Seat 2: sTYLz_23 folded before Flop (didn't bet)
Seat 3: AA Mac (button) folded before Flop (didn't bet)
Seat 4: CashMatteo (small blind) folded before Flop
Seat 5: krrum (big blind) collected ($0.10)
Seat 6: SomeGoodKush folded before Flop (didn't bet)

Hand #2201: 

PokerStars Hand #250520020483:  Hold'em No Limit ($0.05/$0.10 CAD) - 2024/05/15 17:56:57 ET
Table 'Astronomia III' 6-max Seat #4 is the button
Seat 1: DSilver ($10 in chips) 
Seat 2: sTYLz_23 ($24.38 in chips) 
Seat 3: AA Mac ($16.05 in chips) 
Seat 4: CashMatteo ($6.27 in chips) 
Seat 5: krrum ($19.81 in chips) 
Seat 6: SomeGoodKush ($18.17 in chips) 
krrum: posts small blind $0.05
SomeGoodKush: posts big blind $0.10
*** HOLE CARDS ***
Dealt to CashMatteo [2h Tc]
DSilver: folds 
sTYLz_23: raises $0.20 to $0.30
AA Mac: folds 
CashMatteo: folds 
krrum: folds 
SomeGoodKush: calls $0.20
*** FLOP *** [8c Jd 5d]
SomeGoodKush: checks 
sTYLz_23: bets $0.31
SomeGoodKush: folds 
Uncalled bet ($0.31) returned to sTYLz_23
sTYLz_23 collected $0.62 from pot
*** SUMMARY ***
Total pot $0.65 | Rake $0.03 
Board [8c Jd 5d]
Seat 1: DSilver folded before Flop (didn't bet)
Seat 2: sTYLz_23 collected ($0.62)
Seat 3: AA Mac folded before Flop (didn't bet)
Seat 4: CashMatteo (button) folded before Flop (didn't bet)
Seat 5: krrum (small blind) folded before Flop
Seat 6: SomeGoodKush (big blind) folded on the Flop

Hand #2202: 

PokerStars Hand #250520027114:  Hold'em No Limit ($0.05/$0.10 CAD) - 2024/05/15 17:57:28 ET
Table 'Astronomia III' 6-max Seat #5 is the button
Seat 1: DSilver ($10 in chips) 
Seat 2: sTYLz_23 ($24.70 in chips) 
Seat 3: AA Mac ($16.05 in chips) 
Seat 4: CashMatteo ($6.27 in chips) 
Seat 5: krrum ($19.76 in chips) 
Seat 6: SomeGoodKush ($17.87 in chips) 
SomeGoodKush: posts small blind $0.05
DSilver: posts big blind $0.10
*** HOLE CARDS ***
Dealt to CashMatteo [2d Kh]
sTYLz_23: folds 
AA Mac: raises $0.10 to $0.20
CashMatteo: folds 
krrum: raises $0.50 to $0.70
SomeGoodKush: folds 
DSilver: raises $1.65 to $2.35
AA Mac: folds 
krrum: folds 
Uncalled bet ($1.65) returned to DSilver
DSilver collected $1.65 from pot
DSilver: doesn't show hand 
*** SUMMARY ***
Total pot $1.65 | Rake $0 
Seat 1: DSilver (big blind) collected ($1.65)
Seat 2: sTYLz_23 folded before Flop (didn't bet)
Seat 3: AA Mac folded before Flop
Seat 4: CashMatteo folded before Flop (didn't bet)
Seat 5: krrum (button) folded before Flop
Seat 6: SomeGoodKush (small blind) folded before Flop

Hand #2203: 

PokerStars Hand #250520035219:  Hold'em No Limit ($0.05/$0.10 CAD) - 2024/05/15 17:58:06 ET
Table 'Astronomia III' 6-max Seat #6 is the button
Seat 1: DSilver ($10.95 in chips) 
Seat 2: sTYLz_23 ($24.70 in chips) 
Seat 3: AA Mac ($15.85 in chips) 
Seat 4: CashMatteo ($6.27 in chips) 
Seat 5: krrum ($19.06 in chips) 
Seat 6: SomeGoodKush ($17.82 in chips) 
DSilver: posts small blind $0.05
sTYLz_23: posts big blind $0.10
*** HOLE CARDS ***
Dealt to CashMatteo [8d Ad]
AA Mac: folds 
CashMatteo: raises $0.15 to $0.25
krrum: folds 
SomeGoodKush: folds 
DSilver: folds 
sTYLz_23: calls $0.15
*** FLOP *** [6h 6s Jh]
sTYLz_23: checks 
CashMatteo: bets $0.27
sTYLz_23: folds 
Uncalled bet ($0.27) returned to CashMatteo
CashMatteo collected $0.53 from pot
CashMatteo: doesn't show hand 
*** SUMMARY ***
Total pot $0.55 | Rake $0.02 
Board [6h 6s Jh]
Seat 1: DSilver (small blind) folded before Flop
Seat 2: sTYLz_23 (big blind) folded on the Flop
Seat 3: AA Mac folded before Flop (didn't bet)
Seat 4: CashMatteo collected ($0.53)
Seat 5: krrum folded before Flop (didn't bet)
Seat 6: SomeGoodKush (button) folded before Flop (didn't bet)

Hand #2204: 

PokerStars Hand #250520041517:  Hold'em No Limit ($0.05/$0.10 CAD) - 2024/05/15 17:58:35 ET
Table 'Astronomia III' 6-max Seat #1 is the button
Seat 1: DSilver ($10.90 in chips) 
Seat 2: sTYLz_23 ($24.45 in chips) 
Seat 3: AA Mac ($15.85 in chips) 
Seat 4: CashMatteo ($6.55 in chips) 
Seat 5: krrum ($19.06 in chips) 
Seat 6: SomeGoodKush ($17.82 in chips) 
sTYLz_23: posts small blind $0.05
AA Mac: posts big blind $0.10
*** HOLE CARDS ***
Dealt to CashMatteo [3s Qs]
CashMatteo: raises $0.15 to $0.25
krrum: folds 
SomeGoodKush: folds 
DSilver: folds 
sTYLz_23: folds 
AA Mac: folds 
Uncalled bet ($0.15) returned to CashMatteo
CashMatteo collected $0.25 from pot
CashMatteo: doesn't show hand 
*** SUMMARY ***
Total pot $0.25 | Rake $0 
Seat 1: DSilver (button) folded before Flop (didn't bet)
Seat 2: sTYLz_23 (small blind) folded before Flop
Seat 3: AA Mac (big blind) folded before Flop
Seat 4: CashMatteo collected ($0.25)
Seat 5: krrum folded before Flop (didn't bet)
Seat 6: SomeGoodKush folded before Flop (didn't bet)

Hand #2205: 

PokerStars Hand #250520044448:  Hold'em No Limit ($0.05/$0.10 CAD) - 2024/05/15 17:58:49 ET
Table 'Astronomia III' 6-max Seat #2 is the button
Seat 1: DSilver ($10.90 in chips) 
Seat 2: sTYLz_23 ($24.40 in chips) 
Seat 3: AA Mac ($15.75 in chips) 
Seat 4: CashMatteo ($6.70 in chips) 
Seat 5: krrum ($19.06 in chips) 
Seat 6: SomeGoodKush ($17.82 in chips) 
AA Mac: posts small blind $0.05
CashMatteo: posts big blind $0.10
*** HOLE CARDS ***
Dealt to CashMatteo [Qd 3s]
krrum: folds 
SomeGoodKush: folds 
DSilver: folds 
sTYLz_23: calls $0.10
AA Mac: calls $0.05
CashMatteo: raises $0.15 to $0.25
sTYLz_23: calls $0.15
AA Mac: calls $0.15
*** FLOP *** [Jh 7s 2d]
AA Mac: checks 
CashMatteo: bets $0.46
sTYLz_23: calls $0.46
AA Mac: folds 
*** TURN *** [Jh 7s 2d] [6d]
CashMatteo: checks 
sTYLz_23: bets $0.80
CashMatteo: folds 
Uncalled bet ($0.80) returned to sTYLz_23
sTYLz_23 collected $1.59 from pot
*** SUMMARY ***
Total pot $1.67 | Rake $0.08 
Board [Jh 7s 2d 6d]
Seat 1: DSilver folded before Flop (didn't bet)
Seat 2: sTYLz_23 (button) collected ($1.59)
Seat 3: AA Mac (small blind) folded on the Flop
Seat 4: CashMatteo (big blind) folded on the Turn
Seat 5: krrum folded before Flop (didn't bet)
Seat 6: SomeGoodKush folded before Flop (didn't bet)

Hand #2206: 

PokerStars Hand #250520053575:  Hold'em No Limit ($0.05/$0.10 CAD) - 2024/05/15 17:59:32 ET
Table 'Astronomia III' 6-max Seat #3 is the button
Seat 1: DSilver ($10.90 in chips) 
Seat 2: sTYLz_23 ($25.28 in chips) 
Seat 3: AA Mac ($15.50 in chips) 
Seat 4: CashMatteo ($5.99 in chips) 
Seat 5: krrum ($19.06 in chips) 
Seat 6: SomeGoodKush ($17.82 in chips) 
CashMatteo: posts small blind $0.05
krrum: posts big blind $0.10
*** HOLE CARDS ***
Dealt to CashMatteo [4d 2h]
SomeGoodKush: folds 
DSilver: folds 
sTYLz_23: folds 
AA Mac: folds 
CashMatteo: folds 
Uncalled bet ($0.05) returned to krrum
krrum collected $0.10 from pot
*** SUMMARY ***
Total pot $0.10 | Rake $0 
Seat 1: DSilver folded before Flop (didn't bet)
Seat 2: sTYLz_23 folded before Flop (didn't bet)
Seat 3: AA Mac (button) folded before Flop (didn't bet)
Seat 4: CashMatteo (small blind) folded before Flop
Seat 5: krrum (big blind) collected ($0.10)
Seat 6: SomeGoodKush folded before Flop (didn't bet)

Hand #2207: 

PokerStars Hand #250520057193:  Hold'em No Limit ($0.05/$0.10 CAD) - 2024/05/15 17:59:49 ET
Table 'Astronomia III' 6-max Seat #4 is the button
Seat 1: DSilver ($10.90 in chips) 
Seat 2: sTYLz_23 ($25.28 in chips) 
Seat 3: AA Mac ($15.50 in chips) 
Seat 4: CashMatteo ($5.94 in chips) 
Seat 5: krrum ($19.11 in chips) 
Seat 6: SomeGoodKush ($17.82 in chips) 
krrum: posts small blind $0.05
SomeGoodKush: posts big blind $0.10
*** HOLE CARDS ***
Dealt to CashMatteo [Qs 5c]
DSilver: folds 
sTYLz_23: calls $0.10
AA Mac: raises $0.30 to $0.40
CashMatteo: folds 
krrum: folds 
SomeGoodKush: folds 
sTYLz_23: folds 
Uncalled bet ($0.30) returned to AA Mac
AA Mac collected $0.35 from pot
AA Mac: doesn't show hand 
*** SUMMARY ***
Total pot $0.35 | Rake $0 
Seat 1: DSilver folded before Flop (didn't bet)
Seat 2: sTYLz_23 folded before Flop
Seat 3: AA Mac collected ($0.35)
Seat 4: CashMatteo (button) folded before Flop (didn't bet)
Seat 5: krrum (small blind) folded before Flop
Seat 6: SomeGoodKush (big blind) folded before Flop

Hand #2208: 

PokerStars Hand #250520061027:  Hold'em No Limit ($0.05/$0.10 CAD) - 2024/05/15 18:00:07 ET
Table 'Astronomia III' 6-max Seat #5 is the button
Seat 1: DSilver ($10.90 in chips) 
Seat 2: sTYLz_23 ($25.18 in chips) 
Seat 3: AA Mac ($15.75 in chips) 
Seat 4: CashMatteo ($5.94 in chips) 
Seat 5: krrum ($19.06 in chips) 
Seat 6: SomeGoodKush ($17.72 in chips) 
SomeGoodKush: posts small blind $0.05
DSilver: posts big blind $0.10
*** HOLE CARDS ***
Dealt to CashMatteo [3h 7d]
sTYLz_23: folds 
AA Mac: folds 
CashMatteo: folds 
krrum: raises $0.15 to $0.25
SomeGoodKush: folds 
DSilver: folds 
Uncalled bet ($0.15) returned to krrum
krrum collected $0.25 from pot
*** SUMMARY ***
Total pot $0.25 | Rake $0 
Seat 1: DSilver (big blind) folded before Flop
Seat 2: sTYLz_23 folded before Flop (didn't bet)
Seat 3: AA Mac folded before Flop (didn't bet)
Seat 4: CashMatteo folded before Flop (didn't bet)
Seat 5: krrum (button) collected ($0.25)
Seat 6: SomeGoodKush (small blind) folded before Flop

Hand #2209: 

PokerStars Hand #250520065807:  Hold'em No Limit ($0.05/$0.10 CAD) - 2024/05/15 18:00:29 ET
Table 'Astronomia III' 6-max Seat #6 is the button
Seat 1: DSilver ($10.80 in chips) 
Seat 2: sTYLz_23 ($25.18 in chips) 
Seat 3: AA Mac ($15.75 in chips) 
Seat 4: CashMatteo ($5.94 in chips) 
Seat 5: krrum ($19.21 in chips) 
Seat 6: SomeGoodKush ($17.67 in chips) 
DSilver: posts small blind $0.05
sTYLz_23: posts big blind $0.10
*** HOLE CARDS ***
Dealt to CashMatteo [Qd 8d]
AA Mac: folds 
CashMatteo: raises $0.15 to $0.25
krrum: folds 
SomeGoodKush: calls $0.25
DSilver: folds 
sTYLz_23: calls $0.15
*** FLOP *** [6d 4d 7s]
sTYLz_23: checks 
CashMatteo: bets $0.86
SomeGoodKush: calls $0.86
sTYLz_23: folds 
*** TURN *** [6d 4d 7s] [Kd]
CashMatteo: bets $1.31
SomeGoodKush: calls $1.31
*** RIVER *** [6d 4d 7s Kd] [7d]
CashMatteo: checks 
SomeGoodKush: checks 
*** SHOW DOWN ***
CashMatteo: shows [Qd 8d] (a flush, King high)
SomeGoodKush: mucks hand 
CashMatteo collected $4.91 from pot
*** SUMMARY ***
Total pot $5.14 | Rake $0.23 
Board [6d 4d 7s Kd 7d]
Seat 1: DSilver (small blind) folded before Flop
Seat 2: sTYLz_23 (big blind) folded on the Flop
Seat 3: AA Mac folded before Flop (didn't bet)
Seat 4: CashMatteo showed [Qd 8d] and won ($4.91) with a flush, King high
Seat 5: krrum folded before Flop (didn't bet)
Seat 6: SomeGoodKush (button) mucked [3c 5c]

Hand #2210: 

PokerStars Hand #250520085313:  Hold'em No Limit ($0.05/$0.10 CAD) - 2024/05/15 18:01:48 ET
Table 'Astronomia III' 6-max Seat #1 is the button
Seat 1: DSilver ($10.75 in chips) 
Seat 2: sTYLz_23 ($24.93 in chips) 
Seat 3: AA Mac ($15.75 in chips) 
Seat 4: CashMatteo ($8.43 in chips) 
Seat 5: krrum ($19.21 in chips) 
Seat 6: SomeGoodKush ($15.25 in chips) 
sTYLz_23: posts small blind $0.05
AA Mac: posts big blind $0.10
*** HOLE CARDS ***
Dealt to CashMatteo [Ad 3s]
CashMatteo: calls $0.10
krrum: folds 
SomeGoodKush: calls $0.10
DSilver: folds 
sTYLz_23: calls $0.05
AA Mac: checks 
*** FLOP *** [2d 6s 9c]
sTYLz_23: checks 
AA Mac: checks 
CashMatteo: checks 
SomeGoodKush: checks 
*** TURN *** [2d 6s 9c] [Jh]
sTYLz_23: checks 
AA Mac: checks 
CashMatteo: checks 
SomeGoodKush: checks 
*** RIVER *** [2d 6s 9c Jh] [8c]
sTYLz_23: checks 
AA Mac: checks 
CashMatteo: checks 
SomeGoodKush: checks 
*** SHOW DOWN ***
sTYLz_23: shows [7c Jc] (a pair of Jacks)
AA Mac: mucks hand 
CashMatteo: mucks hand 
SomeGoodKush: mucks hand 
sTYLz_23 collected $0.38 from pot
*** SUMMARY ***
Total pot $0.40 | Rake $0.02 
Board [2d 6s 9c Jh 8c]
Seat 1: DSilver (button) folded before Flop (didn't bet)
Seat 2: sTYLz_23 (small blind) showed [7c Jc] and won ($0.38) with a pair of Jacks
Seat 3: AA Mac (big blind) mucked [5s 4h]
Seat 4: CashMatteo mucked [Ad 3s]
Seat 5: krrum folded before Flop (didn't bet)
Seat 6: SomeGoodKush mucked [Tc Kh]

Hand #2211: 

PokerStars Hand #250520099683:  Hold'em No Limit ($0.05/$0.10 CAD) - 2024/05/15 18:02:37 ET
Table 'Astronomia III' 6-max Seat #2 is the button
Seat 1: DSilver ($10.75 in chips) 
Seat 2: sTYLz_23 ($25.21 in chips) 
Seat 3: AA Mac ($15.65 in chips) 
Seat 4: CashMatteo ($8.33 in chips) 
Seat 5: krrum ($19.21 in chips) 
Seat 6: SomeGoodKush ($15.15 in chips) 
AA Mac: posts small blind $0.05
CashMatteo: posts big blind $0.10
*** HOLE CARDS ***
Dealt to CashMatteo [4h 7s]
krrum: folds 
SomeGoodKush: folds 
DSilver: raises $0.20 to $0.30
sTYLz_23: calls $0.30
AA Mac: folds 
CashMatteo: folds 
*** FLOP *** [5c Jc Th]
DSilver: bets $0.40
sTYLz_23: folds 
Uncalled bet ($0.40) returned to DSilver
DSilver collected $0.72 from pot
DSilver: doesn't show hand 
*** SUMMARY ***
Total pot $0.75 | Rake $0.03 
Board [5c Jc Th]
Seat 1: DSilver collected ($0.72)
Seat 2: sTYLz_23 (button) folded on the Flop
Seat 3: AA Mac (small blind) folded before Flop
Seat 4: CashMatteo (big blind) folded before Flop
Seat 5: krrum folded before Flop (didn't bet)
Seat 6: SomeGoodKush folded before Flop (didn't bet)

Hand #2212: 

PokerStars Hand #250520112625:  Hold'em No Limit ($0.05/$0.10 CAD) - 2024/05/15 18:03:20 ET
Table 'Astronomia III' 6-max Seat #3 is the button
Seat 1: DSilver ($11.17 in chips) 
Seat 2: sTYLz_23 ($24.91 in chips) 
Seat 3: AA Mac ($15.60 in chips) 
Seat 4: CashMatteo ($8.23 in chips) 
Seat 6: SomeGoodKush ($15.15 in chips) 
CashMatteo: posts small blind $0.05
krrum: is sitting out 
SomeGoodKush: posts big blind $0.10
*** HOLE CARDS ***
Dealt to CashMatteo [3s Jh]
krrum leaves the table
DSilver: folds 
sTYLz_23: folds 
AA Mac: folds 
CashMatteo: folds 
Uncalled bet ($0.05) returned to SomeGoodKush
SomeGoodKush collected $0.10 from pot
SomeGoodKush: doesn't show hand 
*** SUMMARY ***
Total pot $0.10 | Rake $0 
Seat 1: DSilver folded before Flop (didn't bet)
Seat 2: sTYLz_23 folded before Flop (didn't bet)
Seat 3: AA Mac (button) folded before Flop (didn't bet)
Seat 4: CashMatteo (small blind) folded before Flop
Seat 6: SomeGoodKush (big blind) collected ($0.10)

Hand #2213: 

PokerStars Hand #250520116193:  Hold'em No Limit ($0.05/$0.10 CAD) - 2024/05/15 18:03:32 ET
Table 'Astronomia III' 6-max Seat #4 is the button
Seat 1: DSilver ($11.17 in chips) 
Seat 2: sTYLz_23 ($24.91 in chips) 
Seat 3: AA Mac ($15.60 in chips) 
Seat 4: CashMatteo ($8.18 in chips) 
Seat 6: SomeGoodKush ($15.20 in chips) 
SomeGoodKush: posts small blind $0.05
DSilver: posts big blind $0.10
*** HOLE CARDS ***
Dealt to CashMatteo [6c Jd]
sTYLz_23 has timed out
sTYLz_23: folds 
AA Mac: folds 
CashMatteo: calls $0.10
SomeGoodKush: folds 
DSilver: checks 
*** FLOP *** [8h 9h Tc]
DSilver: checks 
xkoosx joins the table at seat #5 
CashMatteo: checks 
*** TURN *** [8h 9h Tc] [Ad]
DSilver: checks 
CashMatteo: checks 
*** RIVER *** [8h 9h Tc Ad] [9s]
DSilver: checks 
CashMatteo: checks 
*** SHOW DOWN ***
DSilver: shows [2d 4s] (a pair of Nines)
CashMatteo: shows [6c Jd] (a pair of Nines - Ace+Jack kicker)
CashMatteo collected $0.24 from pot
*** SUMMARY ***
Total pot $0.25 | Rake $0.01 
Board [8h 9h Tc Ad 9s]
Seat 1: DSilver (big blind) showed [2d 4s] and lost with a pair of Nines
Seat 2: sTYLz_23 folded before Flop (didn't bet)
Seat 3: AA Mac folded before Flop (didn't bet)
Seat 4: CashMatteo (button) showed [6c Jd] and won ($0.24) with a pair of Nines
Seat 6: SomeGoodKush (small blind) folded before Flop

Hand #2214: 

PokerStars Hand #250520132828:  Hold'em No Limit ($0.05/$0.10 CAD) - 2024/05/15 18:04:27 ET
Table 'Astronomia III' 6-max Seat #6 is the button
Seat 1: DSilver ($11.07 in chips) 
Seat 2: sTYLz_23 ($24.91 in chips) 
Seat 3: AA Mac ($15.60 in chips) 
Seat 4: CashMatteo ($8.32 in chips) 
Seat 5: xkoosx ($10 in chips) 
Seat 6: SomeGoodKush ($15.15 in chips) 
DSilver: posts small blind $0.05
sTYLz_23: posts big blind $0.10
xkoosx: posts big blind $0.10
*** HOLE CARDS ***
Dealt to CashMatteo [Js Ks]
AA Mac: folds 
CashMatteo: raises $0.15 to $0.25
xkoosx: calls $0.15
SomeGoodKush: folds 
DSilver: folds 
sTYLz_23: folds 
*** FLOP *** [Jh 3h 5s]
CashMatteo: bets $0.31
xkoosx: raises $0.31 to $0.62
CashMatteo: calls $0.31
*** TURN *** [Jh 3h 5s] [Kh]
CashMatteo: checks 
xkoosx: bets $1.80
CashMatteo: calls $1.80
*** RIVER *** [Jh 3h 5s Kh] [Kc]
CashMatteo: bets $3.02
xkoosx: raises $4.31 to $7.33 and is all-in
CashMatteo: calls $2.63 and is all-in
Uncalled bet ($1.68) returned to xkoosx
*** SHOW DOWN ***
xkoosx: shows [Jc Kd] (a full house, Kings full of Jacks)
CashMatteo: shows [Js Ks] (a full house, Kings full of Jacks)
CashMatteo collected $8.02 from pot
xkoosx collected $8.01 from pot
*** SUMMARY ***
Total pot $16.79 | Rake $0.76 
Board [Jh 3h 5s Kh Kc]
Seat 1: DSilver (small blind) folded before Flop
Seat 2: sTYLz_23 (big blind) folded before Flop
Seat 3: AA Mac folded before Flop (didn't bet)
Seat 4: CashMatteo showed [Js Ks] and won ($8.02) with a full house, Kings full of Jacks
Seat 5: xkoosx showed [Jc Kd] and won ($8.01) with a full house, Kings full of Jacks
Seat 6: SomeGoodKush (button) folded before Flop (didn't bet)

Hand #2215: 

PokerStars Hand #250520155413:  Hold'em No Limit ($0.05/$0.10 CAD) - 2024/05/15 18:05:42 ET
Table 'Astronomia III' 6-max Seat #1 is the button
Seat 1: DSilver ($11.02 in chips) 
Seat 2: sTYLz_23 ($24.81 in chips) 
Seat 3: AA Mac ($15.60 in chips) 
Seat 4: CashMatteo ($8.02 in chips) 
Seat 5: xkoosx ($9.69 in chips) 
Seat 6: SomeGoodKush ($15.15 in chips) 
sTYLz_23: posts small blind $0.05
AA Mac: posts big blind $0.10
*** HOLE CARDS ***
Dealt to CashMatteo [Ac 5c]
CashMatteo: raises $0.15 to $0.25
xkoosx: folds 
SomeGoodKush: folds 
DSilver: folds 
sTYLz_23: folds 
AA Mac: folds 
Uncalled bet ($0.15) returned to CashMatteo
CashMatteo collected $0.25 from pot
CashMatteo: doesn't show hand 
*** SUMMARY ***
Total pot $0.25 | Rake $0 
Seat 1: DSilver (button) folded before Flop (didn't bet)
Seat 2: sTYLz_23 (small blind) folded before Flop
Seat 3: AA Mac (big blind) folded before Flop
Seat 4: CashMatteo collected ($0.25)
Seat 5: xkoosx folded before Flop (didn't bet)
Seat 6: SomeGoodKush folded before Flop (didn't bet)

Hand #2216: 

PokerStars Hand #250520160819:  Hold'em No Limit ($0.05/$0.10 CAD) - 2024/05/15 18:06:00 ET
Table 'Astronomia III' 6-max Seat #2 is the button
Seat 1: DSilver ($11.02 in chips) 
Seat 2: sTYLz_23 ($24.76 in chips) 
Seat 3: AA Mac ($15.50 in chips) 
Seat 4: CashMatteo ($8.17 in chips) 
Seat 5: xkoosx ($9.69 in chips) 
Seat 6: SomeGoodKush ($15.15 in chips) 
AA Mac: posts small blind $0.05
CashMatteo: posts big blind $0.10
*** HOLE CARDS ***
Dealt to CashMatteo [Js 9s]
xkoosx: raises $0.20 to $0.30
SomeGoodKush: calls $0.30
DSilver: folds 
sTYLz_23: folds 
AA Mac: folds 
CashMatteo: calls $0.20
*** FLOP *** [Jd 3c 6s]
CashMatteo: bets $0.66
xkoosx: folds 
SomeGoodKush: calls $0.66
*** TURN *** [Jd 3c 6s] [9d]
CashMatteo: bets $1.49
SomeGoodKush: folds 
Uncalled bet ($1.49) returned to CashMatteo
CashMatteo collected $2.17 from pot
CashMatteo: doesn't show hand 
*** SUMMARY ***
Total pot $2.27 | Rake $0.10 
Board [Jd 3c 6s 9d]
Seat 1: DSilver folded before Flop (didn't bet)
Seat 2: sTYLz_23 (button) folded before Flop (didn't bet)
Seat 3: AA Mac (small blind) folded before Flop
Seat 4: CashMatteo (big blind) collected ($2.17)
Seat 5: xkoosx folded on the Flop
Seat 6: SomeGoodKush folded on the Turn

Hand #2217: 

PokerStars Hand #250520175817:  Hold'em No Limit ($0.05/$0.10 CAD) - 2024/05/15 18:06:49 ET
Table 'Astronomia III' 6-max Seat #3 is the button
Seat 1: DSilver ($11.02 in chips) 
Seat 2: sTYLz_23 ($24.76 in chips) 
Seat 3: AA Mac ($15.45 in chips) 
Seat 4: CashMatteo ($9.38 in chips) 
Seat 5: xkoosx ($9.39 in chips) 
Seat 6: SomeGoodKush ($14.19 in chips) 
CashMatteo: posts small blind $0.05
xkoosx: posts big blind $0.10
*** HOLE CARDS ***
Dealt to CashMatteo [Qh 8d]
SomeGoodKush: folds 
DSilver: folds 
sTYLz_23: folds 
AA Mac: raises $0.20 to $0.30
CashMatteo: calls $0.25
xkoosx: calls $0.20
*** FLOP *** [9s Js Jh]
CashMatteo: checks 
xkoosx: checks 
AA Mac: bets $0.46
CashMatteo: calls $0.46
xkoosx: folds 
*** TURN *** [9s Js Jh] [4d]
CashMatteo: checks 
AA Mac: checks 
*** RIVER *** [9s Js Jh 4d] [Kd]
CashMatteo: checks 
AA Mac: checks 
*** SHOW DOWN ***
CashMatteo: shows [Qh 8d] (a pair of Jacks)
AA Mac: shows [6h 6s] (two pair, Jacks and Sixes)
AA Mac collected $1.74 from pot
*** SUMMARY ***
Total pot $1.82 | Rake $0.08 
Board [9s Js Jh 4d Kd]
Seat 1: DSilver folded before Flop (didn't bet)
Seat 2: sTYLz_23 folded before Flop (didn't bet)
Seat 3: AA Mac (button) showed [6h 6s] and won ($1.74) with two pair, Jacks and Sixes
Seat 4: CashMatteo (small blind) showed [Qh 8d] and lost with a pair of Jacks
Seat 5: xkoosx (big blind) folded on the Flop
Seat 6: SomeGoodKush folded before Flop (didn't bet)

Hand #2218: 

PokerStars Hand #250520189889:  Hold'em No Limit ($0.05/$0.10 CAD) - 2024/05/15 18:07:36 ET
Table 'Astronomia III' 6-max Seat #4 is the button
Seat 1: DSilver ($11.02 in chips) 
Seat 2: sTYLz_23 ($24.76 in chips) 
Seat 3: AA Mac ($16.43 in chips) 
Seat 4: CashMatteo ($8.62 in chips) 
Seat 5: xkoosx ($9.09 in chips) 
Seat 6: SomeGoodKush ($14.19 in chips) 
xkoosx: posts small blind $0.05
SomeGoodKush: posts big blind $0.10
*** HOLE CARDS ***
Dealt to CashMatteo [6c Jd]
DSilver: folds 
sTYLz_23: raises $0.20 to $0.30
AA Mac: folds 
CashMatteo: folds 
xkoosx: folds 
SomeGoodKush: folds 
Uncalled bet ($0.20) returned to sTYLz_23
sTYLz_23 collected $0.25 from pot
*** SUMMARY ***
Total pot $0.25 | Rake $0 
Seat 1: DSilver folded before Flop (didn't bet)
Seat 2: sTYLz_23 collected ($0.25)
Seat 3: AA Mac folded before Flop (didn't bet)
Seat 4: CashMatteo (button) folded before Flop (didn't bet)
Seat 5: xkoosx (small blind) folded before Flop
Seat 6: SomeGoodKush (big blind) folded before Flop

Hand #2219: 

PokerStars Hand #250520196748:  Hold'em No Limit ($0.05/$0.10 CAD) - 2024/05/15 18:08:00 ET
Table 'Astronomia III' 6-max Seat #5 is the button
Seat 1: DSilver ($11.02 in chips) 
Seat 2: sTYLz_23 ($24.91 in chips) 
Seat 3: AA Mac ($16.43 in chips) 
Seat 4: CashMatteo ($8.62 in chips) 
Seat 5: xkoosx ($9.04 in chips) 
Seat 6: SomeGoodKush ($14.09 in chips) 
SomeGoodKush: posts small blind $0.05
DSilver: posts big blind $0.10
*** HOLE CARDS ***
Dealt to CashMatteo [9c Qh]
sTYLz_23: folds 
AA Mac: raises $0.10 to $0.20
CashMatteo: calls $0.20
xkoosx: calls $0.20
SomeGoodKush: folds 
DSilver: calls $0.10
*** FLOP *** [2c 7s 6d]
DSilver: checks 
AA Mac: checks 
CashMatteo: checks 
xkoosx: bets $0.61
DSilver: folds 
AA Mac: calls $0.61
CashMatteo: folds 
*** TURN *** [2c 7s 6d] [6c]
AA Mac: checks 
xkoosx: bets $0.99
AA Mac: raises $0.99 to $1.98
xkoosx: calls $0.99
*** RIVER *** [2c 7s 6d 6c] [4s]
AA Mac: bets $13.64 and is all-in
xkoosx: folds 
Uncalled bet ($13.64) returned to AA Mac
AA Mac collected $5.76 from pot
AA Mac: doesn't show hand 
*** SUMMARY ***
Total pot $6.03 | Rake $0.27 
Board [2c 7s 6d 6c 4s]
Seat 1: DSilver (big blind) folded on the Flop
Seat 2: sTYLz_23 folded before Flop (didn't bet)
Seat 3: AA Mac collected ($5.76)
Seat 4: CashMatteo folded on the Flop
Seat 5: xkoosx (button) folded on the River
Seat 6: SomeGoodKush (small blind) folded before Flop

Hand #2220: 

PokerStars Hand #250520222115:  Hold'em No Limit ($0.05/$0.10 CAD) - 2024/05/15 18:09:25 ET
Table 'Astronomia III' 6-max Seat #6 is the button
Seat 1: DSilver ($10.82 in chips) 
Seat 2: sTYLz_23 ($24.91 in chips) 
Seat 3: AA Mac ($19.40 in chips) 
Seat 4: CashMatteo ($8.42 in chips) 
Seat 5: xkoosx ($6.25 in chips) 
Seat 6: SomeGoodKush ($14.04 in chips) 
DSilver: posts small blind $0.05
sTYLz_23: posts big blind $0.10
*** HOLE CARDS ***
Dealt to CashMatteo [5s 5c]
AA Mac: folds 
CashMatteo: raises $0.15 to $0.25
xkoosx: folds 
SomeGoodKush: folds 
DSilver: folds 
sTYLz_23: folds 
Uncalled bet ($0.15) returned to CashMatteo
CashMatteo collected $0.25 from pot
CashMatteo: doesn't show hand 
*** SUMMARY ***
Total pot $0.25 | Rake $0 
Seat 1: DSilver (small blind) folded before Flop
Seat 2: sTYLz_23 (big blind) folded before Flop
Seat 3: AA Mac folded before Flop (didn't bet)
Seat 4: CashMatteo collected ($0.25)
Seat 5: xkoosx folded before Flop (didn't bet)
Seat 6: SomeGoodKush (button) folded before Flop (didn't bet)

Hand #2221: 

PokerStars Hand #250520228530:  Hold'em No Limit ($0.05/$0.10 CAD) - 2024/05/15 18:09:46 ET
Table 'Astronomia III' 6-max Seat #1 is the button
Seat 1: DSilver ($10.77 in chips) 
Seat 2: sTYLz_23 ($24.81 in chips) 
Seat 3: AA Mac ($19.40 in chips) 
Seat 4: CashMatteo ($8.57 in chips) 
Seat 5: xkoosx ($6.25 in chips) 
Seat 6: SomeGoodKush ($14.04 in chips) 
sTYLz_23: posts small blind $0.05
AA Mac: posts big blind $0.10
*** HOLE CARDS ***
Dealt to CashMatteo [3c 3s]
CashMatteo: calls $0.10
xkoosx: folds 
SomeGoodKush: calls $0.10
DSilver: folds 
sTYLz_23: calls $0.05
AA Mac: checks 
*** FLOP *** [4h Th 9d]
sTYLz_23: checks 
AA Mac: checks 
CashMatteo: bets $0.19
SomeGoodKush: folds 
sTYLz_23: folds 
AA Mac: folds 
Uncalled bet ($0.19) returned to CashMatteo
CashMatteo collected $0.38 from pot
CashMatteo: doesn't show hand 
*** SUMMARY ***
Total pot $0.40 | Rake $0.02 
Board [4h Th 9d]
Seat 1: DSilver (button) folded before Flop (didn't bet)
Seat 2: sTYLz_23 (small blind) folded on the Flop
Seat 3: AA Mac (big blind) folded on the Flop
Seat 4: CashMatteo collected ($0.38)
Seat 5: xkoosx folded before Flop (didn't bet)
Seat 6: SomeGoodKush folded on the Flop

Hand #2222: 

PokerStars Hand #250520255269:  Hold'em No Limit ($0.05/$0.10 CAD) - 2024/05/15 18:11:14 ET
Table 'Astronomia III' 6-max Seat #2 is the button
Seat 1: DSilver ($10.77 in chips) 
Seat 2: sTYLz_23 ($24.71 in chips) 
Seat 3: AA Mac ($19.30 in chips) 
Seat 4: CashMatteo ($8.85 in chips) 
Seat 5: xkoosx ($6.25 in chips) 
Seat 6: SomeGoodKush ($13.94 in chips) 
AA Mac: posts small blind $0.05
CashMatteo: posts big blind $0.10
*** HOLE CARDS ***
Dealt to CashMatteo [Tc Kc]
xkoosx: folds 
SomeGoodKush: raises $0.10 to $0.20
DSilver: calls $0.20
sTYLz_23 has timed out
sTYLz_23: folds 
AA Mac: folds 
CashMatteo: raises $0.45 to $0.65
SomeGoodKush: folds 
DSilver: folds 
Uncalled bet ($0.45) returned to CashMatteo
CashMatteo collected $0.65 from pot
CashMatteo: doesn't show hand 
*** SUMMARY ***
Total pot $0.65 | Rake $0 
Seat 1: DSilver folded before Flop
Seat 2: sTYLz_23 (button) folded before Flop (didn't bet)
Seat 3: AA Mac (small blind) folded before Flop
Seat 4: CashMatteo (big blind) collected ($0.65)
Seat 5: xkoosx folded before Flop (didn't bet)
Seat 6: SomeGoodKush folded before Flop

Hand #2223: 

PokerStars Hand #250520272217:  Hold'em No Limit ($0.05/$0.10 CAD) - 2024/05/15 18:12:11 ET
Table 'Astronomia III' 6-max Seat #3 is the button
Seat 1: DSilver ($10.57 in chips) 
Seat 2: sTYLz_23 ($24.71 in chips) 
Seat 3: AA Mac ($19.25 in chips) 
Seat 4: CashMatteo ($9.30 in chips) 
Seat 5: xkoosx ($6.25 in chips) 
Seat 6: SomeGoodKush ($13.74 in chips) 
CashMatteo: posts small blind $0.05
xkoosx: posts big blind $0.10
*** HOLE CARDS ***
Dealt to CashMatteo [5c Ah]
SomeGoodKush: raises $0.10 to $0.20
DSilver: folds 
sTYLz_23: raises $0.55 to $0.75
AA Mac: folds 
CashMatteo: folds 
xkoosx: folds 
SomeGoodKush: folds 
Uncalled bet ($0.55) returned to sTYLz_23
sTYLz_23 collected $0.55 from pot
*** SUMMARY ***
Total pot $0.55 | Rake $0 
Seat 1: DSilver folded before Flop (didn't bet)
Seat 2: sTYLz_23 collected ($0.55)
Seat 3: AA Mac (button) folded before Flop (didn't bet)
Seat 4: CashMatteo (small blind) folded before Flop
Seat 5: xkoosx (big blind) folded before Flop
Seat 6: SomeGoodKush folded before Flop

Hand #2224: 

PokerStars Hand #250520277939:  Hold'em No Limit ($0.05/$0.10 CAD) - 2024/05/15 18:12:30 ET
Table 'Astronomia III' 6-max Seat #4 is the button
Seat 1: DSilver ($10.57 in chips) 
Seat 2: sTYLz_23 ($25.06 in chips) 
Seat 3: AA Mac ($19.25 in chips) 
Seat 4: CashMatteo ($9.25 in chips) 
Seat 5: xkoosx ($6.15 in chips) 
Seat 6: SomeGoodKush ($13.54 in chips) 
xkoosx: posts small blind $0.05
SomeGoodKush: posts big blind $0.10
*** HOLE CARDS ***
Dealt to CashMatteo [3h Td]
DSilver: raises $0.15 to $0.25
sTYLz_23: folds 
AA Mac: folds 
CashMatteo has timed out
CashMatteo: folds 
xkoosx: calls $0.20
SomeGoodKush: folds 
*** FLOP *** [7s 2h 4d]
xkoosx: checks 
DSilver: checks 
*** TURN *** [7s 2h 4d] [Tc]
xkoosx: checks 
DSilver: checks 
*** RIVER *** [7s 2h 4d Tc] [8h]
xkoosx: bets $0.57
DSilver: folds 
Uncalled bet ($0.57) returned to xkoosx
xkoosx collected $0.57 from pot
xkoosx: doesn't show hand 
*** SUMMARY ***
Total pot $0.60 | Rake $0.03 
Board [7s 2h 4d Tc 8h]
Seat 1: DSilver folded on the River
Seat 2: sTYLz_23 folded before Flop (didn't bet)
Seat 3: AA Mac folded before Flop (didn't bet)
Seat 4: CashMatteo (button) folded before Flop (didn't bet)
Seat 5: xkoosx (small blind) collected ($0.57)
Seat 6: SomeGoodKush (big blind) folded before Flop

Hand #2225: 

PokerStars Hand #250520299314:  Hold'em No Limit ($0.05/$0.10 CAD) - 2024/05/15 18:13:42 ET
Table 'Astronomia III' 6-max Seat #5 is the button
Seat 1: DSilver ($10.32 in chips) 
Seat 2: sTYLz_23 ($25.06 in chips) 
Seat 3: AA Mac ($19.25 in chips) 
Seat 4: CashMatteo ($9.25 in chips) 
Seat 5: xkoosx ($10 in chips) 
Seat 6: SomeGoodKush ($13.44 in chips) 
SomeGoodKush: posts small blind $0.05
DSilver: posts big blind $0.10
*** HOLE CARDS ***
Dealt to CashMatteo [Ts 9h]
sTYLz_23: folds 
AA Mac: folds 
CashMatteo: calls $0.10
xkoosx: calls $0.10
SomeGoodKush: calls $0.05
DSilver: checks 
*** FLOP *** [7d 7h Tc]
SomeGoodKush: checks 
DSilver: checks 
CashMatteo: bets $0.19
xkoosx: folds 
SomeGoodKush: folds 
DSilver: folds 
Uncalled bet ($0.19) returned to CashMatteo
CashMatteo collected $0.38 from pot
CashMatteo: doesn't show hand 
*** SUMMARY ***
Total pot $0.40 | Rake $0.02 
Board [7d 7h Tc]
Seat 1: DSilver (big blind) folded on the Flop
Seat 2: sTYLz_23 folded before Flop (didn't bet)
Seat 3: AA Mac folded before Flop (didn't bet)
Seat 4: CashMatteo collected ($0.38)
Seat 5: xkoosx (button) folded on the Flop
Seat 6: SomeGoodKush (small blind) folded on the Flop

Hand #2226: 

PokerStars Hand #250520315207:  Hold'em No Limit ($0.05/$0.10 CAD) - 2024/05/15 18:14:37 ET
Table 'Astronomia III' 6-max Seat #6 is the button
Seat 1: DSilver ($10.22 in chips) 
Seat 3: AA Mac ($19.25 in chips) 
Seat 4: CashMatteo ($9.53 in chips) 
Seat 5: xkoosx ($9.90 in chips) 
Seat 6: SomeGoodKush ($13.34 in chips) 
DSilver: posts small blind $0.05
AA Mac: posts big blind $0.10
*** HOLE CARDS ***
Dealt to CashMatteo [Kd 5d]
CashMatteo: raises $0.15 to $0.25
xkoosx: folds 
SomeGoodKush: folds 
DSilver: folds 
AA Mac: folds 
Uncalled bet ($0.15) returned to CashMatteo
CashMatteo collected $0.25 from pot
CashMatteo: doesn't show hand 
*** SUMMARY ***
Total pot $0.25 | Rake $0 
Seat 1: DSilver (small blind) folded before Flop
Seat 3: AA Mac (big blind) folded before Flop
Seat 4: CashMatteo collected ($0.25)
Seat 5: xkoosx folded before Flop (didn't bet)
Seat 6: SomeGoodKush (button) folded before Flop (didn't bet)

Hand #2227: 

PokerStars Hand #250520320720:  Hold'em No Limit ($0.05/$0.10 CAD) - 2024/05/15 18:14:56 ET
Table 'Astronomia III' 6-max Seat #1 is the button
Seat 1: DSilver ($10.17 in chips) 
Seat 3: AA Mac ($19.15 in chips) 
Seat 4: CashMatteo ($9.68 in chips) 
Seat 5: xkoosx ($9.90 in chips) 
Seat 6: SomeGoodKush ($13.34 in chips) 
AA Mac: posts small blind $0.05
CashMatteo: posts big blind $0.10
*** HOLE CARDS ***
Dealt to CashMatteo [9d Ah]
xkoosx: folds 
SomeGoodKush: folds 
DSilver: raises $0.15 to $0.25
AA Mac: folds 
CashMatteo: calls $0.15
*** FLOP *** [Jh Qh Ac]
CashMatteo: bets $0.37
DSilver: raises $0.53 to $0.90
CashMatteo: calls $0.53
*** TURN *** [Jh Qh Ac] [Kh]
CashMatteo: checks 
DSilver: bets $1.80
CashMatteo: calls $1.80
*** RIVER *** [Jh Qh Ac Kh] [3c]
CashMatteo: checks 
DSilver: bets $5.68
CashMatteo: folds 
Uncalled bet ($5.68) returned to DSilver
DSilver collected $5.68 from pot
DSilver: doesn't show hand 
*** SUMMARY ***
Total pot $5.95 | Rake $0.27 
Board [Jh Qh Ac Kh 3c]
Seat 1: DSilver (button) collected ($5.68)
Seat 3: AA Mac (small blind) folded before Flop
Seat 4: CashMatteo (big blind) folded on the River
Seat 5: xkoosx folded before Flop (didn't bet)
Seat 6: SomeGoodKush folded before Flop (didn't bet)

Hand #2228: 

PokerStars Hand #250520346271:  Hold'em No Limit ($0.05/$0.10 CAD) - 2024/05/15 18:16:23 ET
Table 'Astronomia III' 6-max Seat #3 is the button
Seat 1: DSilver ($12.90 in chips) 
Seat 3: AA Mac ($19.10 in chips) 
Seat 4: CashMatteo ($6.73 in chips) 
Seat 5: xkoosx ($9.90 in chips) 
Seat 6: SomeGoodKush ($13.34 in chips) 
CashMatteo: posts small blind $0.05
xkoosx: posts big blind $0.10
*** HOLE CARDS ***
Dealt to CashMatteo [5h 3s]
SomeGoodKush: folds 
DSilver: folds 
AA Mac: folds 
CashMatteo: folds 
Uncalled bet ($0.05) returned to xkoosx
xkoosx collected $0.10 from pot
xkoosx: doesn't show hand 
*** SUMMARY ***
Total pot $0.10 | Rake $0 
Seat 1: DSilver folded before Flop (didn't bet)
Seat 3: AA Mac (button) folded before Flop (didn't bet)
Seat 4: CashMatteo (small blind) folded before Flop
Seat 5: xkoosx (big blind) collected ($0.10)
Seat 6: SomeGoodKush folded before Flop (didn't bet)

Hand #2229: 

PokerStars Hand #250520350626:  Hold'em No Limit ($0.05/$0.10 CAD) - 2024/05/15 18:16:38 ET
Table 'Astronomia III' 6-max Seat #4 is the button
Seat 1: DSilver ($12.90 in chips) 
Seat 3: AA Mac ($19.10 in chips) 
Seat 4: CashMatteo ($6.68 in chips) 
Seat 5: xkoosx ($9.95 in chips) 
Seat 6: SomeGoodKush ($13.34 in chips) 
xkoosx: posts small blind $0.05
SomeGoodKush: posts big blind $0.10
sTYLz_23: sits out 
*** HOLE CARDS ***
Dealt to CashMatteo [Ad 2h]
DSilver: folds 
AA Mac: folds 
CashMatteo: calls $0.10
xkoosx: calls $0.05
SomeGoodKush: checks 
*** FLOP *** [7h Jc 5h]
xkoosx: bets $0.29
SomeGoodKush: calls $0.29
CashMatteo: folds 
*** TURN *** [7h Jc 5h] [Ks]
xkoosx: bets $0.84
SomeGoodKush: calls $0.84
*** RIVER *** [7h Jc 5h Ks] [4s]
xkoosx: bets $2.44
SomeGoodKush: folds 
Uncalled bet ($2.44) returned to xkoosx
xkoosx collected $2.44 from pot
xkoosx: doesn't show hand 
*** SUMMARY ***
Total pot $2.56 | Rake $0.12 
Board [7h Jc 5h Ks 4s]
Seat 1: DSilver folded before Flop (didn't bet)
Seat 3: AA Mac folded before Flop (didn't bet)
Seat 4: CashMatteo (button) folded on the Flop
Seat 5: xkoosx (small blind) collected ($2.44)
Seat 6: SomeGoodKush (big blind) folded on the River

Hand #2230: 

PokerStars Hand #250520366717:  Hold'em No Limit ($0.05/$0.10 CAD) - 2024/05/15 18:17:35 ET
Table 'Astronomia III' 6-max Seat #5 is the button
Seat 1: DSilver ($12.90 in chips) 
Seat 2: sTYLz_23 ($25.06 in chips) 
Seat 3: AA Mac ($19.10 in chips) 
Seat 4: CashMatteo ($6.58 in chips) 
Seat 5: xkoosx ($11.16 in chips) 
Seat 6: SomeGoodKush ($12.11 in chips) 
SomeGoodKush: posts small blind $0.05
DSilver: posts big blind $0.10
sTYLz_23: posts small & big blinds $0.15
*** HOLE CARDS ***
Dealt to CashMatteo [Td Js]
sTYLz_23: checks 
AA Mac: folds 
CashMatteo: calls $0.10
xkoosx: folds 
SomeGoodKush: folds 
DSilver: checks 
*** FLOP *** [Qs Jc Th]
DSilver: checks 
sTYLz_23: checks 
CashMatteo: bets $0.48
DSilver: folds 
sTYLz_23: folds 
Uncalled bet ($0.48) returned to CashMatteo
CashMatteo collected $0.38 from pot
CashMatteo: doesn't show hand 
*** SUMMARY ***
Total pot $0.40 | Rake $0.02 
Board [Qs Jc Th]
Seat 1: DSilver (big blind) folded on the Flop
Seat 2: sTYLz_23 folded on the Flop (didn't bet)
Seat 3: AA Mac folded before Flop (didn't bet)
Seat 4: CashMatteo collected ($0.38)
Seat 5: xkoosx (button) folded before Flop (didn't bet)
Seat 6: SomeGoodKush (small blind) folded before Flop

Hand #2231: 

PokerStars Hand #250520374349:  Hold'em No Limit ($0.05/$0.10 CAD) - 2024/05/15 18:18:01 ET
Table 'Astronomia III' 6-max Seat #6 is the button
Seat 1: DSilver ($12.80 in chips) 
Seat 2: sTYLz_23 ($24.91 in chips) 
Seat 3: AA Mac ($19.10 in chips) 
Seat 4: CashMatteo ($6.86 in chips) 
Seat 5: xkoosx ($11.16 in chips) 
Seat 6: SomeGoodKush ($12.06 in chips) 
DSilver: posts small blind $0.05
sTYLz_23: posts big blind $0.10
*** HOLE CARDS ***
Dealt to CashMatteo [Kd 5d]
AA Mac: folds 
CashMatteo: calls $0.10
xkoosx: folds 
SomeGoodKush: calls $0.10
DSilver: folds 
sTYLz_23: checks 
*** FLOP *** [8c Td 7c]
sTYLz_23: checks 
CashMatteo: checks 
SomeGoodKush: bets $0.11
sTYLz_23: folds 
CashMatteo: folds 
Uncalled bet ($0.11) returned to SomeGoodKush
SomeGoodKush collected $0.33 from pot
SomeGoodKush: doesn't show hand 
*** SUMMARY ***
Total pot $0.35 | Rake $0.02 
Board [8c Td 7c]
Seat 1: DSilver (small blind) folded before Flop
Seat 2: sTYLz_23 (big blind) folded on the Flop
Seat 3: AA Mac folded before Flop (didn't bet)
Seat 4: CashMatteo folded on the Flop
Seat 5: xkoosx folded before Flop (didn't bet)
Seat 6: SomeGoodKush (button) collected ($0.33)

Hand #2232: 

PokerStars Hand #250520385430:  Hold'em No Limit ($0.05/$0.10 CAD) - 2024/05/15 18:18:40 ET
Table 'Astronomia III' 6-max Seat #1 is the button
Seat 1: DSilver ($12.75 in chips) 
Seat 2: sTYLz_23 ($24.81 in chips) 
Seat 3: AA Mac ($19.10 in chips) 
Seat 4: CashMatteo ($6.76 in chips) 
Seat 5: xkoosx ($11.16 in chips) 
Seat 6: SomeGoodKush ($12.29 in chips) 
sTYLz_23: posts small blind $0.05
AA Mac: posts big blind $0.10
*** HOLE CARDS ***
Dealt to CashMatteo [Qs Ad]
CashMatteo: raises $0.15 to $0.25
xkoosx: folds 
SomeGoodKush: folds 
DSilver: folds 
sTYLz_23: calls $0.20
AA Mac: folds 
*** FLOP *** [4s 3c 9d]
sTYLz_23: checks 
CashMatteo: bets $0.39
sTYLz_23: folds 
Uncalled bet ($0.39) returned to CashMatteo
CashMatteo collected $0.57 from pot
CashMatteo: doesn't show hand 
*** SUMMARY ***
Total pot $0.60 | Rake $0.03 
Board [4s 3c 9d]
Seat 1: DSilver (button) folded before Flop (didn't bet)
Seat 2: sTYLz_23 (small blind) folded on the Flop
Seat 3: AA Mac (big blind) folded before Flop
Seat 4: CashMatteo collected ($0.57)
Seat 5: xkoosx folded before Flop (didn't bet)
Seat 6: SomeGoodKush folded before Flop (didn't bet)

Hand #2233: 

PokerStars Hand #250520397286:  Hold'em No Limit ($0.05/$0.10 CAD) - 2024/05/15 18:19:22 ET
Table 'Astronomia III' 6-max Seat #2 is the button
Seat 1: DSilver ($12.75 in chips) 
Seat 2: sTYLz_23 ($24.56 in chips) 
Seat 3: AA Mac ($19 in chips) 
Seat 4: CashMatteo ($7.08 in chips) 
Seat 5: xkoosx ($11.16 in chips) 
Seat 6: SomeGoodKush ($12.29 in chips) 
AA Mac: posts small blind $0.05
CashMatteo: posts big blind $0.10
*** HOLE CARDS ***
Dealt to CashMatteo [2d Td]
xkoosx: calls $0.10
SomeGoodKush: folds 
DSilver: folds 
sTYLz_23: calls $0.10
AA Mac: calls $0.05
CashMatteo: checks 
*** FLOP *** [Kc 8d Js]
AA Mac: checks 
CashMatteo: checks 
xkoosx: checks 
sTYLz_23: bets $0.19
AA Mac: folds 
CashMatteo: folds 
xkoosx: folds 
Uncalled bet ($0.19) returned to sTYLz_23
sTYLz_23 collected $0.38 from pot
*** SUMMARY ***
Total pot $0.40 | Rake $0.02 
Board [Kc 8d Js]
Seat 1: DSilver folded before Flop (didn't bet)
Seat 2: sTYLz_23 (button) collected ($0.38)
Seat 3: AA Mac (small blind) folded on the Flop
Seat 4: CashMatteo (big blind) folded on the Flop
Seat 5: xkoosx folded on the Flop
Seat 6: SomeGoodKush folded before Flop (didn't bet)

Hand #2234: 

PokerStars Hand #250520409248:  Hold'em No Limit ($0.05/$0.10 CAD) - 2024/05/15 18:20:04 ET
Table 'Astronomia III' 6-max Seat #3 is the button
Seat 1: DSilver ($12.75 in chips) 
Seat 2: sTYLz_23 ($24.84 in chips) 
Seat 3: AA Mac ($18.90 in chips) 
Seat 4: CashMatteo ($6.98 in chips) 
Seat 5: xkoosx ($11.06 in chips) 
Seat 6: SomeGoodKush ($12.29 in chips) 
CashMatteo: posts small blind $0.05
xkoosx: posts big blind $0.10
*** HOLE CARDS ***
Dealt to CashMatteo [Th Ks]
SomeGoodKush: raises $0.10 to $0.20
DSilver: folds 
sTYLz_23: folds 
AA Mac: folds 
CashMatteo: calls $0.15
xkoosx: calls $0.10
*** FLOP *** [4s Td 8c]
CashMatteo: bets $0.30
xkoosx: calls $0.30
SomeGoodKush: folds 
*** TURN *** [4s Td 8c] [9c]
CashMatteo: checks 
xkoosx: bets $1.15
CashMatteo: folds 
Uncalled bet ($1.15) returned to xkoosx
xkoosx collected $1.15 from pot
xkoosx: doesn't show hand 
*** SUMMARY ***
Total pot $1.20 | Rake $0.05 
Board [4s Td 8c 9c]
Seat 1: DSilver folded before Flop (didn't bet)
Seat 2: sTYLz_23 folded before Flop (didn't bet)
Seat 3: AA Mac (button) folded before Flop (didn't bet)
Seat 4: CashMatteo (small blind) folded on the Turn
Seat 5: xkoosx (big blind) collected ($1.15)
Seat 6: SomeGoodKush folded on the Flop

Hand #2235: 

PokerStars Hand #250520423861:  Hold'em No Limit ($0.05/$0.10 CAD) - 2024/05/15 18:20:55 ET
Table 'Astronomia III' 6-max Seat #4 is the button
Seat 1: DSilver ($12.75 in chips) 
Seat 2: sTYLz_23 ($24.84 in chips) 
Seat 3: AA Mac ($18.90 in chips) 
Seat 4: CashMatteo ($6.48 in chips) 
Seat 5: xkoosx ($11.71 in chips) 
Seat 6: SomeGoodKush ($12.09 in chips) 
xkoosx: posts small blind $0.05
SomeGoodKush: posts big blind $0.10
*** HOLE CARDS ***
Dealt to CashMatteo [7s 3h]
DSilver: raises $0.15 to $0.25
sTYLz_23: folds 
AA Mac: folds 
CashMatteo: folds 
xkoosx: folds 
SomeGoodKush: folds 
Uncalled bet ($0.15) returned to DSilver
DSilver collected $0.25 from pot
DSilver: doesn't show hand 
*** SUMMARY ***
Total pot $0.25 | Rake $0 
Seat 1: DSilver collected ($0.25)
Seat 2: sTYLz_23 folded before Flop (didn't bet)
Seat 3: AA Mac folded before Flop (didn't bet)
Seat 4: CashMatteo (button) folded before Flop (didn't bet)
Seat 5: xkoosx (small blind) folded before Flop
Seat 6: SomeGoodKush (big blind) folded before Flop

Hand #2236: 

PokerStars Hand #250520432572:  Hold'em No Limit ($0.05/$0.10 CAD) - 2024/05/15 18:21:25 ET
Table 'Astronomia III' 6-max Seat #5 is the button
Seat 1: DSilver ($12.90 in chips) 
Seat 2: sTYLz_23 ($24.84 in chips) 
Seat 3: AA Mac ($18.90 in chips) 
Seat 4: CashMatteo ($6.48 in chips) 
Seat 5: xkoosx ($11.66 in chips) 
Seat 6: SomeGoodKush ($11.99 in chips) 
SomeGoodKush: posts small blind $0.05
DSilver: posts big blind $0.10
*** HOLE CARDS ***
Dealt to CashMatteo [3c 9h]
sTYLz_23: folds 
AA Mac: folds 
CashMatteo: folds 
xkoosx: folds 
SomeGoodKush: calls $0.05
DSilver: checks 
*** FLOP *** [3h Kc Jc]
xkoosx leaves the table
SomeGoodKush: bets $0.10
1stedcharizard joins the table at seat #5 
DSilver: folds 
Uncalled bet ($0.10) returned to SomeGoodKush
SomeGoodKush collected $0.19 from pot
SomeGoodKush: doesn't show hand 
*** SUMMARY ***
Total pot $0.20 | Rake $0.01 
Board [3h Kc Jc]
Seat 1: DSilver (big blind) folded on the Flop
Seat 2: sTYLz_23 folded before Flop (didn't bet)
Seat 3: AA Mac folded before Flop (didn't bet)
Seat 4: CashMatteo folded before Flop (didn't bet)
Seat 5: xkoosx (button) folded before Flop (didn't bet)
Seat 6: SomeGoodKush (small blind) collected ($0.19)

Hand #2237: 

PokerStars Hand #250520443942:  Hold'em No Limit ($0.05/$0.10 CAD) - 2024/05/15 18:22:05 ET
Table 'Astronomia III' 6-max Seat #6 is the button
Seat 1: DSilver ($12.80 in chips) 
Seat 2: sTYLz_23 ($24.84 in chips) 
Seat 3: AA Mac ($18.90 in chips) 
Seat 4: CashMatteo ($6.48 in chips) 
Seat 6: SomeGoodKush ($12.08 in chips) 
DSilver: posts small blind $0.05
sTYLz_23: posts big blind $0.10
1stedcharizard: sits out 
*** HOLE CARDS ***
Dealt to CashMatteo [Jd 5s]
AA Mac: folds 
CashMatteo: folds 
SomeGoodKush: raises $0.10 to $0.20
DSilver: folds 
sTYLz_23 has timed out
sTYLz_23: folds 
Uncalled bet ($0.10) returned to SomeGoodKush
SomeGoodKush collected $0.25 from pot
SomeGoodKush: doesn't show hand 
*** SUMMARY ***
Total pot $0.25 | Rake $0 
Seat 1: DSilver (small blind) folded before Flop
Seat 2: sTYLz_23 (big blind) folded before Flop
Seat 3: AA Mac folded before Flop (didn't bet)
Seat 4: CashMatteo folded before Flop (didn't bet)
Seat 6: SomeGoodKush (button) collected ($0.25)

Hand #2238: 

PokerStars Hand #250520453385:  Hold'em No Limit ($0.05/$0.10 CAD) - 2024/05/15 18:22:37 ET
Table 'Astronomia III' 6-max Seat #1 is the button
Seat 1: DSilver ($12.75 in chips) 
Seat 3: AA Mac ($18.90 in chips) 
Seat 4: CashMatteo ($6.48 in chips) 
Seat 6: SomeGoodKush ($12.23 in chips) 
AA Mac: posts small blind $0.05
CashMatteo: posts big blind $0.10
1stedcharizard: sits out 
*** HOLE CARDS ***
Dealt to CashMatteo [Ts 6s]
SomeGoodKush: raises $0.10 to $0.20
DSilver: folds 
AA Mac: folds 
CashMatteo: calls $0.10
*** FLOP *** [Kd Js 8s]
CashMatteo: checks 
SomeGoodKush: bets $0.14
CashMatteo: calls $0.14
*** TURN *** [Kd Js 8s] [4d]
CashMatteo: checks 
SomeGoodKush: bets $0.53
CashMatteo: calls $0.53
*** RIVER *** [Kd Js 8s 4d] [6d]
CashMatteo: checks 
SomeGoodKush: bets $1.71
CashMatteo: folds 
Uncalled bet ($1.71) returned to SomeGoodKush
SomeGoodKush collected $1.71 from pot
SomeGoodKush: doesn't show hand 
*** SUMMARY ***
Total pot $1.79 | Rake $0.08 
Board [Kd Js 8s 4d 6d]
Seat 1: DSilver (button) folded before Flop (didn't bet)
Seat 3: AA Mac (small blind) folded before Flop
Seat 4: CashMatteo (big blind) folded on the River
Seat 6: SomeGoodKush collected ($1.71)

Hand #2239: 

PokerStars Hand #250520465962:  Hold'em No Limit ($0.05/$0.10 CAD) - 2024/05/15 18:23:22 ET
Table 'Astronomia III' 6-max Seat #3 is the button
Seat 1: DSilver ($12.75 in chips) 
Seat 2: sTYLz_23 ($24.74 in chips) 
Seat 3: AA Mac ($18.85 in chips) 
Seat 4: CashMatteo ($5.61 in chips) 
Seat 5: 1stedcharizard ($10 in chips) 
Seat 6: SomeGoodKush ($13.07 in chips) 
CashMatteo: posts small blind $0.05
1stedcharizard: posts big blind $0.10
sTYLz_23: posts small blind $0.05
*** HOLE CARDS ***
Dealt to CashMatteo [Ts 8d]
SomeGoodKush: folds 
DSilver: folds 
sTYLz_23: calls $0.10
AA Mac: calls $0.10
CashMatteo: folds 
1stedcharizard: checks 
*** FLOP *** [7c 3h 6d]
1stedcharizard: checks 
sTYLz_23: checks 
AA Mac: checks 
*** TURN *** [7c 3h 6d] [6h]
1stedcharizard: checks 
sTYLz_23: checks 
AA Mac: checks 
*** RIVER *** [7c 3h 6d 6h] [4h]
1stedcharizard: checks 
sTYLz_23: checks 
AA Mac: checks 
*** SHOW DOWN ***
1stedcharizard: shows [Kc 8s] (a pair of Sixes)
sTYLz_23: shows [Jc Ks] (a pair of Sixes - King+Jack kicker)
AA Mac: mucks hand 
sTYLz_23 collected $0.38 from pot
*** SUMMARY ***
Total pot $0.40 | Rake $0.02 
Board [7c 3h 6d 6h 4h]
Seat 1: DSilver folded before Flop (didn't bet)
Seat 2: sTYLz_23 showed [Jc Ks] and won ($0.38) with a pair of Sixes
Seat 3: AA Mac (button) mucked [Qc Js]
Seat 4: CashMatteo (small blind) folded before Flop
Seat 5: 1stedcharizard (big blind) showed [Kc 8s] and lost with a pair of Sixes
Seat 6: SomeGoodKush folded before Flop (didn't bet)

Hand #2240: 

PokerStars Hand #250520490897:  Hold'em No Limit ($0.05/$0.10 CAD) - 2024/05/15 18:24:49 ET
Table 'Astronomia III' 6-max Seat #4 is the button
Seat 1: DSilver ($12.75 in chips) 
Seat 2: sTYLz_23 ($24.97 in chips) 
Seat 3: AA Mac ($18.75 in chips) 
Seat 4: CashMatteo ($5.56 in chips) 
Seat 5: 1stedcharizard ($10 in chips) 
Seat 6: SomeGoodKush ($13.07 in chips) 
1stedcharizard: posts small blind $0.05
SomeGoodKush: posts big blind $0.10
*** HOLE CARDS ***
Dealt to CashMatteo [3c 5d]
DSilver: folds 
sTYLz_23: raises $0.20 to $0.30
AA Mac: folds 
CashMatteo: folds 
1stedcharizard: folds 
SomeGoodKush: folds 
Uncalled bet ($0.20) returned to sTYLz_23
sTYLz_23 collected $0.25 from pot
*** SUMMARY ***
Total pot $0.25 | Rake $0 
Seat 1: DSilver folded before Flop (didn't bet)
Seat 2: sTYLz_23 collected ($0.25)
Seat 3: AA Mac folded before Flop (didn't bet)
Seat 4: CashMatteo (button) folded before Flop (didn't bet)
Seat 5: 1stedcharizard (small blind) folded before Flop
Seat 6: SomeGoodKush (big blind) folded before Flop

Hand #2241: 

PokerStars Hand #250520497889:  Hold'em No Limit ($0.05/$0.10 CAD) - 2024/05/15 18:25:14 ET
Table 'Astronomia III' 6-max Seat #5 is the button
Seat 1: DSilver ($12.75 in chips) 
Seat 2: sTYLz_23 ($25.12 in chips) 
Seat 3: AA Mac ($18.75 in chips) 
Seat 4: CashMatteo ($5.56 in chips) 
Seat 5: 1stedcharizard ($10 in chips) 
Seat 6: SomeGoodKush ($12.97 in chips) 
SomeGoodKush: posts small blind $0.05
DSilver: posts big blind $0.10
*** HOLE CARDS ***
Dealt to CashMatteo [Qs 4h]
sTYLz_23: folds 
AA Mac: folds 
CashMatteo: folds 
1stedcharizard: raises $0.15 to $0.25
SomeGoodKush: folds 
DSilver: folds 
Uncalled bet ($0.15) returned to 1stedcharizard
1stedcharizard collected $0.25 from pot
1stedcharizard: doesn't show hand 
*** SUMMARY ***
Total pot $0.25 | Rake $0 
Seat 1: DSilver (big blind) folded before Flop
Seat 2: sTYLz_23 folded before Flop (didn't bet)
Seat 3: AA Mac folded before Flop (didn't bet)
Seat 4: CashMatteo folded before Flop (didn't bet)
Seat 5: 1stedcharizard (button) collected ($0.25)
Seat 6: SomeGoodKush (small blind) folded before Flop

Hand #2242: 

PokerStars Hand #250520503774:  Hold'em No Limit ($0.05/$0.10 CAD) - 2024/05/15 18:25:34 ET
Table 'Astronomia III' 6-max Seat #6 is the button
Seat 1: DSilver ($12.65 in chips) 
Seat 2: sTYLz_23 ($25.12 in chips) 
Seat 3: AA Mac ($18.75 in chips) 
Seat 4: CashMatteo ($5.56 in chips) 
Seat 5: 1stedcharizard ($10.15 in chips) 
Seat 6: SomeGoodKush ($12.92 in chips) 
DSilver: posts small blind $0.05
sTYLz_23: posts big blind $0.10
*** HOLE CARDS ***
Dealt to CashMatteo [Ks Qh]
AA Mac: folds 
CashMatteo: raises $0.15 to $0.25
1stedcharizard: folds 
SomeGoodKush: folds 
DSilver: folds 
sTYLz_23: calls $0.15
*** FLOP *** [9d Kc As]
sTYLz_23: checks 
CashMatteo: bets $0.17
sTYLz_23: calls $0.17
*** TURN *** [9d Kc As] [7d]
sTYLz_23: checks 
CashMatteo: bets $0.53
sTYLz_23: calls $0.53
*** RIVER *** [9d Kc As 7d] [2c]
sTYLz_23: checks 
CashMatteo: checks 
*** SHOW DOWN ***
sTYLz_23: shows [Jh Ad] (a pair of Aces)
CashMatteo: mucks hand 
sTYLz_23 collected $1.86 from pot
*** SUMMARY ***
Total pot $1.95 | Rake $0.09 
Board [9d Kc As 7d 2c]
Seat 1: DSilver (small blind) folded before Flop
Seat 2: sTYLz_23 (big blind) showed [Jh Ad] and won ($1.86) with a pair of Aces
Seat 3: AA Mac folded before Flop (didn't bet)
Seat 4: CashMatteo mucked [Ks Qh]
Seat 5: 1stedcharizard folded before Flop (didn't bet)
Seat 6: SomeGoodKush (button) folded before Flop (didn't bet)

Hand #2243: 

PokerStars Hand #250520517712:  Hold'em No Limit ($0.05/$0.10 CAD) - 2024/05/15 18:26:23 ET
Table 'Astronomia III' 6-max Seat #1 is the button
Seat 1: DSilver ($12.60 in chips) 
Seat 2: sTYLz_23 ($26.03 in chips) 
Seat 3: AA Mac ($18.75 in chips) 
Seat 4: CashMatteo ($4.61 in chips) 
Seat 5: 1stedcharizard ($10.15 in chips) 
Seat 6: SomeGoodKush ($12.92 in chips) 
sTYLz_23: posts small blind $0.05
AA Mac: posts big blind $0.10
*** HOLE CARDS ***
Dealt to CashMatteo [2h 8h]
CashMatteo: folds 
1stedcharizard: folds 
SomeGoodKush: folds 
DSilver: folds 
sTYLz_23: calls $0.05
AA Mac: checks 
*** FLOP *** [3h Ah 4c]
sTYLz_23: checks 
AA Mac: checks 
*** TURN *** [3h Ah 4c] [6h]
sTYLz_23: checks 
AA Mac: bets $0.10
sTYLz_23: folds 
Uncalled bet ($0.10) returned to AA Mac
AA Mac collected $0.19 from pot
AA Mac: doesn't show hand 
*** SUMMARY ***
Total pot $0.20 | Rake $0.01 
Board [3h Ah 4c 6h]
Seat 1: DSilver (button) folded before Flop (didn't bet)
Seat 2: sTYLz_23 (small blind) folded on the Turn
Seat 3: AA Mac (big blind) collected ($0.19)
Seat 4: CashMatteo folded before Flop (didn't bet)
Seat 5: 1stedcharizard folded before Flop (didn't bet)
Seat 6: SomeGoodKush folded before Flop (didn't bet)

Hand #2244: 

PokerStars Hand #250520535358:  Hold'em No Limit ($0.05/$0.10 CAD) - 2024/05/15 18:27:26 ET
Table 'Astronomia III' 6-max Seat #2 is the button
Seat 1: DSilver ($12.60 in chips) 
Seat 2: sTYLz_23 ($25.93 in chips) 
Seat 3: AA Mac ($18.84 in chips) 
Seat 4: CashMatteo ($4.61 in chips) 
Seat 5: 1stedcharizard ($10.15 in chips) 
Seat 6: SomeGoodKush ($12.92 in chips) 
AA Mac: posts small blind $0.05
CashMatteo: posts big blind $0.10
*** HOLE CARDS ***
Dealt to CashMatteo [Ts Tc]
1stedcharizard: folds 
SomeGoodKush: raises $0.10 to $0.20
DSilver: calls $0.20
sTYLz_23: folds 
AA Mac: folds 
CashMatteo: raises $0.65 to $0.85
SomeGoodKush: folds 
DSilver: folds 
Uncalled bet ($0.65) returned to CashMatteo
CashMatteo collected $0.65 from pot
CashMatteo: doesn't show hand 
*** SUMMARY ***
Total pot $0.65 | Rake $0 
Seat 1: DSilver folded before Flop
Seat 2: sTYLz_23 (button) folded before Flop (didn't bet)
Seat 3: AA Mac (small blind) folded before Flop
Seat 4: CashMatteo (big blind) collected ($0.65)
Seat 5: 1stedcharizard folded before Flop (didn't bet)
Seat 6: SomeGoodKush folded before Flop

Hand #2245: 

PokerStars Hand #250520542299:  Hold'em No Limit ($0.05/$0.10 CAD) - 2024/05/15 18:27:51 ET
Table 'Astronomia III' 6-max Seat #3 is the button
Seat 1: DSilver ($12.40 in chips) 
Seat 2: sTYLz_23 ($25.93 in chips) 
Seat 3: AA Mac ($18.79 in chips) 
Seat 4: CashMatteo ($5.06 in chips) 
Seat 5: 1stedcharizard ($10.15 in chips) 
Seat 6: SomeGoodKush ($12.72 in chips) 
CashMatteo: posts small blind $0.05
1stedcharizard: posts big blind $0.10
*** HOLE CARDS ***
Dealt to CashMatteo [7c 4d]
SomeGoodKush: folds 
DSilver: folds 
sTYLz_23: folds 
AA Mac: folds 
CashMatteo: folds 
Uncalled bet ($0.05) returned to 1stedcharizard
1stedcharizard collected $0.10 from pot
1stedcharizard: doesn't show hand 
*** SUMMARY ***
Total pot $0.10 | Rake $0 
Seat 1: DSilver folded before Flop (didn't bet)
Seat 2: sTYLz_23 folded before Flop (didn't bet)
Seat 3: AA Mac (button) folded before Flop (didn't bet)
Seat 4: CashMatteo (small blind) folded before Flop
Seat 5: 1stedcharizard (big blind) collected ($0.10)
Seat 6: SomeGoodKush folded before Flop (didn't bet)

Hand #2246: 

PokerStars Hand #250520546832:  Hold'em No Limit ($0.05/$0.10 CAD) - 2024/05/15 18:28:07 ET
Table 'Astronomia III' 6-max Seat #4 is the button
Seat 1: DSilver ($12.40 in chips) 
Seat 2: sTYLz_23 ($25.93 in chips) 
Seat 3: AA Mac ($18.79 in chips) 
Seat 4: CashMatteo ($5.01 in chips) 
Seat 5: 1stedcharizard ($10.20 in chips) 
Seat 6: SomeGoodKush ($12.72 in chips) 
1stedcharizard: posts small blind $0.05
SomeGoodKush: posts big blind $0.10
*** HOLE CARDS ***
Dealt to CashMatteo [2s 3d]
DSilver: folds 
sTYLz_23: folds 
AA Mac: folds 
CashMatteo: folds 
1stedcharizard: folds 
Uncalled bet ($0.05) returned to SomeGoodKush
SomeGoodKush collected $0.10 from pot
SomeGoodKush: doesn't show hand 
*** SUMMARY ***
Total pot $0.10 | Rake $0 
Seat 1: DSilver folded before Flop (didn't bet)
Seat 2: sTYLz_23 folded before Flop (didn't bet)
Seat 3: AA Mac folded before Flop (didn't bet)
Seat 4: CashMatteo (button) folded before Flop (didn't bet)
Seat 5: 1stedcharizard (small blind) folded before Flop
Seat 6: SomeGoodKush (big blind) collected ($0.10)

Hand #2247: 

PokerStars Hand #250520549866:  Hold'em No Limit ($0.05/$0.10 CAD) - 2024/05/15 18:28:17 ET
Table 'Astronomia III' 6-max Seat #5 is the button
Seat 1: DSilver ($12.40 in chips) 
Seat 2: sTYLz_23 ($25.93 in chips) 
Seat 3: AA Mac ($18.79 in chips) 
Seat 4: CashMatteo ($5.01 in chips) 
Seat 5: 1stedcharizard ($10.15 in chips) 
Seat 6: SomeGoodKush ($12.77 in chips) 
SomeGoodKush: posts small blind $0.05
DSilver: posts big blind $0.10
*** HOLE CARDS ***
Dealt to CashMatteo [4c 8h]
sTYLz_23 has timed out
sTYLz_23: folds 
AA Mac: folds 
CashMatteo: folds 
1stedcharizard: raises $0.15 to $0.25
SomeGoodKush: folds 
DSilver: folds 
Uncalled bet ($0.15) returned to 1stedcharizard
1stedcharizard collected $0.25 from pot
1stedcharizard: doesn't show hand 
*** SUMMARY ***
Total pot $0.25 | Rake $0 
Seat 1: DSilver (big blind) folded before Flop
Seat 2: sTYLz_23 folded before Flop (didn't bet)
Seat 3: AA Mac folded before Flop (didn't bet)
Seat 4: CashMatteo folded before Flop (didn't bet)
Seat 5: 1stedcharizard (button) collected ($0.25)
Seat 6: SomeGoodKush (small blind) folded before Flop

Hand #2248: 

PokerStars Hand #250520558850:  Hold'em No Limit ($0.05/$0.10 CAD) - 2024/05/15 18:28:49 ET
Table 'Astronomia III' 6-max Seat #6 is the button
Seat 1: DSilver ($12.30 in chips) 
Seat 2: sTYLz_23 ($25.93 in chips) 
Seat 3: AA Mac ($18.79 in chips) 
Seat 4: CashMatteo ($5.01 in chips) 
Seat 5: 1stedcharizard ($10.30 in chips) 
Seat 6: SomeGoodKush ($12.72 in chips) 
DSilver: posts small blind $0.05
sTYLz_23: posts big blind $0.10
*** HOLE CARDS ***
Dealt to CashMatteo [Td 4h]
AA Mac: raises $0.20 to $0.30
CashMatteo: folds 
1stedcharizard: calls $0.30
SomeGoodKush: folds 
DSilver: folds 
sTYLz_23: folds 
*** FLOP *** [8d Qd 4c]
AA Mac: bets $0.49
1stedcharizard: folds 
Uncalled bet ($0.49) returned to AA Mac
AA Mac collected $0.72 from pot
AA Mac: doesn't show hand 
*** SUMMARY ***
Total pot $0.75 | Rake $0.03 
Board [8d Qd 4c]
Seat 1: DSilver (small blind) folded before Flop
Seat 2: sTYLz_23 (big blind) folded before Flop
Seat 3: AA Mac collected ($0.72)
Seat 4: CashMatteo folded before Flop (didn't bet)
Seat 5: 1stedcharizard folded on the Flop
Seat 6: SomeGoodKush (button) folded before Flop (didn't bet)

Hand #2249: 

PokerStars Hand #250520565707:  Hold'em No Limit ($0.05/$0.10 CAD) - 2024/05/15 18:29:14 ET
Table 'Astronomia III' 6-max Seat #1 is the button
Seat 1: DSilver ($12.25 in chips) 
Seat 2: sTYLz_23 ($25.83 in chips) 
Seat 3: AA Mac ($19.21 in chips) 
Seat 4: CashMatteo ($5.01 in chips) 
Seat 5: 1stedcharizard ($10 in chips) 
Seat 6: SomeGoodKush ($12.72 in chips) 
sTYLz_23: posts small blind $0.05
AA Mac: posts big blind $0.10
*** HOLE CARDS ***
Dealt to CashMatteo [7c 5d]
CashMatteo: folds 
1stedcharizard: folds 
SomeGoodKush: folds 
DSilver: folds 
sTYLz_23: calls $0.05
AA Mac: checks 
*** FLOP *** [7d Ts As]
sTYLz_23: checks 
AA Mac: checks 
*** TURN *** [7d Ts As] [9h]
sTYLz_23: checks 
AA Mac: checks 
*** RIVER *** [7d Ts As 9h] [6c]
sTYLz_23: checks 
AA Mac: bets $0.10
sTYLz_23: folds 
Uncalled bet ($0.10) returned to AA Mac
AA Mac collected $0.19 from pot
AA Mac: doesn't show hand 
*** SUMMARY ***
Total pot $0.20 | Rake $0.01 
Board [7d Ts As 9h 6c]
Seat 1: DSilver (button) folded before Flop (didn't bet)
Seat 2: sTYLz_23 (small blind) folded on the River
Seat 3: AA Mac (big blind) collected ($0.19)
Seat 4: CashMatteo folded before Flop (didn't bet)
Seat 5: 1stedcharizard folded before Flop (didn't bet)
Seat 6: SomeGoodKush folded before Flop (didn't bet)

Hand #2250: 

PokerStars Hand #250520578950:  Hold'em No Limit ($0.05/$0.10 CAD) - 2024/05/15 18:30:01 ET
Table 'Astronomia III' 6-max Seat #2 is the button
Seat 1: DSilver ($12.25 in chips) 
Seat 2: sTYLz_23 ($25.73 in chips) 
Seat 3: AA Mac ($19.30 in chips) 
Seat 4: CashMatteo ($5.01 in chips) 
Seat 5: 1stedcharizard ($10 in chips) 
Seat 6: SomeGoodKush ($12.72 in chips) 
AA Mac: posts small blind $0.05
CashMatteo: posts big blind $0.10
*** HOLE CARDS ***
Dealt to CashMatteo [2s 4h]
1stedcharizard: folds 
SomeGoodKush: folds 
DSilver: folds 
sTYLz_23: folds 
AA Mac: raises $0.20 to $0.30
CashMatteo: folds 
Uncalled bet ($0.20) returned to AA Mac
AA Mac collected $0.20 from pot
AA Mac: doesn't show hand 
*** SUMMARY ***
Total pot $0.20 | Rake $0 
Seat 1: DSilver folded before Flop (didn't bet)
Seat 2: sTYLz_23 (button) folded before Flop (didn't bet)
Seat 3: AA Mac (small blind) collected ($0.20)
Seat 4: CashMatteo (big blind) folded before Flop
Seat 5: 1stedcharizard folded before Flop (didn't bet)
Seat 6: SomeGoodKush folded before Flop (didn't bet)

Hand #2251: 

PokerStars Hand #250520587119:  Hold'em No Limit ($0.05/$0.10 CAD) - 2024/05/15 18:30:29 ET
Table 'Astronomia III' 6-max Seat #3 is the button
Seat 1: DSilver ($12.25 in chips) 
Seat 2: sTYLz_23 ($25.73 in chips) 
Seat 3: AA Mac ($19.40 in chips) 
Seat 4: CashMatteo ($4.91 in chips) 
Seat 5: 1stedcharizard ($10 in chips) 
Seat 6: SomeGoodKush ($12.72 in chips) 
CashMatteo: posts small blind $0.05
1stedcharizard: posts big blind $0.10
*** HOLE CARDS ***
Dealt to CashMatteo [7c Kc]
SomeGoodKush: folds 
DSilver: folds 
sTYLz_23 has timed out
sTYLz_23: folds 
AA Mac: raises $0.20 to $0.30
CashMatteo: calls $0.25
1stedcharizard: folds 
*** FLOP *** [2h 2c 9h]
CashMatteo: checks 
AA Mac: bets $0.46
CashMatteo: folds 
Uncalled bet ($0.46) returned to AA Mac
AA Mac collected $0.67 from pot
AA Mac: doesn't show hand 
*** SUMMARY ***
Total pot $0.70 | Rake $0.03 
Board [2h 2c 9h]
Seat 1: DSilver folded before Flop (didn't bet)
Seat 2: sTYLz_23 folded before Flop (didn't bet)
Seat 3: AA Mac (button) collected ($0.67)
Seat 4: CashMatteo (small blind) folded on the Flop
Seat 5: 1stedcharizard (big blind) folded before Flop
Seat 6: SomeGoodKush folded before Flop (didn't bet)

Hand #2252: 

PokerStars Hand #250520599490:  Hold'em No Limit ($0.05/$0.10 CAD) - 2024/05/15 18:31:13 ET
Table 'Astronomia III' 6-max Seat #4 is the button
Seat 1: DSilver ($12.25 in chips) 
Seat 2: sTYLz_23 ($25.73 in chips) 
Seat 3: AA Mac ($19.77 in chips) 
Seat 4: CashMatteo ($4.61 in chips) 
Seat 5: 1stedcharizard ($10 in chips) 
Seat 6: SomeGoodKush ($12.72 in chips) 
1stedcharizard: posts small blind $0.05
SomeGoodKush: posts big blind $0.10
*** HOLE CARDS ***
Dealt to CashMatteo [2s 9c]
DSilver: folds 
sTYLz_23 has timed out
sTYLz_23: folds 
AA Mac: folds 
CashMatteo: folds 
1stedcharizard: folds 
Uncalled bet ($0.05) returned to SomeGoodKush
SomeGoodKush collected $0.10 from pot
SomeGoodKush: doesn't show hand 
*** SUMMARY ***
Total pot $0.10 | Rake $0 
Seat 1: DSilver folded before Flop (didn't bet)
Seat 2: sTYLz_23 folded before Flop (didn't bet)
Seat 3: AA Mac folded before Flop (didn't bet)
Seat 4: CashMatteo (button) folded before Flop (didn't bet)
Seat 5: 1stedcharizard (small blind) folded before Flop
Seat 6: SomeGoodKush (big blind) collected ($0.10)

Hand #2253: 

PokerStars Hand #250520605776:  Hold'em No Limit ($0.05/$0.10 CAD) - 2024/05/15 18:31:35 ET
Table 'Astronomia III' 6-max Seat #5 is the button
Seat 1: DSilver ($12.25 in chips) 
Seat 2: sTYLz_23 ($25.73 in chips) 
Seat 3: AA Mac ($19.77 in chips) 
Seat 4: CashMatteo ($4.61 in chips) 
Seat 5: 1stedcharizard ($10 in chips) 
Seat 6: SomeGoodKush ($12.77 in chips) 
SomeGoodKush: posts small blind $0.05
DSilver: posts big blind $0.10
*** HOLE CARDS ***
Dealt to CashMatteo [2c 6h]
sTYLz_23 has timed out
sTYLz_23: folds 
AA Mac: folds 
CashMatteo: folds 
1stedcharizard: folds 
SomeGoodKush: calls $0.05
DSilver: checks 
*** FLOP *** [2h Ac Qc]
SomeGoodKush: bets $0.10
DSilver: folds 
Uncalled bet ($0.10) returned to SomeGoodKush
SomeGoodKush collected $0.19 from pot
SomeGoodKush: doesn't show hand 
*** SUMMARY ***
Total pot $0.20 | Rake $0.01 
Board [2h Ac Qc]
Seat 1: DSilver (big blind) folded on the Flop
Seat 2: sTYLz_23 folded before Flop (didn't bet)
Seat 3: AA Mac folded before Flop (didn't bet)
Seat 4: CashMatteo folded before Flop (didn't bet)
Seat 5: 1stedcharizard (button) folded before Flop (didn't bet)
Seat 6: SomeGoodKush (small blind) collected ($0.19)

Hand #2254: 

PokerStars Hand #250520616840:  Hold'em No Limit ($0.05/$0.10 CAD) - 2024/05/15 18:32:15 ET
Table 'Astronomia III' 6-max Seat #6 is the button
Seat 1: DSilver ($12.15 in chips) 
Seat 3: AA Mac ($19.77 in chips) 
Seat 4: CashMatteo ($4.61 in chips) 
Seat 5: 1stedcharizard ($10 in chips) 
Seat 6: SomeGoodKush ($12.86 in chips) 
DSilver: posts small blind $0.05
AA Mac: posts big blind $0.10
*** HOLE CARDS ***
Dealt to CashMatteo [3s 3h]
CashMatteo: calls $0.10
1stedcharizard: raises $0.25 to $0.35
SomeGoodKush: folds 
DSilver: folds 
AA Mac: folds 
CashMatteo: calls $0.25
*** FLOP *** [Ah Qc 7d]
CashMatteo: checks 
1stedcharizard: bets $0.27
CashMatteo: folds 
Uncalled bet ($0.27) returned to 1stedcharizard
1stedcharizard collected $0.81 from pot
1stedcharizard: doesn't show hand 
*** SUMMARY ***
Total pot $0.85 | Rake $0.04 
Board [Ah Qc 7d]
Seat 1: DSilver (small blind) folded before Flop
Seat 3: AA Mac (big blind) folded before Flop
Seat 4: CashMatteo folded on the Flop
Seat 5: 1stedcharizard collected ($0.81)
Seat 6: SomeGoodKush (button) folded before Flop (didn't bet)

Hand #2255: 

PokerStars Hand #250520627589:  Hold'em No Limit ($0.05/$0.10 CAD) - 2024/05/15 18:32:54 ET
Table 'Astronomia III' 6-max Seat #1 is the button
Seat 1: DSilver ($12.10 in chips) 
Seat 3: AA Mac ($19.67 in chips) 
Seat 4: CashMatteo ($4.26 in chips) 
Seat 5: 1stedcharizard ($10.46 in chips) 
Seat 6: SomeGoodKush ($12.86 in chips) 
sTYLz_23 will be allowed to play after the button
AA Mac: posts small blind $0.05
CashMatteo: posts big blind $0.10
*** HOLE CARDS ***
Dealt to CashMatteo [5s 6c]
1stedcharizard: folds 
SomeGoodKush: folds 
DSilver: raises $0.15 to $0.25
AA Mac: folds 
CashMatteo: folds 
Uncalled bet ($0.15) returned to DSilver
DSilver collected $0.25 from pot
DSilver: doesn't show hand 
*** SUMMARY ***
Total pot $0.25 | Rake $0 
Seat 1: DSilver (button) collected ($0.25)
Seat 3: AA Mac (small blind) folded before Flop
Seat 4: CashMatteo (big blind) folded before Flop
Seat 5: 1stedcharizard folded before Flop (didn't bet)
Seat 6: SomeGoodKush folded before Flop (didn't bet)

Hand #2256: 

PokerStars Hand #250520633480:  Hold'em No Limit ($0.05/$0.10 CAD) - 2024/05/15 18:33:15 ET
Table 'Astronomia III' 6-max Seat #3 is the button
Seat 1: DSilver ($12.25 in chips) 
Seat 3: AA Mac ($19.62 in chips) 
Seat 4: CashMatteo ($4.16 in chips) 
Seat 5: 1stedcharizard ($10.46 in chips) 
Seat 6: SomeGoodKush ($12.86 in chips) 
CashMatteo: posts small blind $0.05
1stedcharizard: posts big blind $0.10
sTYLz_23: sits out 
*** HOLE CARDS ***
Dealt to CashMatteo [Tc 5d]
SomeGoodKush: folds 
DSilver: folds 
AA Mac: folds 
CashMatteo: folds 
Uncalled bet ($0.05) returned to 1stedcharizard
1stedcharizard collected $0.10 from pot
1stedcharizard: doesn't show hand 
*** SUMMARY ***
Total pot $0.10 | Rake $0 
Seat 1: DSilver folded before Flop (didn't bet)
Seat 3: AA Mac (button) folded before Flop (didn't bet)
Seat 4: CashMatteo (small blind) folded before Flop
Seat 5: 1stedcharizard (big blind) collected ($0.10)
Seat 6: SomeGoodKush folded before Flop (didn't bet)

Hand #2257: 

PokerStars Hand #250520637338:  Hold'em No Limit ($0.05/$0.10 CAD) - 2024/05/15 18:33:28 ET
Table 'Astronomia III' 6-max Seat #4 is the button
Seat 1: DSilver ($12.25 in chips) 
Seat 3: AA Mac ($19.62 in chips) 
Seat 4: CashMatteo ($4.11 in chips) 
Seat 5: 1stedcharizard ($10.51 in chips) 
1stedcharizard: posts small blind $0.05
SomeGoodKush: is sitting out 
DSilver: posts big blind $0.10
sTYLz_23: sits out 
*** HOLE CARDS ***
Dealt to CashMatteo [6s 4c]
AA Mac: raises $0.20 to $0.30
CashMatteo: folds 
SomeGoodKush leaves the table
1stedcharizard: folds 
DSilver: folds 
Uncalled bet ($0.20) returned to AA Mac
AA Mac collected $0.25 from pot
AA Mac: doesn't show hand 
*** SUMMARY ***
Total pot $0.25 | Rake $0 
Seat 1: DSilver (big blind) folded before Flop
Seat 3: AA Mac collected ($0.25)
Seat 4: CashMatteo (button) folded before Flop (didn't bet)
Seat 5: 1stedcharizard (small blind) folded before Flop

Hand #2258: 

PokerStars Hand #250520642080:  Hold'em No Limit ($0.05/$0.10 CAD) - 2024/05/15 18:33:45 ET
Table 'Astronomia III' 6-max Seat #5 is the button
Seat 1: DSilver ($12.15 in chips) 
Seat 2: sTYLz_23 ($25.73 in chips) 
Seat 3: AA Mac ($19.77 in chips) 
Seat 4: CashMatteo ($4.11 in chips) 
Seat 5: 1stedcharizard ($10.46 in chips) 
DSilver: posts small blind $0.05
sTYLz_23: posts big blind $0.10
*** HOLE CARDS ***
Dealt to CashMatteo [8c Kc]
AA Mac: folds 
CashMatteo: raises $0.15 to $0.25
1stedcharizard: folds 
DSilver: folds 
sTYLz_23: calls $0.15
*** FLOP *** [4s Jh 3c]
sTYLz_23: checks 
CashMatteo: checks 
*** TURN *** [4s Jh 3c] [Jc]
sTYLz_23: checks 
CashMatteo: checks 
*** RIVER *** [4s Jh 3c Jc] [4c]
sTYLz_23: checks 
CashMatteo: bets $0.53
sTYLz_23: calls $0.53
*** SHOW DOWN ***
CashMatteo: shows [8c Kc] (a flush, King high)
sTYLz_23: mucks hand 
CashMatteo collected $1.54 from pot
*** SUMMARY ***
Total pot $1.61 | Rake $0.07 
Board [4s Jh 3c Jc 4c]
Seat 1: DSilver (small blind) folded before Flop
Seat 2: sTYLz_23 (big blind) mucked [Ah Kd]
Seat 3: AA Mac folded before Flop (didn't bet)
Seat 4: CashMatteo showed [8c Kc] and won ($1.54) with a flush, King high
Seat 5: 1stedcharizard (button) folded before Flop (didn't bet)

Hand #2259: 

PokerStars Hand #250520653923:  Hold'em No Limit ($0.05/$0.10 CAD) - 2024/05/15 18:34:28 ET
Table 'Astronomia III' 6-max Seat #2 is the button
Seat 2: sTYLz_23 ($24.95 in chips) 
Seat 3: AA Mac ($19.77 in chips) 
Seat 4: CashMatteo ($4.87 in chips) 
Seat 5: 1stedcharizard ($10.46 in chips) 
AA Mac: posts small blind $0.05
CashMatteo: posts big blind $0.10
*** HOLE CARDS ***
Dealt to CashMatteo [8d Ks]
DSilver leaves the table
1stedcharizard: folds 
sTYLz_23: folds 
AA Mac: folds 
Uncalled bet ($0.05) returned to CashMatteo
CashMatteo collected $0.10 from pot
CashMatteo: doesn't show hand 
*** SUMMARY ***
Total pot $0.10 | Rake $0 
Seat 2: sTYLz_23 (button) folded before Flop (didn't bet)
Seat 3: AA Mac (small blind) folded before Flop
Seat 4: CashMatteo (big blind) collected ($0.10)
Seat 5: 1stedcharizard folded before Flop (didn't bet)

Hand #2260: 

PokerStars Hand #250520656662:  Hold'em No Limit ($0.05/$0.10 CAD) - 2024/05/15 18:34:38 ET
Table 'Astronomia III' 6-max Seat #3 is the button
Seat 2: sTYLz_23 ($24.95 in chips) 
Seat 3: AA Mac ($19.72 in chips) 
Seat 4: CashMatteo ($4.92 in chips) 
Seat 5: 1stedcharizard ($10.46 in chips) 
CashMatteo: posts small blind $0.05
1stedcharizard: posts big blind $0.10
*** HOLE CARDS ***
Dealt to CashMatteo [4h 8h]
sTYLz_23: folds 
AA Mac: folds 
CashMatteo: calls $0.05
1stedcharizard: checks 
*** FLOP *** [8c 2s 5s]
CashMatteo: checks 
1stedcharizard: bets $0.10
CashMatteo: calls $0.10
*** TURN *** [8c 2s 5s] [Td]
CashMatteo: checks 
1stedcharizard: bets $0.38
CashMatteo: calls $0.38
*** RIVER *** [8c 2s 5s Td] [6d]
CashMatteo: checks 
1stedcharizard: bets $1.11
CashMatteo: folds 
Uncalled bet ($1.11) returned to 1stedcharizard
1stedcharizard collected $1.11 from pot
1stedcharizard: doesn't show hand 
*** SUMMARY ***
Total pot $1.16 | Rake $0.05 
Board [8c 2s 5s Td 6d]
Seat 2: sTYLz_23 folded before Flop (didn't bet)
Seat 3: AA Mac (button) folded before Flop (didn't bet)
Seat 4: CashMatteo (small blind) folded on the River
Seat 5: 1stedcharizard (big blind) collected ($1.11)

Hand #2261: 

PokerStars Hand #250520676005:  Hold'em No Limit ($0.05/$0.10 CAD) - 2024/05/15 18:35:49 ET
Table 'Astronomia III' 6-max Seat #4 is the button
Seat 2: sTYLz_23 ($24.95 in chips) 
Seat 3: AA Mac ($19.72 in chips) 
Seat 4: CashMatteo ($4.34 in chips) 
Seat 5: 1stedcharizard ($10.99 in chips) 
1stedcharizard: posts small blind $0.05
sTYLz_23: posts big blind $0.10
*** HOLE CARDS ***
Dealt to CashMatteo [5h 6c]
AA Mac: folds 
CashMatteo: folds 
1stedcharizard: raises $0.25 to $0.35
sTYLz_23: folds 
Uncalled bet ($0.25) returned to 1stedcharizard
1stedcharizard collected $0.20 from pot
1stedcharizard: doesn't show hand 
*** SUMMARY ***
Total pot $0.20 | Rake $0 
Seat 2: sTYLz_23 (big blind) folded before Flop
Seat 3: AA Mac folded before Flop (didn't bet)
Seat 4: CashMatteo (button) folded before Flop (didn't bet)
Seat 5: 1stedcharizard (small blind) collected ($0.20)

Hand #2262: 

PokerStars Hand #250520680883:  Hold'em No Limit ($0.05/$0.10 CAD) - 2024/05/15 18:36:06 ET
Table 'Astronomia III' 6-max Seat #5 is the button
Seat 2: sTYLz_23 ($24.85 in chips) 
Seat 4: CashMatteo ($4.34 in chips) 
Seat 5: 1stedcharizard ($11.09 in chips) 
sTYLz_23: posts small blind $0.05
AA Mac: is sitting out 
CashMatteo: posts big blind $0.10
*** HOLE CARDS ***
Dealt to CashMatteo [9h 2c]
1stedcharizard: raises $0.15 to $0.25
sTYLz_23: folds 
CashMatteo: folds 
Uncalled bet ($0.15) returned to 1stedcharizard
1stedcharizard collected $0.25 from pot
1stedcharizard: doesn't show hand 
*** SUMMARY ***
Total pot $0.25 | Rake $0 
Seat 2: sTYLz_23 (small blind) folded before Flop
Seat 4: CashMatteo (big blind) folded before Flop
Seat 5: 1stedcharizard (button) collected ($0.25)

Hand #2263: 

PokerStars Hand #250520684064:  Hold'em No Limit ($0.05/$0.10 CAD) - 2024/05/15 18:36:18 ET
Table 'Astronomia III' 6-max Seat #4 is the button
Seat 2: sTYLz_23 ($24.80 in chips) 
Seat 4: CashMatteo ($4.24 in chips) 
CashMatteo: posts small blind $0.05
1stedcharizard: is sitting out 
sTYLz_23: posts big blind $0.10
*** HOLE CARDS ***
Dealt to CashMatteo [Qs 2h]
CashMatteo: folds 
Uncalled bet ($0.05) returned to sTYLz_23
sTYLz_23 collected $0.10 from pot
AA Mac leaves the table
*** SUMMARY ***
Total pot $0.10 | Rake $0 
Seat 2: sTYLz_23 (big blind) collected ($0.10)
Seat 4: CashMatteo (button) (small blind) folded before Flop

Hand #2264: 

PokerStars Hand #250520686308:  Hold'em No Limit ($0.05/$0.10 CAD) - 2024/05/15 18:36:26 ET
Table 'Astronomia III' 6-max Seat #2 is the button
Seat 2: sTYLz_23 ($24.85 in chips) 
Seat 4: CashMatteo ($4.19 in chips) 
sTYLz_23: posts small blind $0.05
CashMatteo: posts big blind $0.10
*** HOLE CARDS ***
Dealt to CashMatteo [8d 9d]
1stedcharizard leaves the table
sTYLz_23: calls $0.05
CashMatteo: raises $0.25 to $0.35
sTYLz_23: folds 
Uncalled bet ($0.25) returned to CashMatteo
CashMatteo collected $0.20 from pot
CashMatteo: doesn't show hand 
*** SUMMARY ***
Total pot $0.20 | Rake $0 
Seat 2: sTYLz_23 (button) (small blind) folded before Flop
Seat 4: CashMatteo (big blind) collected ($0.20)

Hand #2265: 

PokerStars Hand #250520692474:  Hold'em No Limit ($0.05/$0.10 CAD) - 2024/05/15 18:36:49 ET
Table 'Astronomia III' 6-max Seat #4 is the button
Seat 2: sTYLz_23 ($24.75 in chips) 
Seat 4: CashMatteo ($4.29 in chips) 
CashMatteo: posts small blind $0.05
sTYLz_23: posts big blind $0.10
*** HOLE CARDS ***
Dealt to CashMatteo [Ac Ts]
CashMatteo: raises $0.15 to $0.25
sTYLz_23: calls $0.15
*** FLOP *** [Ad 4d 5s]
sTYLz_23: checks 
CashMatteo: bets $0.34
sTYLz_23: folds 
Uncalled bet ($0.34) returned to CashMatteo
CashMatteo collected $0.48 from pot
CashMatteo: doesn't show hand 
*** SUMMARY ***
Total pot $0.50 | Rake $0.02 
Board [Ad 4d 5s]
Seat 2: sTYLz_23 (big blind) folded on the Flop
Seat 4: CashMatteo (button) (small blind) collected ($0.48)

Hand #2266: 

PokerStars Hand #250520699204:  Hold'em No Limit ($0.05/$0.10 CAD) - 2024/05/15 18:37:13 ET
Table 'Astronomia III' 6-max Seat #2 is the button
Seat 2: sTYLz_23 ($24.50 in chips) 
Seat 4: CashMatteo ($4.52 in chips) 
sTYLz_23: posts small blind $0.05
CashMatteo: posts big blind $0.10
*** HOLE CARDS ***
Dealt to CashMatteo [Ks 6d]
sTYLz_23: calls $0.05
CashMatteo: checks 
*** FLOP *** [Kc 9c Ah]
CashMatteo: bets $0.19
sTYLz_23: folds 
Uncalled bet ($0.19) returned to CashMatteo
CashMatteo collected $0.19 from pot
CashMatteo: doesn't show hand 
*** SUMMARY ***
Total pot $0.20 | Rake $0.01 
Board [Kc 9c Ah]
Seat 2: sTYLz_23 (button) (small blind) folded on the Flop
Seat 4: CashMatteo (big blind) collected ($0.19)

Hand #2267: 

PokerStars Hand #250520702813:  Hold'em No Limit ($0.05/$0.10 CAD) - 2024/05/15 18:37:26 ET
Table 'Astronomia III' 6-max Seat #4 is the button
Seat 2: sTYLz_23 ($24.40 in chips) 
Seat 4: CashMatteo ($4.61 in chips) 
CashMatteo: posts small blind $0.05
sTYLz_23: posts big blind $0.10
*** HOLE CARDS ***
Dealt to CashMatteo [2s 7h]
CashMatteo: folds 
Uncalled bet ($0.05) returned to sTYLz_23
sTYLz_23 collected $0.10 from pot
*** SUMMARY ***
Total pot $0.10 | Rake $0 
Seat 2: sTYLz_23 (big blind) collected ($0.10)
Seat 4: CashMatteo (button) (small blind) folded before Flop

Hand #2268: 

PokerStars Hand #250520704578:  Hold'em No Limit ($0.05/$0.10 CAD) - 2024/05/15 18:37:33 ET
Table 'Astronomia III' 6-max Seat #2 is the button
Seat 2: sTYLz_23 ($24.45 in chips) 
Seat 4: CashMatteo ($4.56 in chips) 
sTYLz_23: posts small blind $0.05
CashMatteo: posts big blind $0.10
*** HOLE CARDS ***
Dealt to CashMatteo [9s 2h]
sTYLz_23: calls $0.05
CashMatteo: checks 
*** FLOP *** [6c 4d 6h]
CashMatteo: checks 
sTYLz_23: bets $0.10
CashMatteo: folds 
Uncalled bet ($0.10) returned to sTYLz_23
sTYLz_23 collected $0.19 from pot
*** SUMMARY ***
Total pot $0.20 | Rake $0.01 
Board [6c 4d 6h]
Seat 2: sTYLz_23 (button) (small blind) collected ($0.19)
Seat 4: CashMatteo (big blind) folded on the Flop

Hand #2269: 

PokerStars Hand #250520708314:  Hold'em No Limit ($0.05/$0.10 CAD) - 2024/05/15 18:37:46 ET
Table 'Astronomia III' 6-max Seat #4 is the button
Seat 2: sTYLz_23 ($24.54 in chips) 
Seat 4: CashMatteo ($4.46 in chips) 
CashMatteo: posts small blind $0.05
sTYLz_23: posts big blind $0.10
*** HOLE CARDS ***
Dealt to CashMatteo [2s 5c]
CashMatteo: folds 
Uncalled bet ($0.05) returned to sTYLz_23
sTYLz_23 collected $0.10 from pot
*** SUMMARY ***
Total pot $0.10 | Rake $0 
Seat 2: sTYLz_23 (big blind) collected ($0.10)
Seat 4: CashMatteo (button) (small blind) folded before Flop

Hand #2270: 

PokerStars Hand #250520709912:  Hold'em No Limit ($0.05/$0.10 CAD) - 2024/05/15 18:37:52 ET
Table 'Astronomia III' 6-max Seat #2 is the button
Seat 2: sTYLz_23 ($24.59 in chips) 
Seat 4: CashMatteo ($4.41 in chips) 
sTYLz_23: posts small blind $0.05
CashMatteo: posts big blind $0.10
*** HOLE CARDS ***
Dealt to CashMatteo [9c 6s]
sTYLz_23: calls $0.05
CashMatteo: checks 
*** FLOP *** [3c 7d Ah]
CashMatteo: checks 
sTYLz_23: bets $0.10
CashMatteo: calls $0.10
*** TURN *** [3c 7d Ah] [5c]
CashMatteo: checks 
sTYLz_23: checks 
*** RIVER *** [3c 7d Ah 5c] [4c]
CashMatteo: bets $0.38
sTYLz_23: calls $0.38
*** SHOW DOWN ***
CashMatteo: shows [9c 6s] (a straight, Three to Seven)
sTYLz_23: mucks hand 
CashMatteo collected $1.11 from pot
*** SUMMARY ***
Total pot $1.16 | Rake $0.05 
Board [3c 7d Ah 5c 4c]
Seat 2: sTYLz_23 (button) (small blind) mucked [2s 3h]
Seat 4: CashMatteo (big blind) showed [9c 6s] and won ($1.11) with a straight, Three to Seven

Hand #2271: 

PokerStars Hand #250520717226:  Hold'em No Limit ($0.05/$0.10 CAD) - 2024/05/15 18:38:19 ET
Table 'Astronomia III' 6-max Seat #4 is the button
Seat 2: sTYLz_23 ($24.01 in chips) 
Seat 4: CashMatteo ($4.94 in chips) 
CashMatteo: posts small blind $0.05
sTYLz_23: posts big blind $0.10
*** HOLE CARDS ***
Dealt to CashMatteo [Jh Jd]
CashMatteo: raises $0.15 to $0.25
sTYLz_23: folds 
Uncalled bet ($0.15) returned to CashMatteo
CashMatteo collected $0.20 from pot
CashMatteo: doesn't show hand 
*** SUMMARY ***
Total pot $0.20 | Rake $0 
Seat 2: sTYLz_23 (big blind) folded before Flop
Seat 4: CashMatteo (button) (small blind) collected ($0.20)

Hand #2272: 

PokerStars Hand #250520720655:  Hold'em No Limit ($0.05/$0.10 CAD) - 2024/05/15 18:38:32 ET
Table 'Astronomia III' 6-max Seat #2 is the button
Seat 2: sTYLz_23 ($23.91 in chips) 
Seat 4: CashMatteo ($5.04 in chips) 
sTYLz_23: posts small blind $0.05
CashMatteo: posts big blind $0.10
*** HOLE CARDS ***
Dealt to CashMatteo [Ac 4c]
sTYLz_23: calls $0.05
CashMatteo: raises $0.25 to $0.35
sTYLz_23: folds 
Uncalled bet ($0.25) returned to CashMatteo
CashMatteo collected $0.20 from pot
CashMatteo: doesn't show hand 
*** SUMMARY ***
Total pot $0.20 | Rake $0 
Seat 2: sTYLz_23 (button) (small blind) folded before Flop
Seat 4: CashMatteo (big blind) collected ($0.20)

Hand #2273: 

PokerStars Hand #250520724049:  Hold'em No Limit ($0.05/$0.10 CAD) - 2024/05/15 18:38:44 ET
Table 'Astronomia III' 6-max Seat #4 is the button
Seat 2: sTYLz_23 ($23.81 in chips) 
Seat 4: CashMatteo ($5.14 in chips) 
CashMatteo: posts small blind $0.05
sTYLz_23: posts big blind $0.10
*** HOLE CARDS ***
Dealt to CashMatteo [Kd 9d]
CashMatteo: raises $0.15 to $0.25
sTYLz_23: folds 
Uncalled bet ($0.15) returned to CashMatteo
CashMatteo collected $0.20 from pot
CashMatteo: doesn't show hand 
*** SUMMARY ***
Total pot $0.20 | Rake $0 
Seat 2: sTYLz_23 (big blind) folded before Flop
Seat 4: CashMatteo (button) (small blind) collected ($0.20)

Hand #2274: 

PokerStars Hand #250520727407:  Hold'em No Limit ($0.05/$0.10 CAD) - 2024/05/15 18:38:56 ET
Table 'Astronomia III' 6-max Seat #2 is the button
Seat 2: sTYLz_23 ($23.71 in chips) 
Seat 4: CashMatteo ($5.24 in chips) 
sTYLz_23: posts small blind $0.05
CashMatteo: posts big blind $0.10
*** HOLE CARDS ***
Dealt to CashMatteo [Ts 5h]
sTYLz_23: calls $0.05
CashMatteo: checks 
*** FLOP *** [6s 3d Qc]
CashMatteo: checks 
sTYLz_23: bets $0.10
CashMatteo: calls $0.10
*** TURN *** [6s 3d Qc] [9s]
CashMatteo: checks 
sTYLz_23: bets $0.10
CashMatteo: folds 
Uncalled bet ($0.10) returned to sTYLz_23
sTYLz_23 collected $0.38 from pot
*** SUMMARY ***
Total pot $0.40 | Rake $0.02 
Board [6s 3d Qc 9s]
Seat 2: sTYLz_23 (button) (small blind) collected ($0.38)
Seat 4: CashMatteo (big blind) folded on the Turn

Hand #2275: 

PokerStars Hand #250520732852:  Hold'em No Limit ($0.05/$0.10 CAD) - 2024/05/15 18:39:16 ET
Table 'Astronomia III' 6-max Seat #4 is the button
Seat 2: sTYLz_23 ($23.89 in chips) 
Seat 4: CashMatteo ($5.04 in chips) 
CashMatteo: posts small blind $0.05
sTYLz_23: posts big blind $0.10
*** HOLE CARDS ***
Dealt to CashMatteo [6d 9c]
CashMatteo: calls $0.05
sTYLz_23: raises $0.20 to $0.30
CashMatteo: calls $0.20
*** FLOP *** [8c Kh 2s]
sTYLz_23: bets $0.29
CashMatteo: calls $0.29
*** TURN *** [8c Kh 2s] [Tc]
sTYLz_23: checks 
CashMatteo: bets $0.77
sTYLz_23: folds 
Uncalled bet ($0.77) returned to CashMatteo
CashMatteo collected $1.13 from pot
CashMatteo: doesn't show hand 
*** SUMMARY ***
Total pot $1.18 | Rake $0.05 
Board [8c Kh 2s Tc]
Seat 2: sTYLz_23 (big blind) folded on the Turn
Seat 4: CashMatteo (button) (small blind) collected ($1.13)

Hand #2276: 

PokerStars Hand #250520741147:  Hold'em No Limit ($0.05/$0.10 CAD) - 2024/05/15 18:39:46 ET
Table 'Astronomia III' 6-max Seat #2 is the button
Seat 2: sTYLz_23 ($23.30 in chips) 
Seat 4: CashMatteo ($5.58 in chips) 
sTYLz_23: posts small blind $0.05
CashMatteo: posts big blind $0.10
*** HOLE CARDS ***
Dealt to CashMatteo [5s Ts]
sTYLz_23: calls $0.05
CashMatteo: checks 
*** FLOP *** [7d Ks 6s]
CashMatteo: bets $0.10
sTYLz_23: folds 
Uncalled bet ($0.10) returned to CashMatteo
CashMatteo collected $0.19 from pot
CashMatteo: doesn't show hand 
*** SUMMARY ***
Total pot $0.20 | Rake $0.01 
Board [7d Ks 6s]
Seat 2: sTYLz_23 (button) (small blind) folded on the Flop
Seat 4: CashMatteo (big blind) collected ($0.19)

Hand #2277: 

PokerStars Hand #250520744970:  Hold'em No Limit ($0.05/$0.10 CAD) - 2024/05/15 18:40:01 ET
Table 'Astronomia III' 6-max Seat #4 is the button
Seat 2: sTYLz_23 ($23.20 in chips) 
Seat 4: CashMatteo ($5.67 in chips) 
CashMatteo: posts small blind $0.05
sTYLz_23: posts big blind $0.10
*** HOLE CARDS ***
Dealt to CashMatteo [Td 7h]
CashMatteo: folds 
Uncalled bet ($0.05) returned to sTYLz_23
sTYLz_23 collected $0.10 from pot
*** SUMMARY ***
Total pot $0.10 | Rake $0 
Seat 2: sTYLz_23 (big blind) collected ($0.10)
Seat 4: CashMatteo (button) (small blind) folded before Flop

Hand #2278: 

PokerStars Hand #250520746900:  Hold'em No Limit ($0.05/$0.10 CAD) - 2024/05/15 18:40:08 ET
Table 'Astronomia III' 6-max Seat #2 is the button
Seat 2: sTYLz_23 ($23.25 in chips) 
Seat 4: CashMatteo ($5.62 in chips) 
sTYLz_23: posts small blind $0.05
CashMatteo: posts big blind $0.10
*** HOLE CARDS ***
Dealt to CashMatteo [8h Jh]
sTYLz_23: calls $0.05
CashMatteo: raises $0.15 to $0.25
sTYLz_23: calls $0.15
*** FLOP *** [Kd Td 6h]
CashMatteo: bets $0.44
sTYLz_23: folds 
Uncalled bet ($0.44) returned to CashMatteo
CashMatteo collected $0.48 from pot
CashMatteo: doesn't show hand 
*** SUMMARY ***
Total pot $0.50 | Rake $0.02 
Board [Kd Td 6h]
Seat 2: sTYLz_23 (button) (small blind) folded on the Flop
Seat 4: CashMatteo (big blind) collected ($0.48)

Hand #2279: 

PokerStars Hand #250520752991:  Hold'em No Limit ($0.05/$0.10 CAD) - 2024/05/15 18:40:30 ET
Table 'Astronomia III' 6-max Seat #4 is the button
Seat 2: sTYLz_23 ($23 in chips) 
Seat 4: CashMatteo ($5.85 in chips) 
CashMatteo: posts small blind $0.05
sTYLz_23: posts big blind $0.10
*** HOLE CARDS ***
Dealt to CashMatteo [5c 9c]
CashMatteo: folds 
Uncalled bet ($0.05) returned to sTYLz_23
sTYLz_23 collected $0.10 from pot
*** SUMMARY ***
Total pot $0.10 | Rake $0 
Seat 2: sTYLz_23 (big blind) collected ($0.10)
Seat 4: CashMatteo (button) (small blind) folded before Flop

Hand #2280: 

PokerStars Hand #250520755017:  Hold'em No Limit ($0.05/$0.10 CAD) - 2024/05/15 18:40:37 ET
Table 'Astronomia III' 6-max Seat #2 is the button
Seat 2: sTYLz_23 ($23.05 in chips) 
Seat 4: CashMatteo ($5.80 in chips) 
sTYLz_23: posts small blind $0.05
CashMatteo: posts big blind $0.10
*** HOLE CARDS ***
Dealt to CashMatteo [9h Jc]
sTYLz_23: calls $0.05
CashMatteo: raises $0.25 to $0.35
sTYLz_23: calls $0.25
*** FLOP *** [Ah 7s 8s]
CashMatteo: bets $0.44
sTYLz_23: folds 
Uncalled bet ($0.44) returned to CashMatteo
CashMatteo collected $0.67 from pot
CashMatteo: doesn't show hand 
*** SUMMARY ***
Total pot $0.70 | Rake $0.03 
Board [Ah 7s 8s]
Seat 2: sTYLz_23 (button) (small blind) folded on the Flop
Seat 4: CashMatteo (big blind) collected ($0.67)

Hand #2281: 

PokerStars Hand #250520760735:  Hold'em No Limit ($0.05/$0.10 CAD) - 2024/05/15 18:40:59 ET
Table 'Astronomia III' 6-max Seat #4 is the button
Seat 2: sTYLz_23 ($22.70 in chips) 
Seat 4: CashMatteo ($6.12 in chips) 
CashMatteo: posts small blind $0.05
sTYLz_23: posts big blind $0.10
*** HOLE CARDS ***
Dealt to CashMatteo [2c Tc]
CashMatteo: folds 
Uncalled bet ($0.05) returned to sTYLz_23
sTYLz_23 collected $0.10 from pot
*** SUMMARY ***
Total pot $0.10 | Rake $0 
Seat 2: sTYLz_23 (big blind) collected ($0.10)
Seat 4: CashMatteo (button) (small blind) folded before Flop

Hand #2282: 

PokerStars Hand #250520763003:  Hold'em No Limit ($0.05/$0.10 CAD) - 2024/05/15 18:41:07 ET
Table 'Astronomia III' 6-max Seat #2 is the button
Seat 2: sTYLz_23 ($22.75 in chips) 
Seat 4: CashMatteo ($6.07 in chips) 
sTYLz_23: posts small blind $0.05
CashMatteo: posts big blind $0.10
*** HOLE CARDS ***
Dealt to CashMatteo [Td 7s]
sTYLz_23: calls $0.05
CashMatteo: checks 
*** FLOP *** [4s 4h 6c]
CashMatteo: checks 
sTYLz_23: checks 
*** TURN *** [4s 4h 6c] [Ks]
CashMatteo: checks 
sTYLz_23: bets $0.10
CashMatteo: folds 
Uncalled bet ($0.10) returned to sTYLz_23
sTYLz_23 collected $0.19 from pot
*** SUMMARY ***
Total pot $0.20 | Rake $0.01 
Board [4s 4h 6c Ks]
Seat 2: sTYLz_23 (button) (small blind) collected ($0.19)
Seat 4: CashMatteo (big blind) folded on the Turn

Hand #2283: 

PokerStars Hand #250520767711:  Hold'em No Limit ($0.05/$0.10 CAD) - 2024/05/15 18:41:24 ET
Table 'Astronomia III' 6-max Seat #4 is the button
Seat 2: sTYLz_23 ($22.84 in chips) 
Seat 4: CashMatteo ($5.97 in chips) 
CashMatteo: posts small blind $0.05
sTYLz_23: posts big blind $0.10
*** HOLE CARDS ***
Dealt to CashMatteo [8s Jc]
CashMatteo: raises $0.15 to $0.25
sTYLz_23: folds 
Uncalled bet ($0.15) returned to CashMatteo
CashMatteo collected $0.20 from pot
CashMatteo: doesn't show hand 
*** SUMMARY ***
Total pot $0.20 | Rake $0 
Seat 2: sTYLz_23 (big blind) folded before Flop
Seat 4: CashMatteo (button) (small blind) collected ($0.20)

Hand #2284: 

PokerStars Hand #250520770994:  Hold'em No Limit ($0.05/$0.10 CAD) - 2024/05/15 18:41:37 ET
Table 'Astronomia III' 6-max Seat #2 is the button
Seat 2: sTYLz_23 ($22.74 in chips) 
Seat 4: CashMatteo ($6.07 in chips) 
sTYLz_23: posts small blind $0.05
CashMatteo: posts big blind $0.10
*** HOLE CARDS ***
Dealt to CashMatteo [3h 4d]
sTYLz_23: calls $0.05
CashMatteo: checks 
*** FLOP *** [Qh 8d 2h]
CashMatteo: checks 
sTYLz_23: checks 
*** TURN *** [Qh 8d 2h] [4h]
CashMatteo: checks 
sTYLz_23: bets $0.20
CashMatteo: raises $0.20 to $0.40
sTYLz_23: calls $0.20
*** RIVER *** [Qh 8d 2h 4h] [Th]
CashMatteo: checks 
sTYLz_23: bets $0.30
CashMatteo: calls $0.30
*** SHOW DOWN ***
sTYLz_23: shows [Jc 8h] (a flush, Queen high)
CashMatteo: mucks hand 
sTYLz_23 collected $1.53 from pot
*** SUMMARY ***
Total pot $1.60 | Rake $0.07 
Board [Qh 8d 2h 4h Th]
Seat 2: sTYLz_23 (button) (small blind) showed [Jc 8h] and won ($1.53) with a flush, Queen high
Seat 4: CashMatteo (big blind) mucked [3h 4d]

Hand #2285: 

PokerStars Hand #250520779424:  Hold'em No Limit ($0.05/$0.10 CAD) - 2024/05/15 18:42:08 ET
Table 'Astronomia III' 6-max Seat #4 is the button
Seat 2: sTYLz_23 ($23.47 in chips) 
Seat 4: CashMatteo ($5.27 in chips) 
CashMatteo: posts small blind $0.05
sTYLz_23: posts big blind $0.10
*** HOLE CARDS ***
Dealt to CashMatteo [9c 5d]
CashMatteo: folds 
Uncalled bet ($0.05) returned to sTYLz_23
sTYLz_23 collected $0.10 from pot
*** SUMMARY ***
Total pot $0.10 | Rake $0 
Seat 2: sTYLz_23 (big blind) collected ($0.10)
Seat 4: CashMatteo (button) (small blind) folded before Flop

Hand #2286: 

PokerStars Hand #250520782608:  Hold'em No Limit ($0.05/$0.10 CAD) - 2024/05/15 18:42:20 ET
Table 'Astronomia III' 6-max Seat #2 is the button
Seat 2: sTYLz_23 ($23.52 in chips) 
Seat 4: CashMatteo ($5.22 in chips) 
sTYLz_23: posts small blind $0.05
CashMatteo: posts big blind $0.10
*** HOLE CARDS ***
Dealt to CashMatteo [Th 7s]
sTYLz_23: calls $0.05
CashMatteo: checks 
*** FLOP *** [2d Qs 8h]
CashMatteo: checks 
sTYLz_23: checks 
*** TURN *** [2d Qs 8h] [7c]
CashMatteo: bets $0.10
sTYLz_23: calls $0.10
*** RIVER *** [2d Qs 8h 7c] [6c]
CashMatteo: bets $0.39
sTYLz_23: folds 
Uncalled bet ($0.39) returned to CashMatteo
CashMatteo collected $0.38 from pot
CashMatteo: doesn't show hand 
*** SUMMARY ***
Total pot $0.40 | Rake $0.02 
Board [2d Qs 8h 7c 6c]
Seat 2: sTYLz_23 (button) (small blind) folded on the River
Seat 4: CashMatteo (big blind) collected ($0.38)

Hand #2287: 

PokerStars Hand #250520791845:  Hold'em No Limit ($0.05/$0.10 CAD) - 2024/05/15 18:42:54 ET
Table 'Astronomia III' 6-max Seat #4 is the button
Seat 2: sTYLz_23 ($23.32 in chips) 
Seat 4: CashMatteo ($5.40 in chips) 
CashMatteo: posts small blind $0.05
sTYLz_23: posts big blind $0.10
*** HOLE CARDS ***
Dealt to CashMatteo [Ts 9c]
CashMatteo: raises $0.15 to $0.25
sTYLz_23: folds 
Uncalled bet ($0.15) returned to CashMatteo
CashMatteo collected $0.20 from pot
CashMatteo: doesn't show hand 
*** SUMMARY ***
Total pot $0.20 | Rake $0 
Seat 2: sTYLz_23 (big blind) folded before Flop
Seat 4: CashMatteo (button) (small blind) collected ($0.20)

Hand #2288: 

PokerStars Hand #250520794257:  Hold'em No Limit ($0.05/$0.10 CAD) - 2024/05/15 18:43:03 ET
Table 'Astronomia III' 6-max Seat #2 is the button
Seat 2: sTYLz_23 ($23.22 in chips) 
Seat 4: CashMatteo ($5.50 in chips) 
sTYLz_23: posts small blind $0.05
CashMatteo: posts big blind $0.10
*** HOLE CARDS ***
Dealt to CashMatteo [8c Qd]
sTYLz_23: folds 
Uncalled bet ($0.05) returned to CashMatteo
CashMatteo collected $0.10 from pot
CashMatteo: doesn't show hand 
*** SUMMARY ***
Total pot $0.10 | Rake $0 
Seat 2: sTYLz_23 (button) (small blind) folded before Flop
Seat 4: CashMatteo (big blind) collected ($0.10)

Hand #2289: 

PokerStars Hand #250520796021:  Hold'em No Limit ($0.05/$0.10 CAD) - 2024/05/15 18:43:09 ET
Table 'Astronomia III' 6-max Seat #4 is the button
Seat 2: sTYLz_23 ($23.17 in chips) 
Seat 4: CashMatteo ($5.55 in chips) 
CashMatteo: posts small blind $0.05
sTYLz_23: posts big blind $0.10
*** HOLE CARDS ***
Dealt to CashMatteo [5c Jh]
CashMatteo: folds 
Uncalled bet ($0.05) returned to sTYLz_23
sTYLz_23 collected $0.10 from pot
*** SUMMARY ***
Total pot $0.10 | Rake $0 
Seat 2: sTYLz_23 (big blind) collected ($0.10)
Seat 4: CashMatteo (button) (small blind) folded before Flop

Hand #2290: 

PokerStars Hand #250520798043:  Hold'em No Limit ($0.05/$0.10 CAD) - 2024/05/15 18:43:17 ET
Table 'Astronomia III' 6-max Seat #2 is the button
Seat 2: sTYLz_23 ($23.22 in chips) 
Seat 4: CashMatteo ($5.50 in chips) 
sTYLz_23: posts small blind $0.05
CashMatteo: posts big blind $0.10
*** HOLE CARDS ***
Dealt to CashMatteo [Kd 7c]
sTYLz_23: calls $0.05
CashMatteo: raises $0.15 to $0.25
sTYLz_23: calls $0.15
*** FLOP *** [5c 5s 3h]
CashMatteo: checks 
sTYLz_23: checks 
*** TURN *** [5c 5s 3h] [Jh]
CashMatteo: checks 
sTYLz_23: checks 
*** RIVER *** [5c 5s 3h Jh] [8d]
CashMatteo: checks 
sTYLz_23: checks 
*** SHOW DOWN ***
CashMatteo: shows [Kd 7c] (a pair of Fives)
sTYLz_23: mucks hand 
CashMatteo collected $0.48 from pot
*** SUMMARY ***
Total pot $0.50 | Rake $0.02 
Board [5c 5s 3h Jh 8d]
Seat 2: sTYLz_23 (button) (small blind) mucked [Ts 7d]
Seat 4: CashMatteo (big blind) showed [Kd 7c] and won ($0.48) with a pair of Fives

Hand #2291: 

PokerStars Hand #250520806303:  Hold'em No Limit ($0.05/$0.10 CAD) - 2024/05/15 18:43:47 ET
Table 'Astronomia III' 6-max Seat #4 is the button
Seat 2: sTYLz_23 ($22.97 in chips) 
Seat 4: CashMatteo ($5.73 in chips) 
CashMatteo: posts small blind $0.05
sTYLz_23: posts big blind $0.10
*** HOLE CARDS ***
Dealt to CashMatteo [9h Tc]
CashMatteo: raises $0.15 to $0.25
sTYLz_23: folds 
Uncalled bet ($0.15) returned to CashMatteo
CashMatteo collected $0.20 from pot
CashMatteo: doesn't show hand 
*** SUMMARY ***
Total pot $0.20 | Rake $0 
Seat 2: sTYLz_23 (big blind) folded before Flop
Seat 4: CashMatteo (button) (small blind) collected ($0.20)

Hand #2292: 

PokerStars Hand #250520809626:  Hold'em No Limit ($0.05/$0.10 CAD) - 2024/05/15 18:44:00 ET
Table 'Astronomia III' 6-max Seat #2 is the button
Seat 2: sTYLz_23 ($22.87 in chips) 
Seat 4: CashMatteo ($5.83 in chips) 
sTYLz_23: posts small blind $0.05
CashMatteo: posts big blind $0.10
*** HOLE CARDS ***
Dealt to CashMatteo [As 8h]
sTYLz_23: calls $0.05
CashMatteo: raises $0.15 to $0.25
sTYLz_23: calls $0.15
*** FLOP *** [4d 5s 3s]
CashMatteo: checks 
sTYLz_23: checks 
*** TURN *** [4d 5s 3s] [7c]
CashMatteo: checks 
sTYLz_23: checks 
*** RIVER *** [4d 5s 3s 7c] [Jc]
CashMatteo: checks 
sTYLz_23: checks 
*** SHOW DOWN ***
CashMatteo: shows [As 8h] (high card Ace)
sTYLz_23: shows [Ad Td] (high card Ace - Jack+Ten kicker)
sTYLz_23 collected $0.48 from pot
*** SUMMARY ***
Total pot $0.50 | Rake $0.02 
Board [4d 5s 3s 7c Jc]
Seat 2: sTYLz_23 (button) (small blind) showed [Ad Td] and won ($0.48) with high card Ace
Seat 4: CashMatteo (big blind) showed [As 8h] and lost with high card Ace

Hand #2293: 

PokerStars Hand #250520816570:  Hold'em No Limit ($0.05/$0.10 CAD) - 2024/05/15 18:44:26 ET
Table 'Astronomia III' 6-max Seat #4 is the button
Seat 2: sTYLz_23 ($23.10 in chips) 
Seat 4: CashMatteo ($5.58 in chips) 
CashMatteo: posts small blind $0.05
sTYLz_23: posts big blind $0.10
*** HOLE CARDS ***
Dealt to CashMatteo [6h 2s]
CashMatteo: folds 
Uncalled bet ($0.05) returned to sTYLz_23
sTYLz_23 collected $0.10 from pot
*** SUMMARY ***
Total pot $0.10 | Rake $0 
Seat 2: sTYLz_23 (big blind) collected ($0.10)
Seat 4: CashMatteo (button) (small blind) folded before Flop

Hand #2294: 

PokerStars Hand #250520818502:  Hold'em No Limit ($0.05/$0.10 CAD) - 2024/05/15 18:44:33 ET
Table 'Astronomia III' 6-max Seat #2 is the button
Seat 2: sTYLz_23 ($23.15 in chips) 
Seat 4: CashMatteo ($5.53 in chips) 
sTYLz_23: posts small blind $0.05
CashMatteo: posts big blind $0.10
*** HOLE CARDS ***
Dealt to CashMatteo [3d Kh]
sTYLz_23: calls $0.05
CashMatteo: checks 
*** FLOP *** [7h 8h 2s]
CashMatteo: checks 
sTYLz_23: checks 
*** TURN *** [7h 8h 2s] [3c]
CashMatteo: bets $0.20
sTYLz_23: folds 
Uncalled bet ($0.20) returned to CashMatteo
CashMatteo collected $0.19 from pot
CashMatteo: doesn't show hand 
*** SUMMARY ***
Total pot $0.20 | Rake $0.01 
Board [7h 8h 2s 3c]
Seat 2: sTYLz_23 (button) (small blind) folded on the Turn
Seat 4: CashMatteo (big blind) collected ($0.19)

Hand #2295: 

PokerStars Hand #250520823276:  Hold'em No Limit ($0.05/$0.10 CAD) - 2024/05/15 18:44:52 ET
Table 'Astronomia III' 6-max Seat #4 is the button
Seat 2: sTYLz_23 ($23.05 in chips) 
Seat 4: CashMatteo ($5.62 in chips) 
CashMatteo: posts small blind $0.05
sTYLz_23: posts big blind $0.10
*** HOLE CARDS ***
Dealt to CashMatteo [As Jh]
CashMatteo: raises $0.15 to $0.25
sTYLz_23: folds 
Uncalled bet ($0.15) returned to CashMatteo
CashMatteo collected $0.20 from pot
CashMatteo: doesn't show hand 
*** SUMMARY ***
Total pot $0.20 | Rake $0 
Seat 2: sTYLz_23 (big blind) folded before Flop
Seat 4: CashMatteo (button) (small blind) collected ($0.20)

Hand #2296: 

PokerStars Hand #250520826556:  Hold'em No Limit ($0.05/$0.10 CAD) - 2024/05/15 18:45:04 ET
Table 'Astronomia III' 6-max Seat #2 is the button
Seat 2: sTYLz_23 ($22.95 in chips) 
Seat 4: CashMatteo ($5.72 in chips) 
sTYLz_23: posts small blind $0.05
CashMatteo: posts big blind $0.10
*** HOLE CARDS ***
Dealt to CashMatteo [Ts 3d]
sTYLz_23: calls $0.05
CashMatteo: checks 
*** FLOP *** [6s 2d 4c]
CashMatteo: checks 
sTYLz_23: bets $0.20
CashMatteo: calls $0.20
*** TURN *** [6s 2d 4c] [9s]
CashMatteo: checks 
sTYLz_23: bets $0.30
CashMatteo: folds 
Uncalled bet ($0.30) returned to sTYLz_23
sTYLz_23 collected $0.57 from pot
*** SUMMARY ***
Total pot $0.60 | Rake $0.03 
Board [6s 2d 4c 9s]
Seat 2: sTYLz_23 (button) (small blind) collected ($0.57)
Seat 4: CashMatteo (big blind) folded on the Turn

Hand #2297: 

PokerStars Hand #250520833770:  Hold'em No Limit ($0.05/$0.10 CAD) - 2024/05/15 18:45:32 ET
Table 'Astronomia III' 6-max Seat #4 is the button
Seat 2: sTYLz_23 ($23.22 in chips) 
Seat 4: CashMatteo ($5.42 in chips) 
CashMatteo: posts small blind $0.05
sTYLz_23: posts big blind $0.10
*** HOLE CARDS ***
Dealt to CashMatteo [8c 2d]
CashMatteo: folds 
Uncalled bet ($0.05) returned to sTYLz_23
sTYLz_23 collected $0.10 from pot
*** SUMMARY ***
Total pot $0.10 | Rake $0 
Seat 2: sTYLz_23 (big blind) collected ($0.10)
Seat 4: CashMatteo (button) (small blind) folded before Flop

Hand #2298: 

PokerStars Hand #250520835517:  Hold'em No Limit ($0.05/$0.10 CAD) - 2024/05/15 18:45:38 ET
Table 'Astronomia III' 6-max Seat #2 is the button
Seat 2: sTYLz_23 ($23.27 in chips) 
Seat 4: CashMatteo ($5.37 in chips) 
sTYLz_23: posts small blind $0.05
CashMatteo: posts big blind $0.10
*** HOLE CARDS ***
Dealt to CashMatteo [Js Jc]
sTYLz_23: calls $0.05
CashMatteo: raises $0.15 to $0.25
sTYLz_23: calls $0.15
*** FLOP *** [Ac 4d 6c]
CashMatteo: checks 
sTYLz_23: checks 
*** TURN *** [Ac 4d 6c] [8d]
CashMatteo: bets $0.40
sTYLz_23: calls $0.40
*** RIVER *** [Ac 4d 6c 8d] [Qd]
CashMatteo: checks 
sTYLz_23: bets $0.50
CashMatteo: calls $0.50
*** SHOW DOWN ***
sTYLz_23: shows [7h Tc] (high card Ace)
CashMatteo: shows [Js Jc] (a pair of Jacks)
CashMatteo collected $2.20 from pot
*** SUMMARY ***
Total pot $2.30 | Rake $0.10 
Board [Ac 4d 6c 8d Qd]
Seat 2: sTYLz_23 (button) (small blind) showed [7h Tc] and lost with high card Ace
Seat 4: CashMatteo (big blind) showed [Js Jc] and won ($2.20) with a pair of Jacks

Hand #2299: 

PokerStars Hand #250520851344:  Hold'em No Limit ($0.05/$0.10 CAD) - 2024/05/15 18:46:40 ET
Table 'Astronomia III' 6-max Seat #4 is the button
Seat 2: sTYLz_23 ($22.12 in chips) 
Seat 4: CashMatteo ($6.42 in chips) 
CashMatteo: posts small blind $0.05
sTYLz_23: posts big blind $0.10
*** HOLE CARDS ***
Dealt to CashMatteo [3h Jc]
CashMatteo: folds 
Uncalled bet ($0.05) returned to sTYLz_23
sTYLz_23 collected $0.10 from pot
*** SUMMARY ***
Total pot $0.10 | Rake $0 
Seat 2: sTYLz_23 (big blind) collected ($0.10)
Seat 4: CashMatteo (button) (small blind) folded before Flop

Hand #2300: 

PokerStars Hand #250520853228:  Hold'em No Limit ($0.05/$0.10 CAD) - 2024/05/15 18:46:47 ET
Table 'Astronomia III' 6-max Seat #2 is the button
Seat 2: sTYLz_23 ($22.17 in chips) 
Seat 4: CashMatteo ($6.37 in chips) 
sTYLz_23: posts small blind $0.05
CashMatteo: posts big blind $0.10
*** HOLE CARDS ***
Dealt to CashMatteo [Kc 5d]
sTYLz_23: calls $0.05
CashMatteo: checks 
*** FLOP *** [Td 4d 8h]
CashMatteo: checks 
sTYLz_23: bets $0.10
CashMatteo: calls $0.10
*** TURN *** [Td 4d 8h] [7h]
CashMatteo: checks 
sTYLz_23: bets $0.30
CashMatteo: folds 
Uncalled bet ($0.30) returned to sTYLz_23
sTYLz_23 collected $0.38 from pot
*** SUMMARY ***
Total pot $0.40 | Rake $0.02 
Board [Td 4d 8h 7h]
Seat 2: sTYLz_23 (button) (small blind) collected ($0.38)
Seat 4: CashMatteo (big blind) folded on the Turn

Hand #2301: 

PokerStars Hand #250520859976:  Hold'em No Limit ($0.05/$0.10 CAD) - 2024/05/15 18:47:13 ET
Table 'Astronomia III' 6-max Seat #4 is the button
Seat 2: sTYLz_23 ($22.35 in chips) 
Seat 4: CashMatteo ($6.17 in chips) 
CashMatteo: posts small blind $0.05
sTYLz_23: posts big blind $0.10
*** HOLE CARDS ***
Dealt to CashMatteo [8h Tc]
CashMatteo: folds 
Uncalled bet ($0.05) returned to sTYLz_23
sTYLz_23 collected $0.10 from pot
*** SUMMARY ***
Total pot $0.10 | Rake $0 
Seat 2: sTYLz_23 (big blind) collected ($0.10)
Seat 4: CashMatteo (button) (small blind) folded before Flop

Hand #2302: 

PokerStars Hand #250520861529:  Hold'em No Limit ($0.05/$0.10 CAD) - 2024/05/15 18:47:19 ET
Table 'Astronomia III' 6-max Seat #2 is the button
Seat 2: sTYLz_23 ($22.40 in chips) 
Seat 4: CashMatteo ($6.12 in chips) 
sTYLz_23: posts small blind $0.05
CashMatteo: posts big blind $0.10
*** HOLE CARDS ***
Dealt to CashMatteo [8s 8c]
sTYLz_23: raises $0.20 to $0.30
kyang1010 joins the table at seat #5 
CashMatteo: raises $0.60 to $0.90
Washingbeard joins the table at seat #1 
sTYLz_23: calls $0.60
*** FLOP *** [Qs 4d 4h]
CashMatteo: checks 
sTYLz_23: checks 
*** TURN *** [Qs 4d 4h] [5d]
CashMatteo: bets $0.86
sTYLz_23: calls $0.86
*** RIVER *** [Qs 4d 4h 5d] [2s]
CashMatteo: checks 
sTYLz_23: checks 
*** SHOW DOWN ***
CashMatteo: shows [8s 8c] (two pair, Eights and Fours)
sTYLz_23: mucks hand 
CashMatteo collected $3.36 from pot
*** SUMMARY ***
Total pot $3.52 | Rake $0.16 
Board [Qs 4d 4h 5d 2s]
Seat 2: sTYLz_23 (button) (small blind) mucked [6s 6h]
Seat 4: CashMatteo (big blind) showed [8s 8c] and won ($3.36) with two pair, Eights and Fours

Hand #2303: 

PokerStars Hand #250520875727:  Hold'em No Limit ($0.05/$0.10 CAD) - 2024/05/15 18:48:14 ET
Table 'Astronomia III' 6-max Seat #2 is the button
Seat 2: sTYLz_23 ($20.64 in chips) 
Seat 4: CashMatteo ($7.72 in chips) 
Seat 5: kyang1010 ($5.41 in chips) 
CashMatteo: posts small blind $0.05
kyang1010: posts big blind $0.10
Washingbeard: sits out 
*** HOLE CARDS ***
Dealt to CashMatteo [3s 4h]
sTYLz_23: calls $0.10
CashMatteo: folds 
kyang1010: checks 
*** FLOP *** [3c 5c Qs]
kyang1010: checks 
sTYLz_23: checks 
*** TURN *** [3c 5c Qs] [Qh]
kyang1010: checks 
sTYLz_23: checks 
*** RIVER *** [3c 5c Qs Qh] [Tc]
kyang1010: checks 
bontyzoom joins the table at seat #3 
strondeau joins the table at seat #6 
sTYLz_23: checks 
*** SHOW DOWN ***
kyang1010: shows [7d Jh] (a pair of Queens)
sTYLz_23: shows [9d Jd] (a pair of Queens - Jack+Ten+Nine kicker)
sTYLz_23 collected $0.24 from pot
*** SUMMARY ***
Total pot $0.25 | Rake $0.01 
Board [3c 5c Qs Qh Tc]
Seat 2: sTYLz_23 (button) showed [9d Jd] and won ($0.24) with a pair of Queens
Seat 4: CashMatteo (small blind) folded before Flop
Seat 5: kyang1010 (big blind) showed [7d Jh] and lost with a pair of Queens

Hand #2304: 

PokerStars Hand #250520886317:  Hold'em No Limit ($0.05/$0.10 CAD) - 2024/05/15 18:48:54 ET
Table 'Astronomia III' 6-max Seat #4 is the button
Seat 2: sTYLz_23 ($20.78 in chips) 
Seat 4: CashMatteo ($7.67 in chips) 
Seat 5: kyang1010 ($5.31 in chips) 
Seat 6: strondeau ($10 in chips) 
kyang1010: posts small blind $0.05
strondeau: posts big blind $0.10
Washingbeard: sits out 
bontyzoom: sits out 
*** HOLE CARDS ***
Dealt to CashMatteo [9d Jd]
sTYLz_23: folds 
CashMatteo: raises $0.15 to $0.25
kyang1010: calls $0.20
strondeau: calls $0.15
*** FLOP *** [Kc Ah 2c]
kyang1010: bets $0.30
strondeau: calls $0.30
CashMatteo: calls $0.30
*** TURN *** [Kc Ah 2c] [2d]
bontyzoom leaves the table
kyang1010: checks 
strondeau: checks 
CashMatteo: checks 
*** RIVER *** [Kc Ah 2c 2d] [9s]
kyang1010: checks 
strondeau: checks 
CashMatteo: checks 
*** SHOW DOWN ***
kyang1010: shows [4c 3c] (a pair of Deuces)
strondeau: shows [4d 3d] (a pair of Deuces)
CashMatteo: shows [9d Jd] (two pair, Nines and Deuces)
CashMatteo collected $1.58 from pot
*** SUMMARY ***
Total pot $1.65 | Rake $0.07 
Board [Kc Ah 2c 2d 9s]
Seat 2: sTYLz_23 folded before Flop (didn't bet)
Seat 4: CashMatteo (button) showed [9d Jd] and won ($1.58) with two pair, Nines and Deuces
Seat 5: kyang1010 (small blind) showed [4c 3c] and lost with a pair of Deuces
Seat 6: strondeau (big blind) showed [4d 3d] and lost with a pair of Deuces

Hand #2305: 

PokerStars Hand #250520895985:  Hold'em No Limit ($0.05/$0.10 CAD) - 2024/05/15 18:49:32 ET
Table 'Astronomia III' 6-max Seat #5 is the button
Seat 1: Washingbeard ($10 in chips) 
Seat 2: sTYLz_23 ($20.78 in chips) 
Seat 4: CashMatteo ($8.70 in chips) 
Seat 5: kyang1010 ($4.76 in chips) 
Seat 6: strondeau ($9.45 in chips) 
strondeau: posts small blind $0.05
Washingbeard: posts big blind $0.10
*** HOLE CARDS ***
Dealt to CashMatteo [2s 5d]
sTYLz_23: folds 
CashMatteo: folds 
kyang1010: folds 
strondeau: calls $0.05
Washingbeard: checks 
*** FLOP *** [7c Qs 7d]
strondeau: bets $0.10
Washingbeard: folds 
Uncalled bet ($0.10) returned to strondeau
strondeau collected $0.19 from pot
*** SUMMARY ***
Total pot $0.20 | Rake $0.01 
Board [7c Qs 7d]
Seat 1: Washingbeard (big blind) folded on the Flop
Seat 2: sTYLz_23 folded before Flop (didn't bet)
Seat 4: CashMatteo folded before Flop (didn't bet)
Seat 5: kyang1010 (button) folded before Flop (didn't bet)
Seat 6: strondeau (small blind) collected ($0.19)

Hand #2306: 

PokerStars Hand #250520905208:  Hold'em No Limit ($0.05/$0.10 CAD) - 2024/05/15 18:50:08 ET
Table 'Astronomia III' 6-max Seat #6 is the button
Seat 1: Washingbeard ($9.90 in chips) 
Seat 2: sTYLz_23 ($20.78 in chips) 
Seat 4: CashMatteo ($8.70 in chips) 
Seat 5: kyang1010 ($4.76 in chips) 
Seat 6: strondeau ($9.54 in chips) 
Washingbeard: posts small blind $0.05
sTYLz_23: posts big blind $0.10
*** HOLE CARDS ***
Dealt to CashMatteo [8d Jh]
CashMatteo: raises $0.15 to $0.25
kyang1010: calls $0.25
strondeau: folds 
Washingbeard: calls $0.20
sTYLz_23: calls $0.15
*** FLOP *** [3s Qh Qs]
goodfun joins the table at seat #3 
Washingbeard: checks 
sTYLz_23: checks 
CashMatteo: checks 
kyang1010: checks 
*** TURN *** [3s Qh Qs] [5h]
Washingbeard: checks 
sTYLz_23: bets $0.40
CashMatteo: folds 
kyang1010: folds 
Washingbeard: calls $0.40
*** RIVER *** [3s Qh Qs 5h] [2c]
Washingbeard: bets $0.66
sTYLz_23: calls $0.66
*** SHOW DOWN ***
Washingbeard: shows [Kd Qd] (three of a kind, Queens)
sTYLz_23: mucks hand 
Washingbeard collected $2.98 from pot
*** SUMMARY ***
Total pot $3.12 | Rake $0.14 
Board [3s Qh Qs 5h 2c]
Seat 1: Washingbeard (small blind) showed [Kd Qd] and won ($2.98) with three of a kind, Queens
Seat 2: sTYLz_23 (big blind) mucked [6c 6s]
Seat 4: CashMatteo folded on the Turn
Seat 5: kyang1010 folded on the Turn
Seat 6: strondeau (button) folded before Flop (didn't bet)

Hand #2307: 

PokerStars Hand #250520921452:  Hold'em No Limit ($0.05/$0.10 CAD) - 2024/05/15 18:51:12 ET
Table 'Astronomia III' 6-max Seat #1 is the button
Seat 1: Washingbeard ($11.57 in chips) 
Seat 2: sTYLz_23 ($19.47 in chips) 
Seat 3: goodfun ($6.30 in chips) 
Seat 4: CashMatteo ($8.45 in chips) 
Seat 5: kyang1010 ($4.51 in chips) 
Seat 6: strondeau ($9.54 in chips) 
sTYLz_23: posts small blind $0.05
goodfun: posts big blind $0.10
*** HOLE CARDS ***
Dealt to CashMatteo [Kd 2h]
CashMatteo: folds 
kyang1010: folds 
strondeau: calls $0.10
Washingbeard: folds 
sTYLz_23: folds 
goodfun: checks 
*** FLOP *** [Ac Jh 5s]
goodfun: checks 
strondeau: bets $0.10
goodfun: calls $0.10
*** TURN *** [Ac Jh 5s] [Qd]
goodfun: checks 
strondeau: bets $0.20
goodfun: raises $0.20 to $0.40
strondeau: calls $0.20
*** RIVER *** [Ac Jh 5s Qd] [As]
goodfun: checks 
strondeau: bets $0.40
goodfun: calls $0.40
*** SHOW DOWN ***
strondeau: shows [7d Js] (two pair, Aces and Jacks)
goodfun: shows [7h Qs] (two pair, Aces and Queens)
goodfun collected $1.96 from pot
*** SUMMARY ***
Total pot $2.05 | Rake $0.09 
Board [Ac Jh 5s Qd As]
Seat 1: Washingbeard (button) folded before Flop (didn't bet)
Seat 2: sTYLz_23 (small blind) folded before Flop
Seat 3: goodfun (big blind) showed [7h Qs] and won ($1.96) with two pair, Aces and Queens
Seat 4: CashMatteo folded before Flop (didn't bet)
Seat 5: kyang1010 folded before Flop (didn't bet)
Seat 6: strondeau showed [7d Js] and lost with two pair, Aces and Jacks

Hand #2308: 

PokerStars Hand #250520935809:  Hold'em No Limit ($0.05/$0.10 CAD) - 2024/05/15 18:52:08 ET
Table 'Astronomia III' 6-max Seat #2 is the button
Seat 1: Washingbeard ($11.57 in chips) 
Seat 2: sTYLz_23 ($19.42 in chips) 
Seat 3: goodfun ($7.26 in chips) 
Seat 4: CashMatteo ($8.45 in chips) 
Seat 5: kyang1010 ($4.51 in chips) 
Seat 6: strondeau ($8.54 in chips) 
goodfun: posts small blind $0.05
CashMatteo: posts big blind $0.10
*** HOLE CARDS ***
Dealt to CashMatteo [Kh Jd]
kyang1010: calls $0.10
strondeau: calls $0.10
Washingbeard: calls $0.10
sTYLz_23: folds 
goodfun: folds 
CashMatteo: raises $0.15 to $0.25
kyang1010: calls $0.15
strondeau: calls $0.15
Washingbeard: calls $0.15
*** FLOP *** [Ts 9h Jh]
CashMatteo: bets $0.50
kyang1010: folds 
strondeau: folds 
Washingbeard: calls $0.50
*** TURN *** [Ts 9h Jh] [5s]
CashMatteo: bets $1.28
Washingbeard: folds 
Uncalled bet ($1.28) returned to CashMatteo
CashMatteo collected $1.96 from pot
CashMatteo: doesn't show hand 
*** SUMMARY ***
Total pot $2.05 | Rake $0.09 
Board [Ts 9h Jh 5s]
Seat 1: Washingbeard folded on the Turn
Seat 2: sTYLz_23 (button) folded before Flop (didn't bet)
Seat 3: goodfun (small blind) folded before Flop
Seat 4: CashMatteo (big blind) collected ($1.96)
Seat 5: kyang1010 folded on the Flop
Seat 6: strondeau folded on the Flop

Hand #2309: 

PokerStars Hand #250520949750:  Hold'em No Limit ($0.05/$0.10 CAD) - 2024/05/15 18:53:04 ET
Table 'Astronomia III' 6-max Seat #3 is the button
Seat 1: Washingbeard ($10.82 in chips) 
Seat 2: sTYLz_23 ($19.42 in chips) 
Seat 3: goodfun ($7.21 in chips) 
Seat 4: CashMatteo ($9.66 in chips) 
Seat 5: kyang1010 ($4.26 in chips) 
Seat 6: strondeau ($8.29 in chips) 
CashMatteo: posts small blind $0.05
kyang1010: posts big blind $0.10
*** HOLE CARDS ***
Dealt to CashMatteo [Tc Ad]
strondeau: calls $0.10
Washingbeard: folds 
sTYLz_23: folds 
goodfun: folds 
CashMatteo: raises $0.15 to $0.25
kyang1010: raises $0.65 to $0.90
strondeau: folds 
CashMatteo: calls $0.65
*** FLOP *** [2h As 7s]
CashMatteo: checks 
kyang1010: bets $0.91
CashMatteo: calls $0.91
*** TURN *** [2h As 7s] [2d]
CashMatteo: checks 
kyang1010: checks 
*** RIVER *** [2h As 7s 2d] [4c]
CashMatteo: bets $1.98
kyang1010: calls $1.98
*** SHOW DOWN ***
CashMatteo: shows [Tc Ad] (two pair, Aces and Deuces)
kyang1010: mucks hand 
CashMatteo collected $7.33 from pot
*** SUMMARY ***
Total pot $7.68 | Rake $0.35 
Board [2h As 7s 2d 4c]
Seat 1: Washingbeard folded before Flop (didn't bet)
Seat 2: sTYLz_23 folded before Flop (didn't bet)
Seat 3: goodfun (button) folded before Flop (didn't bet)
Seat 4: CashMatteo (small blind) showed [Tc Ad] and won ($7.33) with two pair, Aces and Deuces
Seat 5: kyang1010 (big blind) mucked [9s 9h]
Seat 6: strondeau folded before Flop

Hand #2310: 

PokerStars Hand #250520968326:  Hold'em No Limit ($0.05/$0.10 CAD) - 2024/05/15 18:54:18 ET
Table 'Astronomia III' 6-max Seat #4 is the button
Seat 1: Washingbeard ($10.82 in chips) 
Seat 2: sTYLz_23 ($19.42 in chips) 
Seat 3: goodfun ($7.21 in chips) 
Seat 4: CashMatteo ($13.20 in chips) 
Seat 5: kyang1010 ($0.47 in chips) 
Seat 6: strondeau ($8.19 in chips) 
kyang1010: posts small blind $0.05
strondeau: posts big blind $0.10
*** HOLE CARDS ***
Dealt to CashMatteo [5d Tc]
Washingbeard: folds 
sTYLz_23: folds 
goodfun: raises $0.25 to $0.35
CashMatteo: folds 
kyang1010: folds 
strondeau: calls $0.25
*** FLOP *** [2d 6s 8d]
strondeau: bets $0.10
goodfun: calls $0.10
*** TURN *** [2d 6s 8d] [7s]
strondeau: bets $0.10
goodfun: raises $0.56 to $0.66
strondeau: calls $0.56
*** RIVER *** [2d 6s 8d 7s] [Jc]
strondeau: checks 
goodfun: checks 
*** SHOW DOWN ***
strondeau: shows [Kd 4d] (high card King)
goodfun: shows [Qc Qh] (a pair of Queens)
goodfun collected $2.17 from pot
*** SUMMARY ***
Total pot $2.27 | Rake $0.10 
Board [2d 6s 8d 7s Jc]
Seat 1: Washingbeard folded before Flop (didn't bet)
Seat 2: sTYLz_23 folded before Flop (didn't bet)
Seat 3: goodfun showed [Qc Qh] and won ($2.17) with a pair of Queens
Seat 4: CashMatteo (button) folded before Flop (didn't bet)
Seat 5: kyang1010 (small blind) folded before Flop
Seat 6: strondeau (big blind) showed [Kd 4d] and lost with high card King

Hand #2311: 

PokerStars Hand #250520983459:  Hold'em No Limit ($0.05/$0.10 CAD) - 2024/05/15 18:55:19 ET
Table 'Astronomia III' 6-max Seat #5 is the button
Seat 1: Washingbeard ($10.82 in chips) 
Seat 2: sTYLz_23 ($19.42 in chips) 
Seat 3: goodfun ($8.27 in chips) 
Seat 4: CashMatteo ($13.20 in chips) 
Seat 5: kyang1010 ($0.42 in chips) 
Seat 6: strondeau ($7.08 in chips) 
strondeau: posts small blind $0.05
Washingbeard: posts big blind $0.10
*** HOLE CARDS ***
Dealt to CashMatteo [Tc 6c]
sTYLz_23: folds 
goodfun: folds 
CashMatteo: folds 
kyang1010: calls $0.10
strondeau: calls $0.05
Washingbeard: checks 
*** FLOP *** [3d 5s 2c]
strondeau: checks 
Washingbeard: checks 
kyang1010: checks 
*** TURN *** [3d 5s 2c] [4s]
strondeau: checks 
Washingbeard: checks 
kyang1010: checks 
*** RIVER *** [3d 5s 2c 4s] [8c]
strondeau: checks 
Washingbeard: bets $0.40
kyang1010: calls $0.32 and is all-in
strondeau: folds 
Uncalled bet ($0.08) returned to Washingbeard
*** SHOW DOWN ***
Washingbeard: shows [8d Ac] (a straight, Ace to Five)
kyang1010: shows [8s 9c] (a pair of Eights)
Washingbeard collected $0.90 from pot
*** SUMMARY ***
Total pot $0.94 | Rake $0.04 
Board [3d 5s 2c 4s 8c]
Seat 1: Washingbeard (big blind) showed [8d Ac] and won ($0.90) with a straight, Ace to Five
Seat 2: sTYLz_23 folded before Flop (didn't bet)
Seat 3: goodfun folded before Flop (didn't bet)
Seat 4: CashMatteo folded before Flop (didn't bet)
Seat 5: kyang1010 (button) showed [8s 9c] and lost with a pair of Eights
Seat 6: strondeau (small blind) folded on the River

Hand #2312: 

PokerStars Hand #250520993929:  Hold'em No Limit ($0.05/$0.10 CAD) - 2024/05/15 18:56:15 ET
Table 'Astronomia III' 6-max Seat #6 is the button
Seat 1: Washingbeard ($11.30 in chips) 
Seat 2: sTYLz_23 ($19.42 in chips) 
Seat 3: goodfun ($8.27 in chips) 
Seat 4: CashMatteo ($13.20 in chips) 
Seat 6: strondeau ($6.98 in chips) 
Washingbeard: posts small blind $0.05
kyang1010 leaves the table
sTYLz_23: posts big blind $0.10
*** HOLE CARDS ***
Dealt to CashMatteo [Ts 7h]
goodfun: folds 
The Burnzeeto joins the table at seat #5 
CashMatteo: folds 
strondeau: calls $0.10
Washingbeard: folds 
sTYLz_23: checks 
*** FLOP *** [8s As 4d]
sTYLz_23: checks 
strondeau: checks 
*** TURN *** [8s As 4d] [Ah]
sTYLz_23: checks 
strondeau: checks 
*** RIVER *** [8s As 4d Ah] [Kc]
sTYLz_23: bets $0.20
strondeau: calls $0.20
*** SHOW DOWN ***
sTYLz_23: shows [5h 2d] (a pair of Aces)
strondeau: shows [3d Kh] (two pair, Aces and Kings)
strondeau collected $0.62 from pot
*** SUMMARY ***
Total pot $0.65 | Rake $0.03 
Board [8s As 4d Ah Kc]
Seat 1: Washingbeard (small blind) folded before Flop
Seat 2: sTYLz_23 (big blind) showed [5h 2d] and lost with a pair of Aces
Seat 3: goodfun folded before Flop (didn't bet)
Seat 4: CashMatteo folded before Flop (didn't bet)
Seat 6: strondeau (button) showed [3d Kh] and won ($0.62) with two pair, Aces and Kings

Hand #2313: 

PokerStars Hand #250520999049:  Hold'em No Limit ($0.05/$0.10 CAD) - 2024/05/15 18:56:42 ET
Table 'Astronomia III' 6-max Seat #1 is the button
Seat 1: Washingbeard ($11.25 in chips) 
Seat 2: sTYLz_23 ($19.12 in chips) 
Seat 3: goodfun ($8.27 in chips) 
Seat 4: CashMatteo ($13.20 in chips) 
Seat 6: strondeau ($7.30 in chips) 
sTYLz_23: posts small blind $0.05
goodfun: posts big blind $0.10
The Burnzeeto: sits out 
*** HOLE CARDS ***
Dealt to CashMatteo [Js 6c]
CashMatteo: folds 
strondeau: folds 
Washingbeard: raises $0.10 to $0.20
sTYLz_23: folds 
goodfun: raises $0.50 to $0.70
Washingbeard: calls $0.50
*** FLOP *** [Qh 4h 3d]
goodfun: bets $0.70
Washingbeard: calls $0.70
*** TURN *** [Qh 4h 3d] [8c]
goodfun: checks 
Washingbeard: checks 
*** RIVER *** [Qh 4h 3d 8c] [Ad]
goodfun: checks 
Washingbeard: bets $0.66
goodfun: calls $0.66
*** SHOW DOWN ***
Washingbeard: shows [8d 8s] (three of a kind, Eights)
goodfun: mucks hand 
Washingbeard collected $3.98 from pot
*** SUMMARY ***
Total pot $4.17 | Rake $0.19 
Board [Qh 4h 3d 8c Ad]
Seat 1: Washingbeard (button) showed [8d 8s] and won ($3.98) with three of a kind, Eights
Seat 2: sTYLz_23 (small blind) folded before Flop
Seat 3: goodfun (big blind) mucked [Tc Ac]
Seat 4: CashMatteo folded before Flop (didn't bet)
Seat 6: strondeau folded before Flop (didn't bet)

Hand #2314: 

PokerStars Hand #250521008071:  Hold'em No Limit ($0.05/$0.10 CAD) - 2024/05/15 18:57:29 ET
Table 'Astronomia III' 6-max Seat #2 is the button
Seat 1: Washingbeard ($13.17 in chips) 
Seat 2: sTYLz_23 ($19.07 in chips) 
Seat 3: goodfun ($6.21 in chips) 
Seat 4: CashMatteo ($13.20 in chips) 
Seat 6: strondeau ($7.30 in chips) 
goodfun: posts small blind $0.05
CashMatteo: posts big blind $0.10
The Burnzeeto: sits out 
*** HOLE CARDS ***
Dealt to CashMatteo [2c 3s]
strondeau: calls $0.10
Washingbeard: folds 
sTYLz_23: calls $0.10
goodfun: folds 
CashMatteo: checks 
*** FLOP *** [6c 4s Js]
CashMatteo: checks 
strondeau: checks 
sTYLz_23: bets $0.20
CashMatteo: folds 
strondeau: calls $0.20
*** TURN *** [6c 4s Js] [7d]
strondeau: bets $0.20
sTYLz_23: raises $1.12 to $1.32
strondeau: calls $1.12
*** RIVER *** [6c 4s Js 7d] [As]
strondeau: checks 
sTYLz_23: checks 
*** SHOW DOWN ***
strondeau: shows [Jc 8h] (a pair of Jacks)
sTYLz_23: shows [7s 6d] (two pair, Sevens and Sixes)
sTYLz_23 collected $3.24 from pot
*** SUMMARY ***
Total pot $3.39 | Rake $0.15 
Board [6c 4s Js 7d As]
Seat 1: Washingbeard folded before Flop (didn't bet)
Seat 2: sTYLz_23 (button) showed [7s 6d] and won ($3.24) with two pair, Sevens and Sixes
Seat 3: goodfun (small blind) folded before Flop
Seat 4: CashMatteo (big blind) folded on the Flop
Seat 6: strondeau showed [Jc 8h] and lost with a pair of Jacks

Hand #2315: 

PokerStars Hand #250521020413:  Hold'em No Limit ($0.05/$0.10 CAD) - 2024/05/15 18:58:33 ET
Table 'Astronomia III' 6-max Seat #3 is the button
Seat 1: Washingbeard ($13.17 in chips) 
Seat 2: sTYLz_23 ($20.69 in chips) 
Seat 3: goodfun ($6.16 in chips) 
Seat 4: CashMatteo ($13.10 in chips) 
Seat 5: The Burnzeeto ($10 in chips) 
Seat 6: strondeau ($5.68 in chips) 
CashMatteo: posts small blind $0.05
The Burnzeeto: posts big blind $0.10
*** HOLE CARDS ***
Dealt to CashMatteo [Qs 5s]
strondeau: raises $0.10 to $0.20
Washingbeard: calls $0.20
sTYLz_23: folds 
goodfun: calls $0.20
CashMatteo: calls $0.15
The Burnzeeto: calls $0.10
*** FLOP *** [4s 7c 5h]
CashMatteo: checks 
The Burnzeeto: checks 
strondeau: checks 
Washingbeard: checks 
goodfun: bets $0.50
CashMatteo: calls $0.50
The Burnzeeto: folds 
strondeau: folds 
Washingbeard: calls $0.50
*** TURN *** [4s 7c 5h] [3c]
CashMatteo: checks 
Washingbeard: checks 
goodfun: checks 
*** RIVER *** [4s 7c 5h 3c] [7s]
CashMatteo: checks 
Washingbeard: bets $1.40
goodfun: calls $1.40
CashMatteo: folds 
*** SHOW DOWN ***
Washingbeard: shows [8c Ac] (a pair of Sevens)
goodfun: shows [5c 2c] (two pair, Sevens and Fives)
goodfun collected $5.06 from pot
*** SUMMARY ***
Total pot $5.30 | Rake $0.24 
Board [4s 7c 5h 3c 7s]
Seat 1: Washingbeard showed [8c Ac] and lost with a pair of Sevens
Seat 2: sTYLz_23 folded before Flop (didn't bet)
Seat 3: goodfun (button) showed [5c 2c] and won ($5.06) with two pair, Sevens and Fives
Seat 4: CashMatteo (small blind) folded on the River
Seat 5: The Burnzeeto (big blind) folded on the Flop
Seat 6: strondeau folded on the Flop

Hand #2316: 

PokerStars Hand #250521035384:  Hold'em No Limit ($0.05/$0.10 CAD) - 2024/05/15 18:59:52 ET
Table 'Astronomia III' 6-max Seat #4 is the button
Seat 1: Washingbeard ($11.07 in chips) 
Seat 2: sTYLz_23 ($20.69 in chips) 
Seat 3: goodfun ($9.12 in chips) 
Seat 4: CashMatteo ($12.40 in chips) 
Seat 5: The Burnzeeto ($10 in chips) 
Seat 6: strondeau ($9.80 in chips) 
The Burnzeeto: posts small blind $0.05
strondeau: posts big blind $0.10
*** HOLE CARDS ***
Dealt to CashMatteo [5s Ah]
Washingbeard: folds 
sTYLz_23: calls $0.10
goodfun: folds 
CashMatteo: calls $0.10
The Burnzeeto: folds 
strondeau: checks 
*** FLOP *** [5d 7s 4c]
strondeau: checks 
sTYLz_23: checks 
CashMatteo: bets $0.17
strondeau: calls $0.17
sTYLz_23: folds 
*** TURN *** [5d 7s 4c] [Ks]
strondeau: checks 
CashMatteo: checks 
*** RIVER *** [5d 7s 4c Ks] [2s]
strondeau: checks 
CashMatteo: checks 
*** SHOW DOWN ***
strondeau: shows [7d Ts] (a pair of Sevens)
CashMatteo: mucks hand 
strondeau collected $0.66 from pot
*** SUMMARY ***
Total pot $0.69 | Rake $0.03 
Board [5d 7s 4c Ks 2s]
Seat 1: Washingbeard folded before Flop (didn't bet)
Seat 2: sTYLz_23 folded on the Flop
Seat 3: goodfun folded before Flop (didn't bet)
Seat 4: CashMatteo (button) mucked [5s Ah]
Seat 5: The Burnzeeto (small blind) folded before Flop
Seat 6: strondeau (big blind) showed [7d Ts] and won ($0.66) with a pair of Sevens

Hand #2317: 

PokerStars Hand #250521047159:  Hold'em No Limit ($0.05/$0.10 CAD) - 2024/05/15 19:00:51 ET
Table 'Astronomia III' 6-max Seat #5 is the button
Seat 1: Washingbeard ($11.07 in chips) 
Seat 2: sTYLz_23 ($20.59 in chips) 
Seat 4: CashMatteo ($12.13 in chips) 
Seat 5: The Burnzeeto ($10 in chips) 
Seat 6: strondeau ($10.19 in chips) 
strondeau: posts small blind $0.05
Washingbeard: posts big blind $0.10
*** HOLE CARDS ***
Dealt to CashMatteo [9s Jh]
sTYLz_23: folds 
CashMatteo: raises $0.15 to $0.25
The Burnzeeto: folds 
strondeau: calls $0.20
Washingbeard: folds 
*** FLOP *** [9h 2h 5d]
strondeau: checks 
CashMatteo: bets $0.39
strondeau: calls $0.39
*** TURN *** [9h 2h 5d] [Jc]
strondeau: checks 
CashMatteo: bets $0.86
strondeau: folds 
Uncalled bet ($0.86) returned to CashMatteo
CashMatteo collected $1.32 from pot
CashMatteo: doesn't show hand 
*** SUMMARY ***
Total pot $1.38 | Rake $0.06 
Board [9h 2h 5d Jc]
Seat 1: Washingbeard (big blind) folded before Flop
Seat 2: sTYLz_23 folded before Flop (didn't bet)
Seat 4: CashMatteo collected ($1.32)
Seat 5: The Burnzeeto (button) folded before Flop (didn't bet)
Seat 6: strondeau (small blind) folded on the Turn

Hand #2318: 

PokerStars Hand #250521055898:  Hold'em No Limit ($0.05/$0.10 CAD) - 2024/05/15 19:01:31 ET
Table 'Astronomia III' 6-max Seat #6 is the button
Seat 1: Washingbeard ($10.97 in chips) 
Seat 2: sTYLz_23 ($20.59 in chips) 
Seat 4: CashMatteo ($12.81 in chips) 
Seat 5: The Burnzeeto ($10 in chips) 
Seat 6: strondeau ($9.55 in chips) 
Washingbeard: posts small blind $0.05
sTYLz_23: posts big blind $0.10
*** HOLE CARDS ***
Dealt to CashMatteo [Qd 2s]
CashMatteo: folds 
The Burnzeeto: folds 
strondeau: calls $0.10
Washingbeard: calls $0.05
sTYLz_23: checks 
*** FLOP *** [8c 3c 4h]
Washingbeard: checks 
sTYLz_23: bets $0.20
strondeau: calls $0.20
Washingbeard: calls $0.20
*** TURN *** [8c 3c 4h] [8d]
Washingbeard: checks 
sTYLz_23: bets $0.50
strondeau: calls $0.50
Washingbeard: folds 
*** RIVER *** [8c 3c 4h 8d] [5c]
sTYLz_23: checks 
strondeau: checks 
*** SHOW DOWN ***
sTYLz_23: shows [Ks 8h] (three of a kind, Eights)
strondeau: mucks hand 
sTYLz_23 collected $1.81 from pot
*** SUMMARY ***
Total pot $1.90 | Rake $0.09 
Board [8c 3c 4h 8d 5c]
Seat 1: Washingbeard (small blind) folded on the Turn
Seat 2: sTYLz_23 (big blind) showed [Ks 8h] and won ($1.81) with three of a kind, Eights
Seat 4: CashMatteo folded before Flop (didn't bet)
Seat 5: The Burnzeeto folded before Flop (didn't bet)
Seat 6: strondeau (button) mucked [7d 7h]

Hand #2319: 

PokerStars Hand #250521068851:  Hold'em No Limit ($0.05/$0.10 CAD) - 2024/05/15 19:02:26 ET
Table 'Astronomia III' 6-max Seat #1 is the button
Seat 1: Washingbeard ($10.67 in chips) 
Seat 2: sTYLz_23 ($21.60 in chips) 
Seat 3: goodfun ($9.12 in chips) 
Seat 4: CashMatteo ($12.81 in chips) 
Seat 5: The Burnzeeto ($10 in chips) 
Seat 6: strondeau ($8.75 in chips) 
sTYLz_23: posts small blind $0.05
goodfun: posts big blind $0.10
*** HOLE CARDS ***
Dealt to CashMatteo [2c 7h]
CashMatteo: folds 
The Burnzeeto has timed out
The Burnzeeto: folds 
strondeau: folds 
Washingbeard: folds 
sTYLz_23: calls $0.05
goodfun: checks 
*** FLOP *** [Ts Td Ah]
sTYLz_23: checks 
goodfun: checks 
*** TURN *** [Ts Td Ah] [8h]
sTYLz_23: bets $0.10
goodfun: folds 
Uncalled bet ($0.10) returned to sTYLz_23
sTYLz_23 collected $0.19 from pot
*** SUMMARY ***
Total pot $0.20 | Rake $0.01 
Board [Ts Td Ah 8h]
Seat 1: Washingbeard (button) folded before Flop (didn't bet)
Seat 2: sTYLz_23 (small blind) collected ($0.19)
Seat 3: goodfun (big blind) folded on the Turn
Seat 4: CashMatteo folded before Flop (didn't bet)
Seat 5: The Burnzeeto folded before Flop (didn't bet)
Seat 6: strondeau folded before Flop (didn't bet)

Hand #2320: 

PokerStars Hand #250521080999:  Hold'em No Limit ($0.05/$0.10 CAD) - 2024/05/15 19:03:16 ET
Table 'Astronomia III' 6-max Seat #2 is the button
Seat 1: Washingbeard ($10.67 in chips) 
Seat 2: sTYLz_23 ($21.69 in chips) 
Seat 3: goodfun ($9.02 in chips) 
Seat 4: CashMatteo ($12.81 in chips) 
Seat 6: strondeau ($8.75 in chips) 
goodfun: posts small blind $0.05
CashMatteo: posts big blind $0.10
*** HOLE CARDS ***
Dealt to CashMatteo [7d Kc]
strondeau: calls $0.10
Washingbeard: folds 
sTYLz_23: calls $0.10
goodfun: folds 
CashMatteo: checks 
*** FLOP *** [Th 4h 7s]
CashMatteo: bets $0.10
strondeau: calls $0.10
sTYLz_23: folds 
*** TURN *** [Th 4h 7s] [Ad]
CashMatteo: checks 
strondeau: checks 
*** RIVER *** [Th 4h 7s Ad] [As]
CashMatteo: bets $0.37
strondeau: folds 
Uncalled bet ($0.37) returned to CashMatteo
CashMatteo collected $0.53 from pot
CashMatteo: doesn't show hand 
*** SUMMARY ***
Total pot $0.55 | Rake $0.02 
Board [Th 4h 7s Ad As]
Seat 1: Washingbeard folded before Flop (didn't bet)
Seat 2: sTYLz_23 (button) folded on the Flop
Seat 3: goodfun (small blind) folded before Flop
Seat 4: CashMatteo (big blind) collected ($0.53)
Seat 6: strondeau folded on the River

Hand #2321: 

PokerStars Hand #250521091692:  Hold'em No Limit ($0.05/$0.10 CAD) - 2024/05/15 19:04:00 ET
Table 'Astronomia III' 6-max Seat #3 is the button
Seat 1: Washingbeard ($10.67 in chips) 
Seat 2: sTYLz_23 ($21.59 in chips) 
Seat 3: goodfun ($8.97 in chips) 
Seat 4: CashMatteo ($13.14 in chips) 
Seat 5: The Burnzeeto ($10 in chips) 
Seat 6: strondeau ($8.55 in chips) 
CashMatteo: posts small blind $0.05
The Burnzeeto: posts big blind $0.10
*** HOLE CARDS ***
Dealt to CashMatteo [Qc 5h]
strondeau: calls $0.10
Washingbeard: folds 
sTYLz_23: folds 
goodfun: calls $0.10
CashMatteo: folds 
The Burnzeeto: checks 
*** FLOP *** [Qs 8c 2s]
The Burnzeeto: checks 
strondeau: checks 
goodfun: checks 
*** TURN *** [Qs 8c 2s] [8h]
The Burnzeeto: checks 
strondeau: checks 
goodfun: checks 
*** RIVER *** [Qs 8c 2s 8h] [Tc]
The Burnzeeto: checks 
strondeau: checks 
goodfun: checks 
*** SHOW DOWN ***
The Burnzeeto: shows [Ad 2h] (two pair, Eights and Deuces)
strondeau: mucks hand 
goodfun: mucks hand 
The Burnzeeto collected $0.33 from pot
*** SUMMARY ***
Total pot $0.35 | Rake $0.02 
Board [Qs 8c 2s 8h Tc]
Seat 1: Washingbeard folded before Flop (didn't bet)
Seat 2: sTYLz_23 folded before Flop (didn't bet)
Seat 3: goodfun (button) mucked [Jc 4c]
Seat 4: CashMatteo (small blind) folded before Flop
Seat 5: The Burnzeeto (big blind) showed [Ad 2h] and won ($0.33) with two pair, Eights and Deuces
Seat 6: strondeau mucked [6c Kc]

Hand #2322: 

PokerStars Hand #250521102789:  Hold'em No Limit ($0.05/$0.10 CAD) - 2024/05/15 19:04:46 ET
Table 'Astronomia III' 6-max Seat #4 is the button
Seat 1: Washingbeard ($10.67 in chips) 
Seat 2: sTYLz_23 ($21.59 in chips) 
Seat 3: goodfun ($8.87 in chips) 
Seat 4: CashMatteo ($13.09 in chips) 
Seat 5: The Burnzeeto ($10.23 in chips) 
Seat 6: strondeau ($8.45 in chips) 
The Burnzeeto: posts small blind $0.05
strondeau: posts big blind $0.10
*** HOLE CARDS ***
Dealt to CashMatteo [Qc 7c]
Washingbeard: folds 
sTYLz_23: raises $0.25 to $0.35
goodfun: folds 
CashMatteo: calls $0.35
The Burnzeeto: folds 
strondeau: calls $0.25
*** FLOP *** [2h 5d Kh]
strondeau: checks 
sTYLz_23: bets $1.15
CashMatteo: folds 
strondeau: calls $1.15
*** TURN *** [2h 5d Kh] [Qh]
strondeau: checks 
sTYLz_23: bets $20.09 and is all-in
strondeau: folds 
Uncalled bet ($20.09) returned to sTYLz_23
sTYLz_23 collected $3.25 from pot
*** SUMMARY ***
Total pot $3.40 | Rake $0.15 
Board [2h 5d Kh Qh]
Seat 1: Washingbeard folded before Flop (didn't bet)
Seat 2: sTYLz_23 collected ($3.25)
Seat 3: goodfun folded before Flop (didn't bet)
Seat 4: CashMatteo (button) folded on the Flop
Seat 5: The Burnzeeto (small blind) folded before Flop
Seat 6: strondeau (big blind) folded on the Turn

Hand #2323: 

PokerStars Hand #250521114474:  Hold'em No Limit ($0.05/$0.10 CAD) - 2024/05/15 19:05:33 ET
Table 'Astronomia III' 6-max Seat #5 is the button
Seat 1: Washingbeard ($10.67 in chips) 
Seat 2: sTYLz_23 ($23.34 in chips) 
Seat 3: goodfun ($8.87 in chips) 
Seat 4: CashMatteo ($12.74 in chips) 
Seat 5: The Burnzeeto ($10.18 in chips) 
Seat 6: strondeau ($6.95 in chips) 
strondeau: posts small blind $0.05
Washingbeard: posts big blind $0.10
*** HOLE CARDS ***
Dealt to CashMatteo [5h As]
sTYLz_23: folds 
goodfun: raises $0.10 to $0.20
CashMatteo: calls $0.20
The Burnzeeto: calls $0.20
strondeau: calls $0.15
Washingbeard: calls $0.10
*** FLOP *** [Jh Jd Th]
strondeau: bets $0.20
Washingbeard: folds 
goodfun: folds 
CashMatteo: folds 
The Burnzeeto: calls $0.20
*** TURN *** [Jh Jd Th] [Ac]
strondeau: bets $0.30
The Burnzeeto: raises $0.96 to $1.26
strondeau: calls $0.96
*** RIVER *** [Jh Jd Th Ac] [Qs]
strondeau: bets $5.29 and is all-in
The Burnzeeto: calls $5.29
*** SHOW DOWN ***
strondeau: shows [Td Kd] (a straight, Ten to Ace)
The Burnzeeto: shows [Qh Jc] (a full house, Jacks full of Queens)
The Burnzeeto collected $13.85 from pot
*** SUMMARY ***
Total pot $14.50 | Rake $0.65 
Board [Jh Jd Th Ac Qs]
Seat 1: Washingbeard (big blind) folded on the Flop
Seat 2: sTYLz_23 folded before Flop (didn't bet)
Seat 3: goodfun folded on the Flop
Seat 4: CashMatteo folded on the Flop
Seat 5: The Burnzeeto (button) showed [Qh Jc] and won ($13.85) with a full house, Jacks full of Queens
Seat 6: strondeau (small blind) showed [Td Kd] and lost with a straight, Ten to Ace

Hand #2324: 

PokerStars Hand #250521128995:  Hold'em No Limit ($0.05/$0.10 CAD) - 2024/05/15 19:06:33 ET
Table 'Astronomia III' 6-max Seat #1 is the button
Seat 1: Washingbeard ($10.47 in chips) 
Seat 2: sTYLz_23 ($23.34 in chips) 
Seat 3: goodfun ($8.67 in chips) 
Seat 4: CashMatteo ($12.54 in chips) 
Seat 5: The Burnzeeto ($17.08 in chips) 
sTYLz_23: posts small blind $0.05
goodfun: posts big blind $0.10
*** HOLE CARDS ***
Dealt to CashMatteo [4h 4c]
CashMatteo: calls $0.10
The Burnzeeto: raises $0.20 to $0.30
Washingbeard: calls $0.30
sTYLz_23: folds 
goodfun: folds 
CashMatteo: calls $0.20
*** FLOP *** [Tc 9d 9c]
CashMatteo: checks 
The Burnzeeto: checks 
Washingbeard: bets $0.50
CashMatteo: folds 
The Burnzeeto: calls $0.50
*** TURN *** [Tc 9d 9c] [7s]
The Burnzeeto: checks 
Washingbeard: bets $1.46
The Burnzeeto: folds 
Uncalled bet ($1.46) returned to Washingbeard
Washingbeard collected $1.96 from pot
Washingbeard: doesn't show hand 
*** SUMMARY ***
Total pot $2.05 | Rake $0.09 
Board [Tc 9d 9c 7s]
Seat 1: Washingbeard (button) collected ($1.96)
Seat 2: sTYLz_23 (small blind) folded before Flop
Seat 3: goodfun (big blind) folded before Flop
Seat 4: CashMatteo folded on the Flop
Seat 5: The Burnzeeto folded on the Turn

Hand #2325: 

PokerStars Hand #250521142945:  Hold'em No Limit ($0.05/$0.10 CAD) - 2024/05/15 19:07:31 ET
Table 'Astronomia III' 6-max Seat #2 is the button
Seat 1: Washingbeard ($11.63 in chips) 
Seat 2: sTYLz_23 ($23.29 in chips) 
Seat 3: goodfun ($8.57 in chips) 
Seat 4: CashMatteo ($12.24 in chips) 
Seat 5: The Burnzeeto ($16.28 in chips) 
Seat 6: strondeau ($10 in chips) 
goodfun: posts small blind $0.05
CashMatteo: posts big blind $0.10
*** HOLE CARDS ***
Dealt to CashMatteo [Ks 2c]
The Burnzeeto: raises $0.20 to $0.30
strondeau: calls $0.30
Washingbeard: folds 
sTYLz_23: folds 
goodfun: calls $0.25
CashMatteo: folds 
*** FLOP *** [4c 7c 8d]
goodfun: bets $0.25
The Burnzeeto: calls $0.25
strondeau: calls $0.25
*** TURN *** [4c 7c 8d] [6s]
goodfun: bets $8.02 and is all-in
The Burnzeeto: folds 
strondeau: calls $8.02
*** RIVER *** [4c 7c 8d 6s] [2s]
*** SHOW DOWN ***
goodfun: shows [9h Tc] (a straight, Six to Ten)
strondeau: shows [5d 5h] (a straight, Four to Eight)
goodfun collected $16.99 from pot
*** SUMMARY ***
Total pot $17.79 | Rake $0.80 
Board [4c 7c 8d 6s 2s]
Seat 1: Washingbeard folded before Flop (didn't bet)
Seat 2: sTYLz_23 (button) folded before Flop (didn't bet)
Seat 3: goodfun (small blind) showed [9h Tc] and won ($16.99) with a straight, Six to Ten
Seat 4: CashMatteo (big blind) folded before Flop
Seat 5: The Burnzeeto folded on the Turn
Seat 6: strondeau showed [5d 5h] and lost with a straight, Four to Eight

Hand #2326: 

PokerStars Hand #250521160286:  Hold'em No Limit ($0.05/$0.10 CAD) - 2024/05/15 19:08:42 ET
Table 'Astronomia III' 6-max Seat #3 is the button
Seat 1: Washingbeard ($11.63 in chips) 
Seat 2: sTYLz_23 ($23.29 in chips) 
Seat 3: goodfun ($16.99 in chips) 
Seat 4: CashMatteo ($12.14 in chips) 
Seat 5: The Burnzeeto ($15.73 in chips) 
Seat 6: strondeau ($1.43 in chips) 
CashMatteo: posts small blind $0.05
The Burnzeeto: posts big blind $0.10
*** HOLE CARDS ***
Dealt to CashMatteo [4s 8d]
strondeau: raises $1.33 to $1.43 and is all-in
Washingbeard: folds 
sTYLz_23: folds 
goodfun: folds 
CashMatteo: folds 
The Burnzeeto: calls $1.33
*** FLOP *** [As 9h Ks]
*** TURN *** [As 9h Ks] [Ad]
*** RIVER *** [As 9h Ks Ad] [6c]
*** SHOW DOWN ***
The Burnzeeto: shows [2d Ah] (three of a kind, Aces)
strondeau: shows [7h 8h] (a pair of Aces)
The Burnzeeto collected $2.78 from pot
*** SUMMARY ***
Total pot $2.91 | Rake $0.13 
Board [As 9h Ks Ad 6c]
Seat 1: Washingbeard folded before Flop (didn't bet)
Seat 2: sTYLz_23 folded before Flop (didn't bet)
Seat 3: goodfun (button) folded before Flop (didn't bet)
Seat 4: CashMatteo (small blind) folded before Flop
Seat 5: The Burnzeeto (big blind) showed [2d Ah] and won ($2.78) with three of a kind, Aces
Seat 6: strondeau showed [7h 8h] and lost with a pair of Aces

Hand #2327: 

PokerStars Hand #250521167231:  Hold'em No Limit ($0.05/$0.10 CAD) - 2024/05/15 19:09:11 ET
Table 'Astronomia III' 6-max Seat #4 is the button
Seat 1: Washingbeard ($11.63 in chips) 
Seat 2: sTYLz_23 ($23.29 in chips) 
Seat 3: goodfun ($16.99 in chips) 
Seat 4: CashMatteo ($12.09 in chips) 
Seat 5: The Burnzeeto ($17.08 in chips) 
The Burnzeeto: posts small blind $0.05
Washingbeard: posts big blind $0.10
*** HOLE CARDS ***
Dealt to CashMatteo [Jh 5s]
strondeau leaves the table
sTYLz_23: calls $0.10
goodfun: folds 
CashMatteo: folds 
The Burnzeeto: folds 
Washingbeard: checks 
*** FLOP *** [8c Kd Ts]
Washingbeard: checks 
sTYLz_23: checks 
*** TURN *** [8c Kd Ts] [Td]
Washingbeard: bets $0.12
sTYLz_23: calls $0.12
*** RIVER *** [8c Kd Ts Td] [2d]
Washingbeard: bets $0.24
sTYLz_23: raises $0.54 to $0.78
Washingbeard: raises $2.23 to $3.01
sTYLz_23: folds 
Uncalled bet ($2.23) returned to Washingbeard
Washingbeard collected $1.96 from pot
Washingbeard: doesn't show hand 
*** SUMMARY ***
Total pot $2.05 | Rake $0.09 
Board [8c Kd Ts Td 2d]
Seat 1: Washingbeard (big blind) collected ($1.96)
Seat 2: sTYLz_23 folded on the River
Seat 3: goodfun folded before Flop (didn't bet)
Seat 4: CashMatteo (button) folded before Flop (didn't bet)
Seat 5: The Burnzeeto (small blind) folded before Flop

Hand #2328: 

PokerStars Hand #250521191824:  Hold'em No Limit ($0.05/$0.10 CAD) - 2024/05/15 19:10:54 ET
Table 'Astronomia III' 6-max Seat #5 is the button
Seat 1: Washingbeard ($12.59 in chips) 
Seat 2: sTYLz_23 ($22.29 in chips) 
Seat 3: goodfun ($16.99 in chips) 
Seat 4: CashMatteo ($12.09 in chips) 
Seat 5: The Burnzeeto ($17.03 in chips) 
Washingbeard: posts small blind $0.05
sTYLz_23: posts big blind $0.10
*** HOLE CARDS ***
Dealt to CashMatteo [5d 6c]
goodfun: folds 
CashMatteo: folds 
The Burnzeeto: raises $0.15 to $0.25
Washingbeard: calls $0.20
sTYLz_23: calls $0.15
*** FLOP *** [6h Js 9h]
Washingbeard: checks 
sTYLz_23: checks 
The Burnzeeto: bets $0.43
Washingbeard: folds 
sTYLz_23: folds 
Uncalled bet ($0.43) returned to The Burnzeeto
The Burnzeeto collected $0.72 from pot
The Burnzeeto: doesn't show hand 
*** SUMMARY ***
Total pot $0.75 | Rake $0.03 
Board [6h Js 9h]
Seat 1: Washingbeard (small blind) folded on the Flop
Seat 2: sTYLz_23 (big blind) folded on the Flop
Seat 3: goodfun folded before Flop (didn't bet)
Seat 4: CashMatteo folded before Flop (didn't bet)
Seat 5: The Burnzeeto (button) collected ($0.72)

Hand #2329: 

PokerStars Hand #250521208127:  Hold'em No Limit ($0.05/$0.10 CAD) - 2024/05/15 19:12:03 ET
Table 'Astronomia III' 6-max Seat #1 is the button
Seat 1: Washingbeard ($12.34 in chips) 
Seat 2: sTYLz_23 ($22.04 in chips) 
Seat 3: goodfun ($16.99 in chips) 
Seat 4: CashMatteo ($12.09 in chips) 
Seat 5: The Burnzeeto ($17.50 in chips) 
sTYLz_23: posts small blind $0.05
goodfun: posts big blind $0.10
*** HOLE CARDS ***
Dealt to CashMatteo [2d Ad]
CashMatteo: raises $0.15 to $0.25
The Burnzeeto: folds 
Washingbeard: calls $0.25
sTYLz_23: folds 
goodfun: folds 
*** FLOP *** [Js 3d 9c]
CashMatteo: bets $0.41
Washingbeard: calls $0.41
*** TURN *** [Js 3d 9c] [Qc]
CashMatteo: checks 
Washingbeard: checks 
*** RIVER *** [Js 3d 9c Qc] [8s]
CashMatteo: checks 
Washingbeard: bets $0.80
CashMatteo: folds 
Uncalled bet ($0.80) returned to Washingbeard
Washingbeard collected $1.40 from pot
Washingbeard: doesn't show hand 
*** SUMMARY ***
Total pot $1.47 | Rake $0.07 
Board [Js 3d 9c Qc 8s]
Seat 1: Washingbeard (button) collected ($1.40)
Seat 2: sTYLz_23 (small blind) folded before Flop
Seat 3: goodfun (big blind) folded before Flop
Seat 4: CashMatteo folded on the River
Seat 5: The Burnzeeto folded before Flop (didn't bet)

Hand #2330: 

PokerStars Hand #250521222989:  Hold'em No Limit ($0.05/$0.10 CAD) - 2024/05/15 19:13:06 ET
Table 'Astronomia III' 6-max Seat #2 is the button
Seat 1: Washingbeard ($13.08 in chips) 
Seat 2: sTYLz_23 ($21.99 in chips) 
Seat 3: goodfun ($16.89 in chips) 
Seat 4: CashMatteo ($11.43 in chips) 
Seat 5: The Burnzeeto ($17.50 in chips) 
goodfun: posts small blind $0.05
CashMatteo: posts big blind $0.10
*** HOLE CARDS ***
Dealt to CashMatteo [5d Qh]
The Burnzeeto has timed out
The Burnzeeto: folds 
Washingbeard: folds 
sTYLz_23: calls $0.10
goodfun: calls $0.05
CashMatteo: checks 
*** FLOP *** [3h Kc Qd]
goodfun: checks 
CashMatteo: checks 
sTYLz_23: bets $0.15
goodfun: folds 
CashMatteo: calls $0.15
*** TURN *** [3h Kc Qd] [4c]
CashMatteo: checks 
JeffreyCai joins the table at seat #6 
sTYLz_23: bets $0.29
CashMatteo: calls $0.29
*** RIVER *** [3h Kc Qd 4c] [Th]
CashMatteo: checks 
sTYLz_23: bets $0.57
CashMatteo: calls $0.57
*** SHOW DOWN ***
sTYLz_23: shows [Js Ks] (a pair of Kings)
CashMatteo: mucks hand 
sTYLz_23 collected $2.22 from pot
*** SUMMARY ***
Total pot $2.32 | Rake $0.10 
Board [3h Kc Qd 4c Th]
Seat 1: Washingbeard folded before Flop (didn't bet)
Seat 2: sTYLz_23 (button) showed [Js Ks] and won ($2.22) with a pair of Kings
Seat 3: goodfun (small blind) folded on the Flop
Seat 4: CashMatteo (big blind) mucked [5d Qh]
Seat 5: The Burnzeeto folded before Flop (didn't bet)

Hand #2331: 

PokerStars Hand #250521235803:  Hold'em No Limit ($0.05/$0.10 CAD) - 2024/05/15 19:14:01 ET
Table 'Astronomia III' 6-max Seat #3 is the button
Seat 1: Washingbeard ($13.08 in chips) 
Seat 2: sTYLz_23 ($23.10 in chips) 
Seat 3: goodfun ($16.79 in chips) 
Seat 4: CashMatteo ($10.32 in chips) 
Seat 5: The Burnzeeto ($17.50 in chips) 
CashMatteo: posts small blind $0.05
The Burnzeeto: posts big blind $0.10
JeffreyCai: sits out 
*** HOLE CARDS ***
Dealt to CashMatteo [Ts 4d]
Washingbeard: folds 
sTYLz_23: calls $0.10
goodfun: calls $0.10
CashMatteo: folds 
The Burnzeeto: checks 
*** FLOP *** [4c Qc 2d]
The Burnzeeto: bets $0.25
sTYLz_23: folds 
goodfun: calls $0.25
*** TURN *** [4c Qc 2d] [7d]
The Burnzeeto: bets $0.49
goodfun: folds 
Uncalled bet ($0.49) returned to The Burnzeeto
The Burnzeeto collected $0.81 from pot
The Burnzeeto: doesn't show hand 
*** SUMMARY ***
Total pot $0.85 | Rake $0.04 
Board [4c Qc 2d 7d]
Seat 1: Washingbeard folded before Flop (didn't bet)
Seat 2: sTYLz_23 folded on the Flop
Seat 3: goodfun (button) folded on the Turn
Seat 4: CashMatteo (small blind) folded before Flop
Seat 5: The Burnzeeto (big blind) collected ($0.81)

Hand #2332: 

PokerStars Hand #250521247142:  Hold'em No Limit ($0.05/$0.10 CAD) - 2024/05/15 19:14:49 ET
Table 'Astronomia III' 6-max Seat #4 is the button
Seat 1: Washingbeard ($13.08 in chips) 
Seat 2: sTYLz_23 ($23 in chips) 
Seat 3: goodfun ($16.44 in chips) 
Seat 4: CashMatteo ($10.27 in chips) 
Seat 5: The Burnzeeto ($17.96 in chips) 
Seat 6: JeffreyCai ($10 in chips) 
The Burnzeeto: posts small blind $0.05
JeffreyCai: posts big blind $0.10
*** HOLE CARDS ***
Dealt to CashMatteo [5s 8h]
Washingbeard: folds 
sTYLz_23: calls $0.10
goodfun: folds 
CashMatteo: folds 
The Burnzeeto: folds 
JeffreyCai: raises $0.40 to $0.50
sTYLz_23: folds 
Uncalled bet ($0.40) returned to JeffreyCai
JeffreyCai collected $0.25 from pot
JeffreyCai: doesn't show hand 
*** SUMMARY ***
Total pot $0.25 | Rake $0 
Seat 1: Washingbeard folded before Flop (didn't bet)
Seat 2: sTYLz_23 folded before Flop
Seat 3: goodfun folded before Flop (didn't bet)
Seat 4: CashMatteo (button) folded before Flop (didn't bet)
Seat 5: The Burnzeeto (small blind) folded before Flop
Seat 6: JeffreyCai (big blind) collected ($0.25)

Hand #2333: 

PokerStars Hand #250521258800:  Hold'em No Limit ($0.05/$0.10 CAD) - 2024/05/15 19:15:38 ET
Table 'Astronomia III' 6-max Seat #5 is the button
Seat 1: Washingbeard ($13.08 in chips) 
Seat 2: sTYLz_23 ($22.90 in chips) 
Seat 3: goodfun ($16.44 in chips) 
Seat 4: CashMatteo ($10.27 in chips) 
Seat 5: The Burnzeeto ($17.91 in chips) 
Seat 6: JeffreyCai ($10.15 in chips) 
JeffreyCai: posts small blind $0.05
Washingbeard: posts big blind $0.10
*** HOLE CARDS ***
Dealt to CashMatteo [Th 2c]
sTYLz_23: folds 
goodfun: raises $0.10 to $0.20
CashMatteo: folds 
The Burnzeeto: calls $0.20
JeffreyCai: calls $0.15
Washingbeard: folds 
*** FLOP *** [3c 9d Jh]
JeffreyCai: checks 
goodfun: checks 
The Burnzeeto: checks 
*** TURN *** [3c 9d Jh] [7c]
JeffreyCai: bets $0.34
goodfun: folds 
The Burnzeeto: folds 
Uncalled bet ($0.34) returned to JeffreyCai
JeffreyCai collected $0.67 from pot
JeffreyCai: doesn't show hand 
*** SUMMARY ***
Total pot $0.70 | Rake $0.03 
Board [3c 9d Jh 7c]
Seat 1: Washingbeard (big blind) folded before Flop
Seat 2: sTYLz_23 folded before Flop (didn't bet)
Seat 3: goodfun folded on the Turn
Seat 4: CashMatteo folded before Flop (didn't bet)
Seat 5: The Burnzeeto (button) folded on the Turn
Seat 6: JeffreyCai (small blind) collected ($0.67)

Hand #2334: 

PokerStars Hand #250521278181:  Hold'em No Limit ($0.05/$0.10 CAD) - 2024/05/15 19:17:02 ET
Table 'Astronomia III' 6-max Seat #6 is the button
Seat 1: Washingbeard ($12.98 in chips) 
Seat 2: sTYLz_23 ($22.90 in chips) 
Seat 3: goodfun ($16.24 in chips) 
Seat 4: CashMatteo ($10.27 in chips) 
Seat 5: The Burnzeeto ($17.71 in chips) 
Seat 6: JeffreyCai ($10.62 in chips) 
Washingbeard: posts small blind $0.05
sTYLz_23: posts big blind $0.10
*** HOLE CARDS ***
Dealt to CashMatteo [8s Qd]
goodfun: raises $0.10 to $0.20
CashMatteo: calls $0.20
The Burnzeeto: folds 
JeffreyCai: folds 
Washingbeard: folds 
sTYLz_23: folds 
*** FLOP *** [Ts 8h 6d]
goodfun: checks 
CashMatteo: bets $0.27
goodfun: calls $0.27
*** TURN *** [Ts 8h 6d] [Jh]
goodfun: checks 
CashMatteo: checks 
*** RIVER *** [Ts 8h 6d Jh] [Kc]
goodfun: checks 
CashMatteo: checks 
*** SHOW DOWN ***
goodfun: shows [Js 9s] (a pair of Jacks)
CashMatteo: mucks hand 
goodfun collected $1.04 from pot
*** SUMMARY ***
Total pot $1.09 | Rake $0.05 
Board [Ts 8h 6d Jh Kc]
Seat 1: Washingbeard (small blind) folded before Flop
Seat 2: sTYLz_23 (big blind) folded before Flop
Seat 3: goodfun showed [Js 9s] and won ($1.04) with a pair of Jacks
Seat 4: CashMatteo mucked [8s Qd]
Seat 5: The Burnzeeto folded before Flop (didn't bet)
Seat 6: JeffreyCai (button) folded before Flop (didn't bet)

Hand #2335: 

PokerStars Hand #250521287962:  Hold'em No Limit ($0.05/$0.10 CAD) - 2024/05/15 19:17:44 ET
Table 'Astronomia III' 6-max Seat #1 is the button
Seat 1: Washingbeard ($12.93 in chips) 
Seat 2: sTYLz_23 ($22.80 in chips) 
Seat 3: goodfun ($16.81 in chips) 
Seat 4: CashMatteo ($9.80 in chips) 
Seat 5: The Burnzeeto ($17.71 in chips) 
Seat 6: JeffreyCai ($10.62 in chips) 
sTYLz_23: posts small blind $0.05
goodfun: posts big blind $0.10
*** HOLE CARDS ***
Dealt to CashMatteo [5d 2c]
CashMatteo: folds 
The Burnzeeto: raises $0.15 to $0.25
JeffreyCai: raises $0.65 to $0.90
Washingbeard: folds 
sTYLz_23: folds 
goodfun: folds 
The Burnzeeto: folds 
Uncalled bet ($0.65) returned to JeffreyCai
JeffreyCai collected $0.65 from pot
JeffreyCai: doesn't show hand 
*** SUMMARY ***
Total pot $0.65 | Rake $0 
Seat 1: Washingbeard (button) folded before Flop (didn't bet)
Seat 2: sTYLz_23 (small blind) folded before Flop
Seat 3: goodfun (big blind) folded before Flop
Seat 4: CashMatteo folded before Flop (didn't bet)
Seat 5: The Burnzeeto folded before Flop
Seat 6: JeffreyCai collected ($0.65)

Hand #2336: 

PokerStars Hand #250521295919:  Hold'em No Limit ($0.05/$0.10 CAD) - 2024/05/15 19:18:18 ET
Table 'Astronomia III' 6-max Seat #2 is the button
Seat 1: Washingbeard ($12.93 in chips) 
Seat 2: sTYLz_23 ($22.75 in chips) 
Seat 3: goodfun ($16.71 in chips) 
Seat 4: CashMatteo ($9.80 in chips) 
Seat 5: The Burnzeeto ($17.46 in chips) 
Seat 6: JeffreyCai ($11.02 in chips) 
goodfun: posts small blind $0.05
CashMatteo: posts big blind $0.10
*** HOLE CARDS ***
Dealt to CashMatteo [Ts Qs]
The Burnzeeto: raises $0.20 to $0.30
JeffreyCai: folds 
Washingbeard: folds 
sTYLz_23 has timed out
sTYLz_23: folds 
goodfun: calls $0.25
CashMatteo: calls $0.20
*** FLOP *** [3d As 9d]
goodfun: checks 
CashMatteo: checks 
The Burnzeeto: bets $0.65
goodfun: calls $0.65
CashMatteo: folds 
*** TURN *** [3d As 9d] [3c]
goodfun: checks 
The Burnzeeto: bets $1.26
goodfun: calls $1.26
*** RIVER *** [3d As 9d 3c] [7d]
goodfun: bets $14.50 and is all-in
The Burnzeeto: folds 
Uncalled bet ($14.50) returned to goodfun
goodfun collected $4.51 from pot
goodfun: doesn't show hand 
*** SUMMARY ***
Total pot $4.72 | Rake $0.21 
Board [3d As 9d 3c 7d]
Seat 1: Washingbeard folded before Flop (didn't bet)
Seat 2: sTYLz_23 (button) folded before Flop (didn't bet)
Seat 3: goodfun (small blind) collected ($4.51)
Seat 4: CashMatteo (big blind) folded on the Flop
Seat 5: The Burnzeeto folded on the River
Seat 6: JeffreyCai folded before Flop (didn't bet)

Hand #2337: 

PokerStars Hand #250521309819:  Hold'em No Limit ($0.05/$0.10 CAD) - 2024/05/15 19:19:18 ET
Table 'Astronomia III' 6-max Seat #3 is the button
Seat 1: Washingbeard ($12.93 in chips) 
Seat 2: sTYLz_23 ($22.75 in chips) 
Seat 3: goodfun ($19.01 in chips) 
Seat 4: CashMatteo ($9.50 in chips) 
Seat 5: The Burnzeeto ($15.25 in chips) 
Seat 6: JeffreyCai ($11.02 in chips) 
CashMatteo: posts small blind $0.05
The Burnzeeto: posts big blind $0.10
*** HOLE CARDS ***
Dealt to CashMatteo [5s Kh]
JeffreyCai: folds 
Washingbeard: folds 
sTYLz_23: raises $0.25 to $0.35
goodfun: calls $0.35
CashMatteo: folds 
The Burnzeeto: calls $0.25
*** FLOP *** [8h 8d 4h]
The Burnzeeto: checks 
sTYLz_23: bets $0.53
goodfun: calls $0.53
The Burnzeeto: folds 
*** TURN *** [8h 8d 4h] [2s]
sTYLz_23: bets $1.03
goodfun: raises $1.03 to $2.06
sTYLz_23: folds 
Uncalled bet ($1.03) returned to goodfun
goodfun collected $4.03 from pot
goodfun: doesn't show hand 
*** SUMMARY ***
Total pot $4.22 | Rake $0.19 
Board [8h 8d 4h 2s]
Seat 1: Washingbeard folded before Flop (didn't bet)
Seat 2: sTYLz_23 folded on the Turn
Seat 3: goodfun (button) collected ($4.03)
Seat 4: CashMatteo (small blind) folded before Flop
Seat 5: The Burnzeeto (big blind) folded on the Flop
Seat 6: JeffreyCai folded before Flop (didn't bet)

Hand #2338: 

PokerStars Hand #250521325642:  Hold'em No Limit ($0.05/$0.10 CAD) - 2024/05/15 19:20:26 ET
Table 'Astronomia III' 6-max Seat #4 is the button
Seat 1: Washingbeard ($12.93 in chips) 
Seat 2: sTYLz_23 ($20.84 in chips) 
Seat 3: goodfun ($21.13 in chips) 
Seat 4: CashMatteo ($9.45 in chips) 
Seat 5: The Burnzeeto ($14.90 in chips) 
Seat 6: JeffreyCai ($11.02 in chips) 
The Burnzeeto: posts small blind $0.05
JeffreyCai: posts big blind $0.10
*** HOLE CARDS ***
Dealt to CashMatteo [7h 7d]
Washingbeard: folds 
sTYLz_23: raises $0.20 to $0.30
goodfun: calls $0.30
CashMatteo: calls $0.30
The Burnzeeto: folds 
JeffreyCai: folds 
*** FLOP *** [7s 9d Qd]
sTYLz_23: checks 
goodfun: bets $0.70
CashMatteo: calls $0.70
sTYLz_23: folds 
*** TURN *** [7s 9d Qd] [5c]
goodfun: bets $1.25
CashMatteo: calls $1.25
*** RIVER *** [7s 9d Qd 5c] [Js]
goodfun: checks 
CashMatteo: bets $2.77
goodfun: calls $2.77
*** SHOW DOWN ***
CashMatteo: shows [7h 7d] (three of a kind, Sevens)
goodfun: mucks hand 
CashMatteo collected $10.02 from pot
*** SUMMARY ***
Total pot $10.49 | Rake $0.47 
Board [7s 9d Qd 5c Js]
Seat 1: Washingbeard folded before Flop (didn't bet)
Seat 2: sTYLz_23 folded on the Flop
Seat 3: goodfun mucked [Qc Ad]
Seat 4: CashMatteo (button) showed [7h 7d] and won ($10.02) with three of a kind, Sevens
Seat 5: The Burnzeeto (small blind) folded before Flop
Seat 6: JeffreyCai (big blind) folded before Flop

Hand #2339: 

PokerStars Hand #250521345711:  Hold'em No Limit ($0.05/$0.10 CAD) - 2024/05/15 19:21:54 ET
Table 'Astronomia III' 6-max Seat #5 is the button
Seat 1: Washingbeard ($12.93 in chips) 
Seat 2: sTYLz_23 ($20.54 in chips) 
Seat 3: goodfun ($16.11 in chips) 
Seat 4: CashMatteo ($14.45 in chips) 
Seat 5: The Burnzeeto ($14.85 in chips) 
Seat 6: JeffreyCai ($10.92 in chips) 
JeffreyCai: posts small blind $0.05
Washingbeard: posts big blind $0.10
*** HOLE CARDS ***
Dealt to CashMatteo [Kh 8h]
sTYLz_23: folds 
goodfun: raises $0.10 to $0.20
CashMatteo: calls $0.20
The Burnzeeto: folds 
JeffreyCai: folds 
Washingbeard: calls $0.10
*** FLOP *** [6d 9h Ac]
Washingbeard: checks 
goodfun: checks 
CashMatteo: checks 
*** TURN *** [6d 9h Ac] [Kd]
Washingbeard: checks 
goodfun: checks 
CashMatteo: bets $0.31
Washingbeard: folds 
goodfun: folds 
Uncalled bet ($0.31) returned to CashMatteo
CashMatteo collected $0.62 from pot
CashMatteo: doesn't show hand 
*** SUMMARY ***
Total pot $0.65 | Rake $0.03 
Board [6d 9h Ac Kd]
Seat 1: Washingbeard (big blind) folded on the Turn
Seat 2: sTYLz_23 folded before Flop (didn't bet)
Seat 3: goodfun folded on the Turn
Seat 4: CashMatteo collected ($0.62)
Seat 5: The Burnzeeto (button) folded before Flop (didn't bet)
Seat 6: JeffreyCai (small blind) folded before Flop

Hand #2340: 

PokerStars Hand #250521356997:  Hold'em No Limit ($0.05/$0.10 CAD) - 2024/05/15 19:22:43 ET
Table 'Astronomia III' 6-max Seat #6 is the button
Seat 1: Washingbeard ($12.73 in chips) 
Seat 2: sTYLz_23 ($20.54 in chips) 
Seat 3: goodfun ($15.91 in chips) 
Seat 4: CashMatteo ($14.87 in chips) 
Seat 5: The Burnzeeto ($14.85 in chips) 
Seat 6: JeffreyCai ($10.87 in chips) 
Washingbeard: posts small blind $0.05
sTYLz_23: posts big blind $0.10
*** HOLE CARDS ***
Dealt to CashMatteo [Ah Js]
goodfun: folds 
CashMatteo: raises $0.15 to $0.25
The Burnzeeto: folds 
JeffreyCai: folds 
Washingbeard: folds 
sTYLz_23: folds 
Uncalled bet ($0.15) returned to CashMatteo
CashMatteo collected $0.25 from pot
CashMatteo: doesn't show hand 
*** SUMMARY ***
Total pot $0.25 | Rake $0 
Seat 1: Washingbeard (small blind) folded before Flop
Seat 2: sTYLz_23 (big blind) folded before Flop
Seat 3: goodfun folded before Flop (didn't bet)
Seat 4: CashMatteo collected ($0.25)
Seat 5: The Burnzeeto folded before Flop (didn't bet)
Seat 6: JeffreyCai (button) folded before Flop (didn't bet)

Hand #2341: 

PokerStars Hand #250521362277:  Hold'em No Limit ($0.05/$0.10 CAD) - 2024/05/15 19:23:06 ET
Table 'Astronomia III' 6-max Seat #1 is the button
Seat 1: Washingbeard ($12.68 in chips) 
Seat 2: sTYLz_23 ($20.44 in chips) 
Seat 3: goodfun ($15.91 in chips) 
Seat 4: CashMatteo ($15.02 in chips) 
Seat 5: The Burnzeeto ($14.85 in chips) 
Seat 6: JeffreyCai ($10.87 in chips) 
sTYLz_23: posts small blind $0.05
goodfun: posts big blind $0.10
*** HOLE CARDS ***
Dealt to CashMatteo [7s 9d]
CashMatteo: folds 
The Burnzeeto: folds 
JeffreyCai: folds 
CashMatteo leaves the table
Washingbeard: raises $0.15 to $0.25
SteveO111166 joins the table at seat #4 
sTYLz_23: calls $0.20
goodfun: calls $0.15
*** FLOP *** [9c 5c 6c]
sTYLz_23: checks 
goodfun: checks 
Washingbeard: bets $0.26
sTYLz_23: calls $0.26
goodfun: folds 
*** TURN *** [9c 5c 6c] [3s]
sTYLz_23: checks 
Washingbeard: bets $0.91
sTYLz_23: raises $0.91 to $1.82
Washingbeard: calls $0.91
*** RIVER *** [9c 5c 6c 3s] [Tc]
sTYLz_23: checks 
Washingbeard: checks 
*** SHOW DOWN ***
sTYLz_23: shows [4c Jc] (a flush, Jack high)
Washingbeard: mucks hand 
sTYLz_23 collected $4.69 from pot
*** SUMMARY ***
Total pot $4.91 | Rake $0.22 
Board [9c 5c 6c 3s Tc]
Seat 1: Washingbeard (button) mucked [9s Qh]
Seat 2: sTYLz_23 (small blind) showed [4c Jc] and won ($4.69) with a flush, Jack high
Seat 3: goodfun (big blind) folded on the Flop
Seat 4: CashMatteo folded before Flop (didn't bet)
Seat 5: The Burnzeeto folded before Flop (didn't bet)
Seat 6: JeffreyCai folded before Flop (didn't bet)

Hand #2342: 

PokerStars Hand #250567505474:  Hold'em No Limit ($0.05/$0.10 CAD) - 2024/05/18 13:43:49 ET
Table 'Bohlinia IV' 6-max Seat #4 is the button
Seat 1: CashMatteo ($8 in chips) 
Seat 2: patrob316 ($6.67 in chips) 
Seat 4: ArmedOne ($8 in chips) 
Seat 6: ZIHUATKID ($7.35 in chips) 
ZIHUATKID: posts small blind $0.05
CashMatteo: posts big blind $0.10
*** HOLE CARDS ***
Dealt to CashMatteo [4h 4d]
patrob316: folds 
ArmedOne: calls $0.10
ZIHUATKID: calls $0.05
patrob316 is disconnected 
CashMatteo: checks 
*** FLOP *** [4s 5h Ah]
ZIHUATKID: checks 
CashMatteo: checks 
ArmedOne: checks 
*** TURN *** [4s 5h Ah] [Qh]
ZIHUATKID: checks 
Hersh.s7 joins the table at seat #3 
CashMatteo: bets $0.35
ArmedOne: calls $0.35
ZIHUATKID: folds 
*** RIVER *** [4s 5h Ah Qh] [Qs]
CashMatteo: bets $1.36
ArmedOne: calls $1.36
*** SHOW DOWN ***
CashMatteo: shows [4h 4d] (a full house, Fours full of Queens)
ArmedOne: mucks hand 
CashMatteo collected $3.55 from pot
*** SUMMARY ***
Total pot $3.72 | Rake $0.17 
Board [4s 5h Ah Qh Qs]
Seat 1: CashMatteo (big blind) showed [4h 4d] and won ($3.55) with a full house, Fours full of Queens
Seat 2: patrob316 folded before Flop (didn't bet)
Seat 4: ArmedOne (button) mucked [Th 8h]
Seat 6: ZIHUATKID (small blind) folded on the Turn

Hand #2343: 

PokerStars Hand #250567517740:  Hold'em No Limit ($0.05/$0.10 CAD) - 2024/05/18 13:44:27 ET
Table 'Bohlinia IV' 6-max Seat #6 is the button
Seat 1: CashMatteo ($9.74 in chips) 
Seat 3: Hersh.s7 ($10.91 in chips) 
Seat 4: ArmedOne ($6.19 in chips) 
Seat 6: ZIHUATKID ($7.25 in chips) 
CashMatteo: posts small blind $0.05
Hersh.s7: posts big blind $0.10
*** HOLE CARDS ***
Dealt to CashMatteo [9d Ac]
ArmedOne: calls $0.10
ZIHUATKID: folds 
CashMatteo: calls $0.05
Hersh.s7: checks 
*** FLOP *** [9s 3c 4d]
CashMatteo: checks 
Hersh.s7: checks 
ArmedOne: checks 
*** TURN *** [9s 3c 4d] [6s]
CashMatteo: checks 
Hersh.s7: checks 
ArmedOne: checks 
*** RIVER *** [9s 3c 4d 6s] [Kh]
CashMatteo: checks 
Hersh.s7: checks 
ArmedOne: checks 
*** SHOW DOWN ***
CashMatteo: shows [9d Ac] (a pair of Nines)
Hersh.s7: mucks hand 
ArmedOne: mucks hand 
CashMatteo collected $0.29 from pot
*** SUMMARY ***
Total pot $0.30 | Rake $0.01 
Board [9s 3c 4d 6s Kh]
Seat 1: CashMatteo (small blind) showed [9d Ac] and won ($0.29) with a pair of Nines
Seat 3: Hersh.s7 (big blind) mucked [2s 3s]
Seat 4: ArmedOne mucked [7d Qc]
Seat 6: ZIHUATKID (button) folded before Flop (didn't bet)

Hand #2344: 

PokerStars Hand #250567527799:  Hold'em No Limit ($0.05/$0.10 CAD) - 2024/05/18 13:44:58 ET
Table 'Bohlinia IV' 6-max Seat #1 is the button
Seat 1: CashMatteo ($9.93 in chips) 
Seat 3: Hersh.s7 ($10.81 in chips) 
Seat 4: ArmedOne ($6.09 in chips) 
Seat 6: ZIHUATKID ($7.25 in chips) 
Hersh.s7: posts small blind $0.05
ArmedOne: posts big blind $0.10
*** HOLE CARDS ***
Dealt to CashMatteo [Jh 2h]
ZIHUATKID: folds 
CashMatteo: folds 
Hersh.s7: raises $0.20 to $0.30
ArmedOne: folds 
Uncalled bet ($0.20) returned to Hersh.s7
Hersh.s7 collected $0.20 from pot
*** SUMMARY ***
Total pot $0.20 | Rake $0 
Seat 1: CashMatteo (button) folded before Flop (didn't bet)
Seat 3: Hersh.s7 (small blind) collected ($0.20)
Seat 4: ArmedOne (big blind) folded before Flop
Seat 6: ZIHUATKID folded before Flop (didn't bet)

Hand #2345: 

PokerStars Hand #250567533971:  Hold'em No Limit ($0.05/$0.10 CAD) - 2024/05/18 13:45:18 ET
Table 'Bohlinia IV' 6-max Seat #3 is the button
Seat 1: CashMatteo ($9.93 in chips) 
Seat 3: Hersh.s7 ($10.91 in chips) 
Seat 4: ArmedOne ($5.99 in chips) 
Seat 6: ZIHUATKID ($7.25 in chips) 
ArmedOne: posts small blind $0.05
ZIHUATKID: posts big blind $0.10
*** HOLE CARDS ***
Dealt to CashMatteo [Ts 9d]
CashMatteo: folds 
Hersh.s7: folds 
ArmedOne: calls $0.05
ZIHUATKID: checks 
*** FLOP *** [3h Jh 6s]
ArmedOne: bets $0.20
ZIHUATKID: calls $0.20
*** TURN *** [3h Jh 6s] [Ac]
ArmedOne: checks 
ZIHUATKID: checks 
*** RIVER *** [3h Jh 6s Ac] [9s]
ArmedOne: bets $0.10
ZIHUATKID: calls $0.10
*** SHOW DOWN ***
ArmedOne: shows [Qs Jc] (a pair of Jacks)
ZIHUATKID: mucks hand 
ArmedOne collected $0.76 from pot
*** SUMMARY ***
Total pot $0.80 | Rake $0.04 
Board [3h Jh 6s Ac 9s]
Seat 1: CashMatteo folded before Flop (didn't bet)
Seat 3: Hersh.s7 (button) folded before Flop (didn't bet)
Seat 4: ArmedOne (small blind) showed [Qs Jc] and won ($0.76) with a pair of Jacks
Seat 6: ZIHUATKID (big blind) mucked [Kh 9h]

Hand #2346: 

PokerStars Hand #250567549563:  Hold'em No Limit ($0.05/$0.10 CAD) - 2024/05/18 13:46:06 ET
Table 'Bohlinia IV' 6-max Seat #4 is the button
Seat 1: CashMatteo ($9.93 in chips) 
Seat 3: Hersh.s7 ($10.91 in chips) 
Seat 4: ArmedOne ($6.35 in chips) 
Seat 6: ZIHUATKID ($6.85 in chips) 
ZIHUATKID: posts small blind $0.05
CashMatteo: posts big blind $0.10
*** HOLE CARDS ***
Dealt to CashMatteo [Td As]
dan2460 joins the table at seat #5 
Hersh.s7: folds 
ArmedOne: folds 
ZIHUATKID: folds 
Uncalled bet ($0.05) returned to CashMatteo
CashMatteo collected $0.10 from pot
CashMatteo: doesn't show hand 
*** SUMMARY ***
Total pot $0.10 | Rake $0 
Seat 1: CashMatteo (big blind) collected ($0.10)
Seat 3: Hersh.s7 folded before Flop (didn't bet)
Seat 4: ArmedOne (button) folded before Flop (didn't bet)
Seat 6: ZIHUATKID (small blind) folded before Flop

Hand #2347: 

PokerStars Hand #250567552599:  Hold'em No Limit ($0.05/$0.10 CAD) - 2024/05/18 13:46:15 ET
Table 'Bohlinia IV' 6-max Seat #6 is the button
Seat 1: CashMatteo ($9.98 in chips) 
Seat 3: Hersh.s7 ($10.91 in chips) 
Seat 4: ArmedOne ($6.35 in chips) 
Seat 5: dan2460 ($4 in chips) 
Seat 6: ZIHUATKID ($6.80 in chips) 
CashMatteo: posts small blind $0.05
Hersh.s7: posts big blind $0.10
dan2460: posts big blind $0.10
*** HOLE CARDS ***
Dealt to CashMatteo [2c Ts]
ArmedOne: calls $0.10
dan2460: checks 
ZIHUATKID: folds 
CashMatteo: calls $0.05
Hersh.s7: checks 
*** FLOP *** [5s 9c 8d]
CashMatteo: checks 
Hersh.s7: bets $0.13
ArmedOne: folds 
dan2460: calls $0.13
CashMatteo: calls $0.13
*** TURN *** [5s 9c 8d] [Kh]
CashMatteo: checks 
Hersh.s7: checks 
dan2460: checks 
*** RIVER *** [5s 9c 8d Kh] [Jd]
CashMatteo: checks 
Hersh.s7: checks 
dan2460: checks 
*** SHOW DOWN ***
CashMatteo: shows [2c Ts] (high card King)
Hersh.s7: shows [9h Th] (a pair of Nines)
dan2460: mucks hand 
Hersh.s7 collected $0.75 from pot
*** SUMMARY ***
Total pot $0.79 | Rake $0.04 
Board [5s 9c 8d Kh Jd]
Seat 1: CashMatteo (small blind) showed [2c Ts] and lost with high card King
Seat 3: Hersh.s7 (big blind) showed [9h Th] and won ($0.75) with a pair of Nines
Seat 4: ArmedOne folded on the Flop
Seat 5: dan2460 mucked [9s 3d]
Seat 6: ZIHUATKID (button) folded before Flop (didn't bet)

Hand #2348: 

PokerStars Hand #250567566196:  Hold'em No Limit ($0.05/$0.10 CAD) - 2024/05/18 13:46:57 ET
Table 'Bohlinia IV' 6-max Seat #1 is the button
Seat 1: CashMatteo ($9.75 in chips) 
Seat 3: Hersh.s7 ($11.43 in chips) 
Seat 4: ArmedOne ($6.25 in chips) 
Seat 5: dan2460 ($3.77 in chips) 
Seat 6: ZIHUATKID ($6.80 in chips) 
Hersh.s7: posts small blind $0.05
ArmedOne: posts big blind $0.10
*** HOLE CARDS ***
Dealt to CashMatteo [9s As]
dan2460: calls $0.10
ZIHUATKID: calls $0.10
CashMatteo: raises $0.15 to $0.25
Hersh.s7: folds 
ArmedOne: folds 
dan2460: calls $0.15
ZIHUATKID: calls $0.15
*** FLOP *** [5h Tc Kc]
dan2460: checks 
ZIHUATKID: checks 
CashMatteo: bets $0.43
dan2460: folds 
ZIHUATKID: folds 
Uncalled bet ($0.43) returned to CashMatteo
CashMatteo collected $0.86 from pot
CashMatteo: doesn't show hand 
*** SUMMARY ***
Total pot $0.90 | Rake $0.04 
Board [5h Tc Kc]
Seat 1: CashMatteo (button) collected ($0.86)
Seat 3: Hersh.s7 (small blind) folded before Flop
Seat 4: ArmedOne (big blind) folded before Flop
Seat 5: dan2460 folded on the Flop
Seat 6: ZIHUATKID folded on the Flop

Hand #2349: 

PokerStars Hand #250567578642:  Hold'em No Limit ($0.05/$0.10 CAD) - 2024/05/18 13:47:35 ET
Table 'Bohlinia IV' 6-max Seat #3 is the button
Seat 1: CashMatteo ($10.36 in chips) 
Seat 3: Hersh.s7 ($11.38 in chips) 
Seat 4: ArmedOne ($6.15 in chips) 
Seat 5: dan2460 ($3.52 in chips) 
Seat 6: ZIHUATKID ($6.55 in chips) 
ArmedOne: posts small blind $0.05
dan2460: posts big blind $0.10
*** HOLE CARDS ***
Dealt to CashMatteo [Kd Jd]
ZIHUATKID: folds 
CashMatteo: raises $0.15 to $0.25
Hersh.s7: folds 
ArmedOne: folds 
dan2460: raises $0.55 to $0.80
CashMatteo: calls $0.55
*** FLOP *** [Qs Td Qc]
dan2460: bets $2.72 and is all-in
CashMatteo: calls $2.72
*** TURN *** [Qs Td Qc] [3h]
*** RIVER *** [Qs Td Qc 3h] [Ah]
*** SHOW DOWN ***
dan2460: shows [Ks Qd] (three of a kind, Queens)
CashMatteo: shows [Kd Jd] (a straight, Ten to Ace)
CashMatteo collected $6.77 from pot
*** SUMMARY ***
Total pot $7.09 | Rake $0.32 
Board [Qs Td Qc 3h Ah]
Seat 1: CashMatteo showed [Kd Jd] and won ($6.77) with a straight, Ten to Ace
Seat 3: Hersh.s7 (button) folded before Flop (didn't bet)
Seat 4: ArmedOne (small blind) folded before Flop
Seat 5: dan2460 (big blind) showed [Ks Qd] and lost with three of a kind, Queens
Seat 6: ZIHUATKID folded before Flop (didn't bet)

Hand #2350: 

PokerStars Hand #250567591496:  Hold'em No Limit ($0.05/$0.10 CAD) - 2024/05/18 13:48:14 ET
Table 'Bohlinia IV' 6-max Seat #4 is the button
Seat 1: CashMatteo ($13.61 in chips) 
Seat 3: Hersh.s7 ($11.38 in chips) 
Seat 4: ArmedOne ($6.10 in chips) 
Seat 6: ZIHUATKID ($6.55 in chips) 
ZIHUATKID: posts small blind $0.05
CashMatteo: posts big blind $0.10
*** HOLE CARDS ***
Dealt to CashMatteo [3c Ac]
Hersh.s7: raises $0.20 to $0.30
ArmedOne: folds 
ZIHUATKID: folds 
CashMatteo: calls $0.20
*** FLOP *** [4h 2h 3h]
dan2460 leaves the table
CashMatteo: checks 
Hersh.s7: checks 
*** TURN *** [4h 2h 3h] [Jh]
CashMatteo: bets $0.41
Hersh.s7: folds 
Uncalled bet ($0.41) returned to CashMatteo
CashMatteo collected $0.62 from pot
CashMatteo: doesn't show hand 
*** SUMMARY ***
Total pot $0.65 | Rake $0.03 
Board [4h 2h 3h Jh]
Seat 1: CashMatteo (big blind) collected ($0.62)
Seat 3: Hersh.s7 folded on the Turn
Seat 4: ArmedOne (button) folded before Flop (didn't bet)
Seat 6: ZIHUATKID (small blind) folded before Flop

Hand #2351: 

PokerStars Hand #250567602738:  Hold'em No Limit ($0.05/$0.10 CAD) - 2024/05/18 13:48:49 ET
Table 'Bohlinia IV' 6-max Seat #6 is the button
Seat 1: CashMatteo ($13.93 in chips) 
Seat 3: Hersh.s7 ($11.08 in chips) 
Seat 4: ArmedOne ($6.10 in chips) 
Seat 6: ZIHUATKID ($6.50 in chips) 
CashMatteo: posts small blind $0.05
Hersh.s7: posts big blind $0.10
*** HOLE CARDS ***
Dealt to CashMatteo [4d 9s]
ArmedOne: folds 
ZIHUATKID: calls $0.10
CashMatteo: folds 
Hersh.s7: checks 
*** FLOP *** [6h Ad Qd]
Hersh.s7: checks 
ZIHUATKID: checks 
*** TURN *** [6h Ad Qd] [Kh]
Hersh.s7: checks 
ZIHUATKID: checks 
*** RIVER *** [6h Ad Qd Kh] [3h]
Hersh.s7: checks 
ZIHUATKID: checks 
*** SHOW DOWN ***
Hersh.s7: shows [8d 7c] (high card Ace)
ZIHUATKID: shows [2d Jd] (high card Ace - King+Queen+Jack kicker)
ZIHUATKID collected $0.24 from pot
*** SUMMARY ***
Total pot $0.25 | Rake $0.01 
Board [6h Ad Qd Kh 3h]
Seat 1: CashMatteo (small blind) folded before Flop
Seat 3: Hersh.s7 (big blind) showed [8d 7c] and lost with high card Ace
Seat 4: ArmedOne folded before Flop (didn't bet)
Seat 6: ZIHUATKID (button) showed [2d Jd] and won ($0.24) with high card Ace

Hand #2352: 

PokerStars Hand #250567610304:  Hold'em No Limit ($0.05/$0.10 CAD) - 2024/05/18 13:49:12 ET
Table 'Bohlinia IV' 6-max Seat #1 is the button
Seat 1: CashMatteo ($13.88 in chips) 
Seat 3: Hersh.s7 ($10.98 in chips) 
Seat 4: ArmedOne ($6.10 in chips) 
Seat 6: ZIHUATKID ($6.64 in chips) 
Hersh.s7: posts small blind $0.05
ArmedOne: posts big blind $0.10
*** HOLE CARDS ***
Dealt to CashMatteo [Qs Ac]
ZIHUATKID: folds 
CashMatteo: raises $0.15 to $0.25
Hersh.s7: folds 
ArmedOne: folds 
Uncalled bet ($0.15) returned to CashMatteo
CashMatteo collected $0.25 from pot
CashMatteo: doesn't show hand 
*** SUMMARY ***
Total pot $0.25 | Rake $0 
Seat 1: CashMatteo (button) collected ($0.25)
Seat 3: Hersh.s7 (small blind) folded before Flop
Seat 4: ArmedOne (big blind) folded before Flop
Seat 6: ZIHUATKID folded before Flop (didn't bet)

Hand #2353: 

PokerStars Hand #250567614019:  Hold'em No Limit ($0.05/$0.10 CAD) - 2024/05/18 13:49:24 ET
Table 'Bohlinia IV' 6-max Seat #3 is the button
Seat 1: CashMatteo ($14.03 in chips) 
Seat 3: Hersh.s7 ($10.93 in chips) 
Seat 4: ArmedOne ($6 in chips) 
Seat 6: ZIHUATKID ($6.64 in chips) 
ArmedOne: posts small blind $0.05
ZIHUATKID: posts big blind $0.10
*** HOLE CARDS ***
Dealt to CashMatteo [6d 8c]
CashMatteo: calls $0.10
Hersh.s7: raises $0.30 to $0.40
ArmedOne: folds 
ZIHUATKID: calls $0.30
CashMatteo: folds 
*** FLOP *** [Ac Kd 2d]
ZIHUATKID: checks 
Hersh.s7: bets $0.30
ZIHUATKID: calls $0.30
*** TURN *** [Ac Kd 2d] [Ah]
ZIHUATKID: checks 
Hersh.s7: bets $1.11
ZIHUATKID: folds 
Uncalled bet ($1.11) returned to Hersh.s7
Hersh.s7 collected $1.48 from pot
*** SUMMARY ***
Total pot $1.55 | Rake $0.07 
Board [Ac Kd 2d Ah]
Seat 1: CashMatteo folded before Flop
Seat 3: Hersh.s7 (button) collected ($1.48)
Seat 4: ArmedOne (small blind) folded before Flop
Seat 6: ZIHUATKID (big blind) folded on the Turn

Hand #2354: 

PokerStars Hand #250567627371:  Hold'em No Limit ($0.05/$0.10 CAD) - 2024/05/18 13:50:05 ET
Table 'Bohlinia IV' 6-max Seat #4 is the button
Seat 1: CashMatteo ($13.93 in chips) 
Seat 3: Hersh.s7 ($11.71 in chips) 
Seat 4: ArmedOne ($5.95 in chips) 
Seat 6: ZIHUATKID ($5.94 in chips) 
ZIHUATKID: posts small blind $0.05
CashMatteo: posts big blind $0.10
*** HOLE CARDS ***
Dealt to CashMatteo [7c Qs]
Hersh.s7: raises $0.20 to $0.30
ArmedOne: folds 
SmckDatAce7 joins the table at seat #5 
ZIHUATKID: folds 
CashMatteo: calls $0.20
*** FLOP *** [Jd 8c 7s]
CashMatteo: checks 
Hersh.s7: checks 
*** TURN *** [Jd 8c 7s] [Kh]
CashMatteo: checks 
patrob316 was removed from the table for failing to post
patrob316 leaves the table
Hersh.s7: checks 
*** RIVER *** [Jd 8c 7s Kh] [Kd]
CashMatteo: bets $0.41
Hersh.s7: folds 
Uncalled bet ($0.41) returned to CashMatteo
CashMatteo collected $0.62 from pot
CashMatteo: doesn't show hand 
*** SUMMARY ***
Total pot $0.65 | Rake $0.03 
Board [Jd 8c 7s Kh Kd]
Seat 1: CashMatteo (big blind) collected ($0.62)
Seat 3: Hersh.s7 folded on the River
Seat 4: ArmedOne (button) folded before Flop (didn't bet)
Seat 6: ZIHUATKID (small blind) folded before Flop

Hand #2355: 

PokerStars Hand #250567642806:  Hold'em No Limit ($0.05/$0.10 CAD) - 2024/05/18 13:50:52 ET
Table 'Bohlinia IV' 6-max Seat #6 is the button
Seat 1: CashMatteo ($14.25 in chips) 
Seat 3: Hersh.s7 ($11.41 in chips) 
Seat 4: ArmedOne ($5.95 in chips) 
Seat 6: ZIHUATKID ($5.89 in chips) 
CashMatteo: posts small blind $0.05
Hersh.s7: posts big blind $0.10
SmckDatAce7: sits out 
*** HOLE CARDS ***
Dealt to CashMatteo [7s Td]
ArmedOne: folds 
ZIHUATKID: folds 
CashMatteo: calls $0.05
Hersh.s7: checks 
*** FLOP *** [Qs Js 9d]
CashMatteo: bets $0.30
roger875 joins the table at seat #2 
Hersh.s7: folds 
Uncalled bet ($0.30) returned to CashMatteo
CashMatteo collected $0.19 from pot
CashMatteo: doesn't show hand 
*** SUMMARY ***
Total pot $0.20 | Rake $0.01 
Board [Qs Js 9d]
Seat 1: CashMatteo (small blind) collected ($0.19)
Seat 3: Hersh.s7 (big blind) folded on the Flop
Seat 4: ArmedOne folded before Flop (didn't bet)
Seat 6: ZIHUATKID (button) folded before Flop (didn't bet)

Hand #2356: 

PokerStars Hand #250567653704:  Hold'em No Limit ($0.05/$0.10 CAD) - 2024/05/18 13:51:27 ET
Table 'Bohlinia IV' 6-max Seat #1 is the button
Seat 1: CashMatteo ($14.34 in chips) 
Seat 3: Hersh.s7 ($11.31 in chips) 
Seat 4: ArmedOne ($5.95 in chips) 
Seat 6: ZIHUATKID ($5.89 in chips) 
roger875 will be allowed to play after the button
Hersh.s7: posts small blind $0.05
ArmedOne: posts big blind $0.10
SmckDatAce7: sits out 
*** HOLE CARDS ***
Dealt to CashMatteo [8s 7s]
ZIHUATKID: folds 
CashMatteo: raises $0.15 to $0.25
Hersh.s7: folds 
ArmedOne: folds 
Uncalled bet ($0.15) returned to CashMatteo
CashMatteo collected $0.25 from pot
CashMatteo: doesn't show hand 
*** SUMMARY ***
Total pot $0.25 | Rake $0 
Seat 1: CashMatteo (button) collected ($0.25)
Seat 3: Hersh.s7 (small blind) folded before Flop
Seat 4: ArmedOne (big blind) folded before Flop
Seat 6: ZIHUATKID folded before Flop (didn't bet)

Hand #2357: 

PokerStars Hand #250567658176:  Hold'em No Limit ($0.05/$0.10 CAD) - 2024/05/18 13:51:40 ET
Table 'Bohlinia IV' 6-max Seat #3 is the button
Seat 1: CashMatteo ($14.49 in chips) 
Seat 3: Hersh.s7 ($11.26 in chips) 
Seat 4: ArmedOne ($5.85 in chips) 
Seat 5: SmckDatAce7 ($9.80 in chips) 
Seat 6: ZIHUATKID ($5.89 in chips) 
ArmedOne: posts small blind $0.05
SmckDatAce7: posts big blind $0.10
roger875: sits out 
*** HOLE CARDS ***
Dealt to CashMatteo [7h Ks]
ZIHUATKID: calls $0.10
CashMatteo: raises $0.25 to $0.35
Hersh.s7: folds 
ArmedOne: folds 
SmckDatAce7: folds 
ZIHUATKID: calls $0.25
*** FLOP *** [8c Ah 6h]
ZIHUATKID: checks 
CashMatteo: bets $0.61
ZIHUATKID: folds 
Uncalled bet ($0.61) returned to CashMatteo
CashMatteo collected $0.81 from pot
CashMatteo: doesn't show hand 
*** SUMMARY ***
Total pot $0.85 | Rake $0.04 
Board [8c Ah 6h]
Seat 1: CashMatteo collected ($0.81)
Seat 3: Hersh.s7 (button) folded before Flop (didn't bet)
Seat 4: ArmedOne (small blind) folded before Flop
Seat 5: SmckDatAce7 (big blind) folded before Flop
Seat 6: ZIHUATKID folded on the Flop

Hand #2358: 

PokerStars Hand #250567669512:  Hold'em No Limit ($0.05/$0.10 CAD) - 2024/05/18 13:52:15 ET
Table 'Bohlinia IV' 6-max Seat #4 is the button
Seat 1: CashMatteo ($14.95 in chips) 
Seat 3: Hersh.s7 ($11.26 in chips) 
Seat 4: ArmedOne ($5.80 in chips) 
Seat 5: SmckDatAce7 ($9.70 in chips) 
Seat 6: ZIHUATKID ($5.54 in chips) 
SmckDatAce7: posts small blind $0.05
ZIHUATKID: posts big blind $0.10
roger875: sits out 
*** HOLE CARDS ***
Dealt to CashMatteo [Jh Ts]
CashMatteo: raises $0.15 to $0.25
Hersh.s7: folds 
ArmedOne: folds 
SmckDatAce7: folds 
ZIHUATKID: folds 
Uncalled bet ($0.15) returned to CashMatteo
CashMatteo collected $0.25 from pot
CashMatteo: doesn't show hand 
*** SUMMARY ***
Total pot $0.25 | Rake $0 
Seat 1: CashMatteo collected ($0.25)
Seat 3: Hersh.s7 folded before Flop (didn't bet)
Seat 4: ArmedOne (button) folded before Flop (didn't bet)
Seat 5: SmckDatAce7 (small blind) folded before Flop
Seat 6: ZIHUATKID (big blind) folded before Flop

Hand #2359: 

PokerStars Hand #250567675321:  Hold'em No Limit ($0.05/$0.10 CAD) - 2024/05/18 13:52:33 ET
Table 'Bohlinia IV' 6-max Seat #5 is the button
Seat 1: CashMatteo ($15.10 in chips) 
Seat 3: Hersh.s7 ($11.26 in chips) 
Seat 4: ArmedOne ($5.80 in chips) 
Seat 5: SmckDatAce7 ($9.65 in chips) 
Seat 6: ZIHUATKID ($5.44 in chips) 
ZIHUATKID: posts small blind $0.05
CashMatteo: posts big blind $0.10
roger875: sits out 
*** HOLE CARDS ***
Dealt to CashMatteo [7h 8d]
Hersh.s7: folds 
ArmedOne: calls $0.10
SmckDatAce7: raises $0.20 to $0.30
ZIHUATKID: folds 
CashMatteo: calls $0.20
ArmedOne: folds 
*** FLOP *** [As Ts 4d]
CashMatteo: checks 
SmckDatAce7: checks 
*** TURN *** [As Ts 4d] [6d]
CashMatteo: bets $0.26
SmckDatAce7: calls $0.26
*** RIVER *** [As Ts 4d 6d] [Jd]
CashMatteo: checks 
SmckDatAce7: checks 
*** SHOW DOWN ***
CashMatteo: shows [7h 8d] (high card Ace)
SmckDatAce7: shows [Qd Qc] (a pair of Queens)
SmckDatAce7 collected $1.21 from pot
*** SUMMARY ***
Total pot $1.27 | Rake $0.06 
Board [As Ts 4d 6d Jd]
Seat 1: CashMatteo (big blind) showed [7h 8d] and lost with high card Ace
Seat 3: Hersh.s7 folded before Flop (didn't bet)
Seat 4: ArmedOne folded before Flop
Seat 5: SmckDatAce7 (button) showed [Qd Qc] and won ($1.21) with a pair of Queens
Seat 6: ZIHUATKID (small blind) folded before Flop

Hand #2360: 

PokerStars Hand #250567688703:  Hold'em No Limit ($0.05/$0.10 CAD) - 2024/05/18 13:53:15 ET
Table 'Bohlinia IV' 6-max Seat #6 is the button
Seat 1: CashMatteo ($14.54 in chips) 
Seat 2: roger875 ($6.17 in chips) 
Seat 3: Hersh.s7 ($11.26 in chips) 
Seat 4: ArmedOne ($5.70 in chips) 
Seat 5: SmckDatAce7 ($10.30 in chips) 
Seat 6: ZIHUATKID ($5.39 in chips) 
CashMatteo: posts small blind $0.05
roger875: posts big blind $0.10
*** HOLE CARDS ***
Dealt to CashMatteo [8h Js]
Hersh.s7: raises $0.20 to $0.30
ArmedOne: folds 
SmckDatAce7: folds 
ZIHUATKID: folds 
CashMatteo: folds 
roger875: calls $0.20
*** FLOP *** [2h 2s 2d]
roger875: checks 
Hersh.s7: bets $0.20
roger875: folds 
Uncalled bet ($0.20) returned to Hersh.s7
Hersh.s7 collected $0.62 from pot
*** SUMMARY ***
Total pot $0.65 | Rake $0.03 
Board [2h 2s 2d]
Seat 1: CashMatteo (small blind) folded before Flop
Seat 2: roger875 (big blind) folded on the Flop
Seat 3: Hersh.s7 collected ($0.62)
Seat 4: ArmedOne folded before Flop (didn't bet)
Seat 5: SmckDatAce7 folded before Flop (didn't bet)
Seat 6: ZIHUATKID (button) folded before Flop (didn't bet)

Hand #2361: 

PokerStars Hand #250567697274:  Hold'em No Limit ($0.05/$0.10 CAD) - 2024/05/18 13:53:42 ET
Table 'Bohlinia IV' 6-max Seat #1 is the button
Seat 1: CashMatteo ($14.49 in chips) 
Seat 2: roger875 ($5.87 in chips) 
Seat 3: Hersh.s7 ($11.58 in chips) 
Seat 4: ArmedOne ($5.70 in chips) 
Seat 5: SmckDatAce7 ($10.30 in chips) 
Seat 6: ZIHUATKID ($5.39 in chips) 
roger875: posts small blind $0.05
Hersh.s7: posts big blind $0.10
*** HOLE CARDS ***
Dealt to CashMatteo [9d Qd]
ArmedOne: calls $0.10
SmckDatAce7: folds 
ZIHUATKID: calls $0.10
CashMatteo: raises $0.15 to $0.25
roger875: folds 
Hersh.s7: raises $0.60 to $0.85
ArmedOne: folds 
ZIHUATKID: folds 
CashMatteo: calls $0.60
*** FLOP *** [6s Kc 7s]
Hersh.s7: bets $0.61
CashMatteo: calls $0.61
*** TURN *** [6s Kc 7s] [2c]
Hersh.s7: checks 
CashMatteo: bets $1.72
Hersh.s7: folds 
Uncalled bet ($1.72) returned to CashMatteo
CashMatteo collected $3.03 from pot
CashMatteo: doesn't show hand 
*** SUMMARY ***
Total pot $3.17 | Rake $0.14 
Board [6s Kc 7s 2c]
Seat 1: CashMatteo (button) collected ($3.03)
Seat 2: roger875 (small blind) folded before Flop
Seat 3: Hersh.s7 (big blind) folded on the Turn
Seat 4: ArmedOne folded before Flop
Seat 5: SmckDatAce7 folded before Flop (didn't bet)
Seat 6: ZIHUATKID folded before Flop

Hand #2362: 

PokerStars Hand #250567716802:  Hold'em No Limit ($0.05/$0.10 CAD) - 2024/05/18 13:54:43 ET
Table 'Bohlinia IV' 6-max Seat #2 is the button
Seat 1: CashMatteo ($16.06 in chips) 
Seat 2: roger875 ($5.82 in chips) 
Seat 3: Hersh.s7 ($10.12 in chips) 
Seat 4: ArmedOne ($5.60 in chips) 
Seat 5: SmckDatAce7 ($10.30 in chips) 
Seat 6: ZIHUATKID ($5.29 in chips) 
Hersh.s7: posts small blind $0.05
ArmedOne: posts big blind $0.10
*** HOLE CARDS ***
Dealt to CashMatteo [Qh 4d]
SmckDatAce7: folds 
ZIHUATKID: folds 
CashMatteo: folds 
roger875: folds 
Hersh.s7: folds 
Uncalled bet ($0.05) returned to ArmedOne
ArmedOne collected $0.10 from pot
ArmedOne: doesn't show hand 
*** SUMMARY ***
Total pot $0.10 | Rake $0 
Seat 1: CashMatteo folded before Flop (didn't bet)
Seat 2: roger875 (button) folded before Flop (didn't bet)
Seat 3: Hersh.s7 (small blind) folded before Flop
Seat 4: ArmedOne (big blind) collected ($0.10)
Seat 5: SmckDatAce7 folded before Flop (didn't bet)
Seat 6: ZIHUATKID folded before Flop (didn't bet)

Hand #2363: 

PokerStars Hand #250567721915:  Hold'em No Limit ($0.05/$0.10 CAD) - 2024/05/18 13:54:58 ET
Table 'Bohlinia IV' 6-max Seat #3 is the button
Seat 1: CashMatteo ($16.06 in chips) 
Seat 2: roger875 ($5.82 in chips) 
Seat 3: Hersh.s7 ($10.07 in chips) 
Seat 4: ArmedOne ($5.65 in chips) 
Seat 5: SmckDatAce7 ($10.30 in chips) 
Seat 6: ZIHUATKID ($5.29 in chips) 
ArmedOne: posts small blind $0.05
SmckDatAce7: posts big blind $0.10
*** HOLE CARDS ***
Dealt to CashMatteo [4c 7s]
ZIHUATKID: folds 
CashMatteo: folds 
roger875: folds 
Hersh.s7: raises $0.20 to $0.30
ArmedOne: calls $0.25
SmckDatAce7: calls $0.20
*** FLOP *** [Kd 7c 6d]
ArmedOne: checks 
SmckDatAce7: checks 
Hersh.s7: checks 
*** TURN *** [Kd 7c 6d] [Qh]
ArmedOne: checks 
SmckDatAce7: checks 
Hersh.s7: checks 
*** RIVER *** [Kd 7c 6d Qh] [Ah]
ArmedOne: bets $0.10
SmckDatAce7: folds 
Hersh.s7: calls $0.10
*** SHOW DOWN ***
ArmedOne: shows [Ac Th] (a pair of Aces)
Hersh.s7: mucks hand 
ArmedOne collected $1.05 from pot
*** SUMMARY ***
Total pot $1.10 | Rake $0.05 
Board [Kd 7c 6d Qh Ah]
Seat 1: CashMatteo folded before Flop (didn't bet)
Seat 2: roger875 folded before Flop (didn't bet)
Seat 3: Hersh.s7 (button) mucked [Kh 8d]
Seat 4: ArmedOne (small blind) showed [Ac Th] and won ($1.05) with a pair of Aces
Seat 5: SmckDatAce7 (big blind) folded on the River
Seat 6: ZIHUATKID folded before Flop (didn't bet)

Hand #2364: 

PokerStars Hand #250567730228:  Hold'em No Limit ($0.05/$0.10 CAD) - 2024/05/18 13:55:39 ET
Table 'Bohlinia IV' 6-max Seat #4 is the button
Seat 1: CashMatteo ($16.06 in chips) 
Seat 2: roger875 ($5.82 in chips) 
Seat 3: Hersh.s7 ($9.67 in chips) 
Seat 4: ArmedOne ($6.30 in chips) 
Seat 5: SmckDatAce7 ($10 in chips) 
Seat 6: ZIHUATKID ($5.29 in chips) 
SmckDatAce7: posts small blind $0.05
ZIHUATKID: posts big blind $0.10
*** HOLE CARDS ***
Dealt to CashMatteo [Td 9c]
CashMatteo: calls $0.10
roger875: raises $0.20 to $0.30
Hersh.s7: folds 
ArmedOne: folds 
SmckDatAce7: folds 
ZIHUATKID: folds 
CashMatteo: calls $0.20
*** FLOP *** [Ad Jh 7h]
CashMatteo: checks 
roger875: bets $0.50
CashMatteo: folds 
Uncalled bet ($0.50) returned to roger875
roger875 collected $0.72 from pot
*** SUMMARY ***
Total pot $0.75 | Rake $0.03 
Board [Ad Jh 7h]
Seat 1: CashMatteo folded on the Flop
Seat 2: roger875 collected ($0.72)
Seat 3: Hersh.s7 folded before Flop (didn't bet)
Seat 4: ArmedOne (button) folded before Flop (didn't bet)
Seat 5: SmckDatAce7 (small blind) folded before Flop
Seat 6: ZIHUATKID (big blind) folded before Flop

Hand #2365: 

PokerStars Hand #250567735615:  Hold'em No Limit ($0.05/$0.10 CAD) - 2024/05/18 13:56:08 ET
Table 'Bohlinia IV' 6-max Seat #5 is the button
Seat 1: CashMatteo ($15.76 in chips) 
Seat 2: roger875 ($6.24 in chips) 
Seat 3: Hersh.s7 ($10 in chips) 
Seat 4: ArmedOne ($6.30 in chips) 
Seat 5: SmckDatAce7 ($9.95 in chips) 
Seat 6: ZIHUATKID ($5.19 in chips) 
ZIHUATKID: posts small blind $0.05
CashMatteo: posts big blind $0.10
*** HOLE CARDS ***
Dealt to CashMatteo [Jc Kh]
roger875: folds 
Hersh.s7: raises $0.20 to $0.30
ArmedOne: folds 
SmckDatAce7: folds 
ZIHUATKID: folds 
CashMatteo: calls $0.20
*** FLOP *** [5d Qs Qc]
CashMatteo: checks 
Hersh.s7: bets $0.20
CashMatteo: calls $0.20
*** TURN *** [5d Qs Qc] [Ad]
CashMatteo: checks 
Hersh.s7: bets $0.66
CashMatteo: folds 
Uncalled bet ($0.66) returned to Hersh.s7
Hersh.s7 collected $1 from pot
*** SUMMARY ***
Total pot $1.05 | Rake $0.05 
Board [5d Qs Qc Ad]
Seat 1: CashMatteo (big blind) folded on the Turn
Seat 2: roger875 folded before Flop (didn't bet)
Seat 3: Hersh.s7 collected ($1)
Seat 4: ArmedOne folded before Flop (didn't bet)
Seat 5: SmckDatAce7 (button) folded before Flop (didn't bet)
Seat 6: ZIHUATKID (small blind) folded before Flop

Hand #2366: 

PokerStars Hand #250567744271:  Hold'em No Limit ($0.05/$0.10 CAD) - 2024/05/18 13:56:54 ET
Table 'Bohlinia IV' 6-max Seat #6 is the button
Seat 1: CashMatteo ($15.26 in chips) 
Seat 2: roger875 ($6.24 in chips) 
Seat 3: Hersh.s7 ($10.50 in chips) 
Seat 4: ArmedOne ($6.30 in chips) 
Seat 5: SmckDatAce7 ($9.95 in chips) 
Seat 6: ZIHUATKID ($5.14 in chips) 
CashMatteo: posts small blind $0.05
roger875: posts big blind $0.10
*** HOLE CARDS ***
Dealt to CashMatteo [9d 7d]
Hersh.s7: raises $0.20 to $0.30
ArmedOne: calls $0.30
SmckDatAce7: calls $0.30
ZIHUATKID: folds 
CashMatteo: calls $0.25
roger875: calls $0.20
*** FLOP *** [5s 8d 6d]
CashMatteo: bets $1.50
roger875: folds 
Hersh.s7: folds 
ArmedOne: folds 
SmckDatAce7: raises $8.15 to $9.65 and is all-in
CashMatteo: calls $8.15
*** TURN *** [5s 8d 6d] [Ah]
*** RIVER *** [5s 8d 6d Ah] [3d]
*** SHOW DOWN ***
CashMatteo: shows [9d 7d] (a flush, Nine high)
SmckDatAce7: shows [Kd Kc] (a pair of Kings)
CashMatteo collected $19.86 from pot
*** SUMMARY ***
Total pot $20.80 | Rake $0.94 
Board [5s 8d 6d Ah 3d]
Seat 1: CashMatteo (small blind) showed [9d 7d] and won ($19.86) with a flush, Nine high
Seat 2: roger875 (big blind) folded on the Flop
Seat 3: Hersh.s7 folded on the Flop
Seat 4: ArmedOne folded on the Flop
Seat 5: SmckDatAce7 showed [Kd Kc] and lost with a pair of Kings
Seat 6: ZIHUATKID (button) folded before Flop (didn't bet)

Hand #2367: 

PokerStars Hand #250567754610:  Hold'em No Limit ($0.05/$0.10 CAD) - 2024/05/18 13:57:48 ET
Table 'Bohlinia IV' 6-max Seat #1 is the button
Seat 1: CashMatteo ($25.17 in chips) 
Seat 2: roger875 ($5.94 in chips) 
Seat 3: Hersh.s7 ($10.20 in chips) 
Seat 4: ArmedOne ($6 in chips) 
Seat 6: ZIHUATKID ($5.14 in chips) 
roger875: posts small blind $0.05
Hersh.s7: posts big blind $0.10
*** HOLE CARDS ***
Dealt to CashMatteo [Tc 4c]
ArmedOne: folds 
ZIHUATKID: calls $0.10
CashMatteo: calls $0.10
roger875: folds 
Hersh.s7: checks 
*** FLOP *** [Jc Js 6d]
Hersh.s7: checks 
ZIHUATKID: checks 
CashMatteo: checks 
*** TURN *** [Jc Js 6d] [Td]
Hersh.s7: checks 
ZIHUATKID: checks 
CashMatteo: checks 
*** RIVER *** [Jc Js 6d Td] [7d]
Hersh.s7: checks 
ZIHUATKID: bets $0.10
CashMatteo: raises $0.53 to $0.63
Hersh.s7: folds 
ZIHUATKID: folds 
Uncalled bet ($0.53) returned to CashMatteo
CashMatteo collected $0.53 from pot
CashMatteo: doesn't show hand 
*** SUMMARY ***
Total pot $0.55 | Rake $0.02 
Board [Jc Js 6d Td 7d]
Seat 1: CashMatteo (button) collected ($0.53)
Seat 2: roger875 (small blind) folded before Flop
Seat 3: Hersh.s7 (big blind) folded on the River
Seat 4: ArmedOne folded before Flop (didn't bet)
Seat 6: ZIHUATKID folded on the River

Hand #2368: 

PokerStars Hand #250567764784:  Hold'em No Limit ($0.05/$0.10 CAD) - 2024/05/18 13:58:41 ET
Table 'Bohlinia IV' 6-max Seat #2 is the button
Seat 1: CashMatteo ($25.50 in chips) 
Seat 2: roger875 ($5.89 in chips) 
Seat 3: Hersh.s7 ($10.10 in chips) 
Seat 4: ArmedOne ($6 in chips) 
Seat 5: SmckDatAce7 ($10 in chips) 
Seat 6: ZIHUATKID ($4.94 in chips) 
Hersh.s7: posts small blind $0.05
ArmedOne: posts big blind $0.10
*** HOLE CARDS ***
Dealt to CashMatteo [Th Ts]
SmckDatAce7: folds 
ZIHUATKID: folds 
CashMatteo: raises $0.15 to $0.25
roger875: calls $0.25
Hersh.s7: folds 
ArmedOne: folds 
*** FLOP *** [5h 6d 9d]
CashMatteo: bets $0.31
roger875: folds 
Uncalled bet ($0.31) returned to CashMatteo
CashMatteo collected $0.62 from pot
CashMatteo: doesn't show hand 
*** SUMMARY ***
Total pot $0.65 | Rake $0.03 
Board [5h 6d 9d]
Seat 1: CashMatteo collected ($0.62)
Seat 2: roger875 (button) folded on the Flop
Seat 3: Hersh.s7 (small blind) folded before Flop
Seat 4: ArmedOne (big blind) folded before Flop
Seat 5: SmckDatAce7 folded before Flop (didn't bet)
Seat 6: ZIHUATKID folded before Flop (didn't bet)

Hand #2369: 

PokerStars Hand #250567770013:  Hold'em No Limit ($0.05/$0.10 CAD) - 2024/05/18 13:59:08 ET
Table 'Bohlinia IV' 6-max Seat #3 is the button
Seat 1: CashMatteo ($25.87 in chips) 
Seat 2: roger875 ($5.64 in chips) 
Seat 3: Hersh.s7 ($10.05 in chips) 
Seat 4: ArmedOne ($5.90 in chips) 
Seat 5: SmckDatAce7 ($10 in chips) 
Seat 6: ZIHUATKID ($4.94 in chips) 
ArmedOne: posts small blind $0.05
SmckDatAce7: posts big blind $0.10
*** HOLE CARDS ***
Dealt to CashMatteo [8d Qh]
ZIHUATKID: folds 
CashMatteo: raises $0.15 to $0.25
roger875: folds 
Hersh.s7: folds 
ArmedOne: folds 
SmckDatAce7: folds 
Uncalled bet ($0.15) returned to CashMatteo
CashMatteo collected $0.25 from pot
CashMatteo: doesn't show hand 
*** SUMMARY ***
Total pot $0.25 | Rake $0 
Seat 1: CashMatteo collected ($0.25)
Seat 2: roger875 folded before Flop (didn't bet)
Seat 3: Hersh.s7 (button) folded before Flop (didn't bet)
Seat 4: ArmedOne (small blind) folded before Flop
Seat 5: SmckDatAce7 (big blind) folded before Flop
Seat 6: ZIHUATKID folded before Flop (didn't bet)

Hand #2370: 

PokerStars Hand #250567775691:  Hold'em No Limit ($0.05/$0.10 CAD) - 2024/05/18 13:59:38 ET
Table 'Bohlinia IV' 6-max Seat #4 is the button
Seat 1: CashMatteo ($26.02 in chips) 
Seat 2: roger875 ($5.64 in chips) 
Seat 3: Hersh.s7 ($10.05 in chips) 
Seat 4: ArmedOne ($5.85 in chips) 
Seat 5: SmckDatAce7 ($9.90 in chips) 
Seat 6: ZIHUATKID ($4.94 in chips) 
SmckDatAce7: posts small blind $0.05
ZIHUATKID: posts big blind $0.10
*** HOLE CARDS ***
Dealt to CashMatteo [5d Ac]
CashMatteo: calls $0.10
roger875: folds 
Hersh.s7: folds 
ArmedOne: calls $0.10
SmckDatAce7: folds 
ZIHUATKID: checks 
*** FLOP *** [Js Kh Jc]
ZIHUATKID: checks 
CashMatteo: bets $0.17
ArmedOne: calls $0.17
ZIHUATKID: folds 
*** TURN *** [Js Kh Jc] [8s]
CashMatteo: checks 
ArmedOne: checks 
*** RIVER *** [Js Kh Jc 8s] [As]
CashMatteo: bets $0.86
ArmedOne: calls $0.86
*** SHOW DOWN ***
CashMatteo: shows [5d Ac] (two pair, Aces and Jacks)
ArmedOne: shows [Tc Ad] (two pair, Aces and Jacks)
CashMatteo collected $1.15 from pot
ArmedOne collected $1.15 from pot
*** SUMMARY ***
Total pot $2.41 | Rake $0.11 
Board [Js Kh Jc 8s As]
Seat 1: CashMatteo showed [5d Ac] and won ($1.15) with two pair, Aces and Jacks
Seat 2: roger875 folded before Flop (didn't bet)
Seat 3: Hersh.s7 folded before Flop (didn't bet)
Seat 4: ArmedOne (button) showed [Tc Ad] and won ($1.15) with two pair, Aces and Jacks
Seat 5: SmckDatAce7 (small blind) folded before Flop
Seat 6: ZIHUATKID (big blind) folded on the Flop

Hand #2371: 

PokerStars Hand #250567783901:  Hold'em No Limit ($0.05/$0.10 CAD) - 2024/05/18 14:00:19 ET
Table 'Bohlinia IV' 6-max Seat #5 is the button
Seat 1: CashMatteo ($26.04 in chips) 
Seat 2: roger875 ($5.64 in chips) 
Seat 3: Hersh.s7 ($10.05 in chips) 
Seat 4: ArmedOne ($5.87 in chips) 
Seat 5: SmckDatAce7 ($9.85 in chips) 
Seat 6: ZIHUATKID ($4.84 in chips) 
ZIHUATKID: posts small blind $0.05
CashMatteo: posts big blind $0.10
*** HOLE CARDS ***
Dealt to CashMatteo [2d 4h]
roger875: folds 
Hersh.s7: folds 
ArmedOne: folds 
SmckDatAce7: raises $0.10 to $0.20
ZIHUATKID: folds 
CashMatteo: folds 
Uncalled bet ($0.10) returned to SmckDatAce7
SmckDatAce7 collected $0.25 from pot
SmckDatAce7: doesn't show hand 
*** SUMMARY ***
Total pot $0.25 | Rake $0 
Seat 1: CashMatteo (big blind) folded before Flop
Seat 2: roger875 folded before Flop (didn't bet)
Seat 3: Hersh.s7 folded before Flop (didn't bet)
Seat 4: ArmedOne folded before Flop (didn't bet)
Seat 5: SmckDatAce7 (button) collected ($0.25)
Seat 6: ZIHUATKID (small blind) folded before Flop

Hand #2372: 

PokerStars Hand #250567787728:  Hold'em No Limit ($0.05/$0.10 CAD) - 2024/05/18 14:00:38 ET
Table 'Bohlinia IV' 6-max Seat #6 is the button
Seat 1: CashMatteo ($25.94 in chips) 
Seat 2: roger875 ($5.64 in chips) 
Seat 3: Hersh.s7 ($10.05 in chips) 
Seat 4: ArmedOne ($5.87 in chips) 
Seat 5: SmckDatAce7 ($10 in chips) 
Seat 6: ZIHUATKID ($4.79 in chips) 
CashMatteo: posts small blind $0.05
roger875: posts big blind $0.10
*** HOLE CARDS ***
Dealt to CashMatteo [Jh Jc]
Hersh.s7: folds 
ArmedOne: calls $0.10
SmckDatAce7: folds 
ZIHUATKID: calls $0.10
CashMatteo: raises $0.25 to $0.35
roger875: calls $0.25
ArmedOne: calls $0.25
ZIHUATKID: folds 
*** FLOP *** [7c 5c As]
CashMatteo: bets $0.65
roger875: folds 
ArmedOne: calls $0.65
*** TURN *** [7c 5c As] [8c]
CashMatteo: checks 
ArmedOne: bets $1.17
CashMatteo: calls $1.17
*** RIVER *** [7c 5c As 8c] [Kc]
CashMatteo: checks 
ArmedOne: checks 
*** SHOW DOWN ***
CashMatteo: shows [Jh Jc] (a flush, King high)
ArmedOne: mucks hand 
CashMatteo collected $4.57 from pot
*** SUMMARY ***
Total pot $4.79 | Rake $0.22 
Board [7c 5c As 8c Kc]
Seat 1: CashMatteo (small blind) showed [Jh Jc] and won ($4.57) with a flush, King high
Seat 2: roger875 (big blind) folded on the Flop
Seat 3: Hersh.s7 folded before Flop (didn't bet)
Seat 4: ArmedOne mucked [4d Ad]
Seat 5: SmckDatAce7 folded before Flop (didn't bet)
Seat 6: ZIHUATKID (button) folded before Flop

Hand #2373: 

PokerStars Hand #250567799179:  Hold'em No Limit ($0.05/$0.10 CAD) - 2024/05/18 14:01:26 ET
Table 'Bohlinia IV' 6-max Seat #1 is the button
Seat 1: CashMatteo ($28.34 in chips) 
Seat 2: roger875 ($5.29 in chips) 
Seat 3: Hersh.s7 ($10.05 in chips) 
Seat 4: ArmedOne ($3.70 in chips) 
Seat 5: SmckDatAce7 ($10 in chips) 
Seat 6: ZIHUATKID ($4.69 in chips) 
roger875: posts small blind $0.05
Hersh.s7: posts big blind $0.10
*** HOLE CARDS ***
Dealt to CashMatteo [3d Qc]
ArmedOne: calls $0.10
SmckDatAce7: folds 
ZIHUATKID: folds 
CashMatteo: folds 
roger875: calls $0.05
Hersh.s7: checks 
*** FLOP *** [6d 4c Jd]
roger875: checks 
Hersh.s7: checks 
ArmedOne: checks 
*** TURN *** [6d 4c Jd] [Td]
roger875: checks 
Hersh.s7: bets $0.10
ArmedOne: folds 
roger875: folds 
Uncalled bet ($0.10) returned to Hersh.s7
Hersh.s7 collected $0.29 from pot
*** SUMMARY ***
Total pot $0.30 | Rake $0.01 
Board [6d 4c Jd Td]
Seat 1: CashMatteo (button) folded before Flop (didn't bet)
Seat 2: roger875 (small blind) folded on the Turn
Seat 3: Hersh.s7 (big blind) collected ($0.29)
Seat 4: ArmedOne folded on the Turn
Seat 5: SmckDatAce7 folded before Flop (didn't bet)
Seat 6: ZIHUATKID folded before Flop (didn't bet)

Hand #2374: 

PokerStars Hand #250567806992:  Hold'em No Limit ($0.05/$0.10 CAD) - 2024/05/18 14:01:55 ET
Table 'Bohlinia IV' 6-max Seat #2 is the button
Seat 1: CashMatteo ($28.34 in chips) 
Seat 2: roger875 ($5.19 in chips) 
Seat 3: Hersh.s7 ($10.24 in chips) 
Seat 4: ArmedOne ($3.60 in chips) 
Seat 5: SmckDatAce7 ($10 in chips) 
Seat 6: ZIHUATKID ($4.69 in chips) 
Hersh.s7: posts small blind $0.05
ArmedOne: posts big blind $0.10
*** HOLE CARDS ***
Dealt to CashMatteo [Tc Kd]
SmckDatAce7: folds 
ZIHUATKID: folds 
CashMatteo: raises $0.15 to $0.25
roger875: folds 
Hersh.s7: folds 
ArmedOne: folds 
Uncalled bet ($0.15) returned to CashMatteo
CashMatteo collected $0.25 from pot
CashMatteo: doesn't show hand 
*** SUMMARY ***
Total pot $0.25 | Rake $0 
Seat 1: CashMatteo collected ($0.25)
Seat 2: roger875 (button) folded before Flop (didn't bet)
Seat 3: Hersh.s7 (small blind) folded before Flop
Seat 4: ArmedOne (big blind) folded before Flop
Seat 5: SmckDatAce7 folded before Flop (didn't bet)
Seat 6: ZIHUATKID folded before Flop (didn't bet)

Hand #2375: 

PokerStars Hand #250567811589:  Hold'em No Limit ($0.05/$0.10 CAD) - 2024/05/18 14:02:08 ET
Table 'Bohlinia IV' 6-max Seat #3 is the button
Seat 1: CashMatteo ($28.49 in chips) 
Seat 2: roger875 ($5.19 in chips) 
Seat 3: Hersh.s7 ($10.19 in chips) 
Seat 4: ArmedOne ($3.50 in chips) 
Seat 5: SmckDatAce7 ($10 in chips) 
Seat 6: ZIHUATKID ($4.69 in chips) 
ArmedOne: posts small blind $0.05
SmckDatAce7: posts big blind $0.10
*** HOLE CARDS ***
Dealt to CashMatteo [2c Kh]
ZIHUATKID: folds 
CashMatteo: folds 
roger875: folds 
Hersh.s7: raises $0.20 to $0.30
ArmedOne: calls $0.25
SmckDatAce7: folds 
*** FLOP *** [2h 9c Kc]
ArmedOne: checks 
Hersh.s7: bets $0.22
ArmedOne: folds 
Uncalled bet ($0.22) returned to Hersh.s7
Hersh.s7 collected $0.67 from pot
*** SUMMARY ***
Total pot $0.70 | Rake $0.03 
Board [2h 9c Kc]
Seat 1: CashMatteo folded before Flop (didn't bet)
Seat 2: roger875 folded before Flop (didn't bet)
Seat 3: Hersh.s7 (button) collected ($0.67)
Seat 4: ArmedOne (small blind) folded on the Flop
Seat 5: SmckDatAce7 (big blind) folded before Flop
Seat 6: ZIHUATKID folded before Flop (didn't bet)

Hand #2376: 

PokerStars Hand #250567817913:  Hold'em No Limit ($0.05/$0.10 CAD) - 2024/05/18 14:02:30 ET
Table 'Bohlinia IV' 6-max Seat #4 is the button
Seat 1: CashMatteo ($28.49 in chips) 
Seat 2: roger875 ($5.19 in chips) 
Seat 3: Hersh.s7 ($10.56 in chips) 
Seat 4: ArmedOne ($3.20 in chips) 
Seat 5: SmckDatAce7 ($9.90 in chips) 
Seat 6: ZIHUATKID ($4.69 in chips) 
SmckDatAce7: posts small blind $0.05
ZIHUATKID: posts big blind $0.10
*** HOLE CARDS ***
Dealt to CashMatteo [Ah 5d]
CashMatteo: raises $0.15 to $0.25
roger875: calls $0.25
Hersh.s7: raises $0.60 to $0.85
ArmedOne: folds 
SmckDatAce7: folds 
ZIHUATKID: folds 
CashMatteo: calls $0.60
roger875: calls $0.60
*** FLOP *** [8c Qc 6h]
CashMatteo: checks 
roger875: checks 
Hersh.s7: bets $0.85
CashMatteo: calls $0.85
roger875: folds 
*** TURN *** [8c Qc 6h] [Kc]
CashMatteo: checks 
Hersh.s7: bets $2.10
CashMatteo: folds 
Uncalled bet ($2.10) returned to Hersh.s7
Hersh.s7 collected $4.20 from pot
*** SUMMARY ***
Total pot $4.40 | Rake $0.20 
Board [8c Qc 6h Kc]
Seat 1: CashMatteo folded on the Turn
Seat 2: roger875 folded on the Flop
Seat 3: Hersh.s7 collected ($4.20)
Seat 4: ArmedOne (button) folded before Flop (didn't bet)
Seat 5: SmckDatAce7 (small blind) folded before Flop
Seat 6: ZIHUATKID (big blind) folded before Flop

Hand #2377: 

PokerStars Hand #250567840966:  Hold'em No Limit ($0.05/$0.10 CAD) - 2024/05/18 14:03:40 ET
Table 'Bohlinia IV' 6-max Seat #5 is the button
Seat 1: CashMatteo ($26.79 in chips) 
Seat 2: roger875 ($4.34 in chips) 
Seat 3: Hersh.s7 ($13.06 in chips) 
Seat 4: ArmedOne ($3.20 in chips) 
Seat 5: SmckDatAce7 ($9.85 in chips) 
Seat 6: ZIHUATKID ($4.59 in chips) 
ZIHUATKID: posts small blind $0.05
CashMatteo: posts big blind $0.10
*** HOLE CARDS ***
Dealt to CashMatteo [9d 4h]
roger875: folds 
Hersh.s7: raises $0.20 to $0.30
ArmedOne: folds 
SmckDatAce7: folds 
ZIHUATKID: folds 
CashMatteo: folds 
Uncalled bet ($0.20) returned to Hersh.s7
Hersh.s7 collected $0.25 from pot
*** SUMMARY ***
Total pot $0.25 | Rake $0 
Seat 1: CashMatteo (big blind) folded before Flop
Seat 2: roger875 folded before Flop (didn't bet)
Seat 3: Hersh.s7 collected ($0.25)
Seat 4: ArmedOne folded before Flop (didn't bet)
Seat 5: SmckDatAce7 (button) folded before Flop (didn't bet)
Seat 6: ZIHUATKID (small blind) folded before Flop

Hand #2378: 

PokerStars Hand #250567846614:  Hold'em No Limit ($0.05/$0.10 CAD) - 2024/05/18 14:03:57 ET
Table 'Bohlinia IV' 6-max Seat #6 is the button
Seat 1: CashMatteo ($26.69 in chips) 
Seat 2: roger875 ($4.34 in chips) 
Seat 3: Hersh.s7 ($13.21 in chips) 
Seat 4: ArmedOne ($3.20 in chips) 
Seat 5: SmckDatAce7 ($9.85 in chips) 
Seat 6: ZIHUATKID ($4.54 in chips) 
CashMatteo: posts small blind $0.05
roger875: posts big blind $0.10
*** HOLE CARDS ***
Dealt to CashMatteo [Th 3c]
Hersh.s7: folds 
ArmedOne: folds 
SmckDatAce7: raises $0.10 to $0.20
ZIHUATKID: folds 
CashMatteo: folds 
roger875: calls $0.10
*** FLOP *** [2d Ah 8d]
roger875: checks 
SmckDatAce7: bets $0.22
roger875: calls $0.22
*** TURN *** [2d Ah 8d] [8s]
roger875: checks 
SmckDatAce7: bets $0.80
roger875: calls $0.80
*** RIVER *** [2d Ah 8d 8s] [Kh]
roger875: checks 
SmckDatAce7: checks 
*** SHOW DOWN ***
roger875: shows [Jh Ad] (two pair, Aces and Eights)
SmckDatAce7: mucks hand 
roger875 collected $2.38 from pot
*** SUMMARY ***
Total pot $2.49 | Rake $0.11 
Board [2d Ah 8d 8s Kh]
Seat 1: CashMatteo (small blind) folded before Flop
Seat 2: roger875 (big blind) showed [Jh Ad] and won ($2.38) with two pair, Aces and Eights
Seat 3: Hersh.s7 folded before Flop (didn't bet)
Seat 4: ArmedOne folded before Flop (didn't bet)
Seat 5: SmckDatAce7 mucked [Js Kc]
Seat 6: ZIHUATKID (button) folded before Flop (didn't bet)

Hand #2379: 

PokerStars Hand #250567860421:  Hold'em No Limit ($0.05/$0.10 CAD) - 2024/05/18 14:04:39 ET
Table 'Bohlinia IV' 6-max Seat #1 is the button
Seat 1: CashMatteo ($26.64 in chips) 
Seat 2: roger875 ($5.50 in chips) 
Seat 3: Hersh.s7 ($13.21 in chips) 
Seat 4: ArmedOne ($3.20 in chips) 
Seat 5: SmckDatAce7 ($8.63 in chips) 
Seat 6: ZIHUATKID ($4.54 in chips) 
roger875: posts small blind $0.05
Hersh.s7: posts big blind $0.10
*** HOLE CARDS ***
Dealt to CashMatteo [7c Jc]
ArmedOne: calls $0.10
SmckDatAce7: raises $0.10 to $0.20
ZIHUATKID: folds 
CashMatteo: calls $0.20
roger875: folds 
Hersh.s7: calls $0.10
ArmedOne: calls $0.10
*** FLOP *** [8c Td 8h]
Hersh.s7: checks 
ArmedOne: checks 
SmckDatAce7: checks 
CashMatteo: checks 
*** TURN *** [8c Td 8h] [5h]
Hersh.s7: checks 
ArmedOne: checks 
SmckDatAce7: checks 
CashMatteo: checks 
*** RIVER *** [8c Td 8h 5h] [As]
Hersh.s7: checks 
ArmedOne: checks 
SmckDatAce7: checks 
CashMatteo: checks 
*** SHOW DOWN ***
Hersh.s7: shows [2c 2s] (two pair, Eights and Deuces)
ArmedOne: shows [Ac 2d] (two pair, Aces and Eights)
SmckDatAce7: shows [Ah 4h] (two pair, Aces and Eights)
CashMatteo: mucks hand 
ArmedOne collected $0.41 from pot
SmckDatAce7 collected $0.40 from pot
*** SUMMARY ***
Total pot $0.85 | Rake $0.04 
Board [8c Td 8h 5h As]
Seat 1: CashMatteo (button) mucked [7c Jc]
Seat 2: roger875 (small blind) folded before Flop
Seat 3: Hersh.s7 (big blind) showed [2c 2s] and lost with two pair, Eights and Deuces
Seat 4: ArmedOne showed [Ac 2d] and won ($0.41) with two pair, Aces and Eights
Seat 5: SmckDatAce7 showed [Ah 4h] and won ($0.40) with two pair, Aces and Eights
Seat 6: ZIHUATKID folded before Flop (didn't bet)

Hand #2380: 

PokerStars Hand #250567871528:  Hold'em No Limit ($0.05/$0.10 CAD) - 2024/05/18 14:05:13 ET
Table 'Bohlinia IV' 6-max Seat #2 is the button
Seat 1: CashMatteo ($26.44 in chips) 
Seat 2: roger875 ($5.45 in chips) 
Seat 3: Hersh.s7 ($13.01 in chips) 
Seat 4: ArmedOne ($3.41 in chips) 
Seat 5: SmckDatAce7 ($8.83 in chips) 
Seat 6: ZIHUATKID ($4.54 in chips) 
Hersh.s7: posts small blind $0.05
ArmedOne: posts big blind $0.10
*** HOLE CARDS ***
Dealt to CashMatteo [4c 9c]
SmckDatAce7: folds 
ZIHUATKID: folds 
CashMatteo: folds 
roger875: raises $0.20 to $0.30
Hersh.s7: folds 
ArmedOne: folds 
Uncalled bet ($0.20) returned to roger875
roger875 collected $0.25 from pot
*** SUMMARY ***
Total pot $0.25 | Rake $0 
Seat 1: CashMatteo folded before Flop (didn't bet)
Seat 2: roger875 (button) collected ($0.25)
Seat 3: Hersh.s7 (small blind) folded before Flop
Seat 4: ArmedOne (big blind) folded before Flop
Seat 5: SmckDatAce7 folded before Flop (didn't bet)
Seat 6: ZIHUATKID folded before Flop (didn't bet)

Hand #2381: 

PokerStars Hand #250567877474:  Hold'em No Limit ($0.05/$0.10 CAD) - 2024/05/18 14:05:31 ET
Table 'Bohlinia IV' 6-max Seat #3 is the button
Seat 1: CashMatteo ($26.44 in chips) 
Seat 2: roger875 ($5.60 in chips) 
Seat 3: Hersh.s7 ($12.96 in chips) 
Seat 4: ArmedOne ($3.31 in chips) 
Seat 5: SmckDatAce7 ($8.83 in chips) 
Seat 6: ZIHUATKID ($4.54 in chips) 
ArmedOne: posts small blind $0.05
SmckDatAce7: posts big blind $0.10
*** HOLE CARDS ***
Dealt to CashMatteo [Jh 8h]
ZIHUATKID: calls $0.10
CashMatteo: raises $0.15 to $0.25
roger875: folds 
Hersh.s7: folds 
ArmedOne: folds 
SmckDatAce7: folds 
ZIHUATKID: calls $0.15
*** FLOP *** [9h Jd 8s]
ZIHUATKID: bets $0.10
CashMatteo: raises $0.50 to $0.60
ZIHUATKID: calls $0.50
*** TURN *** [9h Jd 8s] [8c]
ZIHUATKID: checks 
CashMatteo: checks 
*** RIVER *** [9h Jd 8s 8c] [2d]
ZIHUATKID: checks 
CashMatteo: bets $0.99
ZIHUATKID: folds 
Uncalled bet ($0.99) returned to CashMatteo
CashMatteo collected $1.77 from pot
CashMatteo: doesn't show hand 
*** SUMMARY ***
Total pot $1.85 | Rake $0.08 
Board [9h Jd 8s 8c 2d]
Seat 1: CashMatteo collected ($1.77)
Seat 2: roger875 folded before Flop (didn't bet)
Seat 3: Hersh.s7 (button) folded before Flop (didn't bet)
Seat 4: ArmedOne (small blind) folded before Flop
Seat 5: SmckDatAce7 (big blind) folded before Flop
Seat 6: ZIHUATKID folded on the River

Hand #2382: 

PokerStars Hand #250567898807:  Hold'em No Limit ($0.05/$0.10 CAD) - 2024/05/18 14:06:34 ET
Table 'Bohlinia IV' 6-max Seat #4 is the button
Seat 1: CashMatteo ($27.36 in chips) 
Seat 2: roger875 ($5.60 in chips) 
Seat 3: Hersh.s7 ($12.96 in chips) 
Seat 4: ArmedOne ($3.26 in chips) 
Seat 5: SmckDatAce7 ($8.73 in chips) 
Seat 6: ZIHUATKID ($3.69 in chips) 
SmckDatAce7: posts small blind $0.05
ZIHUATKID: posts big blind $0.10
*** HOLE CARDS ***
Dealt to CashMatteo [Ks 6c]
CashMatteo: calls $0.10
roger875: raises $0.30 to $0.40
Hersh.s7: folds 
ArmedOne: folds 
SmckDatAce7: folds 
ZIHUATKID: calls $0.30
CashMatteo: calls $0.30
*** FLOP *** [7d 4d 7s]
ZIHUATKID: checks 
CashMatteo: checks 
roger875: bets $1
ZIHUATKID: raises $1.20 to $2.20
CashMatteo: folds 
roger875: folds 
Uncalled bet ($1.20) returned to ZIHUATKID
ZIHUATKID collected $3.10 from pot
ZIHUATKID: doesn't show hand 
*** SUMMARY ***
Total pot $3.25 | Rake $0.15 
Board [7d 4d 7s]
Seat 1: CashMatteo folded on the Flop
Seat 2: roger875 folded on the Flop
Seat 3: Hersh.s7 folded before Flop (didn't bet)
Seat 4: ArmedOne (button) folded before Flop (didn't bet)
Seat 5: SmckDatAce7 (small blind) folded before Flop
Seat 6: ZIHUATKID (big blind) collected ($3.10)

Hand #2383: 

PokerStars Hand #250567914180:  Hold'em No Limit ($0.05/$0.10 CAD) - 2024/05/18 14:07:20 ET
Table 'Bohlinia IV' 6-max Seat #5 is the button
Seat 1: CashMatteo ($26.96 in chips) 
Seat 2: roger875 ($4.20 in chips) 
Seat 3: Hersh.s7 ($12.96 in chips) 
Seat 4: ArmedOne ($3.26 in chips) 
Seat 5: SmckDatAce7 ($8.68 in chips) 
Seat 6: ZIHUATKID ($5.39 in chips) 
ZIHUATKID: posts small blind $0.05
CashMatteo: posts big blind $0.10
*** HOLE CARDS ***
Dealt to CashMatteo [3c 5s]
roger875: folds 
Hersh.s7: folds 
ArmedOne: calls $0.10
SmckDatAce7: folds 
ZIHUATKID: calls $0.05
CashMatteo: checks 
*** FLOP *** [Qs 9c Qd]
ZIHUATKID: checks 
CashMatteo: checks 
ArmedOne: checks 
*** TURN *** [Qs 9c Qd] [6d]
ZIHUATKID: checks 
CashMatteo: checks 
ArmedOne: bets $0.15
ZIHUATKID: raises $0.15 to $0.30
CashMatteo: folds 
ArmedOne: calls $0.15
*** RIVER *** [Qs 9c Qd 6d] [5c]
ZIHUATKID: bets $0.60
ArmedOne: folds 
Uncalled bet ($0.60) returned to ZIHUATKID
ZIHUATKID collected $0.86 from pot
ZIHUATKID: doesn't show hand 
*** SUMMARY ***
Total pot $0.90 | Rake $0.04 
Board [Qs 9c Qd 6d 5c]
Seat 1: CashMatteo (big blind) folded on the Turn
Seat 2: roger875 folded before Flop (didn't bet)
Seat 3: Hersh.s7 folded before Flop (didn't bet)
Seat 4: ArmedOne folded on the River
Seat 5: SmckDatAce7 (button) folded before Flop (didn't bet)
Seat 6: ZIHUATKID (small blind) collected ($0.86)

Hand #2384: 

PokerStars Hand #250567931602:  Hold'em No Limit ($0.05/$0.10 CAD) - 2024/05/18 14:08:12 ET
Table 'Bohlinia IV' 6-max Seat #6 is the button
Seat 1: CashMatteo ($26.86 in chips) 
Seat 2: roger875 ($4.20 in chips) 
Seat 3: Hersh.s7 ($12.96 in chips) 
Seat 4: ArmedOne ($2.86 in chips) 
Seat 5: SmckDatAce7 ($8.68 in chips) 
Seat 6: ZIHUATKID ($5.85 in chips) 
CashMatteo: posts small blind $0.05
roger875: posts big blind $0.10
*** HOLE CARDS ***
Dealt to CashMatteo [5d 8d]
Hersh.s7: folds 
ArmedOne: calls $0.10
SmckDatAce7: folds 
ZIHUATKID: folds 
CashMatteo: calls $0.05
roger875: checks 
*** FLOP *** [Jh 2s 2h]
CashMatteo: checks 
roger875: checks 
ArmedOne: checks 
*** TURN *** [Jh 2s 2h] [7d]
CashMatteo: checks 
roger875: checks 
ArmedOne: checks 
*** RIVER *** [Jh 2s 2h 7d] [8h]
CashMatteo: checks 
roger875: checks 
ArmedOne: checks 
*** SHOW DOWN ***
CashMatteo: shows [5d 8d] (two pair, Eights and Deuces)
roger875: mucks hand 
ArmedOne: mucks hand 
CashMatteo collected $0.29 from pot
*** SUMMARY ***
Total pot $0.30 | Rake $0.01 
Board [Jh 2s 2h 7d 8h]
Seat 1: CashMatteo (small blind) showed [5d 8d] and won ($0.29) with two pair, Eights and Deuces
Seat 2: roger875 (big blind) mucked [Qd 6s]
Seat 3: Hersh.s7 folded before Flop (didn't bet)
Seat 4: ArmedOne mucked [Ac 5h]
Seat 5: SmckDatAce7 folded before Flop (didn't bet)
Seat 6: ZIHUATKID (button) folded before Flop (didn't bet)

Hand #2385: 

PokerStars Hand #250567945459:  Hold'em No Limit ($0.05/$0.10 CAD) - 2024/05/18 14:08:53 ET
Table 'Bohlinia IV' 6-max Seat #1 is the button
Seat 1: CashMatteo ($27.05 in chips) 
Seat 2: roger875 ($4.10 in chips) 
Seat 3: Hersh.s7 ($12.96 in chips) 
Seat 4: ArmedOne ($2.76 in chips) 
Seat 5: SmckDatAce7 ($8.68 in chips) 
Seat 6: ZIHUATKID ($5.85 in chips) 
roger875: posts small blind $0.05
Hersh.s7: posts big blind $0.10
*** HOLE CARDS ***
Dealt to CashMatteo [Jd 4d]
ArmedOne: calls $0.10
SmckDatAce7: raises $0.10 to $0.20
ZIHUATKID: folds 
CashMatteo: folds 
roger875: folds 
Hersh.s7: folds 
ArmedOne: calls $0.10
*** FLOP *** [4c Th 4h]
ArmedOne: checks 
SmckDatAce7: bets $0.50
ArmedOne: folds 
Uncalled bet ($0.50) returned to SmckDatAce7
SmckDatAce7 collected $0.53 from pot
SmckDatAce7: doesn't show hand 
*** SUMMARY ***
Total pot $0.55 | Rake $0.02 
Board [4c Th 4h]
Seat 1: CashMatteo (button) folded before Flop (didn't bet)
Seat 2: roger875 (small blind) folded before Flop
Seat 3: Hersh.s7 (big blind) folded before Flop
Seat 4: ArmedOne folded on the Flop
Seat 5: SmckDatAce7 collected ($0.53)
Seat 6: ZIHUATKID folded before Flop (didn't bet)

Hand #2386: 

PokerStars Hand #250567956881:  Hold'em No Limit ($0.05/$0.10 CAD) - 2024/05/18 14:09:28 ET
Table 'Bohlinia IV' 6-max Seat #2 is the button
Seat 1: CashMatteo ($27.05 in chips) 
Seat 2: roger875 ($4.05 in chips) 
Seat 3: Hersh.s7 ($12.86 in chips) 
Seat 4: ArmedOne ($2.56 in chips) 
Seat 5: SmckDatAce7 ($9.01 in chips) 
Seat 6: ZIHUATKID ($5.85 in chips) 
Hersh.s7: posts small blind $0.05
ArmedOne: posts big blind $0.10
*** HOLE CARDS ***
Dealt to CashMatteo [2s Td]
SmckDatAce7: raises $0.20 to $0.30
ZIHUATKID: folds 
CashMatteo: folds 
roger875: calls $0.30
Hersh.s7: folds 
ArmedOne: calls $0.20
*** FLOP *** [Qc 4h 8c]
ArmedOne: bets $0.91
SmckDatAce7: calls $0.91
roger875: folds 
*** TURN *** [Qc 4h 8c] [8d]
ArmedOne: bets $1.35 and is all-in
SmckDatAce7: calls $1.35
*** RIVER *** [Qc 4h 8c 8d] [7d]
*** SHOW DOWN ***
ArmedOne: shows [Qh Kh] (two pair, Queens and Eights)
SmckDatAce7: shows [Ks Qs] (two pair, Queens and Eights)
ArmedOne collected $2.61 from pot
SmckDatAce7 collected $2.61 from pot
*** SUMMARY ***
Total pot $5.47 | Rake $0.25 
Board [Qc 4h 8c 8d 7d]
Seat 1: CashMatteo folded before Flop (didn't bet)
Seat 2: roger875 (button) folded on the Flop
Seat 3: Hersh.s7 (small blind) folded before Flop
Seat 4: ArmedOne (big blind) showed [Qh Kh] and won ($2.61) with two pair, Queens and Eights
Seat 5: SmckDatAce7 showed [Ks Qs] and won ($2.61) with two pair, Queens and Eights
Seat 6: ZIHUATKID folded before Flop (didn't bet)

Hand #2387: 

PokerStars Hand #250567967559:  Hold'em No Limit ($0.05/$0.10 CAD) - 2024/05/18 14:10:01 ET
Table 'Bohlinia IV' 6-max Seat #3 is the button
Seat 1: CashMatteo ($27.05 in chips) 
Seat 2: roger875 ($3.75 in chips) 
Seat 3: Hersh.s7 ($12.81 in chips) 
Seat 4: ArmedOne ($2.61 in chips) 
Seat 5: SmckDatAce7 ($9.06 in chips) 
Seat 6: ZIHUATKID ($5.85 in chips) 
ArmedOne: posts small blind $0.05
SmckDatAce7: posts big blind $0.10
*** HOLE CARDS ***
Dealt to CashMatteo [6c 4s]
ZIHUATKID: calls $0.10
CashMatteo: folds 
roger875: folds 
Hersh.s7: folds 
ArmedOne: calls $0.05
SmckDatAce7: checks 
*** FLOP *** [Kc 9d 5h]
ArmedOne: checks 
SmckDatAce7: checks 
ZIHUATKID: checks 
*** TURN *** [Kc 9d 5h] [As]
ArmedOne: checks 
SmckDatAce7: checks 
ZIHUATKID: checks 
*** RIVER *** [Kc 9d 5h As] [8c]
ArmedOne: checks 
SmckDatAce7: checks 
ZIHUATKID: checks 
*** SHOW DOWN ***
ArmedOne: shows [7h Th] (high card Ace)
SmckDatAce7: shows [Qs 5d] (a pair of Fives)
ZIHUATKID: mucks hand 
SmckDatAce7 collected $0.29 from pot
*** SUMMARY ***
Total pot $0.30 | Rake $0.01 
Board [Kc 9d 5h As 8c]
Seat 1: CashMatteo folded before Flop (didn't bet)
Seat 2: roger875 folded before Flop (didn't bet)
Seat 3: Hersh.s7 (button) folded before Flop (didn't bet)
Seat 4: ArmedOne (small blind) showed [7h Th] and lost with high card Ace
Seat 5: SmckDatAce7 (big blind) showed [Qs 5d] and won ($0.29) with a pair of Fives
Seat 6: ZIHUATKID mucked [Td 7d]

Hand #2388: 

PokerStars Hand #250567980400:  Hold'em No Limit ($0.05/$0.10 CAD) - 2024/05/18 14:10:40 ET
Table 'Bohlinia IV' 6-max Seat #4 is the button
Seat 1: CashMatteo ($27.05 in chips) 
Seat 2: roger875 ($3.75 in chips) 
Seat 3: Hersh.s7 ($12.81 in chips) 
Seat 4: ArmedOne ($2.51 in chips) 
Seat 5: SmckDatAce7 ($9.25 in chips) 
Seat 6: ZIHUATKID ($5.75 in chips) 
SmckDatAce7: posts small blind $0.05
ZIHUATKID: posts big blind $0.10
*** HOLE CARDS ***
Dealt to CashMatteo [Kh 2h]
CashMatteo: raises $0.15 to $0.25
roger875: calls $0.25
Hersh.s7: folds 
ArmedOne: calls $0.25
SmckDatAce7: folds 
ZIHUATKID: folds 
*** FLOP *** [9c 9s 8s]
CashMatteo: checks 
roger875: checks 
ArmedOne: checks 
*** TURN *** [9c 9s 8s] [Tc]
CashMatteo: bets $0.43
roger875: folds 
ArmedOne: folds 
Uncalled bet ($0.43) returned to CashMatteo
CashMatteo collected $0.86 from pot
CashMatteo: doesn't show hand 
*** SUMMARY ***
Total pot $0.90 | Rake $0.04 
Board [9c 9s 8s Tc]
Seat 1: CashMatteo collected ($0.86)
Seat 2: roger875 folded on the Turn
Seat 3: Hersh.s7 folded before Flop (didn't bet)
Seat 4: ArmedOne (button) folded on the Turn
Seat 5: SmckDatAce7 (small blind) folded before Flop
Seat 6: ZIHUATKID (big blind) folded before Flop

Hand #2389: 

PokerStars Hand #250567994282:  Hold'em No Limit ($0.05/$0.10 CAD) - 2024/05/18 14:11:21 ET
Table 'Bohlinia IV' 6-max Seat #5 is the button
Seat 1: CashMatteo ($27.66 in chips) 
Seat 2: roger875 ($3.50 in chips) 
Seat 3: Hersh.s7 ($12.81 in chips) 
Seat 4: ArmedOne ($2.26 in chips) 
Seat 5: SmckDatAce7 ($9.20 in chips) 
Seat 6: ZIHUATKID ($5.65 in chips) 
ZIHUATKID: posts small blind $0.05
CashMatteo: posts big blind $0.10
*** HOLE CARDS ***
Dealt to CashMatteo [5h 9d]
roger875: folds 
Hersh.s7: folds 
ArmedOne: folds 
SmckDatAce7: folds 
ZIHUATKID: folds 
Uncalled bet ($0.05) returned to CashMatteo
CashMatteo collected $0.10 from pot
CashMatteo: doesn't show hand 
*** SUMMARY ***
Total pot $0.10 | Rake $0 
Seat 1: CashMatteo (big blind) collected ($0.10)
Seat 2: roger875 folded before Flop (didn't bet)
Seat 3: Hersh.s7 folded before Flop (didn't bet)
Seat 4: ArmedOne folded before Flop (didn't bet)
Seat 5: SmckDatAce7 (button) folded before Flop (didn't bet)
Seat 6: ZIHUATKID (small blind) folded before Flop

Hand #2390: 

PokerStars Hand #250567998025:  Hold'em No Limit ($0.05/$0.10 CAD) - 2024/05/18 14:11:32 ET
Table 'Bohlinia IV' 6-max Seat #6 is the button
Seat 1: CashMatteo ($27.71 in chips) 
Seat 2: roger875 ($3.50 in chips) 
Seat 3: Hersh.s7 ($12.81 in chips) 
Seat 4: ArmedOne ($2.26 in chips) 
Seat 5: SmckDatAce7 ($9.20 in chips) 
Seat 6: ZIHUATKID ($5.60 in chips) 
CashMatteo: posts small blind $0.05
roger875: posts big blind $0.10
*** HOLE CARDS ***
Dealt to CashMatteo [7c 9c]
Hersh.s7: raises $0.20 to $0.30
ArmedOne: calls $0.30
SmckDatAce7: folds 
ZIHUATKID: folds 
CashMatteo: calls $0.25
roger875: folds 
*** FLOP *** [6h 5c 6d]
CashMatteo: checks 
roger875 leaves the table
Hersh.s7: bets $0.32
ArmedOne: raises $1.64 to $1.96 and is all-in
CashMatteo: folds 
Hersh.s7: calls $1.64
*** TURN *** [6h 5c 6d] [8h]
*** RIVER *** [6h 5c 6d 8h] [8d]
*** SHOW DOWN ***
Hersh.s7: shows [Kd Kh] (two pair, Kings and Eights)
ArmedOne: shows [Ts Th] (two pair, Tens and Eights)
Hersh.s7 collected $4.70 from pot
*** SUMMARY ***
Total pot $4.92 | Rake $0.22 
Board [6h 5c 6d 8h 8d]
Seat 1: CashMatteo (small blind) folded on the Flop
Seat 2: roger875 (big blind) folded before Flop
Seat 3: Hersh.s7 showed [Kd Kh] and won ($4.70) with two pair, Kings and Eights
Seat 4: ArmedOne showed [Ts Th] and lost with two pair, Tens and Eights
Seat 5: SmckDatAce7 folded before Flop (didn't bet)
Seat 6: ZIHUATKID (button) folded before Flop (didn't bet)

Hand #2391: 

PokerStars Hand #250568012870:  Hold'em No Limit ($0.05/$0.10 CAD) - 2024/05/18 14:12:16 ET
Table 'Bohlinia IV' 6-max Seat #1 is the button
Seat 1: CashMatteo ($27.41 in chips) 
Seat 3: Hersh.s7 ($15.25 in chips) 
Seat 5: SmckDatAce7 ($9.20 in chips) 
Seat 6: ZIHUATKID ($5.60 in chips) 
Hersh.s7: posts small blind $0.05
SmckDatAce7: posts big blind $0.10
*** HOLE CARDS ***
Dealt to CashMatteo [As 5h]
ArmedOne leaves the table
ZIHUATKID: folds 
CashMatteo: calls $0.10
Hersh.s7: folds 
SmckDatAce7: checks 
*** FLOP *** [3c 8d Kd]
SmckDatAce7: checks 
CashMatteo: checks 
*** TURN *** [3c 8d Kd] [Kc]
SmckDatAce7: checks 
CashMatteo: checks 
*** RIVER *** [3c 8d Kd Kc] [Qh]
SmckDatAce7: checks 
CashMatteo: checks 
*** SHOW DOWN ***
SmckDatAce7: shows [9d 7c] (a pair of Kings)
CashMatteo: shows [As 5h] (a pair of Kings - Ace kicker)
CashMatteo collected $0.24 from pot
*** SUMMARY ***
Total pot $0.25 | Rake $0.01 
Board [3c 8d Kd Kc Qh]
Seat 1: CashMatteo (button) showed [As 5h] and won ($0.24) with a pair of Kings
Seat 3: Hersh.s7 (small blind) folded before Flop
Seat 5: SmckDatAce7 (big blind) showed [9d 7c] and lost with a pair of Kings
Seat 6: ZIHUATKID folded before Flop (didn't bet)

Hand #2392: 

PokerStars Hand #250568021715:  Hold'em No Limit ($0.05/$0.10 CAD) - 2024/05/18 14:12:43 ET
Table 'Bohlinia IV' 6-max Seat #3 is the button
Seat 1: CashMatteo ($27.55 in chips) 
Seat 3: Hersh.s7 ($15.20 in chips) 
Seat 5: SmckDatAce7 ($9.10 in chips) 
Seat 6: ZIHUATKID ($5.60 in chips) 
SmckDatAce7: posts small blind $0.05
ZIHUATKID: posts big blind $0.10
*** HOLE CARDS ***
Dealt to CashMatteo [Kd As]
CashMatteo: raises $0.15 to $0.25
Hersh.s7: folds 
60centPoker joins the table at seat #2 
SmckDatAce7: folds 
ZIHUATKID: folds 
Uncalled bet ($0.15) returned to CashMatteo
CashMatteo collected $0.25 from pot
CashMatteo: doesn't show hand 
*** SUMMARY ***
Total pot $0.25 | Rake $0 
Seat 1: CashMatteo collected ($0.25)
Seat 3: Hersh.s7 (button) folded before Flop (didn't bet)
Seat 5: SmckDatAce7 (small blind) folded before Flop
Seat 6: ZIHUATKID (big blind) folded before Flop

Hand #2393: 

PokerStars Hand #250568026753:  Hold'em No Limit ($0.05/$0.10 CAD) - 2024/05/18 14:12:58 ET
Table 'Bohlinia IV' 6-max Seat #5 is the button
Seat 1: CashMatteo ($27.70 in chips) 
Seat 3: Hersh.s7 ($15.20 in chips) 
Seat 5: SmckDatAce7 ($9.05 in chips) 
Seat 6: ZIHUATKID ($5.50 in chips) 
ZIHUATKID: posts small blind $0.05
CashMatteo: posts big blind $0.10
60centPoker: sits out 
*** HOLE CARDS ***
Dealt to CashMatteo [3d 8c]
Hersh.s7: folds 
SmckDatAce7: folds 
ZIHUATKID: folds 
Uncalled bet ($0.05) returned to CashMatteo
CashMatteo collected $0.10 from pot
CashMatteo: doesn't show hand 
*** SUMMARY ***
Total pot $0.10 | Rake $0 
Seat 1: CashMatteo (big blind) collected ($0.10)
Seat 3: Hersh.s7 folded before Flop (didn't bet)
Seat 5: SmckDatAce7 (button) folded before Flop (didn't bet)
Seat 6: ZIHUATKID (small blind) folded before Flop

Hand #2394: 

PokerStars Hand #250568030347:  Hold'em No Limit ($0.05/$0.10 CAD) - 2024/05/18 14:13:09 ET
Table 'Bohlinia IV' 6-max Seat #6 is the button
Seat 1: CashMatteo ($27.75 in chips) 
Seat 2: 60centPoker ($10 in chips) 
Seat 3: Hersh.s7 ($15.20 in chips) 
Seat 5: SmckDatAce7 ($9.05 in chips) 
Seat 6: ZIHUATKID ($5.45 in chips) 
CashMatteo: posts small blind $0.05
60centPoker: posts big blind $0.10
*** HOLE CARDS ***
Dealt to CashMatteo [6d Ad]
Hersh.s7: folds 
SmckDatAce7: raises $0.10 to $0.20
ZIHUATKID: folds 
CashMatteo: calls $0.15
60centPoker: folds 
*** FLOP *** [5d 9d Ks]
CashMatteo: checks 
SmckDatAce7: bets $0.40
joetreviso joins the table at seat #4 
CashMatteo: calls $0.40
*** TURN *** [5d 9d Ks] [8s]
CashMatteo: checks 
SmckDatAce7: bets $0.82
CashMatteo: calls $0.82
*** RIVER *** [5d 9d Ks 8s] [8d]
CashMatteo: bets $3.51
SmckDatAce7: folds 
Uncalled bet ($3.51) returned to CashMatteo
CashMatteo collected $2.81 from pot
CashMatteo: doesn't show hand 
*** SUMMARY ***
Total pot $2.94 | Rake $0.13 
Board [5d 9d Ks 8s 8d]
Seat 1: CashMatteo (small blind) collected ($2.81)
Seat 2: 60centPoker (big blind) folded before Flop
Seat 3: Hersh.s7 folded before Flop (didn't bet)
Seat 5: SmckDatAce7 folded on the River
Seat 6: ZIHUATKID (button) folded before Flop (didn't bet)

Hand #2395: 

PokerStars Hand #250568052316:  Hold'em No Limit ($0.05/$0.10 CAD) - 2024/05/18 14:14:15 ET
Table 'Bohlinia IV' 6-max Seat #1 is the button
Seat 1: CashMatteo ($29.14 in chips) 
Seat 2: 60centPoker ($9.90 in chips) 
Seat 3: Hersh.s7 ($15.20 in chips) 
Seat 5: SmckDatAce7 ($7.63 in chips) 
Seat 6: ZIHUATKID ($5.45 in chips) 
60centPoker: posts small blind $0.05
Hersh.s7: posts big blind $0.10
joetreviso: sits out 
*** HOLE CARDS ***
Dealt to CashMatteo [Kd 3h]
SmckDatAce7: raises $0.10 to $0.20
ZIHUATKID: folds 
CashMatteo: calls $0.20
60centPoker: folds 
Hersh.s7: folds 
*** FLOP *** [6d 3s 2h]
SmckDatAce7: bets $0.30
CashMatteo: calls $0.30
*** TURN *** [6d 3s 2h] [8s]
SmckDatAce7: bets $0.55
CashMatteo: calls $0.55
*** RIVER *** [6d 3s 2h 8s] [3d]
SmckDatAce7: bets $2.15
CashMatteo: calls $2.15
*** SHOW DOWN ***
SmckDatAce7: shows [7d 7c] (two pair, Sevens and Threes)
CashMatteo: shows [Kd 3h] (three of a kind, Threes)
CashMatteo collected $6.26 from pot
*** SUMMARY ***
Total pot $6.55 | Rake $0.29 
Board [6d 3s 2h 8s 3d]
Seat 1: CashMatteo (button) showed [Kd 3h] and won ($6.26) with three of a kind, Threes
Seat 2: 60centPoker (small blind) folded before Flop
Seat 3: Hersh.s7 (big blind) folded before Flop
Seat 5: SmckDatAce7 showed [7d 7c] and lost with two pair, Sevens and Threes
Seat 6: ZIHUATKID folded before Flop (didn't bet)

Hand #2396: 

PokerStars Hand #250568067753:  Hold'em No Limit ($0.05/$0.10 CAD) - 2024/05/18 14:15:00 ET
Table 'Bohlinia IV' 6-max Seat #2 is the button
Seat 1: CashMatteo ($32.20 in chips) 
Seat 2: 60centPoker ($9.85 in chips) 
Seat 3: Hersh.s7 ($15.10 in chips) 
Seat 4: joetreviso ($10 in chips) 
Seat 5: SmckDatAce7 ($4.43 in chips) 
Seat 6: ZIHUATKID ($5.45 in chips) 
Hersh.s7: posts small blind $0.05
joetreviso: posts big blind $0.10
*** HOLE CARDS ***
Dealt to CashMatteo [Jh 8c]
SmckDatAce7: folds 
ZIHUATKID: folds 
CashMatteo: calls $0.10
60centPoker: folds 
Hersh.s7: folds 
joetreviso: raises $0.25 to $0.35
CashMatteo: calls $0.25
*** FLOP *** [2c 6d 3s]
joetreviso: checks 
CashMatteo: checks 
*** TURN *** [2c 6d 3s] [Ac]
joetreviso: bets $0.72
CashMatteo: folds 
Uncalled bet ($0.72) returned to joetreviso
joetreviso collected $0.72 from pot
joetreviso: doesn't show hand 
*** SUMMARY ***
Total pot $0.75 | Rake $0.03 
Board [2c 6d 3s Ac]
Seat 1: CashMatteo folded on the Turn
Seat 2: 60centPoker (button) folded before Flop (didn't bet)
Seat 3: Hersh.s7 (small blind) folded before Flop
Seat 4: joetreviso (big blind) collected ($0.72)
Seat 5: SmckDatAce7 folded before Flop (didn't bet)
Seat 6: ZIHUATKID folded before Flop (didn't bet)

Hand #2397: 

PokerStars Hand #250568077681:  Hold'em No Limit ($0.05/$0.10 CAD) - 2024/05/18 14:15:29 ET
Table 'Bohlinia IV' 6-max Seat #3 is the button
Seat 1: CashMatteo ($31.85 in chips) 
Seat 2: 60centPoker ($9.85 in chips) 
Seat 3: Hersh.s7 ($15.05 in chips) 
Seat 4: joetreviso ($10.37 in chips) 
Seat 5: SmckDatAce7 ($10 in chips) 
Seat 6: ZIHUATKID ($5.45 in chips) 
joetreviso: posts small blind $0.05
SmckDatAce7: posts big blind $0.10
*** HOLE CARDS ***
Dealt to CashMatteo [Th 9h]
ZIHUATKID: calls $0.10
CashMatteo: raises $0.15 to $0.25
60centPoker: folds 
Hersh.s7: folds 
joetreviso: folds 
SmckDatAce7: folds 
ZIHUATKID: calls $0.15
*** FLOP *** [Kc 4s 3d]
ZIHUATKID: checks 
CashMatteo: bets $0.31
ZIHUATKID: folds 
Uncalled bet ($0.31) returned to CashMatteo
CashMatteo collected $0.62 from pot
CashMatteo: doesn't show hand 
*** SUMMARY ***
Total pot $0.65 | Rake $0.03 
Board [Kc 4s 3d]
Seat 1: CashMatteo collected ($0.62)
Seat 2: 60centPoker folded before Flop (didn't bet)
Seat 3: Hersh.s7 (button) folded before Flop (didn't bet)
Seat 4: joetreviso (small blind) folded before Flop
Seat 5: SmckDatAce7 (big blind) folded before Flop
Seat 6: ZIHUATKID folded on the Flop

Hand #2398: 

PokerStars Hand #250568087764:  Hold'em No Limit ($0.05/$0.10 CAD) - 2024/05/18 14:15:59 ET
Table 'Bohlinia IV' 6-max Seat #4 is the button
Seat 1: CashMatteo ($32.22 in chips) 
Seat 2: 60centPoker ($9.85 in chips) 
Seat 3: Hersh.s7 ($15.05 in chips) 
Seat 4: joetreviso ($10.32 in chips) 
Seat 5: SmckDatAce7 ($9.90 in chips) 
Seat 6: ZIHUATKID ($5.20 in chips) 
SmckDatAce7: posts small blind $0.05
ZIHUATKID: posts big blind $0.10
*** HOLE CARDS ***
Dealt to CashMatteo [Kd Jh]
CashMatteo: raises $0.15 to $0.25
60centPoker: folds 
Hersh.s7: folds 
joetreviso: folds 
SmckDatAce7: folds 
ZIHUATKID: calls $0.15
*** FLOP *** [9h 7s 7d]
ZIHUATKID: checks 
CashMatteo: checks 
*** TURN *** [9h 7s 7d] [2c]
ZIHUATKID: bets $0.10
CashMatteo: calls $0.10
*** RIVER *** [9h 7s 7d 2c] [Ac]
ZIHUATKID: checks 
CashMatteo: checks 
*** SHOW DOWN ***
ZIHUATKID: shows [9d 8c] (two pair, Nines and Sevens)
CashMatteo: mucks hand 
ZIHUATKID collected $0.72 from pot
*** SUMMARY ***
Total pot $0.75 | Rake $0.03 
Board [9h 7s 7d 2c Ac]
Seat 1: CashMatteo mucked [Kd Jh]
Seat 2: 60centPoker folded before Flop (didn't bet)
Seat 3: Hersh.s7 folded before Flop (didn't bet)
Seat 4: joetreviso (button) folded before Flop (didn't bet)
Seat 5: SmckDatAce7 (small blind) folded before Flop
Seat 6: ZIHUATKID (big blind) showed [9d 8c] and won ($0.72) with two pair, Nines and Sevens

Hand #2399: 

PokerStars Hand #250568102927:  Hold'em No Limit ($0.05/$0.10 CAD) - 2024/05/18 14:16:47 ET
Table 'Bohlinia IV' 6-max Seat #5 is the button
Seat 1: CashMatteo ($31.87 in chips) 
Seat 2: 60centPoker ($9.85 in chips) 
Seat 3: Hersh.s7 ($15.05 in chips) 
Seat 4: joetreviso ($10.32 in chips) 
Seat 5: SmckDatAce7 ($9.85 in chips) 
Seat 6: ZIHUATKID ($5.57 in chips) 
ZIHUATKID: posts small blind $0.05
CashMatteo: posts big blind $0.10
*** HOLE CARDS ***
Dealt to CashMatteo [8d Ad]
60centPoker: folds 
Hersh.s7: folds 
joetreviso: raises $0.10 to $0.20
SmckDatAce7: folds 
ZIHUATKID: folds 
CashMatteo: calls $0.10
*** FLOP *** [Ah Th 8c]
CashMatteo: checks 
joetreviso: bets $0.43
CashMatteo: calls $0.43
*** TURN *** [Ah Th 8c] [7c]
CashMatteo: checks 
joetreviso: bets $1.25
CashMatteo: raises $3.75 to $5
joetreviso: folds 
Uncalled bet ($3.75) returned to CashMatteo
CashMatteo collected $3.64 from pot
CashMatteo: doesn't show hand 
*** SUMMARY ***
Total pot $3.81 | Rake $0.17 
Board [Ah Th 8c 7c]
Seat 1: CashMatteo (big blind) collected ($3.64)
Seat 2: 60centPoker folded before Flop (didn't bet)
Seat 3: Hersh.s7 folded before Flop (didn't bet)
Seat 4: joetreviso folded on the Turn
Seat 5: SmckDatAce7 (button) folded before Flop (didn't bet)
Seat 6: ZIHUATKID (small blind) folded before Flop

Hand #2400: 

PokerStars Hand #250568123142:  Hold'em No Limit ($0.05/$0.10 CAD) - 2024/05/18 14:17:48 ET
Table 'Bohlinia IV' 6-max Seat #6 is the button
Seat 1: CashMatteo ($33.63 in chips) 
Seat 2: 60centPoker ($9.85 in chips) 
Seat 3: Hersh.s7 ($15.05 in chips) 
Seat 4: joetreviso ($8.44 in chips) 
Seat 5: SmckDatAce7 ($9.85 in chips) 
Seat 6: ZIHUATKID ($5.52 in chips) 
CashMatteo: posts small blind $0.05
60centPoker: posts big blind $0.10
*** HOLE CARDS ***
Dealt to CashMatteo [Ac 6c]
Hersh.s7: folds 
joetreviso: folds 
SmckDatAce7: folds 
ZIHUATKID: calls $0.10
CashMatteo: raises $0.15 to $0.25
60centPoker: folds 
ZIHUATKID: raises $0.15 to $0.40
CashMatteo: calls $0.15
*** FLOP *** [As Kd 8h]
CashMatteo: checks 
ZIHUATKID: checks 
*** TURN *** [As Kd 8h] [9s]
CashMatteo: checks 
ZIHUATKID: bets $0.10
CashMatteo: raises $0.53 to $0.63
ZIHUATKID: calls $0.53
*** RIVER *** [As Kd 8h 9s] [Jd]
CashMatteo: checks 
ZIHUATKID: bets $0.30
CashMatteo: raises $1.33 to $1.63
ZIHUATKID: calls $1.33
*** SHOW DOWN ***
CashMatteo: shows [Ac 6c] (a pair of Aces)
ZIHUATKID: shows [Ks Jc] (two pair, Kings and Jacks)
ZIHUATKID collected $5.18 from pot
*** SUMMARY ***
Total pot $5.42 | Rake $0.24 
Board [As Kd 8h 9s Jd]
Seat 1: CashMatteo (small blind) showed [Ac 6c] and lost with a pair of Aces
Seat 2: 60centPoker (big blind) folded before Flop
Seat 3: Hersh.s7 folded before Flop (didn't bet)
Seat 4: joetreviso folded before Flop (didn't bet)
Seat 5: SmckDatAce7 folded before Flop (didn't bet)
Seat 6: ZIHUATKID (button) showed [Ks Jc] and won ($5.18) with two pair, Kings and Jacks

Hand #2401: 

PokerStars Hand #250568149349:  Hold'em No Limit ($0.05/$0.10 CAD) - 2024/05/18 14:19:06 ET
Table 'Bohlinia IV' 6-max Seat #1 is the button
Seat 1: CashMatteo ($30.97 in chips) 
Seat 2: 60centPoker ($9.75 in chips) 
Seat 3: Hersh.s7 ($15.05 in chips) 
Seat 4: joetreviso ($8.44 in chips) 
Seat 5: SmckDatAce7 ($9.85 in chips) 
Seat 6: ZIHUATKID ($8.04 in chips) 
60centPoker: posts small blind $0.05
Hersh.s7: posts big blind $0.10
*** HOLE CARDS ***
Dealt to CashMatteo [8s 2d]
joetreviso: folds 
SmckDatAce7: folds 
ZIHUATKID: folds 
CashMatteo: folds 
60centPoker: folds 
Uncalled bet ($0.05) returned to Hersh.s7
Hersh.s7 collected $0.10 from pot
*** SUMMARY ***
Total pot $0.10 | Rake $0 
Seat 1: CashMatteo (button) folded before Flop (didn't bet)
Seat 2: 60centPoker (small blind) folded before Flop
Seat 3: Hersh.s7 (big blind) collected ($0.10)
Seat 4: joetreviso folded before Flop (didn't bet)
Seat 5: SmckDatAce7 folded before Flop (didn't bet)
Seat 6: ZIHUATKID folded before Flop (didn't bet)

Hand #2402: 

PokerStars Hand #250568155580:  Hold'em No Limit ($0.05/$0.10 CAD) - 2024/05/18 14:19:24 ET
Table 'Bohlinia IV' 6-max Seat #2 is the button
Seat 1: CashMatteo ($30.97 in chips) 
Seat 2: 60centPoker ($9.70 in chips) 
Seat 3: Hersh.s7 ($15.10 in chips) 
Seat 4: joetreviso ($8.44 in chips) 
Seat 5: SmckDatAce7 ($9.85 in chips) 
Seat 6: ZIHUATKID ($8.04 in chips) 
Hersh.s7: posts small blind $0.05
joetreviso: posts big blind $0.10
*** HOLE CARDS ***
Dealt to CashMatteo [Jd 8s]
SmckDatAce7: folds 
ZIHUATKID: calls $0.10
CashMatteo: raises $0.15 to $0.25
60centPoker: folds 
Hersh.s7: folds 
joetreviso: folds 
ZIHUATKID: calls $0.15
*** FLOP *** [Kc Ah Jh]
ZIHUATKID: checks 
CashMatteo: bets $0.41
ZIHUATKID: folds 
Uncalled bet ($0.41) returned to CashMatteo
CashMatteo collected $0.62 from pot
CashMatteo: doesn't show hand 
*** SUMMARY ***
Total pot $0.65 | Rake $0.03 
Board [Kc Ah Jh]
Seat 1: CashMatteo collected ($0.62)
Seat 2: 60centPoker (button) folded before Flop (didn't bet)
Seat 3: Hersh.s7 (small blind) folded before Flop
Seat 4: joetreviso (big blind) folded before Flop
Seat 5: SmckDatAce7 folded before Flop (didn't bet)
Seat 6: ZIHUATKID folded on the Flop

Hand #2403: 

PokerStars Hand #250568169592:  Hold'em No Limit ($0.05/$0.10 CAD) - 2024/05/18 14:20:06 ET
Table 'Bohlinia IV' 6-max Seat #3 is the button
Seat 1: CashMatteo ($31.34 in chips) 
Seat 2: 60centPoker ($9.70 in chips) 
Seat 3: Hersh.s7 ($15.05 in chips) 
Seat 4: joetreviso ($8.34 in chips) 
Seat 5: SmckDatAce7 ($9.85 in chips) 
Seat 6: ZIHUATKID ($7.79 in chips) 
joetreviso: posts small blind $0.05
SmckDatAce7: posts big blind $0.10
*** HOLE CARDS ***
Dealt to CashMatteo [5h Ts]
ZIHUATKID: folds 
CashMatteo: folds 
60centPoker: raises $0.20 to $0.30
Hersh.s7: calls $0.30
joetreviso: folds 
SmckDatAce7: calls $0.20
*** FLOP *** [3c 6c 9h]
SmckDatAce7: bets $0.46
60centPoker: folds 
Hersh.s7: calls $0.46
*** TURN *** [3c 6c 9h] [7c]
SmckDatAce7: bets $1
Hersh.s7: calls $1
*** RIVER *** [3c 6c 9h 7c] [3h]
SmckDatAce7: bets $3.70
Hersh.s7: raises $5.55 to $9.25
SmckDatAce7: calls $4.39 and is all-in
Uncalled bet ($1.16) returned to Hersh.s7
*** SHOW DOWN ***
Hersh.s7: shows [6d 6h] (a full house, Sixes full of Threes)
SmckDatAce7: shows [Jd Jh] (two pair, Jacks and Threes)
Hersh.s7 collected $19.15 from pot
*** SUMMARY ***
Total pot $20.05 | Rake $0.90 
Board [3c 6c 9h 7c 3h]
Seat 1: CashMatteo folded before Flop (didn't bet)
Seat 2: 60centPoker folded on the Flop
Seat 3: Hersh.s7 (button) showed [6d 6h] and won ($19.15) with a full house, Sixes full of Threes
Seat 4: joetreviso (small blind) folded before Flop
Seat 5: SmckDatAce7 (big blind) showed [Jd Jh] and lost with two pair, Jacks and Threes
Seat 6: ZIHUATKID folded before Flop (didn't bet)

Hand #2404: 

PokerStars Hand #250568191648:  Hold'em No Limit ($0.05/$0.10 CAD) - 2024/05/18 14:21:11 ET
Table 'Bohlinia IV' 6-max Seat #4 is the button
Seat 1: CashMatteo ($31.34 in chips) 
Seat 2: 60centPoker ($9.40 in chips) 
Seat 3: Hersh.s7 ($24.35 in chips) 
Seat 4: joetreviso ($8.29 in chips) 
Seat 6: ZIHUATKID ($7.79 in chips) 
SmckDatAce7 leaves the table
ZIHUATKID: posts small blind $0.05
CashMatteo: posts big blind $0.10
*** HOLE CARDS ***
Dealt to CashMatteo [8s 8h]
60centPoker: folds 
Hersh.s7: folds 
joetreviso: folds 
ZIHUATKID: folds 
Uncalled bet ($0.05) returned to CashMatteo
CashMatteo collected $0.10 from pot
CashMatteo: doesn't show hand 
*** SUMMARY ***
Total pot $0.10 | Rake $0 
Seat 1: CashMatteo (big blind) collected ($0.10)
Seat 2: 60centPoker folded before Flop (didn't bet)
Seat 3: Hersh.s7 folded before Flop (didn't bet)
Seat 4: joetreviso (button) folded before Flop (didn't bet)
Seat 6: ZIHUATKID (small blind) folded before Flop

Hand #2405: 

PokerStars Hand #250568196307:  Hold'em No Limit ($0.05/$0.10 CAD) - 2024/05/18 14:21:25 ET
Table 'Bohlinia IV' 6-max Seat #6 is the button
Seat 1: CashMatteo ($31.39 in chips) 
Seat 2: 60centPoker ($9.40 in chips) 
Seat 3: Hersh.s7 ($24.35 in chips) 
Seat 4: joetreviso ($8.29 in chips) 
Seat 6: ZIHUATKID ($7.74 in chips) 
CashMatteo: posts small blind $0.05
60centPoker: posts big blind $0.10
*** HOLE CARDS ***
Dealt to CashMatteo [Qh Ks]
Hersh.s7: folds 
joetreviso: folds 
ZIHUATKID: folds 
CashMatteo: raises $0.15 to $0.25
60centPoker: raises $0.49 to $0.74
CashMatteo: calls $0.49
*** FLOP *** [Td 8d Ah]
CashMatteo: checks 
60centPoker: bets $0.10
CashMatteo: calls $0.10
*** TURN *** [Td 8d Ah] [5c]
CashMatteo: checks 
60centPoker: checks 
*** RIVER *** [Td 8d Ah 5c] [9c]
CashMatteo: checks 
60centPoker: checks 
*** SHOW DOWN ***
CashMatteo: shows [Qh Ks] (high card Ace)
60centPoker: shows [Th Kd] (a pair of Tens)
60centPoker collected $1.60 from pot
*** SUMMARY ***
Total pot $1.68 | Rake $0.08 
Board [Td 8d Ah 5c 9c]
Seat 1: CashMatteo (small blind) showed [Qh Ks] and lost with high card Ace
Seat 2: 60centPoker (big blind) showed [Th Kd] and won ($1.60) with a pair of Tens
Seat 3: Hersh.s7 folded before Flop (didn't bet)
Seat 4: joetreviso folded before Flop (didn't bet)
Seat 6: ZIHUATKID (button) folded before Flop (didn't bet)

Hand #2406: 

PokerStars Hand #250568219246:  Hold'em No Limit ($0.05/$0.10 CAD) - 2024/05/18 14:22:33 ET
Table 'Bohlinia IV' 6-max Seat #1 is the button
Seat 1: CashMatteo ($30.55 in chips) 
Seat 2: 60centPoker ($10.16 in chips) 
Seat 3: Hersh.s7 ($24.35 in chips) 
Seat 4: joetreviso ($8.29 in chips) 
Seat 6: ZIHUATKID ($7.74 in chips) 
60centPoker: posts small blind $0.05
Hersh.s7: posts big blind $0.10
*** HOLE CARDS ***
Dealt to CashMatteo [Tc Th]
joetreviso: folds 
ZIHUATKID: calls $0.10
CashMatteo: raises $0.15 to $0.25
60centPoker: folds 
Hersh.s7: folds 
ZIHUATKID: calls $0.15
*** FLOP *** [Qh 6d 4h]
ZIHUATKID: checks 
CashMatteo: bets $0.31
ZIHUATKID: folds 
Uncalled bet ($0.31) returned to CashMatteo
CashMatteo collected $0.62 from pot
CashMatteo: doesn't show hand 
*** SUMMARY ***
Total pot $0.65 | Rake $0.03 
Board [Qh 6d 4h]
Seat 1: CashMatteo (button) collected ($0.62)
Seat 2: 60centPoker (small blind) folded before Flop
Seat 3: Hersh.s7 (big blind) folded before Flop
Seat 4: joetreviso folded before Flop (didn't bet)
Seat 6: ZIHUATKID folded on the Flop

Hand #2407: 

PokerStars Hand #250568232795:  Hold'em No Limit ($0.05/$0.10 CAD) - 2024/05/18 14:23:13 ET
Table 'Bohlinia IV' 6-max Seat #2 is the button
Seat 1: CashMatteo ($30.92 in chips) 
Seat 2: 60centPoker ($10.11 in chips) 
Seat 3: Hersh.s7 ($24.25 in chips) 
Seat 4: joetreviso ($10 in chips) 
Seat 6: ZIHUATKID ($7.49 in chips) 
Hersh.s7: posts small blind $0.05
joetreviso: posts big blind $0.10
*** HOLE CARDS ***
Dealt to CashMatteo [Ks Kh]
ZIHUATKID: folds 
CashMatteo: raises $0.15 to $0.25
60centPoker: folds 
Hersh.s7: folds 
joetreviso: calls $0.15
*** FLOP *** [Jh 7s 8h]
joetreviso: checks 
CashMatteo: bets $0.27
joetreviso: calls $0.27
*** TURN *** [Jh 7s 8h] [Tc]
joetreviso: checks 
CashMatteo: bets $0.82
joetreviso: calls $0.82
*** RIVER *** [Jh 7s 8h Tc] [7c]
joetreviso: checks 
CashMatteo: checks 
*** SHOW DOWN ***
joetreviso: shows [Th Qh] (two pair, Tens and Sevens)
CashMatteo: shows [Ks Kh] (two pair, Kings and Sevens)
CashMatteo collected $2.61 from pot
*** SUMMARY ***
Total pot $2.73 | Rake $0.12 
Board [Jh 7s 8h Tc 7c]
Seat 1: CashMatteo showed [Ks Kh] and won ($2.61) with two pair, Kings and Sevens
Seat 2: 60centPoker (button) folded before Flop (didn't bet)
Seat 3: Hersh.s7 (small blind) folded before Flop
Seat 4: joetreviso (big blind) showed [Th Qh] and lost with two pair, Tens and Sevens
Seat 6: ZIHUATKID folded before Flop (didn't bet)

Hand #2408: 

PokerStars Hand #250568248753:  Hold'em No Limit ($0.05/$0.10 CAD) - 2024/05/18 14:24:00 ET
Table 'Bohlinia IV' 6-max Seat #3 is the button
Seat 1: CashMatteo ($32.19 in chips) 
Seat 2: 60centPoker ($10.11 in chips) 
Seat 3: Hersh.s7 ($24.20 in chips) 
Seat 4: joetreviso ($8.66 in chips) 
Seat 6: ZIHUATKID ($7.49 in chips) 
joetreviso: posts small blind $0.05
ZIHUATKID: posts big blind $0.10
*** HOLE CARDS ***
Dealt to CashMatteo [4s Jh]
CashMatteo: folds 
60centPoker: folds 
Hersh.s7: folds 
joetreviso: folds 
Uncalled bet ($0.05) returned to ZIHUATKID
CashMatteo leaves the table
ZIHUATKID collected $0.10 from pot
ZIHUATKID: doesn't show hand 
*** SUMMARY ***
Total pot $0.10 | Rake $0 
Seat 1: CashMatteo folded before Flop (didn't bet)
Seat 2: 60centPoker folded before Flop (didn't bet)
Seat 3: Hersh.s7 (button) folded before Flop (didn't bet)
Seat 4: joetreviso (small blind) folded before Flop
Seat 6: ZIHUATKID (big blind) collected ($0.10)

Hand #2409: 

PokerStars Hand #250568822969:  Hold'em No Limit ($0.10/$0.25 CAD) - 2024/05/18 14:52:46 ET
Table 'Sadalbari III' 6-max Seat #4 is the button
Seat 1: Missinagnew ($38.96 in chips) 
Seat 2: hickdaddyx2 ($18.59 in chips) 
Seat 3: SikaTrx ($25.28 in chips) 
Seat 4: crdalchemy93 ($32.32 in chips) 
Seat 5: SSSS AM E SOSA ($21.44 in chips) 
Seat 6: CashMatteo ($13.50 in chips) 
SSSS AM E SOSA: posts small blind $0.10
CashMatteo: posts big blind $0.25
*** HOLE CARDS ***
Dealt to CashMatteo [Qc 6c]
Missinagnew: folds 
hickdaddyx2: calls $0.25
SikaTrx: folds 
crdalchemy93: folds 
SSSS AM E SOSA: calls $0.15
CashMatteo: checks 
*** FLOP *** [Qs 3c 8d]
SSSS AM E SOSA: checks 
CashMatteo: bets $0.36
hickdaddyx2: folds 
SSSS AM E SOSA: raises $1.44 to $1.80
CashMatteo: calls $1.44
*** TURN *** [Qs 3c 8d] [9s]
SSSS AM E SOSA: bets $4.15
CashMatteo: folds 
Uncalled bet ($4.15) returned to SSSS AM E SOSA
SSSS AM E SOSA collected $4.15 from pot
*** SUMMARY ***
Total pot $4.35 | Rake $0.20 
Board [Qs 3c 8d 9s]
Seat 1: Missinagnew folded before Flop (didn't bet)
Seat 2: hickdaddyx2 folded on the Flop
Seat 3: SikaTrx folded before Flop (didn't bet)
Seat 4: crdalchemy93 (button) folded before Flop (didn't bet)
Seat 5: SSSS AM E SOSA (small blind) collected ($4.15)
Seat 6: CashMatteo (big blind) folded on the Turn

Hand #2410: 

PokerStars Hand #250568842735:  Hold'em No Limit ($0.10/$0.25 CAD) - 2024/05/18 14:53:45 ET
Table 'Sadalbari III' 6-max Seat #5 is the button
Seat 1: Missinagnew ($38.96 in chips) 
Seat 2: hickdaddyx2 ($18.34 in chips) 
Seat 3: SikaTrx ($25.28 in chips) 
Seat 4: crdalchemy93 ($32.32 in chips) 
Seat 5: SSSS AM E SOSA ($23.54 in chips) 
Seat 6: CashMatteo ($11.45 in chips) 
CashMatteo: posts small blind $0.10
Missinagnew: posts big blind $0.25
*** HOLE CARDS ***
Dealt to CashMatteo [6h 5d]
hickdaddyx2: calls $0.25
SikaTrx: folds 
crdalchemy93: folds 
SSSS AM E SOSA: folds 
CashMatteo: folds 
Missinagnew: checks 
*** FLOP *** [7c 7s Ts]
Missinagnew: checks 
hickdaddyx2: checks 
*** TURN *** [7c 7s Ts] [2s]
Missinagnew: checks 
hickdaddyx2: checks 
*** RIVER *** [7c 7s Ts 2s] [8s]
Missinagnew: checks 
hickdaddyx2: bets $0.57
Missinagnew: calls $0.57
*** SHOW DOWN ***
hickdaddyx2: shows [As 4h] (a flush, Ace high)
Missinagnew: mucks hand 
hickdaddyx2 collected $1.66 from pot
*** SUMMARY ***
Total pot $1.74 | Rake $0.08 
Board [7c 7s Ts 2s 8s]
Seat 1: Missinagnew (big blind) mucked [Qh 6s]
Seat 2: hickdaddyx2 showed [As 4h] and won ($1.66) with a flush, Ace high
Seat 3: SikaTrx folded before Flop (didn't bet)
Seat 4: crdalchemy93 folded before Flop (didn't bet)
Seat 5: SSSS AM E SOSA (button) folded before Flop (didn't bet)
Seat 6: CashMatteo (small blind) folded before Flop

Hand #2411: 

PokerStars Hand #250568861392:  Hold'em No Limit ($0.10/$0.25 CAD) - 2024/05/18 14:54:42 ET
Table 'Sadalbari III' 6-max Seat #6 is the button
Seat 1: Missinagnew ($38.14 in chips) 
Seat 2: hickdaddyx2 ($19.18 in chips) 
Seat 3: SikaTrx ($25.28 in chips) 
Seat 4: crdalchemy93 ($32.32 in chips) 
Seat 5: SSSS AM E SOSA ($23.54 in chips) 
Seat 6: CashMatteo ($11.35 in chips) 
Missinagnew: posts small blind $0.10
hickdaddyx2: posts big blind $0.25
*** HOLE CARDS ***
Dealt to CashMatteo [9s 6h]
SikaTrx: folds 
crdalchemy93: folds 
SSSS AM E SOSA: folds 
CashMatteo: folds 
Missinagnew: raises $0.37 to $0.62
hickdaddyx2: folds 
Uncalled bet ($0.37) returned to Missinagnew
Missinagnew collected $0.50 from pot
Missinagnew: doesn't show hand 
*** SUMMARY ***
Total pot $0.50 | Rake $0 
Seat 1: Missinagnew (small blind) collected ($0.50)
Seat 2: hickdaddyx2 (big blind) folded before Flop
Seat 3: SikaTrx folded before Flop (didn't bet)
Seat 4: crdalchemy93 folded before Flop (didn't bet)
Seat 5: SSSS AM E SOSA folded before Flop (didn't bet)
Seat 6: CashMatteo (button) folded before Flop (didn't bet)

Hand #2412: 

PokerStars Hand #250568866113:  Hold'em No Limit ($0.10/$0.25 CAD) - 2024/05/18 14:54:56 ET
Table 'Sadalbari III' 6-max Seat #1 is the button
Seat 1: Missinagnew ($38.39 in chips) 
Seat 2: hickdaddyx2 ($18.93 in chips) 
Seat 3: SikaTrx ($25.28 in chips) 
Seat 4: crdalchemy93 ($32.32 in chips) 
Seat 5: SSSS AM E SOSA ($23.54 in chips) 
Seat 6: CashMatteo ($11.35 in chips) 
hickdaddyx2: posts small blind $0.10
SikaTrx: posts big blind $0.25
*** HOLE CARDS ***
Dealt to CashMatteo [Qd Qs]
crdalchemy93: folds 
SSSS AM E SOSA: folds 
CashMatteo: raises $0.37 to $0.62
Missinagnew: folds 
hickdaddyx2: folds 
SikaTrx: folds 
Uncalled bet ($0.37) returned to CashMatteo
CashMatteo collected $0.60 from pot
CashMatteo: doesn't show hand 
*** SUMMARY ***
Total pot $0.60 | Rake $0 
Seat 1: Missinagnew (button) folded before Flop (didn't bet)
Seat 2: hickdaddyx2 (small blind) folded before Flop
Seat 3: SikaTrx (big blind) folded before Flop
Seat 4: crdalchemy93 folded before Flop (didn't bet)
Seat 5: SSSS AM E SOSA folded before Flop (didn't bet)
Seat 6: CashMatteo collected ($0.60)

Hand #2413: 

PokerStars Hand #250568873772:  Hold'em No Limit ($0.10/$0.25 CAD) - 2024/05/18 14:55:30 ET
Table 'Sadalbari III' 6-max Seat #2 is the button
Seat 1: Missinagnew ($38.39 in chips) 
Seat 2: hickdaddyx2 ($18.83 in chips) 
Seat 3: SikaTrx ($25.03 in chips) 
Seat 4: crdalchemy93 ($32.32 in chips) 
Seat 5: SSSS AM E SOSA ($23.54 in chips) 
Seat 6: CashMatteo ($11.70 in chips) 
SikaTrx: posts small blind $0.10
crdalchemy93: posts big blind $0.25
*** HOLE CARDS ***
Dealt to CashMatteo [Qd 3s]
SSSS AM E SOSA: folds 
CashMatteo: folds 
Missinagnew: folds 
hickdaddyx2: raises $0.75 to $1
SikaTrx: folds 
crdalchemy93: folds 
Uncalled bet ($0.75) returned to hickdaddyx2
hickdaddyx2 collected $0.60 from pot
*** SUMMARY ***
Total pot $0.60 | Rake $0 
Seat 1: Missinagnew folded before Flop (didn't bet)
Seat 2: hickdaddyx2 (button) collected ($0.60)
Seat 3: SikaTrx (small blind) folded before Flop
Seat 4: crdalchemy93 (big blind) folded before Flop
Seat 5: SSSS AM E SOSA folded before Flop (didn't bet)
Seat 6: CashMatteo folded before Flop (didn't bet)

Hand #2414: 

PokerStars Hand #250568878527:  Hold'em No Limit ($0.10/$0.25 CAD) - 2024/05/18 14:55:55 ET
Table 'Sadalbari III' 6-max Seat #3 is the button
Seat 2: hickdaddyx2 ($19.18 in chips) 
Seat 3: SikaTrx ($24.93 in chips) 
Seat 4: crdalchemy93 ($32.07 in chips) 
Seat 5: SSSS AM E SOSA ($23.54 in chips) 
Seat 6: CashMatteo ($11.70 in chips) 
crdalchemy93: posts small blind $0.10
SSSS AM E SOSA: posts big blind $0.25
*** HOLE CARDS ***
Dealt to CashMatteo [7c 5d]
CashMatteo: folds 
hickdaddyx2: calls $0.25
SikaTrx: raises $0.50 to $0.75
crdalchemy93: folds 
SSSS AM E SOSA: folds 
hickdaddyx2: calls $0.50
*** FLOP *** [2c 3h 6h]
hickdaddyx2: checks 
SikaTrx: bets $0.58
hickdaddyx2: calls $0.58
*** TURN *** [2c 3h 6h] [6c]
hickdaddyx2: checks 
SikaTrx: checks 
*** RIVER *** [2c 3h 6h 6c] [6d]
hickdaddyx2: bets $0.50
SikaTrx: calls $0.50
*** SHOW DOWN ***
hickdaddyx2: shows [4d 4h] (a full house, Sixes full of Fours)
SikaTrx: mucks hand 
hickdaddyx2 collected $3.83 from pot
*** SUMMARY ***
Total pot $4.01 | Rake $0.18 
Board [2c 3h 6h 6c 6d]
Seat 2: hickdaddyx2 showed [4d 4h] and won ($3.83) with a full house, Sixes full of Fours
Seat 3: SikaTrx (button) mucked [Ah Tc]
Seat 4: crdalchemy93 (small blind) folded before Flop
Seat 5: SSSS AM E SOSA (big blind) folded before Flop
Seat 6: CashMatteo folded before Flop (didn't bet)

Hand #2415: 

PokerStars Hand #250568888767:  Hold'em No Limit ($0.10/$0.25 CAD) - 2024/05/18 14:56:46 ET
Table 'Sadalbari III' 6-max Seat #4 is the button
Seat 2: hickdaddyx2 ($21.18 in chips) 
Seat 3: SikaTrx ($23.10 in chips) 
Seat 4: crdalchemy93 ($31.97 in chips) 
Seat 5: SSSS AM E SOSA ($23.29 in chips) 
Seat 6: CashMatteo ($11.70 in chips) 
SSSS AM E SOSA: posts small blind $0.10
CashMatteo: posts big blind $0.25
*** HOLE CARDS ***
Dealt to CashMatteo [3h 5h]
hickdaddyx2: folds 
SikaTrx: raises $0.30 to $0.55
crdalchemy93: folds 
SSSS AM E SOSA: calls $0.45
CashMatteo: calls $0.30
*** FLOP *** [5d 9c 2h]
SSSS AM E SOSA: checks 
CashMatteo: checks 
SikaTrx: checks 
*** TURN *** [5d 9c 2h] [Jh]
SSSS AM E SOSA: checks 
CashMatteo: bets $1.04
SikaTrx: calls $1.04
SSSS AM E SOSA: calls $1.04
*** RIVER *** [5d 9c 2h Jh] [Js]
SSSS AM E SOSA: checks 
CashMatteo: checks 
SikaTrx: bets $3.25
SSSS AM E SOSA: folds 
CashMatteo has timed out
CashMatteo: folds 
Uncalled bet ($3.25) returned to SikaTrx
SikaTrx collected $4.56 from pot
SikaTrx: doesn't show hand 
*** SUMMARY ***
Total pot $4.77 | Rake $0.21 
Board [5d 9c 2h Jh Js]
Seat 2: hickdaddyx2 folded before Flop (didn't bet)
Seat 3: SikaTrx collected ($4.56)
Seat 4: crdalchemy93 (button) folded before Flop (didn't bet)
Seat 5: SSSS AM E SOSA (small blind) folded on the River
Seat 6: CashMatteo (big blind) folded on the River

Hand #2416: 

PokerStars Hand #250568904931:  Hold'em No Limit ($0.10/$0.25 CAD) - 2024/05/18 14:58:07 ET
Table 'Sadalbari III' 6-max Seat #5 is the button
Seat 2: hickdaddyx2 ($21.18 in chips) 
Seat 3: SikaTrx ($26.07 in chips) 
Seat 4: crdalchemy93 ($31.97 in chips) 
Seat 5: SSSS AM E SOSA ($21.70 in chips) 
Seat 6: CashMatteo ($10.11 in chips) 
CashMatteo: posts small blind $0.10
hickdaddyx2: posts big blind $0.25
*** HOLE CARDS ***
Dealt to CashMatteo [Kh 9s]
SikaTrx: folds 
crdalchemy93: folds 
SSSS AM E SOSA: calls $0.25
CashMatteo: calls $0.15
hickdaddyx2: checks 
*** FLOP *** [Ks 5h Qd]
CashMatteo: bets $0.61
hickdaddyx2: folds 
SSSS AM E SOSA: calls $0.61
*** TURN *** [Ks 5h Qd] [2h]
CashMatteo: checks 
SSSS AM E SOSA: bets $1.88
CashMatteo: calls $1.88
*** RIVER *** [Ks 5h Qd 2h] [Jh]
CashMatteo: checks 
SSSS AM E SOSA: checks 
*** SHOW DOWN ***
CashMatteo: shows [Kh 9s] (a pair of Kings)
SSSS AM E SOSA: shows [Ac Kd] (a pair of Kings - Ace kicker)
SSSS AM E SOSA collected $5.47 from pot
*** SUMMARY ***
Total pot $5.73 | Rake $0.26 
Board [Ks 5h Qd 2h Jh]
Seat 2: hickdaddyx2 (big blind) folded on the Flop
Seat 3: SikaTrx folded before Flop (didn't bet)
Seat 4: crdalchemy93 folded before Flop (didn't bet)
Seat 5: SSSS AM E SOSA (button) showed [Ac Kd] and won ($5.47) with a pair of Kings
Seat 6: CashMatteo (small blind) showed [Kh 9s] and lost with a pair of Kings

Hand #2417: 

PokerStars Hand #250568914693:  Hold'em No Limit ($0.10/$0.25 CAD) - 2024/05/18 14:58:54 ET
Table 'Sadalbari III' 6-max Seat #6 is the button
Seat 2: hickdaddyx2 ($20.93 in chips) 
Seat 3: SikaTrx ($26.07 in chips) 
Seat 4: crdalchemy93 ($31.97 in chips) 
Seat 5: SSSS AM E SOSA ($24.43 in chips) 
Seat 6: CashMatteo ($7.37 in chips) 
hickdaddyx2: posts small blind $0.10
SikaTrx: posts big blind $0.25
*** HOLE CARDS ***
Dealt to CashMatteo [6s 6c]
crdalchemy93: raises $0.25 to $0.50
SSSS AM E SOSA: folds 
SSSS AM E SOSA leaves the table
CashMatteo: calls $0.50
hickdaddyx2: folds 
SikaTrx: folds 
*** FLOP *** [8s 3h Js]
crdalchemy93: checks 
braydon.2002 joins the table at seat #5 
CashMatteo: bets $0.65
crdalchemy93: folds 
Uncalled bet ($0.65) returned to CashMatteo
CashMatteo collected $1.29 from pot
CashMatteo: doesn't show hand 
*** SUMMARY ***
Total pot $1.35 | Rake $0.06 
Board [8s 3h Js]
Seat 2: hickdaddyx2 (small blind) folded before Flop
Seat 3: SikaTrx (big blind) folded before Flop
Seat 4: crdalchemy93 folded on the Flop
Seat 5: SSSS AM E SOSA folded before Flop (didn't bet)
Seat 6: CashMatteo (button) collected ($1.29)

Hand #2418: 

PokerStars Hand #250568919937:  Hold'em No Limit ($0.10/$0.25 CAD) - 2024/05/18 14:59:20 ET
Table 'Sadalbari III' 6-max Seat #2 is the button
Seat 2: hickdaddyx2 ($20.83 in chips) 
Seat 3: SikaTrx ($25.82 in chips) 
Seat 4: crdalchemy93 ($31.47 in chips) 
Seat 6: CashMatteo ($8.16 in chips) 
SikaTrx: posts small blind $0.10
crdalchemy93: posts big blind $0.25
braydon.2002: sits out 
*** HOLE CARDS ***
Dealt to CashMatteo [3s Kd]
CashMatteo: folds 
hickdaddyx2: calls $0.25
SikaTrx: calls $0.15
crdalchemy93: checks 
*** FLOP *** [7c 9s Qc]
SikaTrx: checks 
crdalchemy93: checks 
hickdaddyx2: checks 
*** TURN *** [7c 9s Qc] [2h]
SikaTrx: checks 
crdalchemy93: checks 
hickdaddyx2: checks 
*** RIVER *** [7c 9s Qc 2h] [9h]
SikaTrx: checks 
crdalchemy93: checks 
hickdaddyx2: checks 
*** SHOW DOWN ***
SikaTrx: shows [4h 3h] (a pair of Nines)
crdalchemy93: shows [Ac 2c] (two pair, Nines and Deuces)
hickdaddyx2: mucks hand 
crdalchemy93 collected $0.72 from pot
*** SUMMARY ***
Total pot $0.75 | Rake $0.03 
Board [7c 9s Qc 2h 9h]
Seat 2: hickdaddyx2 (button) mucked [4c Tc]
Seat 3: SikaTrx (small blind) showed [4h 3h] and lost with a pair of Nines
Seat 4: crdalchemy93 (big blind) showed [Ac 2c] and won ($0.72) with two pair, Nines and Deuces
Seat 6: CashMatteo folded before Flop (didn't bet)

Hand #2419: 

PokerStars Hand #250568934758:  Hold'em No Limit ($0.10/$0.25 CAD) - 2024/05/18 15:00:27 ET
Table 'Sadalbari III' 6-max Seat #3 is the button
Seat 2: hickdaddyx2 ($20.58 in chips) 
Seat 3: SikaTrx ($25.57 in chips) 
Seat 4: crdalchemy93 ($31.94 in chips) 
Seat 5: braydon.2002 ($25 in chips) 
Seat 6: CashMatteo ($8.16 in chips) 
crdalchemy93: posts small blind $0.10
braydon.2002: posts big blind $0.25
Missinagnew: sits out 
*** HOLE CARDS ***
Dealt to CashMatteo [Qs 7s]
CashMatteo: calls $0.25
hickdaddyx2: calls $0.25
SikaTrx: raises $0.40 to $0.65
crdalchemy93: folds 
braydon.2002: folds 
CashMatteo: calls $0.40
hickdaddyx2: calls $0.40
*** FLOP *** [Jd Qc 3d]
CashMatteo: checks 
hickdaddyx2: checks 
SikaTrx: checks 
*** TURN *** [Jd Qc 3d] [6d]
CashMatteo: bets $1.10
hickdaddyx2: folds 
SikaTrx: calls $1.10
*** RIVER *** [Jd Qc 3d 6d] [5c]
CashMatteo: checks 
SikaTrx: checks 
*** SHOW DOWN ***
CashMatteo: shows [Qs 7s] (a pair of Queens)
SikaTrx: mucks hand 
CashMatteo collected $4.30 from pot
*** SUMMARY ***
Total pot $4.50 | Rake $0.20 
Board [Jd Qc 3d 6d 5c]
Seat 2: hickdaddyx2 folded on the Turn
Seat 3: SikaTrx (button) mucked [Ks Jc]
Seat 4: crdalchemy93 (small blind) folded before Flop
Seat 5: braydon.2002 (big blind) folded before Flop
Seat 6: CashMatteo showed [Qs 7s] and won ($4.30) with a pair of Queens

Hand #2420: 

PokerStars Hand #250568951501:  Hold'em No Limit ($0.10/$0.25 CAD) - 2024/05/18 15:01:31 ET
Table 'Sadalbari III' 6-max Seat #4 is the button
Seat 2: hickdaddyx2 ($19.93 in chips) 
Seat 3: SikaTrx ($23.82 in chips) 
Seat 4: crdalchemy93 ($31.84 in chips) 
Seat 5: braydon.2002 ($25 in chips) 
Seat 6: CashMatteo ($10.71 in chips) 
braydon.2002: posts small blind $0.10
CashMatteo: posts big blind $0.25
Missinagnew: sits out 
*** HOLE CARDS ***
Dealt to CashMatteo [4c 6c]
hickdaddyx2: folds 
SikaTrx: folds 
crdalchemy93: raises $0.35 to $0.60
braydon.2002: folds 
CashMatteo: folds 
Uncalled bet ($0.35) returned to crdalchemy93
crdalchemy93 collected $0.60 from pot
crdalchemy93: doesn't show hand 
*** SUMMARY ***
Total pot $0.60 | Rake $0 
Seat 2: hickdaddyx2 folded before Flop (didn't bet)
Seat 3: SikaTrx folded before Flop (didn't bet)
Seat 4: crdalchemy93 (button) collected ($0.60)
Seat 5: braydon.2002 (small blind) folded before Flop
Seat 6: CashMatteo (big blind) folded before Flop

Hand #2421: 

PokerStars Hand #250568957234:  Hold'em No Limit ($0.10/$0.25 CAD) - 2024/05/18 15:01:53 ET
Table 'Sadalbari III' 6-max Seat #5 is the button
Seat 1: Missinagnew ($38.39 in chips) 
Seat 2: hickdaddyx2 ($19.93 in chips) 
Seat 3: SikaTrx ($23.82 in chips) 
Seat 4: crdalchemy93 ($32.19 in chips) 
Seat 5: braydon.2002 ($25 in chips) 
Seat 6: CashMatteo ($10.46 in chips) 
CashMatteo: posts small blind $0.10
Missinagnew: posts big blind $0.25
*** HOLE CARDS ***
Dealt to CashMatteo [2h Ah]
hickdaddyx2: calls $0.25
hickdaddyx2 is disconnected 
SikaTrx has timed out
SikaTrx: folds 
crdalchemy93: raises $0.55 to $0.80
braydon.2002: folds 
CashMatteo: calls $0.70
Missinagnew: folds 
hickdaddyx2: calls $0.55
*** FLOP *** [3s 5h As]
CashMatteo: checks 
hickdaddyx2: checks 
crdalchemy93: checks 
*** TURN *** [3s 5h As] [Kh]
CashMatteo: bets $1.50
hickdaddyx2: calls $1.50
crdalchemy93: folds 
*** RIVER *** [3s 5h As Kh] [Ac]
CashMatteo: bets $3.95
hickdaddyx2: folds 
Uncalled bet ($3.95) returned to CashMatteo
CashMatteo collected $5.40 from pot
CashMatteo: doesn't show hand 
*** SUMMARY ***
Total pot $5.65 | Rake $0.25 
Board [3s 5h As Kh Ac]
Seat 1: Missinagnew (big blind) folded before Flop
Seat 2: hickdaddyx2 folded on the River
Seat 3: SikaTrx folded before Flop (didn't bet)
Seat 4: crdalchemy93 folded on the Turn
Seat 5: braydon.2002 (button) folded before Flop (didn't bet)
Seat 6: CashMatteo (small blind) collected ($5.40)

Hand #2422: 

PokerStars Hand #250568987153:  Hold'em No Limit ($0.10/$0.25 CAD) - 2024/05/18 15:03:26 ET
Table 'Sadalbari III' 6-max Seat #6 is the button
Seat 1: Missinagnew ($38.14 in chips) 
Seat 3: SikaTrx ($23.82 in chips) 
Seat 4: crdalchemy93 ($31.39 in chips) 
Seat 5: braydon.2002 ($25 in chips) 
Seat 6: CashMatteo ($13.56 in chips) 
Missinagnew: posts small blind $0.10
SikaTrx: posts big blind $0.25
*** HOLE CARDS ***
Dealt to CashMatteo [As Ah]
crdalchemy93: folds 
braydon.2002: folds 
CashMatteo: raises $0.37 to $0.62
Missinagnew: folds 
SikaTrx: folds 
Uncalled bet ($0.37) returned to CashMatteo
CashMatteo collected $0.60 from pot
CashMatteo: doesn't show hand 
*** SUMMARY ***
Total pot $0.60 | Rake $0 
Seat 1: Missinagnew (small blind) folded before Flop
Seat 3: SikaTrx (big blind) folded before Flop
Seat 4: crdalchemy93 folded before Flop (didn't bet)
Seat 5: braydon.2002 folded before Flop (didn't bet)
Seat 6: CashMatteo (button) collected ($0.60)

Hand #2423: 

PokerStars Hand #250568992596:  Hold'em No Limit ($0.10/$0.25 CAD) - 2024/05/18 15:03:43 ET
Table 'Sadalbari III' 6-max Seat #1 is the button
Seat 1: Missinagnew ($38.04 in chips) 
Seat 4: crdalchemy93 ($31.39 in chips) 
Seat 5: braydon.2002 ($25 in chips) 
Seat 6: CashMatteo ($13.91 in chips) 
hickdaddyx2 will be allowed to play after the button
crdalchemy93: posts small blind $0.10
braydon.2002: posts big blind $0.25
*** HOLE CARDS ***
Dealt to CashMatteo [6s 4h]
CashMatteo: folds 
Missinagnew: raises $0.37 to $0.62
SikaTrx leaves the table
crdalchemy93: raises $1.88 to $2.50
braydon.2002: folds 
Missinagnew: calls $1.88
*** FLOP *** [3d Kh 7c]
crdalchemy93: bets $1.65
Missinagnew: folds 
Uncalled bet ($1.65) returned to crdalchemy93
crdalchemy93 collected $5.01 from pot
crdalchemy93: doesn't show hand 
*** SUMMARY ***
Total pot $5.25 | Rake $0.24 
Board [3d Kh 7c]
Seat 1: Missinagnew (button) folded on the Flop
Seat 4: crdalchemy93 (small blind) collected ($5.01)
Seat 5: braydon.2002 (big blind) folded before Flop
Seat 6: CashMatteo folded before Flop (didn't bet)

Hand #2424: 

PokerStars Hand #250569006554:  Hold'em No Limit ($0.10/$0.25 CAD) - 2024/05/18 15:04:24 ET
Table 'Sadalbari III' 6-max Seat #4 is the button
Seat 1: Missinagnew ($35.54 in chips) 
Seat 2: hickdaddyx2 ($17.63 in chips) 
Seat 4: crdalchemy93 ($33.90 in chips) 
Seat 5: braydon.2002 ($25 in chips) 
Seat 6: CashMatteo ($13.91 in chips) 
braydon.2002: posts small blind $0.10
CashMatteo: posts big blind $0.25
hickdaddyx2: posts small & big blinds $0.35
*** HOLE CARDS ***
Dealt to CashMatteo [8h 2h]
Missinagnew: folds 
hickdaddyx2: checks 
crdalchemy93: folds 
braydon.2002: folds 
CashMatteo: checks 
*** FLOP *** [Th 8d 8s]
CashMatteo: checks 
hickdaddyx2: checks 
*** TURN *** [Th 8d 8s] [Ac]
CashMatteo: checks 
mistasho joins the table at seat #3 
hickdaddyx2: checks 
*** RIVER *** [Th 8d 8s Ac] [7h]
CashMatteo: bets $0.67
hickdaddyx2: folds 
Uncalled bet ($0.67) returned to CashMatteo
CashMatteo collected $0.67 from pot
CashMatteo: doesn't show hand 
*** SUMMARY ***
Total pot $0.70 | Rake $0.03 
Board [Th 8d 8s Ac 7h]
Seat 1: Missinagnew folded before Flop (didn't bet)
Seat 2: hickdaddyx2 folded on the River (didn't bet)
Seat 4: crdalchemy93 (button) folded before Flop (didn't bet)
Seat 5: braydon.2002 (small blind) folded before Flop
Seat 6: CashMatteo (big blind) collected ($0.67)

Hand #2425: 

PokerStars Hand #250569022352:  Hold'em No Limit ($0.10/$0.25 CAD) - 2024/05/18 15:05:09 ET
Table 'Sadalbari III' 6-max Seat #5 is the button
Seat 1: Missinagnew ($35.54 in chips) 
Seat 2: hickdaddyx2 ($17.28 in chips) 
Seat 4: crdalchemy93 ($33.90 in chips) 
Seat 5: braydon.2002 ($25 in chips) 
Seat 6: CashMatteo ($14.33 in chips) 
CashMatteo: posts small blind $0.10
Missinagnew: posts big blind $0.25
mistasho: sits out 
*** HOLE CARDS ***
Dealt to CashMatteo [3d Ks]
hickdaddyx2: folds 
crdalchemy93: folds 
braydon.2002: folds 
CashMatteo: folds 
Uncalled bet ($0.15) returned to Missinagnew
Missinagnew collected $0.20 from pot
Missinagnew: doesn't show hand 
*** SUMMARY ***
Total pot $0.20 | Rake $0 
Seat 1: Missinagnew (big blind) collected ($0.20)
Seat 2: hickdaddyx2 folded before Flop (didn't bet)
Seat 4: crdalchemy93 folded before Flop (didn't bet)
Seat 5: braydon.2002 (button) folded before Flop (didn't bet)
Seat 6: CashMatteo (small blind) folded before Flop

Hand #2426: 

PokerStars Hand #250569029845:  Hold'em No Limit ($0.10/$0.25 CAD) - 2024/05/18 15:05:30 ET
Table 'Sadalbari III' 6-max Seat #6 is the button
Seat 1: Missinagnew ($35.64 in chips) 
Seat 2: hickdaddyx2 ($17.28 in chips) 
Seat 4: crdalchemy93 ($33.90 in chips) 
Seat 5: braydon.2002 ($25 in chips) 
Seat 6: CashMatteo ($14.23 in chips) 
Missinagnew: posts small blind $0.10
hickdaddyx2: posts big blind $0.25
mistasho: sits out 
*** HOLE CARDS ***
Dealt to CashMatteo [8d 2s]
crdalchemy93: folds 
braydon.2002: folds 
CashMatteo: folds 
Missinagnew: folds 
Uncalled bet ($0.15) returned to hickdaddyx2
hickdaddyx2 collected $0.20 from pot
*** SUMMARY ***
Total pot $0.20 | Rake $0 
Seat 1: Missinagnew (small blind) folded before Flop
Seat 2: hickdaddyx2 (big blind) collected ($0.20)
Seat 4: crdalchemy93 folded before Flop (didn't bet)
Seat 5: braydon.2002 folded before Flop (didn't bet)
Seat 6: CashMatteo (button) folded before Flop (didn't bet)

Hand #2427: 

PokerStars Hand #250569034983:  Hold'em No Limit ($0.10/$0.25 CAD) - 2024/05/18 15:05:44 ET
Table 'Sadalbari III' 6-max Seat #1 is the button
Seat 1: Missinagnew ($35.54 in chips) 
Seat 2: hickdaddyx2 ($17.38 in chips) 
Seat 3: mistasho ($27.37 in chips) 
Seat 4: crdalchemy93 ($33.90 in chips) 
Seat 5: braydon.2002 ($25 in chips) 
Seat 6: CashMatteo ($14.23 in chips) 
hickdaddyx2: posts small blind $0.10
mistasho: posts big blind $0.25
*** HOLE CARDS ***
Dealt to CashMatteo [Kc Tc]
crdalchemy93: folds 
braydon.2002: folds 
CashMatteo: raises $0.37 to $0.62
Missinagnew: folds 
hickdaddyx2: folds 
mistasho: folds 
Uncalled bet ($0.37) returned to CashMatteo
CashMatteo collected $0.60 from pot
CashMatteo: doesn't show hand 
*** SUMMARY ***
Total pot $0.60 | Rake $0 
Seat 1: Missinagnew (button) folded before Flop (didn't bet)
Seat 2: hickdaddyx2 (small blind) folded before Flop
Seat 3: mistasho (big blind) folded before Flop
Seat 4: crdalchemy93 folded before Flop (didn't bet)
Seat 5: braydon.2002 folded before Flop (didn't bet)
Seat 6: CashMatteo collected ($0.60)

Hand #2428: 

PokerStars Hand #250569040209:  Hold'em No Limit ($0.10/$0.25 CAD) - 2024/05/18 15:05:59 ET
Table 'Sadalbari III' 6-max Seat #2 is the button
Seat 1: Missinagnew ($35.54 in chips) 
Seat 2: hickdaddyx2 ($17.28 in chips) 
Seat 3: mistasho ($27.12 in chips) 
Seat 4: crdalchemy93 ($33.90 in chips) 
Seat 5: braydon.2002 ($25 in chips) 
Seat 6: CashMatteo ($14.58 in chips) 
mistasho: posts small blind $0.10
crdalchemy93: posts big blind $0.25
*** HOLE CARDS ***
Dealt to CashMatteo [2d Kc]
braydon.2002: raises $0.25 to $0.50
CashMatteo: folds 
Missinagnew: calls $0.50
hickdaddyx2: calls $0.50
mistasho: folds 
crdalchemy93: calls $0.25
*** FLOP *** [6d 2s 7h]
crdalchemy93: checks 
braydon.2002: checks 
Missinagnew: bets $1.01
hickdaddyx2: folds 
crdalchemy93: folds 
braydon.2002: folds 
Uncalled bet ($1.01) returned to Missinagnew
Missinagnew collected $2.01 from pot
Missinagnew: doesn't show hand 
*** SUMMARY ***
Total pot $2.10 | Rake $0.09 
Board [6d 2s 7h]
Seat 1: Missinagnew collected ($2.01)
Seat 2: hickdaddyx2 (button) folded on the Flop
Seat 3: mistasho (small blind) folded before Flop
Seat 4: crdalchemy93 (big blind) folded on the Flop
Seat 5: braydon.2002 folded on the Flop
Seat 6: CashMatteo folded before Flop (didn't bet)

Hand #2429: 

PokerStars Hand #250569062324:  Hold'em No Limit ($0.10/$0.25 CAD) - 2024/05/18 15:07:00 ET
Table 'Sadalbari III' 6-max Seat #3 is the button
Seat 1: Missinagnew ($37.05 in chips) 
Seat 2: hickdaddyx2 ($16.78 in chips) 
Seat 3: mistasho ($27.02 in chips) 
Seat 4: crdalchemy93 ($33.40 in chips) 
Seat 5: braydon.2002 ($25 in chips) 
Seat 6: CashMatteo ($14.58 in chips) 
crdalchemy93: posts small blind $0.10
braydon.2002: posts big blind $0.25
*** HOLE CARDS ***
Dealt to CashMatteo [Js 8s]
CashMatteo: raises $0.37 to $0.62
Missinagnew: folds 
hickdaddyx2: calls $0.62
mistasho: folds 
crdalchemy93: folds 
braydon.2002: folds 
*** FLOP *** [9s 3d Jh]
CashMatteo: bets $0.76
hickdaddyx2: calls $0.76
*** TURN *** [9s 3d Jh] [5d]
CashMatteo: bets $1.49
hickdaddyx2: calls $1.49
*** RIVER *** [9s 3d Jh 5d] [6s]
CashMatteo: checks 
hickdaddyx2: bets $1.50
CashMatteo: calls $1.50
*** SHOW DOWN ***
hickdaddyx2: shows [Jd Ah] (a pair of Jacks)
CashMatteo: mucks hand 
hickdaddyx2 collected $8.68 from pot
*** SUMMARY ***
Total pot $9.09 | Rake $0.41 
Board [9s 3d Jh 5d 6s]
Seat 1: Missinagnew folded before Flop (didn't bet)
Seat 2: hickdaddyx2 showed [Jd Ah] and won ($8.68) with a pair of Jacks
Seat 3: mistasho (button) folded before Flop (didn't bet)
Seat 4: crdalchemy93 (small blind) folded before Flop
Seat 5: braydon.2002 (big blind) folded before Flop
Seat 6: CashMatteo mucked [Js 8s]

Hand #2430: 

PokerStars Hand #250569081153:  Hold'em No Limit ($0.10/$0.25 CAD) - 2024/05/18 15:07:53 ET
Table 'Sadalbari III' 6-max Seat #4 is the button
Seat 1: Missinagnew ($37.05 in chips) 
Seat 2: hickdaddyx2 ($21.09 in chips) 
Seat 3: mistasho ($27.02 in chips) 
Seat 4: crdalchemy93 ($33.30 in chips) 
Seat 5: braydon.2002 ($25 in chips) 
Seat 6: CashMatteo ($10.21 in chips) 
braydon.2002: posts small blind $0.10
CashMatteo: posts big blind $0.25
*** HOLE CARDS ***
Dealt to CashMatteo [Ks 4h]
Missinagnew: folds 
hickdaddyx2: calls $0.25
mistasho: folds 
crdalchemy93: folds 
braydon.2002: folds 
CashMatteo: checks 
*** FLOP *** [3c 6d 5c]
CashMatteo: bets $0.29
hickdaddyx2: calls $0.29
*** TURN *** [3c 6d 5c] [Js]
CashMatteo: bets $0.57
hickdaddyx2: folds 
Uncalled bet ($0.57) returned to CashMatteo
CashMatteo collected $1.13 from pot
CashMatteo: doesn't show hand 
*** SUMMARY ***
Total pot $1.18 | Rake $0.05 
Board [3c 6d 5c Js]
Seat 1: Missinagnew folded before Flop (didn't bet)
Seat 2: hickdaddyx2 folded on the Turn
Seat 3: mistasho folded before Flop (didn't bet)
Seat 4: crdalchemy93 (button) folded before Flop (didn't bet)
Seat 5: braydon.2002 (small blind) folded before Flop
Seat 6: CashMatteo (big blind) collected ($1.13)

Hand #2431: 

PokerStars Hand #250569093526:  Hold'em No Limit ($0.10/$0.25 CAD) - 2024/05/18 15:08:27 ET
Table 'Sadalbari III' 6-max Seat #5 is the button
Seat 1: Missinagnew ($37.05 in chips) 
Seat 2: hickdaddyx2 ($20.55 in chips) 
Seat 3: mistasho ($27.02 in chips) 
Seat 4: crdalchemy93 ($33.30 in chips) 
Seat 5: braydon.2002 ($25 in chips) 
Seat 6: CashMatteo ($10.80 in chips) 
CashMatteo: posts small blind $0.10
Missinagnew: posts big blind $0.25
*** HOLE CARDS ***
Dealt to CashMatteo [7c 4s]
hickdaddyx2: calls $0.25
mistasho: folds 
crdalchemy93: folds 
braydon.2002: folds 
CashMatteo: calls $0.15
Missinagnew: checks 
*** FLOP *** [Ah 5s 2h]
CashMatteo: checks 
Missinagnew: checks 
hickdaddyx2: checks 
*** TURN *** [Ah 5s 2h] [9s]
CashMatteo: bets $0.36
Missinagnew: folds 
hickdaddyx2: folds 
Uncalled bet ($0.36) returned to CashMatteo
CashMatteo collected $0.72 from pot
CashMatteo: doesn't show hand 
*** SUMMARY ***
Total pot $0.75 | Rake $0.03 
Board [Ah 5s 2h 9s]
Seat 1: Missinagnew (big blind) folded on the Turn
Seat 2: hickdaddyx2 folded on the Turn
Seat 3: mistasho folded before Flop (didn't bet)
Seat 4: crdalchemy93 folded before Flop (didn't bet)
Seat 5: braydon.2002 (button) folded before Flop (didn't bet)
Seat 6: CashMatteo (small blind) collected ($0.72)

Hand #2432: 

PokerStars Hand #250569110329:  Hold'em No Limit ($0.10/$0.25 CAD) - 2024/05/18 15:09:13 ET
Table 'Sadalbari III' 6-max Seat #6 is the button
Seat 1: Missinagnew ($36.80 in chips) 
Seat 2: hickdaddyx2 ($20.30 in chips) 
Seat 3: mistasho ($27.02 in chips) 
Seat 4: crdalchemy93 ($33.30 in chips) 
Seat 5: braydon.2002 ($25 in chips) 
Seat 6: CashMatteo ($11.27 in chips) 
Missinagnew: posts small blind $0.10
hickdaddyx2: posts big blind $0.25
*** HOLE CARDS ***
Dealt to CashMatteo [Ks Ac]
mistasho: folds 
crdalchemy93: raises $0.25 to $0.50
braydon.2002: raises $1 to $1.50
CashMatteo: raises $9.77 to $11.27 and is all-in
Missinagnew: folds 
hickdaddyx2: folds 
crdalchemy93: folds 
braydon.2002: calls $9.77
*** FLOP *** [Kh 8h Kd]
*** TURN *** [Kh 8h Kd] [5h]
*** RIVER *** [Kh 8h Kd 5h] [3c]
*** SHOW DOWN ***
braydon.2002: shows [Tc Ts] (two pair, Kings and Tens)
CashMatteo: shows [Ks Ac] (three of a kind, Kings)
CashMatteo collected $22.34 from pot
*** SUMMARY ***
Total pot $23.39 | Rake $1.05 
Board [Kh 8h Kd 5h 3c]
Seat 1: Missinagnew (small blind) folded before Flop
Seat 2: hickdaddyx2 (big blind) folded before Flop
Seat 3: mistasho folded before Flop (didn't bet)
Seat 4: crdalchemy93 folded before Flop
Seat 5: braydon.2002 showed [Tc Ts] and lost with two pair, Kings and Tens
Seat 6: CashMatteo (button) showed [Ks Ac] and won ($22.34) with three of a kind, Kings

Hand #2433: 

PokerStars Hand #250569123097:  Hold'em No Limit ($0.10/$0.25 CAD) - 2024/05/18 15:09:49 ET
Table 'Sadalbari III' 6-max Seat #1 is the button
Seat 1: Missinagnew ($36.70 in chips) 
Seat 2: hickdaddyx2 ($20.05 in chips) 
Seat 3: mistasho ($27.02 in chips) 
Seat 4: crdalchemy93 ($32.80 in chips) 
Seat 5: braydon.2002 ($25 in chips) 
Seat 6: CashMatteo ($22.34 in chips) 
hickdaddyx2: posts small blind $0.10
mistasho: posts big blind $0.25
*** HOLE CARDS ***
Dealt to CashMatteo [Ad Jh]
crdalchemy93: folds 
braydon.2002: folds 
CashMatteo: raises $0.37 to $0.62
Missinagnew: calls $0.62
hickdaddyx2: calls $0.52
mistasho: folds 
*** FLOP *** [7d 6h 8d]
hickdaddyx2: checks 
CashMatteo: bets $1.01
Missinagnew: folds 
hickdaddyx2: calls $1.01
*** TURN *** [7d 6h 8d] [2h]
hickdaddyx2: checks 
crdalchemy93 leaves the table
CashMatteo: checks 
*** RIVER *** [7d 6h 8d 2h] [2s]
hickdaddyx2: bets $1
CashMatteo: calls $1
*** SHOW DOWN ***
hickdaddyx2: shows [Qs Qc] (two pair, Queens and Deuces)
CashMatteo: mucks hand 
hickdaddyx2 collected $5.85 from pot
*** SUMMARY ***
Total pot $6.13 | Rake $0.28 
Board [7d 6h 8d 2h 2s]
Seat 1: Missinagnew (button) folded on the Flop
Seat 2: hickdaddyx2 (small blind) showed [Qs Qc] and won ($5.85) with two pair, Queens and Deuces
Seat 3: mistasho (big blind) folded before Flop
Seat 4: crdalchemy93 folded before Flop (didn't bet)
Seat 5: braydon.2002 folded before Flop (didn't bet)
Seat 6: CashMatteo mucked [Ad Jh]

Hand #2434: 

PokerStars Hand #250569137873:  Hold'em No Limit ($0.10/$0.25 CAD) - 2024/05/18 15:10:30 ET
Table 'Sadalbari III' 6-max Seat #2 is the button
Seat 1: Missinagnew ($36.08 in chips) 
Seat 2: hickdaddyx2 ($23.27 in chips) 
Seat 3: mistasho ($26.77 in chips) 
Seat 5: braydon.2002 ($25 in chips) 
Seat 6: CashMatteo ($19.71 in chips) 
mistasho: posts small blind $0.10
braydon.2002: posts big blind $0.25
*** HOLE CARDS ***
Dealt to CashMatteo [As Kc]
CashMatteo: raises $0.37 to $0.62
Alpha Mule joins the table at seat #4 
Missinagnew: folds 
hickdaddyx2: folds 
mistasho: folds 
braydon.2002: folds 
Uncalled bet ($0.37) returned to CashMatteo
CashMatteo collected $0.60 from pot
CashMatteo: doesn't show hand 
*** SUMMARY ***
Total pot $0.60 | Rake $0 
Seat 1: Missinagnew folded before Flop (didn't bet)
Seat 2: hickdaddyx2 (button) folded before Flop (didn't bet)
Seat 3: mistasho (small blind) folded before Flop
Seat 5: braydon.2002 (big blind) folded before Flop
Seat 6: CashMatteo collected ($0.60)

Hand #2435: 

PokerStars Hand #250569143645:  Hold'em No Limit ($0.10/$0.25 CAD) - 2024/05/18 15:10:46 ET
Table 'Sadalbari III' 6-max Seat #3 is the button
Seat 1: Missinagnew ($36.08 in chips) 
Seat 2: hickdaddyx2 ($23.27 in chips) 
Seat 3: mistasho ($26.67 in chips) 
Seat 5: braydon.2002 ($25 in chips) 
Seat 6: CashMatteo ($20.06 in chips) 
Alpha Mule will be allowed to play after the button
braydon.2002: posts small blind $0.10
CashMatteo: posts big blind $0.25
*** HOLE CARDS ***
Dealt to CashMatteo [5d 5s]
Missinagnew: folds 
hickdaddyx2: folds 
mistasho: folds 
braydon.2002: raises $0.50 to $0.75
CashMatteo: calls $0.50
*** FLOP *** [3s Ac 9h]
braydon.2002: bets $0.36
CashMatteo: calls $0.36
*** TURN *** [3s Ac 9h] [Jd]
braydon.2002: checks 
CashMatteo: checks 
*** RIVER *** [3s Ac 9h Jd] [3d]
braydon.2002: bets $0.25
CashMatteo: calls $0.25
*** SHOW DOWN ***
braydon.2002: shows [Js 7c] (two pair, Jacks and Threes)
CashMatteo: mucks hand 
braydon.2002 collected $2.60 from pot
*** SUMMARY ***
Total pot $2.72 | Rake $0.12 
Board [3s Ac 9h Jd 3d]
Seat 1: Missinagnew folded before Flop (didn't bet)
Seat 2: hickdaddyx2 folded before Flop (didn't bet)
Seat 3: mistasho (button) folded before Flop (didn't bet)
Seat 5: braydon.2002 (small blind) showed [Js 7c] and won ($2.60) with two pair, Jacks and Threes
Seat 6: CashMatteo (big blind) mucked [5d 5s]

Hand #2436: 

PokerStars Hand #250569158143:  Hold'em No Limit ($0.10/$0.25 CAD) - 2024/05/18 15:11:26 ET
Table 'Sadalbari III' 6-max Seat #5 is the button
Seat 1: Missinagnew ($36.08 in chips) 
Seat 2: hickdaddyx2 ($23.27 in chips) 
Seat 3: mistasho ($26.67 in chips) 
Seat 5: braydon.2002 ($26.24 in chips) 
Seat 6: CashMatteo ($18.70 in chips) 
CashMatteo: posts small blind $0.10
Missinagnew: posts big blind $0.25
Alpha Mule: sits out 
*** HOLE CARDS ***
Dealt to CashMatteo [5c 3c]
hickdaddyx2: calls $0.25
mistasho: folds 
braydon.2002: folds 
CashMatteo: calls $0.15
Missinagnew: checks 
*** FLOP *** [7s Ac Qs]
CashMatteo: checks 
Missinagnew: checks 
hickdaddyx2: checks 
*** TURN *** [7s Ac Qs] [Qh]
CashMatteo: checks 
Missinagnew: checks 
hickdaddyx2: checks 
*** RIVER *** [7s Ac Qs Qh] [8h]
CashMatteo: checks 
Missinagnew: bets $0.25
hickdaddyx2: calls $0.25
CashMatteo: folds 
*** SHOW DOWN ***
Missinagnew: shows [Qd 4c] (three of a kind, Queens)
hickdaddyx2: mucks hand 
Missinagnew collected $1.19 from pot
*** SUMMARY ***
Total pot $1.25 | Rake $0.06 
Board [7s Ac Qs Qh 8h]
Seat 1: Missinagnew (big blind) showed [Qd 4c] and won ($1.19) with three of a kind, Queens
Seat 2: hickdaddyx2 mucked [6h 6s]
Seat 3: mistasho folded before Flop (didn't bet)
Seat 5: braydon.2002 (button) folded before Flop (didn't bet)
Seat 6: CashMatteo (small blind) folded on the River

Hand #2437: 

PokerStars Hand #250569175975:  Hold'em No Limit ($0.10/$0.25 CAD) - 2024/05/18 15:12:15 ET
Table 'Sadalbari III' 6-max Seat #6 is the button
Seat 1: Missinagnew ($36.77 in chips) 
Seat 2: hickdaddyx2 ($22.77 in chips) 
Seat 3: mistasho ($26.67 in chips) 
Seat 5: braydon.2002 ($26.24 in chips) 
Seat 6: CashMatteo ($18.45 in chips) 
Missinagnew: posts small blind $0.10
hickdaddyx2: posts big blind $0.25
Alpha Mule: sits out 
*** HOLE CARDS ***
Dealt to CashMatteo [Th 8d]
mistasho: folds 
braydon.2002: folds 
CashMatteo: folds 
Missinagnew: folds 
Uncalled bet ($0.15) returned to hickdaddyx2
hickdaddyx2 collected $0.20 from pot
*** SUMMARY ***
Total pot $0.20 | Rake $0 
Seat 1: Missinagnew (small blind) folded before Flop
Seat 2: hickdaddyx2 (big blind) collected ($0.20)
Seat 3: mistasho folded before Flop (didn't bet)
Seat 5: braydon.2002 folded before Flop (didn't bet)
Seat 6: CashMatteo (button) folded before Flop (didn't bet)

Hand #2438: 

PokerStars Hand #250569182504:  Hold'em No Limit ($0.10/$0.25 CAD) - 2024/05/18 15:12:33 ET
Table 'Sadalbari III' 6-max Seat #1 is the button
Seat 1: Missinagnew ($36.67 in chips) 
Seat 2: hickdaddyx2 ($22.87 in chips) 
Seat 3: mistasho ($26.67 in chips) 
Seat 5: braydon.2002 ($26.24 in chips) 
Seat 6: CashMatteo ($18.45 in chips) 
hickdaddyx2: posts small blind $0.10
mistasho: posts big blind $0.25
Alpha Mule: sits out 
*** HOLE CARDS ***
Dealt to CashMatteo [8c 9d]
braydon.2002: folds 
CashMatteo: calls $0.25
Missinagnew: folds 
hickdaddyx2: folds 
mistasho: raises $26.42 to $26.67 and is all-in
CashMatteo: folds 
Uncalled bet ($26.42) returned to mistasho
mistasho collected $0.60 from pot
mistasho: doesn't show hand 
*** SUMMARY ***
Total pot $0.60 | Rake $0 
Seat 1: Missinagnew (button) folded before Flop (didn't bet)
Seat 2: hickdaddyx2 (small blind) folded before Flop
Seat 3: mistasho (big blind) collected ($0.60)
Seat 5: braydon.2002 folded before Flop (didn't bet)
Seat 6: CashMatteo folded before Flop

Hand #2439: 

PokerStars Hand #250569191272:  Hold'em No Limit ($0.10/$0.25 CAD) - 2024/05/18 15:12:57 ET
Table 'Sadalbari III' 6-max Seat #2 is the button
Seat 1: Missinagnew ($36.67 in chips) 
Seat 2: hickdaddyx2 ($22.77 in chips) 
Seat 3: mistasho ($27.02 in chips) 
Seat 4: Alpha Mule ($25 in chips) 
Seat 5: braydon.2002 ($26.24 in chips) 
Seat 6: CashMatteo ($18.20 in chips) 
mistasho: posts small blind $0.10
Alpha Mule: posts big blind $0.25
*** HOLE CARDS ***
Dealt to CashMatteo [8d Qs]
braydon.2002: folds 
CashMatteo: calls $0.25
Missinagnew: folds 
hickdaddyx2: calls $0.25
mistasho: folds 
Alpha Mule: checks 
*** FLOP *** [Ad 3c Kh]
Alpha Mule: checks 
CashMatteo: checks 
hickdaddyx2: checks 
*** TURN *** [Ad 3c Kh] [4s]
Alpha Mule: checks 
CashMatteo: checks 
hickdaddyx2: bets $0.81
Alpha Mule: folds 
CashMatteo: folds 
Uncalled bet ($0.81) returned to hickdaddyx2
hickdaddyx2 collected $0.81 from pot
*** SUMMARY ***
Total pot $0.85 | Rake $0.04 
Board [Ad 3c Kh 4s]
Seat 1: Missinagnew folded before Flop (didn't bet)
Seat 2: hickdaddyx2 (button) collected ($0.81)
Seat 3: mistasho (small blind) folded before Flop
Seat 4: Alpha Mule (big blind) folded on the Turn
Seat 5: braydon.2002 folded before Flop (didn't bet)
Seat 6: CashMatteo folded on the Turn

Hand #2440: 

PokerStars Hand #250569207141:  Hold'em No Limit ($0.10/$0.25 CAD) - 2024/05/18 15:13:41 ET
Table 'Sadalbari III' 6-max Seat #3 is the button
Seat 1: Missinagnew ($36.67 in chips) 
Seat 2: hickdaddyx2 ($23.33 in chips) 
Seat 3: mistasho ($26.92 in chips) 
Seat 4: Alpha Mule ($25 in chips) 
Seat 5: braydon.2002 ($26.24 in chips) 
Seat 6: CashMatteo ($17.95 in chips) 
Alpha Mule: posts small blind $0.10
braydon.2002: posts big blind $0.25
*** HOLE CARDS ***
Dealt to CashMatteo [Jc 4s]
CashMatteo: folds 
Missinagnew: raises $0.37 to $0.62
hickdaddyx2: calls $0.62
mistasho: folds 
Alpha Mule: folds 
braydon.2002: folds 
*** FLOP *** [7c Ks 6c]
Missinagnew: checks 
hickdaddyx2: checks 
*** TURN *** [7c Ks 6c] [3h]
Missinagnew: checks 
hickdaddyx2: checks 
*** RIVER *** [7c Ks 6c 3h] [4d]
Missinagnew: checks 
hickdaddyx2: checks 
*** SHOW DOWN ***
Missinagnew: shows [Qc Jd] (high card King)
hickdaddyx2: shows [Th Ah] (high card Ace)
hickdaddyx2 collected $1.52 from pot
*** SUMMARY ***
Total pot $1.59 | Rake $0.07 
Board [7c Ks 6c 3h 4d]
Seat 1: Missinagnew showed [Qc Jd] and lost with high card King
Seat 2: hickdaddyx2 showed [Th Ah] and won ($1.52) with high card Ace
Seat 3: mistasho (button) folded before Flop (didn't bet)
Seat 4: Alpha Mule (small blind) folded before Flop
Seat 5: braydon.2002 (big blind) folded before Flop
Seat 6: CashMatteo folded before Flop (didn't bet)

Hand #2441: 

PokerStars Hand #250569223570:  Hold'em No Limit ($0.10/$0.25 CAD) - 2024/05/18 15:14:26 ET
Table 'Sadalbari III' 6-max Seat #4 is the button
Seat 1: Missinagnew ($36.05 in chips) 
Seat 2: hickdaddyx2 ($24.23 in chips) 
Seat 3: mistasho ($26.92 in chips) 
Seat 4: Alpha Mule ($25 in chips) 
Seat 5: braydon.2002 ($25.99 in chips) 
Seat 6: CashMatteo ($17.95 in chips) 
braydon.2002: posts small blind $0.10
CashMatteo: posts big blind $0.25
*** HOLE CARDS ***
Dealt to CashMatteo [7d 3c]
Missinagnew: folds 
hickdaddyx2: calls $0.25
mistasho: folds 
Alpha Mule: folds 
braydon.2002: folds 
CashMatteo: checks 
*** FLOP *** [Qc 2s Jc]
CashMatteo: checks 
hickdaddyx2: checks 
*** TURN *** [Qc 2s Jc] [7s]
CashMatteo: checks 
hickdaddyx2: checks 
*** RIVER *** [Qc 2s Jc 7s] [Kd]
CashMatteo: checks 
hickdaddyx2: checks 
*** SHOW DOWN ***
CashMatteo: shows [7d 3c] (a pair of Sevens)
hickdaddyx2: mucks hand 
CashMatteo collected $0.57 from pot
*** SUMMARY ***
Total pot $0.60 | Rake $0.03 
Board [Qc 2s Jc 7s Kd]
Seat 1: Missinagnew folded before Flop (didn't bet)
Seat 2: hickdaddyx2 mucked [4d As]
Seat 3: mistasho folded before Flop (didn't bet)
Seat 4: Alpha Mule (button) folded before Flop (didn't bet)
Seat 5: braydon.2002 (small blind) folded before Flop
Seat 6: CashMatteo (big blind) showed [7d 3c] and won ($0.57) with a pair of Sevens

Hand #2442: 

PokerStars Hand #250569241698:  Hold'em No Limit ($0.10/$0.25 CAD) - 2024/05/18 15:15:16 ET
Table 'Sadalbari III' 6-max Seat #5 is the button
Seat 1: Missinagnew ($36.05 in chips) 
Seat 2: hickdaddyx2 ($23.98 in chips) 
Seat 3: mistasho ($26.92 in chips) 
Seat 4: Alpha Mule ($25 in chips) 
Seat 5: braydon.2002 ($25.89 in chips) 
Seat 6: CashMatteo ($18.27 in chips) 
CashMatteo: posts small blind $0.10
Missinagnew: posts big blind $0.25
*** HOLE CARDS ***
Dealt to CashMatteo [2s Tc]
hickdaddyx2: calls $0.25
mistasho: folds 
Alpha Mule: folds 
braydon.2002: folds 
CashMatteo: folds 
Missinagnew: checks 
*** FLOP *** [9s Ah 8s]
Missinagnew: checks 
hickdaddyx2: bets $0.57
Missinagnew: folds 
Uncalled bet ($0.57) returned to hickdaddyx2
hickdaddyx2 collected $0.57 from pot
*** SUMMARY ***
Total pot $0.60 | Rake $0.03 
Board [9s Ah 8s]
Seat 1: Missinagnew (big blind) folded on the Flop
Seat 2: hickdaddyx2 collected ($0.57)
Seat 3: mistasho folded before Flop (didn't bet)
Seat 4: Alpha Mule folded before Flop (didn't bet)
Seat 5: braydon.2002 (button) folded before Flop (didn't bet)
Seat 6: CashMatteo (small blind) folded before Flop

Hand #2443: 

PokerStars Hand #250569255099:  Hold'em No Limit ($0.10/$0.25 CAD) - 2024/05/18 15:15:53 ET
Table 'Sadalbari III' 6-max Seat #6 is the button
Seat 1: Missinagnew ($35.80 in chips) 
Seat 2: hickdaddyx2 ($24.30 in chips) 
Seat 3: mistasho ($26.92 in chips) 
Seat 4: Alpha Mule ($25 in chips) 
Seat 5: braydon.2002 ($25.89 in chips) 
Seat 6: CashMatteo ($18.17 in chips) 
Missinagnew: posts small blind $0.10
hickdaddyx2: posts big blind $0.25
*** HOLE CARDS ***
Dealt to CashMatteo [Kd 6s]
mistasho: folds 
Alpha Mule: folds 
braydon.2002: folds 
CashMatteo: calls $0.25
Missinagnew: folds 
hickdaddyx2: checks 
*** FLOP *** [2h 7h 5s]
hickdaddyx2: checks 
CashMatteo: checks 
*** TURN *** [2h 7h 5s] [Td]
hickdaddyx2: checks 
CashMatteo: checks 
*** RIVER *** [2h 7h 5s Td] [Jh]
hickdaddyx2: checks 
CashMatteo: checks 
*** SHOW DOWN ***
hickdaddyx2: shows [6d Tc] (a pair of Tens)
CashMatteo: mucks hand 
hickdaddyx2 collected $0.57 from pot
*** SUMMARY ***
Total pot $0.60 | Rake $0.03 
Board [2h 7h 5s Td Jh]
Seat 1: Missinagnew (small blind) folded before Flop
Seat 2: hickdaddyx2 (big blind) showed [6d Tc] and won ($0.57) with a pair of Tens
Seat 3: mistasho folded before Flop (didn't bet)
Seat 4: Alpha Mule folded before Flop (didn't bet)
Seat 5: braydon.2002 folded before Flop (didn't bet)
Seat 6: CashMatteo (button) mucked [Kd 6s]

Hand #2444: 

PokerStars Hand #250569269056:  Hold'em No Limit ($0.10/$0.25 CAD) - 2024/05/18 15:16:31 ET
Table 'Sadalbari III' 6-max Seat #1 is the button
Seat 1: Missinagnew ($35.70 in chips) 
Seat 2: hickdaddyx2 ($24.62 in chips) 
Seat 3: mistasho ($26.92 in chips) 
Seat 4: Alpha Mule ($25 in chips) 
Seat 5: braydon.2002 ($25.89 in chips) 
Seat 6: CashMatteo ($17.92 in chips) 
hickdaddyx2: posts small blind $0.10
mistasho: posts big blind $0.25
*** HOLE CARDS ***
Dealt to CashMatteo [4s Js]
Alpha Mule: folds 
braydon.2002: folds 
CashMatteo: calls $0.25
Missinagnew: folds 
hickdaddyx2: calls $0.15
mistasho: checks 
*** FLOP *** [Ac Kc 3d]
hickdaddyx2: bets $0.50
mistasho: folds 
CashMatteo: folds 
Uncalled bet ($0.50) returned to hickdaddyx2
hickdaddyx2 collected $0.72 from pot
*** SUMMARY ***
Total pot $0.75 | Rake $0.03 
Board [Ac Kc 3d]
Seat 1: Missinagnew (button) folded before Flop (didn't bet)
Seat 2: hickdaddyx2 (small blind) collected ($0.72)
Seat 3: mistasho (big blind) folded on the Flop
Seat 4: Alpha Mule folded before Flop (didn't bet)
Seat 5: braydon.2002 folded before Flop (didn't bet)
Seat 6: CashMatteo folded on the Flop

Hand #2445: 

PokerStars Hand #250569279561:  Hold'em No Limit ($0.10/$0.25 CAD) - 2024/05/18 15:17:00 ET
Table 'Sadalbari III' 6-max Seat #2 is the button
Seat 1: Missinagnew ($35.70 in chips) 
Seat 2: hickdaddyx2 ($25.09 in chips) 
Seat 3: mistasho ($26.67 in chips) 
Seat 4: Alpha Mule ($25 in chips) 
Seat 5: braydon.2002 ($25.89 in chips) 
Seat 6: CashMatteo ($17.67 in chips) 
mistasho: posts small blind $0.10
Alpha Mule: posts big blind $0.25
*** HOLE CARDS ***
Dealt to CashMatteo [3d 9h]
braydon.2002: raises $0.50 to $0.75
CashMatteo: folds 
Missinagnew: folds 
hickdaddyx2: calls $0.75
mistasho: folds 
Alpha Mule: folds 
*** FLOP *** [Th Jd 4h]
braydon.2002: bets $1.33
hickdaddyx2: folds 
Uncalled bet ($1.33) returned to braydon.2002
braydon.2002 collected $1.77 from pot
braydon.2002: doesn't show hand 
*** SUMMARY ***
Total pot $1.85 | Rake $0.08 
Board [Th Jd 4h]
Seat 1: Missinagnew folded before Flop (didn't bet)
Seat 2: hickdaddyx2 (button) folded on the Flop
Seat 3: mistasho (small blind) folded before Flop
Seat 4: Alpha Mule (big blind) folded before Flop
Seat 5: braydon.2002 collected ($1.77)
Seat 6: CashMatteo folded before Flop (didn't bet)

Hand #2446: 

PokerStars Hand #250569288209:  Hold'em No Limit ($0.10/$0.25 CAD) - 2024/05/18 15:17:25 ET
Table 'Sadalbari III' 6-max Seat #3 is the button
Seat 1: Missinagnew ($35.70 in chips) 
Seat 2: hickdaddyx2 ($24.34 in chips) 
Seat 3: mistasho ($26.57 in chips) 
Seat 4: Alpha Mule ($25 in chips) 
Seat 5: braydon.2002 ($26.91 in chips) 
Seat 6: CashMatteo ($17.67 in chips) 
Alpha Mule: posts small blind $0.10
braydon.2002: posts big blind $0.25
*** HOLE CARDS ***
Dealt to CashMatteo [8c 2c]
CashMatteo: folds 
Missinagnew: folds 
hickdaddyx2: calls $0.25
mistasho: folds 
Alpha Mule: folds 
braydon.2002: checks 
*** FLOP *** [Ts 4d 5s]
braydon.2002: bets $0.43
hickdaddyx2: calls $0.43
*** TURN *** [Ts 4d 5s] [Ah]
braydon.2002: bets $1.85
hickdaddyx2: folds 
Uncalled bet ($1.85) returned to braydon.2002
braydon.2002 collected $1.39 from pot
braydon.2002: doesn't show hand 
*** SUMMARY ***
Total pot $1.46 | Rake $0.07 
Board [Ts 4d 5s Ah]
Seat 1: Missinagnew folded before Flop (didn't bet)
Seat 2: hickdaddyx2 folded on the Turn
Seat 3: mistasho (button) folded before Flop (didn't bet)
Seat 4: Alpha Mule (small blind) folded before Flop
Seat 5: braydon.2002 (big blind) collected ($1.39)
Seat 6: CashMatteo folded before Flop (didn't bet)

Hand #2447: 

PokerStars Hand #250569301777:  Hold'em No Limit ($0.10/$0.25 CAD) - 2024/05/18 15:18:02 ET
Table 'Sadalbari III' 6-max Seat #4 is the button
Seat 1: Missinagnew ($35.70 in chips) 
Seat 2: hickdaddyx2 ($23.66 in chips) 
Seat 4: Alpha Mule ($25 in chips) 
Seat 5: braydon.2002 ($27.62 in chips) 
Seat 6: CashMatteo ($17.67 in chips) 
braydon.2002: posts small blind $0.10
CashMatteo: posts big blind $0.25
*** HOLE CARDS ***
Dealt to CashMatteo [5d Kd]
Missinagnew: folds 
hickdaddyx2: calls $0.25
Alpha Mule: folds 
braydon.2002: raises $2 to $2.25
CashMatteo: folds 
hickdaddyx2: folds 
Uncalled bet ($2) returned to braydon.2002
braydon.2002 collected $0.75 from pot
braydon.2002: doesn't show hand 
*** SUMMARY ***
Total pot $0.75 | Rake $0 
Seat 1: Missinagnew folded before Flop (didn't bet)
Seat 2: hickdaddyx2 folded before Flop
Seat 4: Alpha Mule (button) folded before Flop (didn't bet)
Seat 5: braydon.2002 (small blind) collected ($0.75)
Seat 6: CashMatteo (big blind) folded before Flop

Hand #2448: 

PokerStars Hand #250569312813:  Hold'em No Limit ($0.10/$0.25 CAD) - 2024/05/18 15:18:32 ET
Table 'Sadalbari III' 6-max Seat #5 is the button
Seat 2: hickdaddyx2 ($23.41 in chips) 
Seat 4: Alpha Mule ($25 in chips) 
Seat 5: braydon.2002 ($28.12 in chips) 
Seat 6: CashMatteo ($17.42 in chips) 
CashMatteo: posts small blind $0.10
Missinagnew: is sitting out 
hickdaddyx2: posts big blind $0.25
*** HOLE CARDS ***
Dealt to CashMatteo [Qd 3d]
Alpha Mule: folds 
braydon.2002: folds 
Missinagnew leaves the table
CashMatteo: calls $0.15
hickdaddyx2: checks 
*** FLOP *** [6d Qc 4d]
CashMatteo: bets $0.48
hickdaddyx2: folds 
Uncalled bet ($0.48) returned to CashMatteo
CashMatteo collected $0.48 from pot
CashMatteo: doesn't show hand 
*** SUMMARY ***
Total pot $0.50 | Rake $0.02 
Board [6d Qc 4d]
Seat 2: hickdaddyx2 (big blind) folded on the Flop
Seat 4: Alpha Mule folded before Flop (didn't bet)
Seat 5: braydon.2002 (button) folded before Flop (didn't bet)
Seat 6: CashMatteo (small blind) collected ($0.48)

Hand #2449: 

PokerStars Hand #250569322008:  Hold'em No Limit ($0.10/$0.25 CAD) - 2024/05/18 15:18:58 ET
Table 'Sadalbari III' 6-max Seat #6 is the button
Seat 2: hickdaddyx2 ($23.16 in chips) 
Seat 4: Alpha Mule ($25 in chips) 
Seat 5: braydon.2002 ($28.12 in chips) 
Seat 6: CashMatteo ($17.65 in chips) 
hickdaddyx2: posts small blind $0.10
Alpha Mule: posts big blind $0.25
*** HOLE CARDS ***
Dealt to CashMatteo [Ah 3d]
braydon.2002: folds 
CashMatteo: raises $0.37 to $0.62
hickdaddyx2: folds 
Alpha Mule: folds 
Uncalled bet ($0.37) returned to CashMatteo
CashMatteo collected $0.60 from pot
CashMatteo: doesn't show hand 
*** SUMMARY ***
Total pot $0.60 | Rake $0 
Seat 2: hickdaddyx2 (small blind) folded before Flop
Seat 4: Alpha Mule (big blind) folded before Flop
Seat 5: braydon.2002 folded before Flop (didn't bet)
Seat 6: CashMatteo (button) collected ($0.60)

Hand #2450: 

PokerStars Hand #250569326871:  Hold'em No Limit ($0.10/$0.25 CAD) - 2024/05/18 15:19:11 ET
Table 'Sadalbari III' 6-max Seat #2 is the button
Seat 2: hickdaddyx2 ($23.06 in chips) 
Seat 4: Alpha Mule ($25 in chips) 
Seat 5: braydon.2002 ($28.12 in chips) 
Seat 6: CashMatteo ($18 in chips) 
Alpha Mule: posts small blind $0.10
braydon.2002: posts big blind $0.25
*** HOLE CARDS ***
Dealt to CashMatteo [8d 9c]
CashMatteo: raises $0.37 to $0.62
hickdaddyx2: folds 
Alpha Mule: folds 
braydon.2002: raises $1.87 to $2.49
CashMatteo: folds 
Uncalled bet ($1.87) returned to braydon.2002
starbwoi joins the table at seat #1 
braydon.2002 collected $1.34 from pot
braydon.2002: doesn't show hand 
*** SUMMARY ***
Total pot $1.34 | Rake $0 
Seat 2: hickdaddyx2 (button) folded before Flop (didn't bet)
Seat 4: Alpha Mule (small blind) folded before Flop
Seat 5: braydon.2002 (big blind) collected ($1.34)
Seat 6: CashMatteo folded before Flop

Hand #2451: 

PokerStars Hand #250569335564:  Hold'em No Limit ($0.10/$0.25 CAD) - 2024/05/18 15:19:35 ET
Table 'Sadalbari III' 6-max Seat #4 is the button
Seat 2: hickdaddyx2 ($23.06 in chips) 
Seat 4: Alpha Mule ($25 in chips) 
Seat 5: braydon.2002 ($28.84 in chips) 
Seat 6: CashMatteo ($17.38 in chips) 
braydon.2002: posts small blind $0.10
CashMatteo: posts big blind $0.25
starbwoi: sits out 
*** HOLE CARDS ***
Dealt to CashMatteo [2s 9s]
hickdaddyx2: calls $0.25
Alpha Mule: folds 
braydon.2002: folds 
CashMatteo: checks 
*** FLOP *** [Qd 4c 6h]
CashMatteo: checks 
hickdaddyx2: checks 
*** TURN *** [Qd 4c 6h] [2d]
CashMatteo: bets $0.29
hickdaddyx2: calls $0.29
*** RIVER *** [Qd 4c 6h 2d] [3s]
CashMatteo: checks 
hickdaddyx2: bets $0.75
CashMatteo: folds 
Uncalled bet ($0.75) returned to hickdaddyx2
hickdaddyx2 collected $1.13 from pot
*** SUMMARY ***
Total pot $1.18 | Rake $0.05 
Board [Qd 4c 6h 2d 3s]
Seat 2: hickdaddyx2 collected ($1.13)
Seat 4: Alpha Mule (button) folded before Flop (didn't bet)
Seat 5: braydon.2002 (small blind) folded before Flop
Seat 6: CashMatteo (big blind) folded on the River

Hand #2452: 

PokerStars Hand #250569353751:  Hold'em No Limit ($0.10/$0.25 CAD) - 2024/05/18 15:20:25 ET
Table 'Sadalbari III' 6-max Seat #5 is the button
Seat 1: starbwoi ($25 in chips) 
Seat 2: hickdaddyx2 ($23.65 in chips) 
Seat 4: Alpha Mule ($25 in chips) 
Seat 5: braydon.2002 ($28.74 in chips) 
Seat 6: CashMatteo ($16.84 in chips) 
CashMatteo: posts small blind $0.10
starbwoi: posts big blind $0.25
mistasho: sits out 
*** HOLE CARDS ***
Dealt to CashMatteo [7c 5c]
hickdaddyx2: calls $0.25
Alpha Mule: raises $0.85 to $1.10
braydon.2002: folds 
CashMatteo: folds 
starbwoi: folds 
hickdaddyx2: calls $0.85
*** FLOP *** [9c Js Jh]
hickdaddyx2: checks 
Alpha Mule: checks 
*** TURN *** [9c Js Jh] [4d]
hickdaddyx2: checks 
Alpha Mule: checks 
*** RIVER *** [9c Js Jh 4d] [6c]
hickdaddyx2: checks 
Alpha Mule: checks 
*** SHOW DOWN ***
hickdaddyx2: shows [Ks As] (a pair of Jacks)
Alpha Mule: mucks hand 
hickdaddyx2 collected $2.44 from pot
*** SUMMARY ***
Total pot $2.55 | Rake $0.11 
Board [9c Js Jh 4d 6c]
Seat 1: starbwoi (big blind) folded before Flop
Seat 2: hickdaddyx2 showed [Ks As] and won ($2.44) with a pair of Jacks
Seat 4: Alpha Mule mucked [Ad Qh]
Seat 5: braydon.2002 (button) folded before Flop (didn't bet)
Seat 6: CashMatteo (small blind) folded before Flop

Hand #2453: 

PokerStars Hand #250569370485:  Hold'em No Limit ($0.10/$0.25 CAD) - 2024/05/18 15:21:11 ET
Table 'Sadalbari III' 6-max Seat #6 is the button
Seat 1: starbwoi ($25 in chips) 
Seat 2: hickdaddyx2 ($24.99 in chips) 
Seat 4: Alpha Mule ($25 in chips) 
Seat 5: braydon.2002 ($28.74 in chips) 
Seat 6: CashMatteo ($16.74 in chips) 
starbwoi: posts small blind $0.10
hickdaddyx2: posts big blind $0.25
mistasho: sits out 
*** HOLE CARDS ***
Dealt to CashMatteo [7s 4s]
Alpha Mule: folds 
braydon.2002: folds 
CashMatteo: calls $0.25
starbwoi: folds 
hickdaddyx2: checks 
*** FLOP *** [3h 5d Ks]
hickdaddyx2: checks 
CashMatteo: checks 
*** TURN *** [3h 5d Ks] [2d]
hickdaddyx2: checks 
CashMatteo: checks 
*** RIVER *** [3h 5d Ks 2d] [2h]
hickdaddyx2: bets $0.25
CashMatteo: folds 
Uncalled bet ($0.25) returned to hickdaddyx2
hickdaddyx2 collected $0.57 from pot
*** SUMMARY ***
Total pot $0.60 | Rake $0.03 
Board [3h 5d Ks 2d 2h]
Seat 1: starbwoi (small blind) folded before Flop
Seat 2: hickdaddyx2 (big blind) collected ($0.57)
Seat 4: Alpha Mule folded before Flop (didn't bet)
Seat 5: braydon.2002 folded before Flop (didn't bet)
Seat 6: CashMatteo (button) folded on the River

Hand #2454: 

PokerStars Hand #250569382086:  Hold'em No Limit ($0.10/$0.25 CAD) - 2024/05/18 15:21:43 ET
Table 'Sadalbari III' 6-max Seat #1 is the button
Seat 1: starbwoi ($25 in chips) 
Seat 2: hickdaddyx2 ($25.31 in chips) 
Seat 3: mistasho ($26.57 in chips) 
Seat 4: Alpha Mule ($25 in chips) 
Seat 5: braydon.2002 ($28.74 in chips) 
Seat 6: CashMatteo ($16.49 in chips) 
hickdaddyx2: posts small blind $0.10
mistasho: posts big blind $0.25
*** HOLE CARDS ***
Dealt to CashMatteo [4d 5d]
Alpha Mule: folds 
braydon.2002: folds 
CashMatteo: raises $0.37 to $0.62
starbwoi: folds 
hickdaddyx2: folds 
mistasho: folds 
Uncalled bet ($0.37) returned to CashMatteo
CashMatteo collected $0.60 from pot
CashMatteo: doesn't show hand 
*** SUMMARY ***
Total pot $0.60 | Rake $0 
Seat 1: starbwoi (button) folded before Flop (didn't bet)
Seat 2: hickdaddyx2 (small blind) folded before Flop
Seat 3: mistasho (big blind) folded before Flop
Seat 4: Alpha Mule folded before Flop (didn't bet)
Seat 5: braydon.2002 folded before Flop (didn't bet)
Seat 6: CashMatteo collected ($0.60)

Hand #2455: 

PokerStars Hand #250569389649:  Hold'em No Limit ($0.10/$0.25 CAD) - 2024/05/18 15:22:03 ET
Table 'Sadalbari III' 6-max Seat #2 is the button
Seat 1: starbwoi ($25 in chips) 
Seat 2: hickdaddyx2 ($25.21 in chips) 
Seat 3: mistasho ($26.32 in chips) 
Seat 4: Alpha Mule ($25 in chips) 
Seat 5: braydon.2002 ($28.74 in chips) 
Seat 6: CashMatteo ($16.84 in chips) 
mistasho: posts small blind $0.10
Alpha Mule: posts big blind $0.25
*** HOLE CARDS ***
Dealt to CashMatteo [Js 9s]
braydon.2002: folds 
CashMatteo: raises $0.37 to $0.62
starbwoi: folds 
hickdaddyx2: folds 
mistasho: folds 
Alpha Mule: folds 
Uncalled bet ($0.37) returned to CashMatteo
CashMatteo collected $0.60 from pot
CashMatteo: doesn't show hand 
*** SUMMARY ***
Total pot $0.60 | Rake $0 
Seat 1: starbwoi folded before Flop (didn't bet)
Seat 2: hickdaddyx2 (button) folded before Flop (didn't bet)
Seat 3: mistasho (small blind) folded before Flop
Seat 4: Alpha Mule (big blind) folded before Flop
Seat 5: braydon.2002 folded before Flop (didn't bet)
Seat 6: CashMatteo collected ($0.60)

Hand #2456: 

PokerStars Hand #250569397633:  Hold'em No Limit ($0.10/$0.25 CAD) - 2024/05/18 15:22:25 ET
Table 'Sadalbari III' 6-max Seat #3 is the button
Seat 1: starbwoi ($25 in chips) 
Seat 2: hickdaddyx2 ($25.21 in chips) 
Seat 3: mistasho ($26.22 in chips) 
Seat 4: Alpha Mule ($25 in chips) 
Seat 5: braydon.2002 ($28.74 in chips) 
Seat 6: CashMatteo ($17.19 in chips) 
Alpha Mule: posts small blind $0.10
braydon.2002: posts big blind $0.25
*** HOLE CARDS ***
Dealt to CashMatteo [4c 6c]
CashMatteo: folds 
starbwoi: folds 
hickdaddyx2: calls $0.25
mistasho: folds 
Alpha Mule: folds 
braydon.2002: checks 
*** FLOP *** [Kd Tc Kh]
braydon.2002: checks 
hickdaddyx2: checks 
*** TURN *** [Kd Tc Kh] [7s]
braydon.2002: checks 
hickdaddyx2: checks 
*** RIVER *** [Kd Tc Kh 7s] [3s]
braydon.2002: bets $0.76
hickdaddyx2: folds 
Uncalled bet ($0.76) returned to braydon.2002
braydon.2002 collected $0.57 from pot
braydon.2002: doesn't show hand 
*** SUMMARY ***
Total pot $0.60 | Rake $0.03 
Board [Kd Tc Kh 7s 3s]
Seat 1: starbwoi folded before Flop (didn't bet)
Seat 2: hickdaddyx2 folded on the River
Seat 3: mistasho (button) folded before Flop (didn't bet)
Seat 4: Alpha Mule (small blind) folded before Flop
Seat 5: braydon.2002 (big blind) collected ($0.57)
Seat 6: CashMatteo folded before Flop (didn't bet)

Hand #2457: 

PokerStars Hand #250569416056:  Hold'em No Limit ($0.10/$0.25 CAD) - 2024/05/18 15:23:16 ET
Table 'Sadalbari III' 6-max Seat #4 is the button
Seat 1: starbwoi ($25 in chips) 
Seat 2: hickdaddyx2 ($24.96 in chips) 
Seat 3: mistasho ($26.22 in chips) 
Seat 4: Alpha Mule ($25 in chips) 
Seat 5: braydon.2002 ($29.06 in chips) 
Seat 6: CashMatteo ($17.19 in chips) 
braydon.2002: posts small blind $0.10
CashMatteo: posts big blind $0.25
*** HOLE CARDS ***
Dealt to CashMatteo [2s Kc]
starbwoi: folds 
hickdaddyx2: folds 
mistasho: folds 
Alpha Mule: folds 
braydon.2002: raises $0.50 to $0.75
CashMatteo: calls $0.50
*** FLOP *** [9s 3c Qd]
braydon.2002: checks 
CashMatteo: bets $0.72
braydon.2002: calls $0.72
*** TURN *** [9s 3c Qd] [Jd]
braydon.2002: checks 
CashMatteo: checks 
*** RIVER *** [9s 3c Qd Jd] [Ts]
braydon.2002: checks 
CashMatteo: bets $1.91
braydon.2002: folds 
Uncalled bet ($1.91) returned to CashMatteo
CashMatteo collected $2.81 from pot
CashMatteo: doesn't show hand 
*** SUMMARY ***
Total pot $2.94 | Rake $0.13 
Board [9s 3c Qd Jd Ts]
Seat 1: starbwoi folded before Flop (didn't bet)
Seat 2: hickdaddyx2 folded before Flop (didn't bet)
Seat 3: mistasho folded before Flop (didn't bet)
Seat 4: Alpha Mule (button) folded before Flop (didn't bet)
Seat 5: braydon.2002 (small blind) folded on the River
Seat 6: CashMatteo (big blind) collected ($2.81)

Hand #2458: 

PokerStars Hand #250569430250:  Hold'em No Limit ($0.10/$0.25 CAD) - 2024/05/18 15:23:55 ET
Table 'Sadalbari III' 6-max Seat #5 is the button
Seat 1: starbwoi ($25 in chips) 
Seat 2: hickdaddyx2 ($24.96 in chips) 
Seat 3: mistasho ($26.22 in chips) 
Seat 4: Alpha Mule ($25 in chips) 
Seat 5: braydon.2002 ($27.59 in chips) 
Seat 6: CashMatteo ($18.53 in chips) 
CashMatteo: posts small blind $0.10
starbwoi: posts big blind $0.25
*** HOLE CARDS ***
Dealt to CashMatteo [8c Ts]
hickdaddyx2: calls $0.25
mistasho: folds 
Alpha Mule: folds 
braydon.2002: folds 
CashMatteo: folds 
starbwoi: checks 
*** FLOP *** [5s Jh Kc]
starbwoi: checks 
hickdaddyx2: checks 
*** TURN *** [5s Jh Kc] [4s]
starbwoi: bets $0.57
hickdaddyx2: folds 
Uncalled bet ($0.57) returned to starbwoi
starbwoi collected $0.57 from pot
starbwoi: doesn't show hand 
*** SUMMARY ***
Total pot $0.60 | Rake $0.03 
Board [5s Jh Kc 4s]
Seat 1: starbwoi (big blind) collected ($0.57)
Seat 2: hickdaddyx2 folded on the Turn
Seat 3: mistasho folded before Flop (didn't bet)
Seat 4: Alpha Mule folded before Flop (didn't bet)
Seat 5: braydon.2002 (button) folded before Flop (didn't bet)
Seat 6: CashMatteo (small blind) folded before Flop

Hand #2459: 

PokerStars Hand #250569445832:  Hold'em No Limit ($0.10/$0.25 CAD) - 2024/05/18 15:24:37 ET
Table 'Sadalbari III' 6-max Seat #6 is the button
Seat 1: starbwoi ($25.32 in chips) 
Seat 2: hickdaddyx2 ($24.71 in chips) 
Seat 3: mistasho ($26.22 in chips) 
Seat 4: Alpha Mule ($25 in chips) 
Seat 5: braydon.2002 ($27.59 in chips) 
Seat 6: CashMatteo ($18.43 in chips) 
starbwoi: posts small blind $0.10
hickdaddyx2: posts big blind $0.25
*** HOLE CARDS ***
Dealt to CashMatteo [7d 2d]
mistasho: folds 
Alpha Mule: folds 
braydon.2002: folds 
CashMatteo: folds 
starbwoi: raises $0.50 to $0.75
hickdaddyx2: folds 
Uncalled bet ($0.50) returned to starbwoi
starbwoi collected $0.50 from pot
starbwoi: doesn't show hand 
*** SUMMARY ***
Total pot $0.50 | Rake $0 
Seat 1: starbwoi (small blind) collected ($0.50)
Seat 2: hickdaddyx2 (big blind) folded before Flop
Seat 3: mistasho folded before Flop (didn't bet)
Seat 4: Alpha Mule folded before Flop (didn't bet)
Seat 5: braydon.2002 folded before Flop (didn't bet)
Seat 6: CashMatteo (button) folded before Flop (didn't bet)

Hand #2460: 

PokerStars Hand #250569453652:  Hold'em No Limit ($0.10/$0.25 CAD) - 2024/05/18 15:24:59 ET
Table 'Sadalbari III' 6-max Seat #1 is the button
Seat 1: starbwoi ($25.57 in chips) 
Seat 2: hickdaddyx2 ($24.46 in chips) 
Seat 3: mistasho ($26.22 in chips) 
Seat 4: Alpha Mule ($25 in chips) 
Seat 5: braydon.2002 ($27.59 in chips) 
Seat 6: CashMatteo ($18.43 in chips) 
hickdaddyx2: posts small blind $0.10
mistasho: posts big blind $0.25
*** HOLE CARDS ***
Dealt to CashMatteo [3d Qs]
Alpha Mule: folds 
braydon.2002: folds 
CashMatteo: folds 
starbwoi: raises $0.37 to $0.62
hickdaddyx2: folds 
mistasho: folds 
Uncalled bet ($0.37) returned to starbwoi
starbwoi collected $0.60 from pot
starbwoi: doesn't show hand 
*** SUMMARY ***
Total pot $0.60 | Rake $0 
Seat 1: starbwoi (button) collected ($0.60)
Seat 2: hickdaddyx2 (small blind) folded before Flop
Seat 3: mistasho (big blind) folded before Flop
Seat 4: Alpha Mule folded before Flop (didn't bet)
Seat 5: braydon.2002 folded before Flop (didn't bet)
Seat 6: CashMatteo folded before Flop (didn't bet)

Hand #2461: 

PokerStars Hand #250569459231:  Hold'em No Limit ($0.10/$0.25 CAD) - 2024/05/18 15:25:14 ET
Table 'Sadalbari III' 6-max Seat #2 is the button
Seat 1: starbwoi ($25.92 in chips) 
Seat 2: hickdaddyx2 ($24.36 in chips) 
Seat 3: mistasho ($25.97 in chips) 
Seat 4: Alpha Mule ($25 in chips) 
Seat 5: braydon.2002 ($27.59 in chips) 
Seat 6: CashMatteo ($18.43 in chips) 
mistasho: posts small blind $0.10
Alpha Mule: posts big blind $0.25
*** HOLE CARDS ***
Dealt to CashMatteo [3h 6s]
braydon.2002: folds 
CashMatteo: folds 
starbwoi: folds 
hickdaddyx2: folds 
mistasho: folds 
Uncalled bet ($0.15) returned to Alpha Mule
Alpha Mule collected $0.20 from pot
Alpha Mule: doesn't show hand 
*** SUMMARY ***
Total pot $0.20 | Rake $0 
Seat 1: starbwoi folded before Flop (didn't bet)
Seat 2: hickdaddyx2 (button) folded before Flop (didn't bet)
Seat 3: mistasho (small blind) folded before Flop
Seat 4: Alpha Mule (big blind) collected ($0.20)
Seat 5: braydon.2002 folded before Flop (didn't bet)
Seat 6: CashMatteo folded before Flop (didn't bet)

Hand #2462: 

PokerStars Hand #250569463053:  Hold'em No Limit ($0.10/$0.25 CAD) - 2024/05/18 15:25:25 ET
Table 'Sadalbari III' 6-max Seat #3 is the button
Seat 1: starbwoi ($25.92 in chips) 
Seat 2: hickdaddyx2 ($24.36 in chips) 
Seat 3: mistasho ($25.87 in chips) 
Seat 4: Alpha Mule ($25.10 in chips) 
Seat 5: braydon.2002 ($27.59 in chips) 
Seat 6: CashMatteo ($18.43 in chips) 
Alpha Mule: posts small blind $0.10
braydon.2002: posts big blind $0.25
*** HOLE CARDS ***
Dealt to CashMatteo [Qc Ks]
CashMatteo: raises $0.37 to $0.62
starbwoi: folds 
hickdaddyx2: calls $0.62
mistasho: folds 
Alpha Mule: folds 
braydon.2002: folds 
*** FLOP *** [7d 3d Ts]
CashMatteo: checks 
hickdaddyx2: bets $1.52
CashMatteo: calls $1.52
*** TURN *** [7d 3d Ts] [4h]
CashMatteo: checks 
hickdaddyx2: bets $2.21
CashMatteo: calls $2.21
*** RIVER *** [7d 3d Ts 4h] [2s]
CashMatteo: checks 
hickdaddyx2: bets $4.32
CashMatteo: folds 
Uncalled bet ($4.32) returned to hickdaddyx2
hickdaddyx2 collected $8.64 from pot
*** SUMMARY ***
Total pot $9.05 | Rake $0.41 
Board [7d 3d Ts 4h 2s]
Seat 1: starbwoi folded before Flop (didn't bet)
Seat 2: hickdaddyx2 collected ($8.64)
Seat 3: mistasho (button) folded before Flop (didn't bet)
Seat 4: Alpha Mule (small blind) folded before Flop
Seat 5: braydon.2002 (big blind) folded before Flop
Seat 6: CashMatteo folded on the River

Hand #2463: 

PokerStars Hand #250569481731:  Hold'em No Limit ($0.10/$0.25 CAD) - 2024/05/18 15:26:17 ET
Table 'Sadalbari III' 6-max Seat #4 is the button
Seat 1: starbwoi ($25.92 in chips) 
Seat 2: hickdaddyx2 ($28.65 in chips) 
Seat 3: mistasho ($25.87 in chips) 
Seat 4: Alpha Mule ($25 in chips) 
Seat 5: braydon.2002 ($27.34 in chips) 
Seat 6: CashMatteo ($14.08 in chips) 
braydon.2002: posts small blind $0.10
CashMatteo: posts big blind $0.25
*** HOLE CARDS ***
Dealt to CashMatteo [As 9c]
starbwoi: folds 
hickdaddyx2: folds 
mistasho: folds 
Alpha Mule: raises $0.50 to $0.75
braydon.2002: folds 
CashMatteo: calls $0.50
*** FLOP *** [Qs Js 4c]
CashMatteo: checks 
Alpha Mule: bets $0.50
CashMatteo: calls $0.50
*** TURN *** [Qs Js 4c] [4s]
CashMatteo: checks 
Alpha Mule: bets $1.24
CashMatteo: folds 
Uncalled bet ($1.24) returned to Alpha Mule
Alpha Mule collected $2.48 from pot
Alpha Mule: doesn't show hand 
*** SUMMARY ***
Total pot $2.60 | Rake $0.12 
Board [Qs Js 4c 4s]
Seat 1: starbwoi folded before Flop (didn't bet)
Seat 2: hickdaddyx2 folded before Flop (didn't bet)
Seat 3: mistasho folded before Flop (didn't bet)
Seat 4: Alpha Mule (button) collected ($2.48)
Seat 5: braydon.2002 (small blind) folded before Flop
Seat 6: CashMatteo (big blind) folded on the Turn

Hand #2464: 

PokerStars Hand #250569493176:  Hold'em No Limit ($0.10/$0.25 CAD) - 2024/05/18 15:26:48 ET
Table 'Sadalbari III' 6-max Seat #5 is the button
Seat 1: starbwoi ($25.92 in chips) 
Seat 2: hickdaddyx2 ($28.65 in chips) 
Seat 3: mistasho ($25.87 in chips) 
Seat 4: Alpha Mule ($26.23 in chips) 
Seat 5: braydon.2002 ($27.24 in chips) 
Seat 6: CashMatteo ($12.83 in chips) 
CashMatteo: posts small blind $0.10
starbwoi: posts big blind $0.25
*** HOLE CARDS ***
Dealt to CashMatteo [4d Qs]
hickdaddyx2: calls $0.25
mistasho: folds 
Alpha Mule: raises $0.50 to $0.75
braydon.2002: folds 
CashMatteo: folds 
starbwoi: folds 
hickdaddyx2: calls $0.50
*** FLOP *** [7d Jc 3s]
hickdaddyx2: checks 
Alpha Mule: checks 
*** TURN *** [7d Jc 3s] [5h]
hickdaddyx2: bets $0.50
Alpha Mule: calls $0.50
*** RIVER *** [7d Jc 3s 5h] [9s]
hickdaddyx2: bets $0.75
Alpha Mule: folds 
Uncalled bet ($0.75) returned to hickdaddyx2
hickdaddyx2 collected $2.72 from pot
*** SUMMARY ***
Total pot $2.85 | Rake $0.13 
Board [7d Jc 3s 5h 9s]
Seat 1: starbwoi (big blind) folded before Flop
Seat 2: hickdaddyx2 collected ($2.72)
Seat 3: mistasho folded before Flop (didn't bet)
Seat 4: Alpha Mule folded on the River
Seat 5: braydon.2002 (button) folded before Flop (didn't bet)
Seat 6: CashMatteo (small blind) folded before Flop

Hand #2465: 

PokerStars Hand #250569506682:  Hold'em No Limit ($0.10/$0.25 CAD) - 2024/05/18 15:27:26 ET
Table 'Sadalbari III' 6-max Seat #6 is the button
Seat 1: starbwoi ($25.67 in chips) 
Seat 2: hickdaddyx2 ($30.12 in chips) 
Seat 3: mistasho ($25.87 in chips) 
Seat 4: Alpha Mule ($25 in chips) 
Seat 5: braydon.2002 ($27.24 in chips) 
Seat 6: CashMatteo ($12.73 in chips) 
starbwoi: posts small blind $0.10
hickdaddyx2: posts big blind $0.25
*** HOLE CARDS ***
Dealt to CashMatteo [Qh 6c]
mistasho: folds 
Alpha Mule: folds 
braydon.2002: folds 
CashMatteo: folds 
starbwoi: raises $0.50 to $0.75
hickdaddyx2: folds 
Uncalled bet ($0.50) returned to starbwoi
starbwoi collected $0.50 from pot
starbwoi: doesn't show hand 
*** SUMMARY ***
Total pot $0.50 | Rake $0 
Seat 1: starbwoi (small blind) collected ($0.50)
Seat 2: hickdaddyx2 (big blind) folded before Flop
Seat 3: mistasho folded before Flop (didn't bet)
Seat 4: Alpha Mule folded before Flop (didn't bet)
Seat 5: braydon.2002 folded before Flop (didn't bet)
Seat 6: CashMatteo (button) folded before Flop (didn't bet)

Hand #2466: 

PokerStars Hand #250569513192:  Hold'em No Limit ($0.10/$0.25 CAD) - 2024/05/18 15:27:44 ET
Table 'Sadalbari III' 6-max Seat #1 is the button
Seat 1: starbwoi ($25.92 in chips) 
Seat 2: hickdaddyx2 ($29.87 in chips) 
Seat 3: mistasho ($25.87 in chips) 
Seat 4: Alpha Mule ($25 in chips) 
Seat 5: braydon.2002 ($27.24 in chips) 
Seat 6: CashMatteo ($12.73 in chips) 
hickdaddyx2: posts small blind $0.10
mistasho: posts big blind $0.25
*** HOLE CARDS ***
Dealt to CashMatteo [Js Ac]
Alpha Mule: folds 
braydon.2002: folds 
CashMatteo: raises $0.37 to $0.62
starbwoi: folds 
hickdaddyx2: folds 
mistasho: folds 
Uncalled bet ($0.37) returned to CashMatteo
CashMatteo collected $0.60 from pot
CashMatteo: doesn't show hand 
*** SUMMARY ***
Total pot $0.60 | Rake $0 
Seat 1: starbwoi (button) folded before Flop (didn't bet)
Seat 2: hickdaddyx2 (small blind) folded before Flop
Seat 3: mistasho (big blind) folded before Flop
Seat 4: Alpha Mule folded before Flop (didn't bet)
Seat 5: braydon.2002 folded before Flop (didn't bet)
Seat 6: CashMatteo collected ($0.60)

Hand #2467: 

PokerStars Hand #250569519546:  Hold'em No Limit ($0.10/$0.25 CAD) - 2024/05/18 15:28:01 ET
Table 'Sadalbari III' 6-max Seat #2 is the button
Seat 1: starbwoi ($25.92 in chips) 
Seat 2: hickdaddyx2 ($29.77 in chips) 
Seat 3: mistasho ($25.62 in chips) 
Seat 4: Alpha Mule ($25 in chips) 
Seat 5: braydon.2002 ($27.24 in chips) 
Seat 6: CashMatteo ($13.08 in chips) 
mistasho: posts small blind $0.10
Alpha Mule: posts big blind $0.25
*** HOLE CARDS ***
Dealt to CashMatteo [5s Qc]
braydon.2002: folds 
CashMatteo: folds 
starbwoi: folds 
hickdaddyx2: folds 
mistasho: raises $0.37 to $0.62
Alpha Mule: folds 
Uncalled bet ($0.37) returned to mistasho
mistasho collected $0.50 from pot
mistasho: doesn't show hand 
*** SUMMARY ***
Total pot $0.50 | Rake $0 
Seat 1: starbwoi folded before Flop (didn't bet)
Seat 2: hickdaddyx2 (button) folded before Flop (didn't bet)
Seat 3: mistasho (small blind) collected ($0.50)
Seat 4: Alpha Mule (big blind) folded before Flop
Seat 5: braydon.2002 folded before Flop (didn't bet)
Seat 6: CashMatteo folded before Flop (didn't bet)

Hand #2468: 

PokerStars Hand #250569526750:  Hold'em No Limit ($0.10/$0.25 CAD) - 2024/05/18 15:28:21 ET
Table 'Sadalbari III' 6-max Seat #3 is the button
Seat 1: starbwoi ($25.92 in chips) 
Seat 2: hickdaddyx2 ($29.77 in chips) 
Seat 3: mistasho ($25.87 in chips) 
Seat 4: Alpha Mule ($25 in chips) 
Seat 5: braydon.2002 ($27.24 in chips) 
Seat 6: CashMatteo ($13.08 in chips) 
Alpha Mule: posts small blind $0.10
braydon.2002: posts big blind $0.25
*** HOLE CARDS ***
Dealt to CashMatteo [5c 5d]
CashMatteo: calls $0.25
starbwoi: folds 
hickdaddyx2: calls $0.25
mistasho: folds 
Alpha Mule: folds 
braydon.2002: checks 
*** FLOP *** [2c Kd 4c]
braydon.2002: checks 
CashMatteo: checks 
hickdaddyx2: checks 
*** TURN *** [2c Kd 4c] [4h]
braydon.2002: checks 
CashMatteo: checks 
hickdaddyx2: checks 
*** RIVER *** [2c Kd 4c 4h] [5s]
braydon.2002: bets $1.08
CashMatteo: raises $2.99 to $4.07
hickdaddyx2: folds 
braydon.2002: raises $11.90 to $15.97
CashMatteo: calls $8.76 and is all-in
Uncalled bet ($3.14) returned to braydon.2002
*** SHOW DOWN ***
braydon.2002: shows [Jd 4d] (three of a kind, Fours)
CashMatteo: shows [5c 5d] (a full house, Fives full of Fours)
CashMatteo collected $25.32 from pot
*** SUMMARY ***
Total pot $26.51 | Rake $1.19 
Board [2c Kd 4c 4h 5s]
Seat 1: starbwoi folded before Flop (didn't bet)
Seat 2: hickdaddyx2 folded on the River
Seat 3: mistasho (button) folded before Flop (didn't bet)
Seat 4: Alpha Mule (small blind) folded before Flop
Seat 5: braydon.2002 (big blind) showed [Jd 4d] and lost with three of a kind, Fours
Seat 6: CashMatteo showed [5c 5d] and won ($25.32) with a full house, Fives full of Fours

Hand #2469: 

PokerStars Hand #250569545549:  Hold'em No Limit ($0.10/$0.25 CAD) - 2024/05/18 15:29:14 ET
Table 'Sadalbari III' 6-max Seat #4 is the button
Seat 1: starbwoi ($25.92 in chips) 
Seat 2: hickdaddyx2 ($29.52 in chips) 
Seat 3: mistasho ($25.87 in chips) 
Seat 4: Alpha Mule ($25 in chips) 
Seat 5: braydon.2002 ($25 in chips) 
Seat 6: CashMatteo ($25.32 in chips) 
braydon.2002: posts small blind $0.10
CashMatteo: posts big blind $0.25
*** HOLE CARDS ***
Dealt to CashMatteo [9d 5c]
starbwoi: folds 
hickdaddyx2: calls $0.25
mistasho: folds 
Alpha Mule: folds 
braydon.2002: raises $24.75 to $25 and is all-in
CashMatteo: folds 
hickdaddyx2: folds 
Uncalled bet ($24.75) returned to braydon.2002
braydon.2002 collected $0.75 from pot
braydon.2002: doesn't show hand 
*** SUMMARY ***
Total pot $0.75 | Rake $0 
Seat 1: starbwoi folded before Flop (didn't bet)
Seat 2: hickdaddyx2 folded before Flop
Seat 3: mistasho folded before Flop (didn't bet)
Seat 4: Alpha Mule (button) folded before Flop (didn't bet)
Seat 5: braydon.2002 (small blind) collected ($0.75)
Seat 6: CashMatteo (big blind) folded before Flop

Hand #2470: 

PokerStars Hand #250569551895:  Hold'em No Limit ($0.10/$0.25 CAD) - 2024/05/18 15:29:32 ET
Table 'Sadalbari III' 6-max Seat #5 is the button
Seat 1: starbwoi ($25.92 in chips) 
Seat 2: hickdaddyx2 ($29.27 in chips) 
Seat 3: mistasho ($25.87 in chips) 
Seat 4: Alpha Mule ($25 in chips) 
Seat 5: braydon.2002 ($25.50 in chips) 
Seat 6: CashMatteo ($25.07 in chips) 
CashMatteo: posts small blind $0.10
starbwoi: posts big blind $0.25
*** HOLE CARDS ***
Dealt to CashMatteo [Kc Kh]
hickdaddyx2: calls $0.25
mistasho: folds 
Alpha Mule: folds 
braydon.2002: raises $25.25 to $25.50 and is all-in
CashMatteo: calls $24.97 and is all-in
starbwoi: folds 
hickdaddyx2: folds 
Uncalled bet ($0.43) returned to braydon.2002
*** FLOP *** [9s 6c 9d]
*** TURN *** [9s 6c 9d] [7s]
*** RIVER *** [9s 6c 9d 7s] [2h]
*** SHOW DOWN ***
CashMatteo: shows [Kc Kh] (two pair, Kings and Nines)
braydon.2002: shows [Qc Js] (a pair of Nines)
CashMatteo collected $48.36 from pot
*** SUMMARY ***
Total pot $50.64 | Rake $2.28 
Board [9s 6c 9d 7s 2h]
Seat 1: starbwoi (big blind) folded before Flop
Seat 2: hickdaddyx2 folded before Flop
Seat 3: mistasho folded before Flop (didn't bet)
Seat 4: Alpha Mule folded before Flop (didn't bet)
Seat 5: braydon.2002 (button) showed [Qc Js] and lost with a pair of Nines
Seat 6: CashMatteo (small blind) showed [Kc Kh] and won ($48.36) with two pair, Kings and Nines

Hand #2471: 

PokerStars Hand #250569560106:  Hold'em No Limit ($0.10/$0.25 CAD) - 2024/05/18 15:29:55 ET
Table 'Sadalbari III' 6-max Seat #6 is the button
Seat 1: starbwoi ($25.67 in chips) 
Seat 2: hickdaddyx2 ($29.02 in chips) 
Seat 3: mistasho ($25.87 in chips) 
Seat 4: Alpha Mule ($25 in chips) 
Seat 5: braydon.2002 ($25 in chips) 
Seat 6: CashMatteo ($48.36 in chips) 
starbwoi: posts small blind $0.10
hickdaddyx2: posts big blind $0.25
*** HOLE CARDS ***
Dealt to CashMatteo [7d Kc]
mistasho has timed out
mistasho: folds 
Alpha Mule: raises $0.50 to $0.75
braydon.2002: folds 
CashMatteo: folds 
starbwoi: folds 
hickdaddyx2: calls $0.50
*** FLOP *** [Ts 8c 3s]
braydon.2002 leaves the table
hickdaddyx2: checks 
Alpha Mule: bets $0.75
hickdaddyx2: calls $0.75
*** TURN *** [Ts 8c 3s] [6d]
hickdaddyx2: checks 
Alpha Mule: checks 
*** RIVER *** [Ts 8c 3s 6d] [5d]
hickdaddyx2: checks 
Alpha Mule: checks 
*** SHOW DOWN ***
hickdaddyx2: shows [Qd Td] (a pair of Tens)
Alpha Mule: mucks hand 
hickdaddyx2 collected $2.96 from pot
*** SUMMARY ***
Total pot $3.10 | Rake $0.14 
Board [Ts 8c 3s 6d 5d]
Seat 1: starbwoi (small blind) folded before Flop
Seat 2: hickdaddyx2 (big blind) showed [Qd Td] and won ($2.96) with a pair of Tens
Seat 3: mistasho folded before Flop (didn't bet)
Seat 4: Alpha Mule mucked [7s 7h]
Seat 5: braydon.2002 folded before Flop (didn't bet)
Seat 6: CashMatteo (button) folded before Flop (didn't bet)

Hand #2472: 

PokerStars Hand #250569576939:  Hold'em No Limit ($0.10/$0.25 CAD) - 2024/05/18 15:30:41 ET
Table 'Sadalbari III' 6-max Seat #1 is the button
Seat 1: starbwoi ($25.57 in chips) 
Seat 2: hickdaddyx2 ($30.48 in chips) 
Seat 3: mistasho ($25.87 in chips) 
Seat 4: Alpha Mule ($25 in chips) 
Seat 6: CashMatteo ($48.36 in chips) 
hickdaddyx2: posts small blind $0.10
mistasho: posts big blind $0.25
*** HOLE CARDS ***
Dealt to CashMatteo [2d 3h]
Alpha Mule: folds 
CashMatteo: folds 
CashMatteo leaves the table
starbwoi: raises $0.37 to $0.62
hickdaddyx2: folds 
mistasho: folds 
Uncalled bet ($0.37) returned to starbwoi
starbwoi collected $0.60 from pot
starbwoi: doesn't show hand 
*** SUMMARY ***
Total pot $0.60 | Rake $0 
Seat 1: starbwoi (button) collected ($0.60)
Seat 2: hickdaddyx2 (small blind) folded before Flop
Seat 3: mistasho (big blind) folded before Flop
Seat 4: Alpha Mule folded before Flop (didn't bet)
Seat 6: CashMatteo folded before Flop (didn't bet)

Hand #2473: 

PokerStars Hand #250570640510:  Hold'em No Limit ($0.01/$0.02 CAD) - 2024/05/18 16:22:29 ET
Table 'Gaussia IV' 6-max Seat #2 is the button
Seat 1: lunderk ($2 in chips) 
Seat 2: 3gls ($1.66 in chips) 
Seat 4: Cungvui ($0.91 in chips) 
Seat 5: CashMatteo ($2 in chips) 
Seat 6: Mr.Tappidy ($4.28 in chips) 
Cungvui: posts small blind $0.01
CashMatteo: posts big blind $0.02
*** HOLE CARDS ***
Dealt to CashMatteo [Qd Jc]
Mr.Tappidy: raises $0.02 to $0.04
lunderk: folds 
ajtatt900 leaves the table
3gls: folds 
Cungvui: folds 
CashMatteo: calls $0.02
*** FLOP *** [5h 8h 4c]
CashMatteo: checks 
Mr.Tappidy: checks 
*** TURN *** [5h 8h 4c] [7c]
CashMatteo: bets $0.05
Mr.Tappidy: calls $0.05
*** RIVER *** [5h 8h 4c 7c] [Qc]
CashMatteo: bets $0.13
Mr.Tappidy: folds 
Uncalled bet ($0.13) returned to CashMatteo
CashMatteo collected $0.18 from pot
CashMatteo: doesn't show hand 
*** SUMMARY ***
Total pot $0.19 | Rake $0.01 
Board [5h 8h 4c 7c Qc]
Seat 1: lunderk folded before Flop (didn't bet)
Seat 2: 3gls (button) folded before Flop (didn't bet)
Seat 4: Cungvui (small blind) folded before Flop
Seat 5: CashMatteo (big blind) collected ($0.18)
Seat 6: Mr.Tappidy folded on the River

Hand #2474: 

PokerStars Hand #250570651697:  Hold'em No Limit ($0.01/$0.02 CAD) - 2024/05/18 16:22:59 ET
Table 'Gaussia IV' 6-max Seat #4 is the button
Seat 1: lunderk ($2 in chips) 
Seat 2: 3gls ($1.66 in chips) 
Seat 4: Cungvui ($0.90 in chips) 
Seat 5: CashMatteo ($2.09 in chips) 
Seat 6: Mr.Tappidy ($4.19 in chips) 
CashMatteo: posts small blind $0.01
Mr.Tappidy: posts big blind $0.02
*** HOLE CARDS ***
Dealt to CashMatteo [As 8s]
lunderk: raises $0.04 to $0.06
3gls: folds 
Cungvui: calls $0.06
CashMatteo: calls $0.05
Mr.Tappidy: calls $0.04
*** FLOP *** [7c 4s 4h]
CashMatteo: checks 
Mr.Tappidy: bets $0.08
1who1 joins the table at seat #3 
lunderk: folds 
Cungvui: raises $0.08 to $0.16
CashMatteo: folds 
Mr.Tappidy: raises $3.97 to $4.13 and is all-in
Cungvui has timed out
Cungvui: folds 
Uncalled bet ($3.97) returned to Mr.Tappidy
Mr.Tappidy collected $0.54 from pot
*** SUMMARY ***
Total pot $0.56 | Rake $0.02 
Board [7c 4s 4h]
Seat 1: lunderk folded on the Flop
Seat 2: 3gls folded before Flop (didn't bet)
Seat 4: Cungvui (button) folded on the Flop
Seat 5: CashMatteo (small blind) folded on the Flop
Seat 6: Mr.Tappidy (big blind) collected ($0.54)

Hand #2475: 

PokerStars Hand #250570674465:  Hold'em No Limit ($0.01/$0.02 CAD) - 2024/05/18 16:24:02 ET
Table 'Gaussia IV' 6-max Seat #5 is the button
Seat 1: lunderk ($2 in chips) 
Seat 2: 3gls ($1.66 in chips) 
Seat 3: 1who1 ($1.99 in chips) 
Seat 5: CashMatteo ($2.03 in chips) 
Seat 6: Mr.Tappidy ($4.51 in chips) 
Mr.Tappidy: posts small blind $0.01
lunderk: posts big blind $0.02
1who1: posts big blind $0.02
*** HOLE CARDS ***
Dealt to CashMatteo [2d As]
3gls: folds 
1who1: checks 
CashMatteo: calls $0.02
Mr.Tappidy: calls $0.01
lunderk: checks 
*** FLOP *** [5s 9h 8c]
Mr.Tappidy: checks 
lunderk: checks 
Cungvui leaves the table
1who1: checks 
CashMatteo: checks 
*** TURN *** [5s 9h 8c] [4d]
Mr.Tappidy: checks 
lunderk: bets $0.02
1who1: calls $0.02
CashMatteo: calls $0.02
Mr.Tappidy: calls $0.02
*** RIVER *** [5s 9h 8c 4d] [Qc]
Mr.Tappidy: checks 
lunderk: checks 
1who1: bets $0.15
CashMatteo: folds 
Mr.Tappidy: raises $0.45 to $0.60
lunderk: folds 
1who1: folds 
Uncalled bet ($0.45) returned to Mr.Tappidy
Mr.Tappidy collected $0.44 from pot
*** SUMMARY ***
Total pot $0.46 | Rake $0.02 
Board [5s 9h 8c 4d Qc]
Seat 1: lunderk (big blind) folded on the River
Seat 2: 3gls folded before Flop (didn't bet)
Seat 3: 1who1 folded on the River
Seat 5: CashMatteo (button) folded on the River
Seat 6: Mr.Tappidy (small blind) collected ($0.44)

Hand #2476: 

PokerStars Hand #250570695382:  Hold'em No Limit ($0.01/$0.02 CAD) - 2024/05/18 16:25:00 ET
Table 'Gaussia IV' 6-max Seat #6 is the button
Seat 1: lunderk ($2 in chips) 
Seat 2: 3gls ($1.66 in chips) 
Seat 3: 1who1 ($1.80 in chips) 
Seat 5: CashMatteo ($1.99 in chips) 
Seat 6: Mr.Tappidy ($4.76 in chips) 
lunderk: posts small blind $0.01
3gls: posts big blind $0.02
*** HOLE CARDS ***
Dealt to CashMatteo [7s Jh]
1who1: calls $0.02
CashMatteo is connected 
CashMatteo is connected 
CashMatteo is connected 
CashMatteo: folds 
Mr.Tappidy: calls $0.02
lunderk: calls $0.01
3gls: checks 
*** FLOP *** [Tc 6h 3d]
lunderk: checks 
3gls: checks 
1who1: checks 
Mr.Tappidy: bets $0.08
lunderk: folds 
3gls: folds 
1who1: calls $0.08
*** TURN *** [Tc 6h 3d] [2c]
1who1: checks 
Mr.Tappidy: bets $0.08
1who1: calls $0.08
*** RIVER *** [Tc 6h 3d 2c] [Js]
Da Newf joins the table at seat #4 
1who1: checks 
Mr.Tappidy: checks 
*** SHOW DOWN ***
1who1: shows [Td 8h] (a pair of Tens)
Mr.Tappidy: mucks hand 
1who1 collected $0.39 from pot
*** SUMMARY ***
Total pot $0.40 | Rake $0.01 
Board [Tc 6h 3d 2c Js]
Seat 1: lunderk (small blind) folded on the Flop
Seat 2: 3gls (big blind) folded on the Flop
Seat 3: 1who1 showed [Td 8h] and won ($0.39) with a pair of Tens
Seat 5: CashMatteo folded before Flop (didn't bet)
Seat 6: Mr.Tappidy (button) mucked [9s 6d]

Hand #2477: 

PokerStars Hand #250570715331:  Hold'em No Limit ($0.01/$0.02 CAD) - 2024/05/18 16:25:56 ET
Table 'Gaussia IV' 6-max Seat #1 is the button
Seat 1: lunderk ($2 in chips) 
Seat 2: 3gls ($1.64 in chips) 
Seat 3: 1who1 ($2.01 in chips) 
Seat 5: CashMatteo ($1.99 in chips) 
Seat 6: Mr.Tappidy ($4.58 in chips) 
3gls: posts small blind $0.01
1who1: posts big blind $0.02
Da Newf: sits out 
*** HOLE CARDS ***
Dealt to CashMatteo [3h Jh]
CashMatteo: calls $0.02
Mr.Tappidy: raises $0.02 to $0.04
lunderk: folds 
3gls: folds 
1who1: calls $0.02
CashMatteo: calls $0.02
*** FLOP *** [4h 7s As]
1who1: checks 
CashMatteo: checks 
Mr.Tappidy: checks 
*** TURN *** [4h 7s As] [Kc]
1who1: checks 
CashMatteo: checks 
Mr.Tappidy: bets $0.07
1who1: folds 
CashMatteo: folds 
Uncalled bet ($0.07) returned to Mr.Tappidy
Mr.Tappidy collected $0.13 from pot
*** SUMMARY ***
Total pot $0.13 | Rake $0 
Board [4h 7s As Kc]
Seat 1: lunderk (button) folded before Flop (didn't bet)
Seat 2: 3gls (small blind) folded before Flop
Seat 3: 1who1 (big blind) folded on the Turn
Seat 5: CashMatteo folded on the Turn
Seat 6: Mr.Tappidy collected ($0.13)

Hand #2478: 

PokerStars Hand #250570728180:  Hold'em No Limit ($0.01/$0.02 CAD) - 2024/05/18 16:26:32 ET
Table 'Gaussia IV' 6-max Seat #2 is the button
Seat 1: lunderk ($2 in chips) 
Seat 2: 3gls ($1.63 in chips) 
Seat 3: 1who1 ($1.97 in chips) 
Seat 4: Da Newf ($0.80 in chips) 
Seat 5: CashMatteo ($1.95 in chips) 
Seat 6: Mr.Tappidy ($4.67 in chips) 
1who1: posts small blind $0.01
Da Newf: posts big blind $0.02
*** HOLE CARDS ***
Dealt to CashMatteo [6d 2c]
CashMatteo: folds 
Mr.Tappidy: calls $0.02
lunderk: folds 
3gls: calls $0.02
1who1: calls $0.01
Da Newf: checks 
*** FLOP *** [9d 2h 7c]
1who1: bets $0.02
Da Newf: folds 
Mr.Tappidy: calls $0.02
3gls: folds 
*** TURN *** [9d 2h 7c] [9s]
1who1: bets $0.02
Mr.Tappidy: calls $0.02
*** RIVER *** [9d 2h 7c 9s] [Qc]
1who1: bets $0.15
Mr.Tappidy: raises $0.45 to $0.60
1who1: calls $0.45
*** SHOW DOWN ***
Mr.Tappidy: shows [5h Kd] (a pair of Nines)
1who1: shows [3s 7d] (two pair, Nines and Sevens)
1who1 collected $1.31 from pot
*** SUMMARY ***
Total pot $1.36 | Rake $0.05 
Board [9d 2h 7c 9s Qc]
Seat 1: lunderk folded before Flop (didn't bet)
Seat 2: 3gls (button) folded on the Flop
Seat 3: 1who1 (small blind) showed [3s 7d] and won ($1.31) with two pair, Nines and Sevens
Seat 4: Da Newf (big blind) folded on the Flop
Seat 5: CashMatteo folded before Flop (didn't bet)
Seat 6: Mr.Tappidy showed [5h Kd] and lost with a pair of Nines

Hand #2479: 

PokerStars Hand #250571248074:  Hold'em No Limit ($0.01/$0.02 CAD) - 2024/05/18 16:27:28 ET
Table 'Gaussia IV' 6-max Seat #4 is the button
Seat 1: lunderk ($2 in chips) 
Seat 2: 3gls ($1.61 in chips) 
Seat 4: Da Newf ($0.78 in chips) 
Seat 5: CashMatteo ($1.95 in chips) 
Seat 6: Mr.Tappidy ($4.01 in chips) 
CashMatteo: posts small blind $0.01
Mr.Tappidy: posts big blind $0.02
*** HOLE CARDS ***
Dealt to CashMatteo [4h 2c]
lunderk: folds 
3gls: folds 
Da Newf: calls $0.02
CashMatteo: folds 
1who1 leaves the table
Mr.Tappidy: raises $0.05 to $0.07
Da Newf: folds 
Uncalled bet ($0.05) returned to Mr.Tappidy
Mr.Tappidy collected $0.05 from pot
*** SUMMARY ***
Total pot $0.05 | Rake $0 
Seat 1: lunderk folded before Flop (didn't bet)
Seat 2: 3gls folded before Flop (didn't bet)
Seat 4: Da Newf (button) folded before Flop
Seat 5: CashMatteo (small blind) folded before Flop
Seat 6: Mr.Tappidy (big blind) collected ($0.05)

Hand #2480: 

PokerStars Hand #250571254588:  Hold'em No Limit ($0.01/$0.02 CAD) - 2024/05/18 16:27:46 ET
Table 'Gaussia IV' 6-max Seat #5 is the button
Seat 1: lunderk ($2 in chips) 
Seat 2: 3gls ($1.61 in chips) 
Seat 4: Da Newf ($0.76 in chips) 
Seat 5: CashMatteo ($1.94 in chips) 
Seat 6: Mr.Tappidy ($4.04 in chips) 
Mr.Tappidy: posts small blind $0.01
lunderk: posts big blind $0.02
*** HOLE CARDS ***
Dealt to CashMatteo [5s 7d]
3gls: folds 
Da Newf: calls $0.02
CashMatteo: folds 
Mr.Tappidy: calls $0.01
theepan895 joins the table at seat #3 
lunderk: raises $0.06 to $0.08
Da Newf: calls $0.06
Mr.Tappidy: calls $0.06
*** FLOP *** [Jh Ac 8c]
Mr.Tappidy: checks 
lunderk: checks 
Da Newf: bets $0.23
Mr.Tappidy: folds 
lunderk: folds 
Uncalled bet ($0.23) returned to Da Newf
Da Newf collected $0.23 from pot
Da Newf: doesn't show hand 
*** SUMMARY ***
Total pot $0.24 | Rake $0.01 
Board [Jh Ac 8c]
Seat 1: lunderk (big blind) folded on the Flop
Seat 2: 3gls folded before Flop (didn't bet)
Seat 4: Da Newf collected ($0.23)
Seat 5: CashMatteo (button) folded before Flop (didn't bet)
Seat 6: Mr.Tappidy (small blind) folded on the Flop

Hand #2481: 

PokerStars Hand #250571269789:  Hold'em No Limit ($0.01/$0.02 CAD) - 2024/05/18 16:28:30 ET
Table 'Gaussia IV' 6-max Seat #6 is the button
Seat 1: lunderk ($2 in chips) 
Seat 3: theepan895 ($1.60 in chips) 
Seat 4: Da Newf ($0.91 in chips) 
Seat 5: CashMatteo ($1.94 in chips) 
Seat 6: Mr.Tappidy ($3.96 in chips) 
lunderk: posts small blind $0.01
theepan895: posts big blind $0.02
*** HOLE CARDS ***
Dealt to CashMatteo [9s 6c]
Da Newf: folds 
CashMatteo: calls $0.02
Mr.Tappidy: calls $0.02
lunderk: folds 
theepan895: raises $0.04 to $0.06
3gls leaves the table
CashMatteo: calls $0.04
Mr.Tappidy: calls $0.04
*** FLOP *** [3s Qd Ad]
theepan895: checks 
CashMatteo: checks 
Mr.Tappidy: checks 
*** TURN *** [3s Qd Ad] [6h]
theepan895: bets $0.11
CashMatteo: calls $0.11
Mr.Tappidy: folds 
*** RIVER *** [3s Qd Ad 6h] [9c]
theepan895: checks 
CashMatteo: bets $0.28
theepan895: folds 
Uncalled bet ($0.28) returned to CashMatteo
CashMatteo collected $0.40 from pot
CashMatteo: doesn't show hand 
*** SUMMARY ***
Total pot $0.41 | Rake $0.01 
Board [3s Qd Ad 6h 9c]
Seat 1: lunderk (small blind) folded before Flop
Seat 3: theepan895 (big blind) folded on the River
Seat 4: Da Newf folded before Flop (didn't bet)
Seat 5: CashMatteo collected ($0.40)
Seat 6: Mr.Tappidy (button) folded on the Turn

Hand #2482: 

PokerStars Hand #250571286258:  Hold'em No Limit ($0.01/$0.02 CAD) - 2024/05/18 16:29:17 ET
Table 'Gaussia IV' 6-max Seat #1 is the button
Seat 1: lunderk ($2 in chips) 
Seat 3: theepan895 ($1.43 in chips) 
Seat 4: Da Newf ($0.91 in chips) 
Seat 5: CashMatteo ($2.17 in chips) 
Seat 6: Mr.Tappidy ($3.90 in chips) 
theepan895: posts small blind $0.01
Da Newf: posts big blind $0.02
*** HOLE CARDS ***
Dealt to CashMatteo [4s 2s]
CashMatteo: folds 
Mr.Tappidy: raises $0.02 to $0.04
lunderk: folds 
theepan895: calls $0.03
Da Newf: calls $0.02
*** FLOP *** [As 7d 6c]
theepan895: checks 
Da Newf: checks 
Mr.Tappidy: bets $0.06
theepan895: calls $0.06
Da Newf: folds 
*** TURN *** [As 7d 6c] [Qd]
theepan895: bets $0.14
Mr.Tappidy: folds 
Uncalled bet ($0.14) returned to theepan895
theepan895 collected $0.23 from pot
*** SUMMARY ***
Total pot $0.24 | Rake $0.01 
Board [As 7d 6c Qd]
Seat 1: lunderk (button) folded before Flop (didn't bet)
Seat 3: theepan895 (small blind) collected ($0.23)
Seat 4: Da Newf (big blind) folded on the Flop
Seat 5: CashMatteo folded before Flop (didn't bet)
Seat 6: Mr.Tappidy folded on the Turn

Hand #2483: 

PokerStars Hand #250571295686:  Hold'em No Limit ($0.01/$0.02 CAD) - 2024/05/18 16:29:44 ET
Table 'Gaussia IV' 6-max Seat #3 is the button
Seat 1: lunderk ($2 in chips) 
Seat 3: theepan895 ($1.56 in chips) 
Seat 4: Da Newf ($0.87 in chips) 
Seat 5: CashMatteo ($2.17 in chips) 
Seat 6: Mr.Tappidy ($3.80 in chips) 
Da Newf: posts small blind $0.01
CashMatteo: posts big blind $0.02
*** HOLE CARDS ***
Dealt to CashMatteo [Jh 5d]
Mr.Tappidy: calls $0.02
lunderk: folds 
theepan895 is disconnected 
theepan895 has timed out
theepan895: folds 
Da Newf: calls $0.01
CashMatteo: checks 
*** FLOP *** [8s 5c 5h]
Da Newf: checks 
CashMatteo: checks 
Mr.Tappidy: bets $0.06
Da Newf: folds 
CashMatteo: calls $0.06
*** TURN *** [8s 5c 5h] [4h]
CashMatteo: checks 
lunderk is disconnected 
Mr.Tappidy: bets $0.09
CashMatteo: calls $0.09
*** RIVER *** [8s 5c 5h 4h] [Td]
CashMatteo: checks 
Mr.Tappidy: checks 
*** SHOW DOWN ***
CashMatteo: shows [Jh 5d] (three of a kind, Fives)
Mr.Tappidy: mucks hand 
CashMatteo collected $0.35 from pot
*** SUMMARY ***
Total pot $0.36 | Rake $0.01 
Board [8s 5c 5h 4h Td]
Seat 1: lunderk folded before Flop (didn't bet)
Seat 3: theepan895 (button) folded before Flop (didn't bet)
Seat 4: Da Newf (small blind) folded on the Flop
Seat 5: CashMatteo (big blind) showed [Jh 5d] and won ($0.35) with three of a kind, Fives
Seat 6: Mr.Tappidy mucked [7s Qd]

Hand #2484: 

PokerStars Hand #250571316373:  Hold'em No Limit ($0.01/$0.02 CAD) - 2024/05/18 16:30:42 ET
Table 'Gaussia IV' 6-max Seat #4 is the button
Seat 4: Da Newf ($0.85 in chips) 
Seat 5: CashMatteo ($2.35 in chips) 
Seat 6: Mr.Tappidy ($3.63 in chips) 
CashMatteo: posts small blind $0.01
Mr.Tappidy: posts big blind $0.02
*** HOLE CARDS ***
Dealt to CashMatteo [Kc Tc]
theepan895 is disconnected 
Da Newf: folds 
CashMatteo: raises $0.03 to $0.05
theepan895 is disconnected 
Mr.Tappidy: calls $0.03
*** FLOP *** [Td 4h Jh]
theepan895 is disconnected 
CashMatteo: bets $0.05
Mr.Tappidy: folds 
Uncalled bet ($0.05) returned to CashMatteo
CashMatteo collected $0.10 from pot
CashMatteo: doesn't show hand 
*** SUMMARY ***
Total pot $0.10 | Rake $0 
Board [Td 4h Jh]
Seat 4: Da Newf (button) folded before Flop (didn't bet)
Seat 5: CashMatteo (small blind) collected ($0.10)
Seat 6: Mr.Tappidy (big blind) folded on the Flop

Hand #2485: 

PokerStars Hand #250571321539:  Hold'em No Limit ($0.01/$0.02 CAD) - 2024/05/18 16:30:56 ET
Table 'Gaussia IV' 6-max Seat #5 is the button
Seat 3: theepan895 ($1.56 in chips) 
Seat 4: Da Newf ($0.85 in chips) 
Seat 5: CashMatteo ($2.40 in chips) 
Seat 6: Mr.Tappidy ($3.58 in chips) 
Mr.Tappidy: posts small blind $0.01
theepan895: posts big blind $0.02
*** HOLE CARDS ***
Dealt to CashMatteo [4s 6d]
Da Newf: calls $0.02
CashMatteo: folds 
Mr.Tappidy: calls $0.01
theepan895 is disconnected 
theepan895 is connected 
theepan895: raises $0.02 to $0.04
Da Newf: calls $0.02
Mr.Tappidy: calls $0.02
*** FLOP *** [9d Qs 2c]
Mr.Tappidy: checks 
theepan895: checks 
Da Newf: checks 
*** TURN *** [9d Qs 2c] [3h]
Mr.Tappidy: bets $0.06
theepan895: raises $0.06 to $0.12
Da Newf: folds 
dannydkht joins the table at seat #2 
Mr.Tappidy: raises $0.24 to $0.36
theepan895 is disconnected 
theepan895 is connected 
theepan895: folds 
Uncalled bet ($0.24) returned to Mr.Tappidy
Mr.Tappidy collected $0.35 from pot
*** SUMMARY ***
Total pot $0.36 | Rake $0.01 
Board [9d Qs 2c 3h]
Seat 3: theepan895 (big blind) folded on the Turn
Seat 4: Da Newf folded on the Turn
Seat 5: CashMatteo (button) folded before Flop (didn't bet)
Seat 6: Mr.Tappidy (small blind) collected ($0.35)

Hand #2486: 

PokerStars Hand #250571337067:  Hold'em No Limit ($0.01/$0.02 CAD) - 2024/05/18 16:31:40 ET
Table 'Gaussia IV' 6-max Seat #6 is the button
Seat 3: theepan895 ($1.40 in chips) 
Seat 4: Da Newf ($0.81 in chips) 
Seat 5: CashMatteo ($2.40 in chips) 
Seat 6: Mr.Tappidy ($3.77 in chips) 
dannydkht will be allowed to play after the button
theepan895: posts small blind $0.01
Da Newf: posts big blind $0.02
*** HOLE CARDS ***
Dealt to CashMatteo [2c 7s]
CashMatteo: folds 
Mr.Tappidy: calls $0.02
theepan895 is disconnected 
theepan895 is connected 
theepan895 is disconnected 
theepan895 is connected 
theepan895: raises $0.04 to $0.06
Da Newf: folds 
Mr.Tappidy: calls $0.04
*** FLOP *** [7d 6s 3c]
theepan895 is disconnected 
theepan895 is connected 
theepan895: checks 
Mr.Tappidy: checks 
*** TURN *** [7d 6s 3c] [4s]
theepan895 is disconnected 
theepan895 is connected 
theepan895: bets $0.10
Mr.Tappidy: raises $0.10 to $0.20
theepan895 is disconnected 
theepan895 is connected 
theepan895: calls $0.10
*** RIVER *** [7d 6s 3c 4s] [Ah]
theepan895: checks 
Mr.Tappidy: checks 
*** SHOW DOWN ***
theepan895: shows [Jc Jd] (a pair of Jacks)
Mr.Tappidy: mucks hand 
theepan895 collected $0.52 from pot
*** SUMMARY ***
Total pot $0.54 | Rake $0.02 
Board [7d 6s 3c 4s Ah]
Seat 3: theepan895 (small blind) showed [Jc Jd] and won ($0.52) with a pair of Jacks
Seat 4: Da Newf (big blind) folded before Flop
Seat 5: CashMatteo folded before Flop (didn't bet)
Seat 6: Mr.Tappidy (button) mucked [Ts 4c]

Hand #2487: 

PokerStars Hand #250571357937:  Hold'em No Limit ($0.01/$0.02 CAD) - 2024/05/18 16:32:38 ET
Table 'Gaussia IV' 6-max Seat #3 is the button
Seat 2: dannydkht ($1.60 in chips) 
Seat 3: theepan895 ($1.66 in chips) 
Seat 4: Da Newf ($0.79 in chips) 
Seat 5: CashMatteo ($2.40 in chips) 
Seat 6: Mr.Tappidy ($3.51 in chips) 
Da Newf: posts small blind $0.01
CashMatteo: posts big blind $0.02
lunderk: sits out 
dannydkht: posts big blind $0.02
*** HOLE CARDS ***
Dealt to CashMatteo [Ad 9d]
Mr.Tappidy: calls $0.02
dannydkht: checks 
theepan895 is connected 
theepan895 is disconnected 
theepan895 is connected 
theepan895 is disconnected 
theepan895 is connected 
theepan895 has timed out while disconnected
theepan895: folds 
Da Newf: calls $0.01
CashMatteo: checks 
*** FLOP *** [Kd Kc 9h]
Da Newf: checks 
theepan895 is disconnected 
CashMatteo: bets $0.06
Mr.Tappidy: folds 
dannydkht: folds 
Da Newf: folds 
Uncalled bet ($0.06) returned to CashMatteo
CashMatteo collected $0.08 from pot
CashMatteo: doesn't show hand 
*** SUMMARY ***
Total pot $0.08 | Rake $0 
Board [Kd Kc 9h]
Seat 2: dannydkht folded on the Flop (didn't bet)
Seat 3: theepan895 (button) folded before Flop (didn't bet)
Seat 4: Da Newf (small blind) folded on the Flop
Seat 5: CashMatteo (big blind) collected ($0.08)
Seat 6: Mr.Tappidy folded on the Flop

Hand #2488: 

PokerStars Hand #250571372123:  Hold'em No Limit ($0.01/$0.02 CAD) - 2024/05/18 16:33:17 ET
Table 'Gaussia IV' 6-max Seat #4 is the button
Seat 2: dannydkht ($1.58 in chips) 
Seat 4: Da Newf ($0.77 in chips) 
Seat 5: CashMatteo ($2.46 in chips) 
Seat 6: Mr.Tappidy ($3.49 in chips) 
CashMatteo: posts small blind $0.01
Mr.Tappidy: posts big blind $0.02
lunderk: sits out 
*** HOLE CARDS ***
Dealt to CashMatteo [7c Jh]
dannydkht: calls $0.02
Da Newf: folds 
CashMatteo: calls $0.01
Mr.Tappidy: checks 
*** FLOP *** [Ad 5s Qs]
CashMatteo: checks 
Mr.Tappidy: checks 
dannydkht: checks 
*** TURN *** [Ad 5s Qs] [Js]
CashMatteo: checks 
Mr.Tappidy: checks 
dannydkht: checks 
*** RIVER *** [Ad 5s Qs Js] [3s]
CashMatteo: bets $0.03
Mr.Tappidy: calls $0.03
dannydkht: calls $0.03
*** SHOW DOWN ***
CashMatteo: shows [7c Jh] (a pair of Jacks)
Mr.Tappidy: mucks hand 
dannydkht: shows [4s 8d] (a flush, Queen high)
dannydkht collected $0.14 from pot
*** SUMMARY ***
Total pot $0.15 | Rake $0.01 
Board [Ad 5s Qs Js 3s]
Seat 2: dannydkht showed [4s 8d] and won ($0.14) with a flush, Queen high
Seat 4: Da Newf (button) folded before Flop (didn't bet)
Seat 5: CashMatteo (small blind) showed [7c Jh] and lost with a pair of Jacks
Seat 6: Mr.Tappidy (big blind) mucked [8c 7h]

Hand #2489: 

PokerStars Hand #250571405482:  Hold'em No Limit ($0.01/$0.02 CAD) - 2024/05/18 16:34:51 ET
Table 'Gaussia IV' 6-max Seat #5 is the button
Seat 1: lunderk ($2 in chips) 
Seat 2: dannydkht ($1.67 in chips) 
Seat 3: theepan895 ($1.66 in chips) 
Seat 4: Da Newf ($0.77 in chips) 
Seat 5: CashMatteo ($2.41 in chips) 
Seat 6: Mr.Tappidy ($3.44 in chips) 
Mr.Tappidy: posts small blind $0.01
lunderk: posts big blind $0.02
*** HOLE CARDS ***
Dealt to CashMatteo [8c As]
dannydkht: calls $0.02
theepan895: raises $0.02 to $0.04
Da Newf: folds 
CashMatteo: calls $0.04
Mr.Tappidy: calls $0.03
lunderk: folds 
dannydkht: calls $0.02
*** FLOP *** [7c 3h 9s]
Mr.Tappidy: checks 
dannydkht: checks 
theepan895: checks 
CashMatteo: checks 
*** TURN *** [7c 3h 9s] [8s]
Mr.Tappidy: bets $0.09
dannydkht: folds 
theepan895: raises $0.09 to $0.18
CashMatteo: folds 
Mr.Tappidy: calls $0.09
*** RIVER *** [7c 3h 9s 8s] [5c]
Mr.Tappidy: checks 
theepan895: bets $0.38
Mr.Tappidy: folds 
Uncalled bet ($0.38) returned to theepan895
theepan895 collected $0.52 from pot
*** SUMMARY ***
Total pot $0.54 | Rake $0.02 
Board [7c 3h 9s 8s 5c]
Seat 1: lunderk (big blind) folded before Flop
Seat 2: dannydkht folded on the Turn
Seat 3: theepan895 collected ($0.52)
Seat 4: Da Newf folded before Flop (didn't bet)
Seat 5: CashMatteo (button) folded on the Turn
Seat 6: Mr.Tappidy (small blind) folded on the River

Hand #2490: 

PokerStars Hand #250571432624:  Hold'em No Limit ($0.01/$0.02 CAD) - 2024/05/18 16:36:09 ET
Table 'Gaussia IV' 6-max Seat #6 is the button
Seat 1: lunderk ($2 in chips) 
Seat 2: dannydkht ($1.63 in chips) 
Seat 3: theepan895 ($1.96 in chips) 
Seat 4: Da Newf ($0.77 in chips) 
Seat 5: CashMatteo ($2.37 in chips) 
Seat 6: Mr.Tappidy ($3.22 in chips) 
lunderk: posts small blind $0.01
dannydkht: posts big blind $0.02
*** HOLE CARDS ***
Dealt to CashMatteo [Th 7c]
theepan895: raises $0.02 to $0.04
Da Newf: folds 
CashMatteo: folds 
Mr.Tappidy: folds 
Mr.Tappidy is disconnected 
lunderk: folds 
dannydkht: calls $0.02
*** FLOP *** [8c As Ad]
dannydkht: checks 
theepan895: checks 
*** TURN *** [8c As Ad] [6h]
dannydkht: checks 
theepan895: bets $0.06
dannydkht: folds 
Uncalled bet ($0.06) returned to theepan895
theepan895 collected $0.09 from pot
*** SUMMARY ***
Total pot $0.09 | Rake $0 
Board [8c As Ad 6h]
Seat 1: lunderk (small blind) folded before Flop
Seat 2: dannydkht (big blind) folded on the Turn
Seat 3: theepan895 collected ($0.09)
Seat 4: Da Newf folded before Flop (didn't bet)
Seat 5: CashMatteo folded before Flop (didn't bet)
Seat 6: Mr.Tappidy (button) folded before Flop (didn't bet)

Hand #2491: 

PokerStars Hand #250571442030:  Hold'em No Limit ($0.01/$0.02 CAD) - 2024/05/18 16:36:36 ET
Table 'Gaussia IV' 6-max Seat #1 is the button
Seat 1: lunderk ($2 in chips) 
Seat 2: dannydkht ($1.59 in chips) 
Seat 3: theepan895 ($2.01 in chips) 
Seat 4: Da Newf ($0.77 in chips) 
Seat 5: CashMatteo ($2.37 in chips) 
dannydkht: posts small blind $0.01
theepan895: posts big blind $0.02
*** HOLE CARDS ***
Dealt to CashMatteo [Th 4s]
Da Newf: folds 
CashMatteo: folds 
lunderk: folds 
dannydkht: calls $0.01
theepan895: checks 
*** FLOP *** [9s 8s 3d]
dannydkht: checks 
theepan895: checks 
*** TURN *** [9s 8s 3d] [Kd]
dannydkht: checks 
theepan895: checks 
*** RIVER *** [9s 8s 3d Kd] [9c]
dannydkht: checks 
theepan895: checks 
*** SHOW DOWN ***
dannydkht: shows [5d 4c] (a pair of Nines)
theepan895: shows [Jh 6d] (a pair of Nines - King+Jack kicker)
theepan895 collected $0.04 from pot
*** SUMMARY ***
Total pot $0.04 | Rake $0 
Board [9s 8s 3d Kd 9c]
Seat 1: lunderk (button) folded before Flop (didn't bet)
Seat 2: dannydkht (small blind) showed [5d 4c] and lost with a pair of Nines
Seat 3: theepan895 (big blind) showed [Jh 6d] and won ($0.04) with a pair of Nines
Seat 4: Da Newf folded before Flop (didn't bet)
Seat 5: CashMatteo folded before Flop (didn't bet)

Hand #2492: 

PokerStars Hand #250571458672:  Hold'em No Limit ($0.01/$0.02 CAD) - 2024/05/18 16:37:24 ET
Table 'Gaussia IV' 6-max Seat #2 is the button
Seat 1: lunderk ($2 in chips) 
Seat 2: dannydkht ($1.57 in chips) 
Seat 3: theepan895 ($2.03 in chips) 
Seat 4: Da Newf ($0.77 in chips) 
Seat 5: CashMatteo ($2.37 in chips) 
theepan895: posts small blind $0.01
Da Newf: posts big blind $0.02
*** HOLE CARDS ***
Dealt to CashMatteo [7s Jd]
CashMatteo: calls $0.02
lunderk: raises $0.04 to $0.06
dannydkht: calls $0.06
theepan895: calls $0.05
Da Newf: calls $0.04
CashMatteo: calls $0.04
*** FLOP *** [Ts 9d 2d]
theepan895: checks 
Da Newf: checks 
CashMatteo: checks 
lunderk: bets $0.15
dannydkht: calls $0.15
theepan895: folds 
Da Newf: folds 
CashMatteo: calls $0.15
*** TURN *** [Ts 9d 2d] [4c]
CashMatteo: checks 
lunderk: checks 
dannydkht: bets $0.56
CashMatteo: folds 
lunderk: folds 
Uncalled bet ($0.56) returned to dannydkht
dannydkht collected $0.72 from pot
dannydkht: doesn't show hand 
*** SUMMARY ***
Total pot $0.75 | Rake $0.03 
Board [Ts 9d 2d 4c]
Seat 1: lunderk folded on the Turn
Seat 2: dannydkht (button) collected ($0.72)
Seat 3: theepan895 (small blind) folded on the Flop
Seat 4: Da Newf (big blind) folded on the Flop
Seat 5: CashMatteo folded on the Turn

Hand #2493: 

PokerStars Hand #250571480706:  Hold'em No Limit ($0.01/$0.02 CAD) - 2024/05/18 16:38:26 ET
Table 'Gaussia IV' 6-max Seat #3 is the button
Seat 1: lunderk ($2 in chips) 
Seat 2: dannydkht ($2.08 in chips) 
Seat 3: theepan895 ($1.97 in chips) 
Seat 4: Da Newf ($0.71 in chips) 
Seat 5: CashMatteo ($2.16 in chips) 
Da Newf: posts small blind $0.01
CashMatteo: posts big blind $0.02
*** HOLE CARDS ***
Dealt to CashMatteo [Kh 8c]
lunderk: folds 
dannydkht has timed out
dannydkht: folds 
theepan895: raises $0.02 to $0.04
Da Newf: folds 
CashMatteo: calls $0.02
*** FLOP *** [2h 8d Ad]
CashMatteo: checks 
theepan895: checks 
*** TURN *** [2h 8d Ad] [5s]
CashMatteo: checks 
theepan895: bets $0.06
CashMatteo: calls $0.06
*** RIVER *** [2h 8d Ad 5s] [3h]
CashMatteo: checks 
theepan895: checks 
*** SHOW DOWN ***
CashMatteo: shows [Kh 8c] (a pair of Eights)
theepan895: mucks hand 
CashMatteo collected $0.20 from pot
*** SUMMARY ***
Total pot $0.21 | Rake $0.01 
Board [2h 8d Ad 5s 3h]
Seat 1: lunderk folded before Flop (didn't bet)
Seat 2: dannydkht folded before Flop (didn't bet)
Seat 3: theepan895 (button) mucked [5h Js]
Seat 4: Da Newf (small blind) folded before Flop
Seat 5: CashMatteo (big blind) showed [Kh 8c] and won ($0.20) with a pair of Eights

Hand #2494: 

PokerStars Hand #250571499174:  Hold'em No Limit ($0.01/$0.02 CAD) - 2024/05/18 16:39:19 ET
Table 'Gaussia IV' 6-max Seat #4 is the button
Seat 1: lunderk ($2 in chips) 
Seat 2: dannydkht ($2.08 in chips) 
Seat 3: theepan895 ($1.87 in chips) 
Seat 4: Da Newf ($0.70 in chips) 
Seat 5: CashMatteo ($2.26 in chips) 
CashMatteo: posts small blind $0.01
lunderk: posts big blind $0.02
*** HOLE CARDS ***
Dealt to CashMatteo [9c Ad]
dannydkht: calls $0.02
theepan895: raises $0.02 to $0.04
Da Newf: folds 
CashMatteo: calls $0.03
lunderk: folds 
dannydkht: calls $0.02
*** FLOP *** [Kh Kc Td]
CashMatteo: checks 
dannydkht: checks 
theepan895: checks 
*** TURN *** [Kh Kc Td] [Qd]
CashMatteo: bets $0.07
dannydkht: folds 
theepan895: raises $0.07 to $0.14
CashMatteo: calls $0.07
*** RIVER *** [Kh Kc Td Qd] [4h]
CashMatteo: checks 
theepan895: checks 
*** SHOW DOWN ***
CashMatteo: shows [9c Ad] (a pair of Kings)
theepan895: mucks hand 
CashMatteo collected $0.41 from pot
*** SUMMARY ***
Total pot $0.42 | Rake $0.01 
Board [Kh Kc Td Qd 4h]
Seat 1: lunderk (big blind) folded before Flop
Seat 2: dannydkht folded on the Turn
Seat 3: theepan895 mucked [Js 8h]
Seat 4: Da Newf (button) folded before Flop (didn't bet)
Seat 5: CashMatteo (small blind) showed [9c Ad] and won ($0.41) with a pair of Kings

Hand #2495: 

PokerStars Hand #250571520264:  Hold'em No Limit ($0.01/$0.02 CAD) - 2024/05/18 16:40:19 ET
Table 'Gaussia IV' 6-max Seat #5 is the button
Seat 1: lunderk ($2 in chips) 
Seat 2: dannydkht ($2.04 in chips) 
Seat 3: theepan895 ($1.69 in chips) 
Seat 4: Da Newf ($0.70 in chips) 
Seat 5: CashMatteo ($2.49 in chips) 
lunderk: posts small blind $0.01
dannydkht: posts big blind $0.02
*** HOLE CARDS ***
Dealt to CashMatteo [6d 2s]
theepan895: raises $0.02 to $0.04
Da Newf: folds 
CashMatteo: folds 
lunderk: folds 
dannydkht: calls $0.02
*** FLOP *** [Td 8s 4s]
dannydkht: checks 
theepan895: checks 
*** TURN *** [Td 8s 4s] [2c]
dannydkht: bets $0.09
theepan895: folds 
Uncalled bet ($0.09) returned to dannydkht
dannydkht collected $0.09 from pot
dannydkht: doesn't show hand 
*** SUMMARY ***
Total pot $0.09 | Rake $0 
Board [Td 8s 4s 2c]
Seat 1: lunderk (small blind) folded before Flop
Seat 2: dannydkht (big blind) collected ($0.09)
Seat 3: theepan895 folded on the Turn
Seat 4: Da Newf folded before Flop (didn't bet)
Seat 5: CashMatteo (button) folded before Flop (didn't bet)

Hand #2496: 

PokerStars Hand #250571529334:  Hold'em No Limit ($0.01/$0.02 CAD) - 2024/05/18 16:40:45 ET
Table 'Gaussia IV' 6-max Seat #1 is the button
Seat 1: lunderk ($2 in chips) 
Seat 2: dannydkht ($2.09 in chips) 
Seat 3: theepan895 ($1.65 in chips) 
Seat 4: Da Newf ($0.70 in chips) 
Seat 5: CashMatteo ($2.49 in chips) 
dannydkht: posts small blind $0.01
theepan895: posts big blind $0.02
*** HOLE CARDS ***
Dealt to CashMatteo [Kd 7d]
Da Newf: folds 
CashMatteo: calls $0.02
lunderk: folds 
dannydkht: calls $0.01
theepan895: raises $0.02 to $0.04
CashMatteo: calls $0.02
dannydkht: calls $0.02
*** FLOP *** [3d Ks 8s]
dannydkht: checks 
theepan895: checks 
CashMatteo: bets $0.06
dannydkht: folds 
theepan895: folds 
Uncalled bet ($0.06) returned to CashMatteo
CashMatteo collected $0.12 from pot
CashMatteo: doesn't show hand 
*** SUMMARY ***
Total pot $0.12 | Rake $0 
Board [3d Ks 8s]
Seat 1: lunderk (button) folded before Flop (didn't bet)
Seat 2: dannydkht (small blind) folded on the Flop
Seat 3: theepan895 (big blind) folded on the Flop
Seat 4: Da Newf folded before Flop (didn't bet)
Seat 5: CashMatteo collected ($0.12)

Hand #2497: 

PokerStars Hand #250571542644:  Hold'em No Limit ($0.01/$0.02 CAD) - 2024/05/18 16:41:24 ET
Table 'Gaussia IV' 6-max Seat #2 is the button
Seat 1: lunderk ($2 in chips) 
Seat 2: dannydkht ($2.05 in chips) 
Seat 3: theepan895 ($1.61 in chips) 
Seat 4: Da Newf ($0.70 in chips) 
Seat 5: CashMatteo ($2.57 in chips) 
theepan895: posts small blind $0.01
Da Newf: posts big blind $0.02
*** HOLE CARDS ***
Dealt to CashMatteo [4d 8h]
CashMatteo: folds 
lunderk: folds 
dannydkht: calls $0.02
theepan895: raises $0.02 to $0.04
Da Newf: calls $0.02
dannydkht: raises $0.14 to $0.18
theepan895: folds 
Da Newf: folds 
Uncalled bet ($0.14) returned to dannydkht
dannydkht collected $0.12 from pot
dannydkht: doesn't show hand 
*** SUMMARY ***
Total pot $0.12 | Rake $0 
Seat 1: lunderk folded before Flop (didn't bet)
Seat 2: dannydkht (button) collected ($0.12)
Seat 3: theepan895 (small blind) folded before Flop
Seat 4: Da Newf (big blind) folded before Flop
Seat 5: CashMatteo folded before Flop (didn't bet)

Hand #2498: 

PokerStars Hand #250571555161:  Hold'em No Limit ($0.01/$0.02 CAD) - 2024/05/18 16:42:00 ET
Table 'Gaussia IV' 6-max Seat #3 is the button
Seat 1: lunderk ($2 in chips) 
Seat 2: dannydkht ($2.13 in chips) 
Seat 3: theepan895 ($1.57 in chips) 
Seat 4: Da Newf ($0.66 in chips) 
Seat 5: CashMatteo ($2.57 in chips) 
Da Newf: posts small blind $0.01
CashMatteo: posts big blind $0.02
*** HOLE CARDS ***
Dealt to CashMatteo [9c Qs]
lunderk: folds 
dannydkht: calls $0.02
theepan895: raises $0.02 to $0.04
Da Newf: calls $0.03
CashMatteo: calls $0.02
dannydkht: calls $0.02
*** FLOP *** [Kd 4c 3s]
Da Newf: checks 
CashMatteo: checks 
dannydkht: checks 
theepan895: checks 
*** TURN *** [Kd 4c 3s] [8h]
Da Newf: checks 
CashMatteo: checks 
dannydkht: bets $0.08
theepan895: raises $0.08 to $0.16
Da Newf: folds 
CashMatteo: folds 
dannydkht: calls $0.08
*** RIVER *** [Kd 4c 3s 8h] [9h]
dannydkht: checks 
theepan895: checks 
*** SHOW DOWN ***
dannydkht: shows [5d 3d] (a pair of Threes)
theepan895: shows [Tc 4d] (a pair of Fours)
theepan895 collected $0.46 from pot
*** SUMMARY ***
Total pot $0.48 | Rake $0.02 
Board [Kd 4c 3s 8h 9h]
Seat 1: lunderk folded before Flop (didn't bet)
Seat 2: dannydkht showed [5d 3d] and lost with a pair of Threes
Seat 3: theepan895 (button) showed [Tc 4d] and won ($0.46) with a pair of Fours
Seat 4: Da Newf (small blind) folded on the Turn
Seat 5: CashMatteo (big blind) folded on the Turn

Hand #2499: 

PokerStars Hand #250571580746:  Hold'em No Limit ($0.01/$0.02 CAD) - 2024/05/18 16:43:14 ET
Table 'Gaussia IV' 6-max Seat #4 is the button
Seat 1: lunderk ($2 in chips) 
Seat 2: dannydkht ($1.93 in chips) 
Seat 3: theepan895 ($1.83 in chips) 
Seat 4: Da Newf ($0.62 in chips) 
Seat 5: CashMatteo ($2.53 in chips) 
CashMatteo: posts small blind $0.01
lunderk: posts big blind $0.02
*** HOLE CARDS ***
Dealt to CashMatteo [Ac Ts]
dannydkht: folds 
theepan895: raises $0.02 to $0.04
Da Newf: folds 
CashMatteo: raises $0.08 to $0.12
lunderk: folds 
theepan895: calls $0.08
*** FLOP *** [Ad Jh Qc]
CashMatteo: bets $0.13
theepan895: folds 
Uncalled bet ($0.13) returned to CashMatteo
CashMatteo collected $0.25 from pot
CashMatteo: doesn't show hand 
*** SUMMARY ***
Total pot $0.26 | Rake $0.01 
Board [Ad Jh Qc]
Seat 1: lunderk (big blind) folded before Flop
Seat 2: dannydkht folded before Flop (didn't bet)
Seat 3: theepan895 folded on the Flop
Seat 4: Da Newf (button) folded before Flop (didn't bet)
Seat 5: CashMatteo (small blind) collected ($0.25)

Hand #2500: 

PokerStars Hand #250571590635:  Hold'em No Limit ($0.01/$0.02 CAD) - 2024/05/18 16:43:43 ET
Table 'Gaussia IV' 6-max Seat #5 is the button
Seat 1: lunderk ($2 in chips) 
Seat 2: dannydkht ($1.93 in chips) 
Seat 3: theepan895 ($1.71 in chips) 
Seat 4: Da Newf ($0.62 in chips) 
Seat 5: CashMatteo ($2.66 in chips) 
lunderk: posts small blind $0.01
dannydkht: posts big blind $0.02
*** HOLE CARDS ***
Dealt to CashMatteo [8c Jh]
theepan895: raises $0.02 to $0.04
Da Newf: folds 
CashMatteo: calls $0.04
lunderk: calls $0.03
dannydkht: calls $0.02
*** FLOP *** [Kd Td 4c]
lunderk: checks 
dannydkht: checks 
theepan895: checks 
CashMatteo: checks 
*** TURN *** [Kd Td 4c] [Js]
lunderk: checks 
dannydkht: checks 
theepan895: bets $0.09
CashMatteo: calls $0.09
lunderk: folds 
dannydkht: folds 
*** RIVER *** [Kd Td 4c Js] [4s]
theepan895: checks 
CashMatteo: bets $0.06
theepan895: calls $0.06
*** SHOW DOWN ***
CashMatteo: shows [8c Jh] (two pair, Jacks and Fours)
theepan895: shows [Kh Ts] (two pair, Kings and Tens)
theepan895 collected $0.44 from pot
*** SUMMARY ***
Total pot $0.46 | Rake $0.02 
Board [Kd Td 4c Js 4s]
Seat 1: lunderk (small blind) folded on the Turn
Seat 2: dannydkht (big blind) folded on the Turn
Seat 3: theepan895 showed [Kh Ts] and won ($0.44) with two pair, Kings and Tens
Seat 4: Da Newf folded before Flop (didn't bet)
Seat 5: CashMatteo (button) showed [8c Jh] and lost with two pair, Jacks and Fours

Hand #2501: 

PokerStars Hand #250571607409:  Hold'em No Limit ($0.01/$0.02 CAD) - 2024/05/18 16:44:32 ET
Table 'Gaussia IV' 6-max Seat #1 is the button
Seat 1: lunderk ($2 in chips) 
Seat 2: dannydkht ($1.89 in chips) 
Seat 3: theepan895 ($1.96 in chips) 
Seat 4: Da Newf ($0.62 in chips) 
Seat 5: CashMatteo ($2.47 in chips) 
dannydkht: posts small blind $0.01
theepan895: posts big blind $0.02
*** HOLE CARDS ***
Dealt to CashMatteo [4s 9c]
Da Newf: folds 
CashMatteo: folds 
lunderk: folds 
dannydkht: folds 
Uncalled bet ($0.01) returned to theepan895
theepan895 collected $0.02 from pot
*** SUMMARY ***
Total pot $0.02 | Rake $0 
Seat 1: lunderk (button) folded before Flop (didn't bet)
Seat 2: dannydkht (small blind) folded before Flop
Seat 3: theepan895 (big blind) collected ($0.02)
Seat 4: Da Newf folded before Flop (didn't bet)
Seat 5: CashMatteo folded before Flop (didn't bet)

Hand #2502: 

PokerStars Hand #250571611253:  Hold'em No Limit ($0.01/$0.02 CAD) - 2024/05/18 16:44:43 ET
Table 'Gaussia IV' 6-max Seat #2 is the button
Seat 1: lunderk ($2 in chips) 
Seat 2: dannydkht ($1.88 in chips) 
Seat 3: theepan895 ($1.97 in chips) 
Seat 4: Da Newf ($0.62 in chips) 
Seat 5: CashMatteo ($2.47 in chips) 
theepan895: posts small blind $0.01
Da Newf: posts big blind $0.02
*** HOLE CARDS ***
Dealt to CashMatteo [7d 3h]
CashMatteo: folds 
lunderk: raises $0.04 to $0.06
dannydkht: calls $0.06
theepan895: calls $0.05
Da Newf: folds 
*** FLOP *** [4c Th 6c]
theepan895: checks 
lunderk: bets $0.10
dannydkht: calls $0.10
theepan895: calls $0.10
*** TURN *** [4c Th 6c] [5s]
theepan895: bets $0.06
lunderk: folds 
dannydkht: calls $0.06
*** RIVER *** [4c Th 6c 5s] [5h]
theepan895: checks 
dannydkht: checks 
*** SHOW DOWN ***
theepan895: shows [9h 8d] (a pair of Fives)
dannydkht: shows [Kd Kh] (two pair, Kings and Fives)
dannydkht collected $0.60 from pot
*** SUMMARY ***
Total pot $0.62 | Rake $0.02 
Board [4c Th 6c 5s 5h]
Seat 1: lunderk folded on the Turn
Seat 2: dannydkht (button) showed [Kd Kh] and won ($0.60) with two pair, Kings and Fives
Seat 3: theepan895 (small blind) showed [9h 8d] and lost with a pair of Fives
Seat 4: Da Newf (big blind) folded before Flop
Seat 5: CashMatteo folded before Flop (didn't bet)

Hand #2503: 

PokerStars Hand #250571625103:  Hold'em No Limit ($0.01/$0.02 CAD) - 2024/05/18 16:45:23 ET
Table 'Gaussia IV' 6-max Seat #3 is the button
Seat 1: lunderk ($2 in chips) 
Seat 2: dannydkht ($2.26 in chips) 
Seat 3: theepan895 ($1.75 in chips) 
Seat 4: Da Newf ($0.60 in chips) 
Seat 5: CashMatteo ($2.47 in chips) 
Da Newf: posts small blind $0.01
CashMatteo: posts big blind $0.02
*** HOLE CARDS ***
Dealt to CashMatteo [Ks 9c]
lunderk: folds 
dannydkht: raises $0.04 to $0.06
theepan895: calls $0.06
Da Newf: folds 
CashMatteo: calls $0.04
*** FLOP *** [Ad 2s Qd]
CashMatteo: checks 
dannydkht: checks 
theepan895: checks 
*** TURN *** [Ad 2s Qd] [Qh]
CashMatteo: checks 
dannydkht: bets $0.09
theepan895: folds 
CashMatteo: folds 
Uncalled bet ($0.09) returned to dannydkht
dannydkht collected $0.18 from pot
dannydkht: doesn't show hand 
*** SUMMARY ***
Total pot $0.19 | Rake $0.01 
Board [Ad 2s Qd Qh]
Seat 1: lunderk folded before Flop (didn't bet)
Seat 2: dannydkht collected ($0.18)
Seat 3: theepan895 (button) folded on the Turn
Seat 4: Da Newf (small blind) folded before Flop
Seat 5: CashMatteo (big blind) folded on the Turn

Hand #2504: 

PokerStars Hand #250571641543:  Hold'em No Limit ($0.01/$0.02 CAD) - 2024/05/18 16:46:11 ET
Table 'Gaussia IV' 6-max Seat #4 is the button
Seat 1: lunderk ($2 in chips) 
Seat 2: dannydkht ($2.38 in chips) 
Seat 3: theepan895 ($1.69 in chips) 
Seat 4: Da Newf ($0.59 in chips) 
Seat 5: CashMatteo ($2.41 in chips) 
CashMatteo: posts small blind $0.01
lunderk: posts big blind $0.02
*** HOLE CARDS ***
Dealt to CashMatteo [Jd 9s]
dannydkht: calls $0.02
Mr.Tappidy was removed from the table for failing to post
Mr.Tappidy leaves the table
theepan895: raises $0.04 to $0.06
Da Newf: folds 
CashMatteo: folds 
lunderk: calls $0.04
dannydkht: calls $0.04
*** FLOP *** [6c 6h Qd]
lunderk: checks 
dannydkht: checks 
theepan895: checks 
*** TURN *** [6c 6h Qd] [Qs]
lunderk: checks 
dannydkht: checks 
theepan895: bets $0.20
lunderk: folds 
dannydkht: folds 
Uncalled bet ($0.20) returned to theepan895
theepan895 collected $0.18 from pot
*** SUMMARY ***
Total pot $0.19 | Rake $0.01 
Board [6c 6h Qd Qs]
Seat 1: lunderk (big blind) folded on the Turn
Seat 2: dannydkht folded on the Turn
Seat 3: theepan895 collected ($0.18)
Seat 4: Da Newf (button) folded before Flop (didn't bet)
Seat 5: CashMatteo (small blind) folded before Flop

Hand #2505: 

PokerStars Hand #250571668066:  Hold'em No Limit ($0.01/$0.02 CAD) - 2024/05/18 16:47:28 ET
Table 'Gaussia IV' 6-max Seat #5 is the button
Seat 1: lunderk ($2 in chips) 
Seat 2: dannydkht ($2.32 in chips) 
Seat 3: theepan895 ($1.81 in chips) 
Seat 4: Da Newf ($0.59 in chips) 
Seat 5: CashMatteo ($2.40 in chips) 
lunderk: posts small blind $0.01
dannydkht: posts big blind $0.02
*** HOLE CARDS ***
Dealt to CashMatteo [9d 9c]
theepan895: raises $0.02 to $0.04
Da Newf: folds 
CashMatteo: raises $0.09 to $0.13
lunderk: folds 
dannydkht: folds 
theepan895: calls $0.09
*** FLOP *** [3s Tc Qs]
theepan895: checks 
CashMatteo: bets $0.14
theepan895: calls $0.14
*** TURN *** [3s Tc Qs] [Jd]
theepan895: bets $0.34
CashMatteo: calls $0.34
*** RIVER *** [3s Tc Qs Jd] [4h]
theepan895: checks 
CashMatteo: checks 
*** SHOW DOWN ***
theepan895: shows [8d Qc] (a pair of Queens)
CashMatteo: mucks hand 
theepan895 collected $1.21 from pot
*** SUMMARY ***
Total pot $1.25 | Rake $0.04 
Board [3s Tc Qs Jd 4h]
Seat 1: lunderk (small blind) folded before Flop
Seat 2: dannydkht (big blind) folded before Flop
Seat 3: theepan895 showed [8d Qc] and won ($1.21) with a pair of Queens
Seat 4: Da Newf folded before Flop (didn't bet)
Seat 5: CashMatteo (button) mucked [9d 9c]

Hand #2506: 

PokerStars Hand #250571681192:  Hold'em No Limit ($0.01/$0.02 CAD) - 2024/05/18 16:48:06 ET
Table 'Gaussia IV' 6-max Seat #1 is the button
Seat 1: lunderk ($2 in chips) 
Seat 2: dannydkht ($2.30 in chips) 
Seat 3: theepan895 ($2.41 in chips) 
Seat 4: Da Newf ($0.59 in chips) 
Seat 5: CashMatteo ($1.79 in chips) 
dannydkht: posts small blind $0.01
theepan895: posts big blind $0.02
*** HOLE CARDS ***
Dealt to CashMatteo [5h 3c]
Da Newf: calls $0.02
CashMatteo: folds 
lunderk: folds 
dannydkht: calls $0.01
theepan895: checks 
*** FLOP *** [Ks 7c Ad]
dannydkht: checks 
theepan895: checks 
Da Newf: checks 
*** TURN *** [Ks 7c Ad] [Js]
dannydkht: checks 
theepan895: bets $0.04
Da Newf: folds 
Howardhof joins the table at seat #6 
dannydkht: calls $0.04
*** RIVER *** [Ks 7c Ad Js] [Kh]
dannydkht: checks 
theepan895: checks 
*** SHOW DOWN ***
dannydkht: shows [Qh 3h] (a pair of Kings)
theepan895: shows [Jh 8h] (two pair, Kings and Jacks)
theepan895 collected $0.14 from pot
*** SUMMARY ***
Total pot $0.14 | Rake $0 
Board [Ks 7c Ad Js Kh]
Seat 1: lunderk (button) folded before Flop (didn't bet)
Seat 2: dannydkht (small blind) showed [Qh 3h] and lost with a pair of Kings
Seat 3: theepan895 (big blind) showed [Jh 8h] and won ($0.14) with two pair, Kings and Jacks
Seat 4: Da Newf folded on the Turn
Seat 5: CashMatteo folded before Flop (didn't bet)

Hand #2507: 

PokerStars Hand #250571704310:  Hold'em No Limit ($0.01/$0.02 CAD) - 2024/05/18 16:49:17 ET
Table 'Gaussia IV' 6-max Seat #2 is the button
Seat 1: lunderk ($2 in chips) 
Seat 2: dannydkht ($2.24 in chips) 
Seat 3: theepan895 ($2.49 in chips) 
Seat 4: Da Newf ($0.57 in chips) 
Seat 5: CashMatteo ($1.79 in chips) 
Seat 6: Howardhof ($2 in chips) 
theepan895: posts small blind $0.01
Da Newf: posts big blind $0.02
Howardhof: posts big blind $0.02
*** HOLE CARDS ***
Dealt to CashMatteo [Kd Th]
CashMatteo: raises $0.03 to $0.05
Howardhof: folds 
lunderk: folds 
dannydkht: folds 
theepan895: calls $0.04
Da Newf: calls $0.03
*** FLOP *** [Qh 8s Qs]
theepan895: checks 
Da Newf: checks 
CashMatteo: checks 
*** TURN *** [Qh 8s Qs] [5d]
theepan895: checks 
Da Newf: checks 
CashMatteo: bets $0.08
theepan895: folds 
Da Newf: folds 
Uncalled bet ($0.08) returned to CashMatteo
CashMatteo collected $0.16 from pot
CashMatteo: doesn't show hand 
*** SUMMARY ***
Total pot $0.17 | Rake $0.01 
Board [Qh 8s Qs 5d]
Seat 1: lunderk folded before Flop (didn't bet)
Seat 2: dannydkht (button) folded before Flop (didn't bet)
Seat 3: theepan895 (small blind) folded on the Turn
Seat 4: Da Newf (big blind) folded on the Turn
Seat 5: CashMatteo collected ($0.16)
Seat 6: Howardhof folded before Flop (didn't bet)

Hand #2508: 

PokerStars Hand #250571718691:  Hold'em No Limit ($0.01/$0.02 CAD) - 2024/05/18 16:50:00 ET
Table 'Gaussia IV' 6-max Seat #3 is the button
Seat 1: lunderk ($2 in chips) 
Seat 2: dannydkht ($2.24 in chips) 
Seat 3: theepan895 ($2.44 in chips) 
Seat 4: Da Newf ($0.52 in chips) 
Seat 5: CashMatteo ($1.90 in chips) 
Seat 6: Howardhof ($1.98 in chips) 
Da Newf: posts small blind $0.01
CashMatteo: posts big blind $0.02
*** HOLE CARDS ***
Dealt to CashMatteo [6d 9c]
Howardhof: folds 
lunderk: folds 
dannydkht: calls $0.02
theepan895: raises $0.02 to $0.04
Da Newf: folds 
CashMatteo: calls $0.02
dannydkht: calls $0.02
*** FLOP *** [3s Js 4s]
CashMatteo: checks 
dannydkht: checks 
theepan895: checks 
*** TURN *** [3s Js 4s] [Ah]
CashMatteo: checks 
dannydkht: checks 
theepan895: bets $0.08
CashMatteo: folds 
dannydkht: folds 
Uncalled bet ($0.08) returned to theepan895
theepan895 collected $0.13 from pot
*** SUMMARY ***
Total pot $0.13 | Rake $0 
Board [3s Js 4s Ah]
Seat 1: lunderk folded before Flop (didn't bet)
Seat 2: dannydkht folded on the Turn
Seat 3: theepan895 (button) collected ($0.13)
Seat 4: Da Newf (small blind) folded before Flop
Seat 5: CashMatteo (big blind) folded on the Turn
Seat 6: Howardhof folded before Flop (didn't bet)

Hand #2509: 

PokerStars Hand #250571739196:  Hold'em No Limit ($0.01/$0.02 CAD) - 2024/05/18 16:51:01 ET
Table 'Gaussia IV' 6-max Seat #4 is the button
Seat 1: lunderk ($2 in chips) 
Seat 2: dannydkht ($2.20 in chips) 
Seat 3: theepan895 ($2.53 in chips) 
Seat 4: Da Newf ($0.51 in chips) 
Seat 5: CashMatteo ($1.86 in chips) 
Seat 6: Howardhof ($1.98 in chips) 
CashMatteo: posts small blind $0.01
Howardhof: posts big blind $0.02
*** HOLE CARDS ***
Dealt to CashMatteo [Jc Kd]
lunderk: folds 
dannydkht has timed out
dannydkht: folds 
theepan895: raises $0.02 to $0.04
Da Newf: folds 
CashMatteo: raises $0.10 to $0.14
Howardhof: folds 
theepan895: calls $0.10
*** FLOP *** [3c Jd 9s]
CashMatteo: bets $0.15
theepan895: folds 
Uncalled bet ($0.15) returned to CashMatteo
CashMatteo collected $0.29 from pot
CashMatteo: doesn't show hand 
*** SUMMARY ***
Total pot $0.30 | Rake $0.01 
Board [3c Jd 9s]
Seat 1: lunderk folded before Flop (didn't bet)
Seat 2: dannydkht folded before Flop (didn't bet)
Seat 3: theepan895 folded on the Flop
Seat 4: Da Newf (button) folded before Flop (didn't bet)
Seat 5: CashMatteo (small blind) collected ($0.29)
Seat 6: Howardhof (big blind) folded before Flop

Hand #2510: 

PokerStars Hand #250571749661:  Hold'em No Limit ($0.01/$0.02 CAD) - 2024/05/18 16:51:32 ET
Table 'Gaussia IV' 6-max Seat #5 is the button
Seat 1: lunderk ($2 in chips) 
Seat 2: dannydkht ($2.20 in chips) 
Seat 3: theepan895 ($2.39 in chips) 
Seat 4: Da Newf ($0.51 in chips) 
Seat 5: CashMatteo ($2.01 in chips) 
Seat 6: Howardhof ($1.96 in chips) 
Howardhof: posts small blind $0.01
lunderk: posts big blind $0.02
*** HOLE CARDS ***
Dealt to CashMatteo [Td 8d]
dannydkht: calls $0.02
theepan895: raises $0.02 to $0.04
Da Newf: calls $0.04
CashMatteo: raises $0.15 to $0.19
Howardhof: calls $0.18
lunderk: folds 
dannydkht: calls $0.17
theepan895: folds 
Da Newf: calls $0.15
*** FLOP *** [9d 6c Qs]
Howardhof: checks 
dannydkht: checks 
Da Newf: checks 
CashMatteo: bets $0.70
Howardhof: folds 
dannydkht: folds 
Da Newf: folds 
Uncalled bet ($0.70) returned to CashMatteo
CashMatteo collected $0.79 from pot
CashMatteo: doesn't show hand 
*** SUMMARY ***
Total pot $0.82 | Rake $0.03 
Board [9d 6c Qs]
Seat 1: lunderk (big blind) folded before Flop
Seat 2: dannydkht folded on the Flop
Seat 3: theepan895 folded before Flop
Seat 4: Da Newf folded on the Flop
Seat 5: CashMatteo (button) collected ($0.79)
Seat 6: Howardhof (small blind) folded on the Flop

Hand #2511: 

PokerStars Hand #250571773198:  Hold'em No Limit ($0.01/$0.02 CAD) - 2024/05/18 16:52:41 ET
Table 'Gaussia IV' 6-max Seat #6 is the button
Seat 1: lunderk ($2 in chips) 
Seat 2: dannydkht ($2.01 in chips) 
Seat 3: theepan895 ($2.35 in chips) 
Seat 4: Da Newf ($0.32 in chips) 
Seat 5: CashMatteo ($2.61 in chips) 
Seat 6: Howardhof ($1.77 in chips) 
lunderk: posts small blind $0.01
dannydkht: posts big blind $0.02
*** HOLE CARDS ***
Dealt to CashMatteo [5d Kd]
theepan895: raises $0.02 to $0.04
Da Newf: folds 
CashMatteo: calls $0.04
Howardhof: calls $0.04
lunderk: calls $0.03
dannydkht: calls $0.02
*** FLOP *** [9c 9s 4d]
lunderk: checks 
dannydkht has timed out
dannydkht: checks 
theepan895: checks 
CashMatteo: checks 
Howardhof: checks 
*** TURN *** [9c 9s 4d] [Th]
lunderk: checks 
dannydkht: checks 
theepan895: bets $0.12
CashMatteo: folds 
Howardhof: calls $0.12
lunderk: folds 
dannydkht: folds 
*** RIVER *** [9c 9s 4d Th] [Qs]
theepan895: checks 
Howardhof: bets $0.42
theepan895: folds 
Uncalled bet ($0.42) returned to Howardhof
Howardhof collected $0.42 from pot
*** SUMMARY ***
Total pot $0.44 | Rake $0.02 
Board [9c 9s 4d Th Qs]
Seat 1: lunderk (small blind) folded on the Turn
Seat 2: dannydkht (big blind) folded on the Turn
Seat 3: theepan895 folded on the River
Seat 4: Da Newf folded before Flop (didn't bet)
Seat 5: CashMatteo folded on the Turn
Seat 6: Howardhof (button) collected ($0.42)

Hand #2512: 

PokerStars Hand #250571799910:  Hold'em No Limit ($0.01/$0.02 CAD) - 2024/05/18 16:54:01 ET
Table 'Gaussia IV' 6-max Seat #1 is the button
Seat 1: lunderk ($2 in chips) 
Seat 2: dannydkht ($1.97 in chips) 
Seat 3: theepan895 ($2.19 in chips) 
Seat 4: Da Newf ($0.32 in chips) 
Seat 5: CashMatteo ($2.57 in chips) 
Seat 6: Howardhof ($2.03 in chips) 
dannydkht: posts small blind $0.01
theepan895: posts big blind $0.02
*** HOLE CARDS ***
Dealt to CashMatteo [8h Jd]
Da Newf: folds 
CashMatteo: calls $0.02
Howardhof: calls $0.02
lunderk: folds 
dannydkht: raises $0.04 to $0.06
theepan895: calls $0.04
CashMatteo: calls $0.04
Howardhof: calls $0.04
*** FLOP *** [Ah 5s 9s]
dannydkht: checks 
theepan895: checks 
CashMatteo: checks 
Howardhof: bets $0.23
dannydkht: folds 
theepan895: calls $0.23
CashMatteo: folds 
*** TURN *** [Ah 5s 9s] [2h]
theepan895: bets $0.50
Howardhof: calls $0.50
*** RIVER *** [Ah 5s 9s 2h] [Ks]
theepan895: checks 
Howardhof: checks 
*** SHOW DOWN ***
theepan895: shows [2d 5c] (two pair, Fives and Deuces)
Howardhof: mucks hand 
theepan895 collected $1.64 from pot
*** SUMMARY ***
Total pot $1.70 | Rake $0.06 
Board [Ah 5s 9s 2h Ks]
Seat 1: lunderk (button) folded before Flop (didn't bet)
Seat 2: dannydkht (small blind) folded on the Flop
Seat 3: theepan895 (big blind) showed [2d 5c] and won ($1.64) with two pair, Fives and Deuces
Seat 4: Da Newf folded before Flop (didn't bet)
Seat 5: CashMatteo folded on the Flop
Seat 6: Howardhof mucked [Ad 4c]

Hand #2513: 

PokerStars Hand #250571824032:  Hold'em No Limit ($0.01/$0.02 CAD) - 2024/05/18 16:55:18 ET
Table 'Gaussia IV' 6-max Seat #2 is the button
Seat 1: lunderk ($2 in chips) 
Seat 2: dannydkht ($1.91 in chips) 
Seat 3: theepan895 ($3.04 in chips) 
Seat 4: Da Newf ($0.32 in chips) 
Seat 5: CashMatteo ($2.51 in chips) 
Seat 6: Howardhof ($1.24 in chips) 
theepan895: posts small blind $0.01
Da Newf: posts big blind $0.02
*** HOLE CARDS ***
Dealt to CashMatteo [2s 5d]
CashMatteo: folds 
Howardhof: folds 
lunderk: folds 
dannydkht: calls $0.02
theepan895: calls $0.01
Da Newf: checks 
*** FLOP *** [Ad 7s 6d]
theepan895: checks 
Da Newf: checks 
dannydkht has timed out
dannydkht: checks 
*** TURN *** [Ad 7s 6d] [Kd]
theepan895: bets $0.04
Da Newf: folds 
dannydkht: calls $0.04
*** RIVER *** [Ad 7s 6d Kd] [5h]
theepan895: checks 
dannydkht: checks 
*** SHOW DOWN ***
theepan895: shows [As 9h] (a pair of Aces)
dannydkht: mucks hand 
theepan895 collected $0.14 from pot
*** SUMMARY ***
Total pot $0.14 | Rake $0 
Board [Ad 7s 6d Kd 5h]
Seat 1: lunderk folded before Flop (didn't bet)
Seat 2: dannydkht (button) mucked [Js Tc]
Seat 3: theepan895 (small blind) showed [As 9h] and won ($0.14) with a pair of Aces
Seat 4: Da Newf (big blind) folded on the Turn
Seat 5: CashMatteo folded before Flop (didn't bet)
Seat 6: Howardhof folded before Flop (didn't bet)

Hand #2514: 

PokerStars Hand #250571836893:  Hold'em No Limit ($0.01/$0.02 CAD) - 2024/05/18 16:56:18 ET
Table 'Gaussia IV' 6-max Seat #3 is the button
Seat 1: lunderk ($2 in chips) 
Seat 2: dannydkht ($1.85 in chips) 
Seat 3: theepan895 ($3.12 in chips) 
Seat 4: Da Newf ($0.30 in chips) 
Seat 5: CashMatteo ($2.51 in chips) 
Seat 6: Howardhof ($1.24 in chips) 
Da Newf: posts small blind $0.01
CashMatteo: posts big blind $0.02
*** HOLE CARDS ***
Dealt to CashMatteo [Ad 3s]
Howardhof: calls $0.02
lunderk: folds 
dannydkht: calls $0.02
theepan895: raises $0.02 to $0.04
Da Newf: calls $0.03
CashMatteo: calls $0.02
Howardhof: raises $0.02 to $0.06
dannydkht: calls $0.04
theepan895: calls $0.02
Da Newf: calls $0.02
CashMatteo: calls $0.02
*** FLOP *** [2s 2d 4d]
Da Newf: checks 
CashMatteo: checks 
Howardhof: checks 
dannydkht: checks 
theepan895: checks 
*** TURN *** [2s 2d 4d] [4s]
Da Newf: checks 
CashMatteo: bets $0.15
Howardhof: folds 
dannydkht: calls $0.15
theepan895: folds 
Da Newf: folds 
*** RIVER *** [2s 2d 4d 4s] [5h]
CashMatteo: bets $0.58
dannydkht: folds 
Uncalled bet ($0.58) returned to CashMatteo
CashMatteo collected $0.58 from pot
CashMatteo: doesn't show hand 
*** SUMMARY ***
Total pot $0.60 | Rake $0.02 
Board [2s 2d 4d 4s 5h]
Seat 1: lunderk folded before Flop (didn't bet)
Seat 2: dannydkht folded on the River
Seat 3: theepan895 (button) folded on the Turn
Seat 4: Da Newf (small blind) folded on the Turn
Seat 5: CashMatteo (big blind) collected ($0.58)
Seat 6: Howardhof folded on the Turn

Hand #2515: 

PokerStars Hand #250571856446:  Hold'em No Limit ($0.01/$0.02 CAD) - 2024/05/18 16:57:48 ET
Table 'Gaussia IV' 6-max Seat #4 is the button
Seat 1: lunderk ($2 in chips) 
Seat 2: dannydkht ($1.64 in chips) 
Seat 3: theepan895 ($3.06 in chips) 
Seat 4: Da Newf ($0.24 in chips) 
Seat 5: CashMatteo ($2.88 in chips) 
Seat 6: Howardhof ($1.18 in chips) 
CashMatteo: posts small blind $0.01
Howardhof: posts big blind $0.02
*** HOLE CARDS ***
Dealt to CashMatteo [8s 2s]
lunderk: folds 
dannydkht: folds 
theepan895: raises $0.02 to $0.04
Da Newf: calls $0.04
CashMatteo: calls $0.03
Howardhof: calls $0.02
*** FLOP *** [7c 3c 4c]
CashMatteo: checks 
Howardhof: checks 
theepan895: checks 
Da Newf: checks 
*** TURN *** [7c 3c 4c] [Qd]
CashMatteo: checks 
Howardhof: checks 
theepan895: bets $0.09
Da Newf: folds 
CashMatteo: folds 
Howardhof: folds 
Uncalled bet ($0.09) returned to theepan895
theepan895 collected $0.15 from pot
*** SUMMARY ***
Total pot $0.16 | Rake $0.01 
Board [7c 3c 4c Qd]
Seat 1: lunderk folded before Flop (didn't bet)
Seat 2: dannydkht folded before Flop (didn't bet)
Seat 3: theepan895 collected ($0.15)
Seat 4: Da Newf (button) folded on the Turn
Seat 5: CashMatteo (small blind) folded on the Turn
Seat 6: Howardhof (big blind) folded on the Turn

Hand #2516: 

PokerStars Hand #250571864909:  Hold'em No Limit ($0.01/$0.02 CAD) - 2024/05/18 16:58:26 ET
Table 'Gaussia IV' 6-max Seat #5 is the button
Seat 1: lunderk ($2 in chips) 
Seat 2: dannydkht ($1.64 in chips) 
Seat 3: theepan895 ($3.17 in chips) 
Seat 4: Da Newf ($0.20 in chips) 
Seat 5: CashMatteo ($2.84 in chips) 
Seat 6: Howardhof ($1.14 in chips) 
Howardhof: posts small blind $0.01
lunderk: posts big blind $0.02
*** HOLE CARDS ***
Dealt to CashMatteo [5d 3h]
dannydkht: calls $0.02
theepan895: raises $0.02 to $0.04
Da Newf: folds 
CashMatteo: folds 
Howardhof: calls $0.03
lunderk: folds 
dannydkht: calls $0.02
*** FLOP *** [5c Jd As]
Howardhof: checks 
dannydkht: checks 
theepan895: checks 
*** TURN *** [5c Jd As] [8c]
Howardhof: bets $0.07
dannydkht: calls $0.07
theepan895: folds 
*** RIVER *** [5c Jd As 8c] [2h]
Howardhof: bets $0.27
dannydkht: folds 
Uncalled bet ($0.27) returned to Howardhof
Howardhof collected $0.27 from pot
*** SUMMARY ***
Total pot $0.28 | Rake $0.01 
Board [5c Jd As 8c 2h]
Seat 1: lunderk (big blind) folded before Flop
Seat 2: dannydkht folded on the River
Seat 3: theepan895 folded on the Turn
Seat 4: Da Newf folded before Flop (didn't bet)
Seat 5: CashMatteo (button) folded before Flop (didn't bet)
Seat 6: Howardhof (small blind) collected ($0.27)

Hand #2517: 

PokerStars Hand #250571880604:  Hold'em No Limit ($0.01/$0.02 CAD) - 2024/05/18 16:59:37 ET
Table 'Gaussia IV' 6-max Seat #6 is the button
Seat 1: lunderk ($2 in chips) 
Seat 2: dannydkht ($1.53 in chips) 
Seat 3: theepan895 ($3.13 in chips) 
Seat 4: Da Newf ($0.20 in chips) 
Seat 5: CashMatteo ($2.84 in chips) 
Seat 6: Howardhof ($1.30 in chips) 
lunderk: posts small blind $0.01
dannydkht: posts big blind $0.02
*** HOLE CARDS ***
Dealt to CashMatteo [Tc 4d]
theepan895: raises $0.02 to $0.04
Da Newf: folds 
CashMatteo: folds 
Howardhof: calls $0.04
lunderk: raises $0.14 to $0.18
dannydkht: folds 
theepan895: folds 
Howardhof: folds 
Uncalled bet ($0.14) returned to lunderk
lunderk collected $0.14 from pot
lunderk: doesn't show hand 
*** SUMMARY ***
Total pot $0.14 | Rake $0 
Seat 1: lunderk (small blind) collected ($0.14)
Seat 2: dannydkht (big blind) folded before Flop
Seat 3: theepan895 folded before Flop
Seat 4: Da Newf folded before Flop (didn't bet)
Seat 5: CashMatteo folded before Flop (didn't bet)
Seat 6: Howardhof (button) folded before Flop

Hand #2518: 

PokerStars Hand #250571886073:  Hold'em No Limit ($0.01/$0.02 CAD) - 2024/05/18 17:00:02 ET
Table 'Gaussia IV' 6-max Seat #1 is the button
Seat 1: lunderk ($2.10 in chips) 
Seat 2: dannydkht ($1.51 in chips) 
Seat 3: theepan895 ($3.09 in chips) 
Seat 4: Da Newf ($0.20 in chips) 
Seat 5: CashMatteo ($2.84 in chips) 
Seat 6: Howardhof ($1.26 in chips) 
dannydkht: posts small blind $0.01
theepan895: posts big blind $0.02
*** HOLE CARDS ***
Dealt to CashMatteo [4h As]
Da Newf: folds 
CashMatteo: calls $0.02
Howardhof: folds 
lunderk: folds 
dannydkht: calls $0.01
theepan895: checks 
*** FLOP *** [9d 3d 6d]
dannydkht: checks 
theepan895: checks 
CashMatteo: checks 
*** TURN *** [9d 3d 6d] [Ts]
dannydkht: checks 
theepan895: bets $0.04
CashMatteo: folds 
dannydkht: calls $0.04
*** RIVER *** [9d 3d 6d Ts] [7d]
dannydkht: checks 
theepan895: checks 
*** SHOW DOWN ***
dannydkht: shows [Jc Qh] (high card Queen)
theepan895: shows [8s Qc] (a straight, Six to Ten)
theepan895 collected $0.14 from pot
*** SUMMARY ***
Total pot $0.14 | Rake $0 
Board [9d 3d 6d Ts 7d]
Seat 1: lunderk (button) folded before Flop (didn't bet)
Seat 2: dannydkht (small blind) showed [Jc Qh] and lost with high card Queen
Seat 3: theepan895 (big blind) showed [8s Qc] and won ($0.14) with a straight, Six to Ten
Seat 4: Da Newf folded before Flop (didn't bet)
Seat 5: CashMatteo folded on the Turn
Seat 6: Howardhof folded before Flop (didn't bet)

Hand #2519: 

PokerStars Hand #250571904389:  Hold'em No Limit ($0.01/$0.02 CAD) - 2024/05/18 17:01:17 ET
Table 'Gaussia IV' 6-max Seat #2 is the button
Seat 1: lunderk ($2.10 in chips) 
Seat 2: dannydkht ($1.45 in chips) 
Seat 3: theepan895 ($3.17 in chips) 
Seat 4: Da Newf ($0.20 in chips) 
Seat 5: CashMatteo ($2.82 in chips) 
Seat 6: Howardhof ($1.26 in chips) 
theepan895: posts small blind $0.01
Da Newf: posts big blind $0.02
*** HOLE CARDS ***
Dealt to CashMatteo [7h 9d]
CashMatteo: folds 
Howardhof: calls $0.02
lunderk: folds 
dannydkht: calls $0.02
theepan895: calls $0.01
Da Newf: checks 
*** FLOP *** [Ad 8d Ah]
theepan895: checks 
Da Newf: checks 
Howardhof: checks 
dannydkht: bets $0.04
theepan895: folds 
Da Newf: folds 
Howardhof: calls $0.04
*** TURN *** [Ad 8d Ah] [Jd]
Howardhof: checks 
dannydkht: checks 
*** RIVER *** [Ad 8d Ah Jd] [Ts]
Howardhof: bets $0.15
dannydkht: folds 
Uncalled bet ($0.15) returned to Howardhof
theepan895 is disconnected 
Howardhof collected $0.15 from pot
*** SUMMARY ***
Total pot $0.16 | Rake $0.01 
Board [Ad 8d Ah Jd Ts]
Seat 1: lunderk folded before Flop (didn't bet)
Seat 2: dannydkht (button) folded on the River
Seat 3: theepan895 (small blind) folded on the Flop
Seat 4: Da Newf (big blind) folded on the Flop
Seat 5: CashMatteo folded before Flop (didn't bet)
Seat 6: Howardhof collected ($0.15)

Hand #2520: 

PokerStars Hand #250571924785:  Hold'em No Limit ($0.01/$0.02 CAD) - 2024/05/18 17:02:20 ET
Table 'Gaussia IV' 6-max Seat #4 is the button
Seat 1: lunderk ($2.10 in chips) 
Seat 2: dannydkht ($1.39 in chips) 
Seat 4: Da Newf ($0.18 in chips) 
Seat 5: CashMatteo ($2.82 in chips) 
Seat 6: Howardhof ($1.35 in chips) 
CashMatteo: posts small blind $0.01
Howardhof: posts big blind $0.02
*** HOLE CARDS ***
Dealt to CashMatteo [7s Kh]
lunderk: raises $0.04 to $0.06
dannydkht: calls $0.06
Da Newf: folds 
CashMatteo: folds 
Howardhof: folds 
*** FLOP *** [3h Qd 3s]
lunderk: bets $0.07
Howardhof leaves the table
dannydkht: calls $0.07
*** TURN *** [3h Qd 3s] [Ad]
lunderk: bets $0.28
dannydkht: folds 
Uncalled bet ($0.28) returned to lunderk
lunderk collected $0.28 from pot
lunderk: doesn't show hand 
service201 joins the table at seat #6 
*** SUMMARY ***
Total pot $0.29 | Rake $0.01 
Board [3h Qd 3s Ad]
Seat 1: lunderk collected ($0.28)
Seat 2: dannydkht folded on the Turn
Seat 4: Da Newf (button) folded before Flop (didn't bet)
Seat 5: CashMatteo (small blind) folded before Flop
Seat 6: Howardhof (big blind) folded before Flop

Hand #2521: 

PokerStars Hand #250571938690:  Hold'em No Limit ($0.01/$0.02 CAD) - 2024/05/18 17:03:03 ET
Table 'Gaussia IV' 6-max Seat #5 is the button
Seat 1: lunderk ($2.25 in chips) 
Seat 2: dannydkht ($1.26 in chips) 
Seat 4: Da Newf ($0.18 in chips) 
Seat 5: CashMatteo ($2.81 in chips) 
service201 will be allowed to play after the button
lunderk: posts small blind $0.01
dannydkht: posts big blind $0.02
*** HOLE CARDS ***
Dealt to CashMatteo [6s 9d]
Da Newf: folds 
CashMatteo: calls $0.02
lunderk: raises $0.02 to $0.04
dannydkht: calls $0.02
CashMatteo: calls $0.02
*** FLOP *** [5c 6d Jd]
lunderk: checks 
dannydkht: checks 
CashMatteo: bets $0.06
lunderk: folds 
dannydkht: folds 
Uncalled bet ($0.06) returned to CashMatteo
CashMatteo collected $0.12 from pot
CashMatteo: doesn't show hand 
*** SUMMARY ***
Total pot $0.12 | Rake $0 
Board [5c 6d Jd]
Seat 1: lunderk (small blind) folded on the Flop
Seat 2: dannydkht (big blind) folded on the Flop
Seat 4: Da Newf folded before Flop (didn't bet)
Seat 5: CashMatteo (button) collected ($0.12)

Hand #2522: 

PokerStars Hand #250571950715:  Hold'em No Limit ($0.01/$0.02 CAD) - 2024/05/18 17:03:38 ET
Table 'Gaussia IV' 6-max Seat #1 is the button
Seat 1: lunderk ($2.21 in chips) 
Seat 2: dannydkht ($1.22 in chips) 
Seat 4: Da Newf ($0.18 in chips) 
Seat 5: CashMatteo ($2.89 in chips) 
Seat 6: service201 ($1.60 in chips) 
dannydkht: posts small blind $0.01
Da Newf: posts big blind $0.02
service201: posts big blind $0.02
*** HOLE CARDS ***
Dealt to CashMatteo [4c 3s]
CashMatteo: raises $0.03 to $0.05
service201: folds 
lunderk: folds 
dannydkht: calls $0.04
Da Newf: folds 
*** FLOP *** [4d 3d Js]
dannydkht: bets $0.14
CashMatteo: calls $0.14
*** TURN *** [4d 3d Js] [Kh]
dannydkht: bets $0.26
CashMatteo: calls $0.26
*** RIVER *** [4d 3d Js Kh] [Jh]
dannydkht: bets $0.77 and is all-in
CashMatteo: folds 
Uncalled bet ($0.77) returned to dannydkht
dannydkht collected $0.91 from pot
dannydkht: doesn't show hand 
*** SUMMARY ***
Total pot $0.94 | Rake $0.03 
Board [4d 3d Js Kh Jh]
Seat 1: lunderk (button) folded before Flop (didn't bet)
Seat 2: dannydkht (small blind) collected ($0.91)
Seat 4: Da Newf (big blind) folded before Flop
Seat 5: CashMatteo folded on the River
Seat 6: service201 folded before Flop (didn't bet)

Hand #2523: 

PokerStars Hand #250571975304:  Hold'em No Limit ($0.01/$0.02 CAD) - 2024/05/18 17:04:50 ET
Table 'Gaussia IV' 6-max Seat #2 is the button
Seat 1: lunderk ($2.21 in chips) 
Seat 2: dannydkht ($1.68 in chips) 
Seat 4: Da Newf ($0.16 in chips) 
Seat 5: CashMatteo ($2.44 in chips) 
Seat 6: service201 ($1.58 in chips) 
Da Newf: posts small blind $0.01
CashMatteo: posts big blind $0.02
*** HOLE CARDS ***
Dealt to CashMatteo [6d 5h]
service201: calls $0.02
lunderk: folds 
dannydkht: folds 
Da Newf: calls $0.01
CashMatteo: checks 
*** FLOP *** [7c Js 6c]
Da Newf: checks 
CashMatteo: bets $0.03
service201: calls $0.03
Da Newf: folds 
*** TURN *** [7c Js 6c] [8d]
CashMatteo: checks 
service201: bets $0.06
CashMatteo: calls $0.06
*** RIVER *** [7c Js 6c 8d] [9s]
CashMatteo: checks 
service201: checks 
*** SHOW DOWN ***
CashMatteo: shows [6d 5h] (a straight, Five to Nine)
service201: mucks hand 
CashMatteo collected $0.23 from pot
*** SUMMARY ***
Total pot $0.24 | Rake $0.01 
Board [7c Js 6c 8d 9s]
Seat 1: lunderk folded before Flop (didn't bet)
Seat 2: dannydkht (button) folded before Flop (didn't bet)
Seat 4: Da Newf (small blind) folded on the Flop
Seat 5: CashMatteo (big blind) showed [6d 5h] and won ($0.23) with a straight, Five to Nine
Seat 6: service201 mucked [Jh 6h]

Hand #2524: 

PokerStars Hand #250571989865:  Hold'em No Limit ($0.01/$0.02 CAD) - 2024/05/18 17:05:33 ET
Table 'Gaussia IV' 6-max Seat #4 is the button
Seat 1: lunderk ($2.21 in chips) 
Seat 2: dannydkht ($1.68 in chips) 
Seat 4: Da Newf ($0.14 in chips) 
Seat 5: CashMatteo ($2.56 in chips) 
Seat 6: service201 ($1.47 in chips) 
CashMatteo: posts small blind $0.01
service201: posts big blind $0.02
*** HOLE CARDS ***
Dealt to CashMatteo [Js 4h]
lunderk: folds 
dannydkht: calls $0.02
Da Newf: calls $0.02
CashMatteo: folds 
service201: checks 
*** FLOP *** [Kh As 3h]
service201: checks 
dannydkht: checks 
Da Newf: bets $0.12 and is all-in
service201: folds 
dannydkht: folds 
Uncalled bet ($0.12) returned to Da Newf
Da Newf collected $0.07 from pot
*** SUMMARY ***
Total pot $0.07 | Rake $0 
Board [Kh As 3h]
Seat 1: lunderk folded before Flop (didn't bet)
Seat 2: dannydkht folded on the Flop
Seat 4: Da Newf (button) collected ($0.07)
Seat 5: CashMatteo (small blind) folded before Flop
Seat 6: service201 (big blind) folded on the Flop

Hand #2525: 

PokerStars Hand #250572000101:  Hold'em No Limit ($0.01/$0.02 CAD) - 2024/05/18 17:06:04 ET
Table 'Gaussia IV' 6-max Seat #5 is the button
Seat 1: lunderk ($2.21 in chips) 
Seat 2: dannydkht ($1.66 in chips) 
Seat 4: Da Newf ($0.19 in chips) 
Seat 5: CashMatteo ($2.55 in chips) 
Seat 6: service201 ($1.45 in chips) 
service201: posts small blind $0.01
lunderk: posts big blind $0.02
*** HOLE CARDS ***
Dealt to CashMatteo [3d 4h]
dannydkht: calls $0.02
Da Newf: folds 
CashMatteo: calls $0.02
service201: calls $0.01
lunderk: checks 
*** FLOP *** [9c Js Jc]
service201: checks 
lunderk: checks 
dannydkht: checks 
CashMatteo: checks 
*** TURN *** [9c Js Jc] [Qs]
service201: checks 
lunderk: checks 
dannydkht: checks 
CashMatteo: folds 
*** RIVER *** [9c Js Jc Qs] [Tc]
CashMatteo leaves the table
service201: bets $0.04
lunderk: folds 
dannydkht: folds 
Uncalled bet ($0.04) returned to service201
service201 collected $0.08 from pot
service201: doesn't show hand 
unXpectedFlava joins the table at seat #5 
*** SUMMARY ***
Total pot $0.08 | Rake $0 
Board [9c Js Jc Qs Tc]
Seat 1: lunderk (big blind) folded on the River
Seat 2: dannydkht folded on the River
Seat 4: Da Newf folded before Flop (didn't bet)
Seat 5: CashMatteo (button) folded on the Turn
Seat 6: service201 (small blind) collected ($0.08)
